TR.NAME,GENE.NAME,N.EXONS,N.INTRONS,TRANSCRIPT.L,EXONS.L,INTRONS.L,AV.INTRON.L,AV.EXON.L,INTRONS.dev.EXONS
NM_032291,SGIP1,25,24,210945,4719,206226,8592.75,188.76,43.70120788
NM_001145278,NECAP2,8,7,19419,2011,17408,2486.857143,251.375,8.656389856
NM_013943,CLIC4,6,5,99057,4440,94617,18923.4,740,21.31013514
NM_018090,NECAP2,8,7,19419,2089,17330,2475.714286,261.125,8.295835328
NM_001145277,NECAP2,7,6,19419,2012,17407,2901.166667,287.4285714,8.651590457
NM_032785,AGBL4,14,13,1491101,3002,1488099,114469.1538,214.4285714,495.7025316
NM_001080397,SLC45A1,8,7,19839,2409,17430,2490,301.125,7.235367372
NM_052998,ADC,12,11,39283,2194,37089,3371.727273,182.8333333,16.9047402
NM_003243,TGFBR3,17,16,205938,6484,199454,12465.875,381.4117647,30.76095003
NM_001918,DBT,11,10,62933,10826,52107,5210.7,984.1818182,4.813135045
NM_001195684,TGFBR3,18,17,225661,6318,219343,12902.52941,351,34.71715733
NM_001195683,TGFBR3,17,16,205938,6481,199457,12466.0625,381.2352941,30.77565191
NM_030806,C1orf21,6,5,242007,10314,231693,46338.6,1719,22.46393252
NM_022457,RFWD2,20,19,262420,2809,259611,13663.73684,140.45,92.42114632
NM_001286644,RFWD2,18,17,262420,2610,259810,15282.94118,145,99.5440613
NM_021222,PRUNE,8,7,27218,2985,24233,3461.857143,373.125,8.118257956
NM_001001740,RFWD2,19,18,262420,2736,259684,14426.88889,144,94.91374269
NM_001270409,LIN9,14,13,78356,3254,75102,5777.076923,232.4285714,23.07990166
NM_001270410,LIN9,15,14,78601,3088,75513,5393.785714,205.8666667,24.45369171
NM_173083,LIN9,15,14,78356,3360,74996,5356.857143,224,22.3202381
NM_199454,PRDM16,17,16,369445,8683,360762,22547.625,510.7647059,41.54808246
NM_022114,PRDM16,17,16,369445,8740,360705,22544.0625,514.1176471,41.27059497
NM_012405,ICMT,5,4,14793,4820,9973,2493.25,964,2.069087137
NM_002744,PRKCZ,18,17,134927,2344,132583,7799,130.2222222,56.56271331
NM_017891,C1orf159,10,9,34540,2114,32426,3602.888889,211.4,15.33869442
NM_001033582,PRKCZ,15,14,80681,2026,78655,5618.214286,135.0666667,38.82280355
NM_001033581,PRKCZ,15,14,111750,2129,109621,7830.071429,141.9333333,51.48943166
NM_001242874,PRKCZ,15,14,111411,2136,109275,7805.357143,142.4,51.15870787
NM_015215,CAMTA1,23,22,984384,8467,975917,44359.86364,368.1304348,115.2612496
NM_032409,PINK1,8,7,18058,2668,15390,2198.571429,333.5,5.768365817
NM_032236,USP48,27,26,104898,4491,100407,3861.807692,166.3333333,22.35738143
NM_017449,EPHB2,16,15,204494,4882,199612,13307.46667,305.125,40.88734125
NM_004442,EPHB2,16,15,204494,4885,199609,13307.26667,305.3125,40.8616172
NM_203343,EPB41,17,16,232957,5706,227251,14203.1875,335.6470588,39.82667368
NM_203342,EPB41,21,20,232957,6015,226942,11347.1,286.4285714,37.72934331
NM_001990,EYA3,18,17,118295,6044,112251,6603,335.7777778,18.57230311
NM_001020658,PUM1,22,21,134213,5407,128806,6133.619048,245.7727273,23.82208249
NM_001166006,EPB41,15,14,150647,2420,148227,10587.64286,161.3333333,61.25082645
NM_001166005,EPB41,21,20,232957,5977,226980,11349,284.6190476,37.97557303
NM_006559,KHDRBS1,9,8,30189,2900,27289,3411.125,322.2222222,9.41
NM_014676,PUM1,22,21,134213,5401,128812,6133.904762,245.5,23.84965747
NM_006600,NUDC,9,8,25151,1822,23329,2916.125,202.4444444,12.80406147
NM_001166007,EPB41,18,17,232957,5795,227162,13362.47059,321.9444444,39.19965487
NM_001271878,KHDRBS1,8,7,30189,2782,27407,3915.285714,347.75,9.851545651
NM_001145454,STMN1,5,4,22318,2243,20075,5018.75,448.6,8.950066875
NM_004437,EPB41,19,18,232957,5837,227120,12617.77778,307.2105263,38.91039918
NM_001282562,EYA3,17,16,118295,5963,112332,7020.75,350.7647059,18.83816871
NM_001282561,EYA3,17,16,118295,5905,112390,7024.375,347.3529412,19.03302286
NM_001282560,EYA3,17,16,111366,1819,109547,6846.6875,107,60.22374931
NM_001281956,CSMD2,71,70,651278,13769,637509,9107.271429,193.9295775,46.3003123
NM_012090,MACF1,93,92,402973,17782,385191,4186.858696,191.2043011,21.66184906
NM_052896,CSMD2,70,69,651846,13188,638658,9255.913043,188.4,48.42720655
NM_005066,SFPQ,10,9,9544,3083,6461,717.8888889,308.3,2.09568602
NM_005119,THRAP3,12,11,80942,4443,76499,6954.454545,370.25,17.21787081
NM_130440,PTPRF,33,32,92798,7739,85059,2658.09375,234.5151515,10.9909549
NM_021639,GPBP1L1,13,12,59328,3751,55577,4631.416667,288.5384615,14.81658224
NM_001194986,TRABD2B,7,6,236364,7036,229328,38221.33333,1005.142857,32.59351904
NM_002840,PTPRF,34,33,92798,7767,85031,2576.69697,228.4411765,10.94772757
NM_018150,RNF220,15,14,246438,3025,243413,17386.64286,201.6666667,80.46710744
NM_007051,FAF1,19,18,519003,2602,516401,28688.94444,136.9473684,198.4631053
NM_021080,DAB1,17,16,1252634,2597,1250037,78127.3125,152.7647059,481.3388525
NM_001193617,SCP2,15,14,124390,2682,121708,8693.428571,178.8,45.37956749
NM_001193600,SCP2,15,14,124390,2608,121782,8698.714286,173.8666667,46.69555215
NM_153035,TCEANC2,5,4,46144,4102,42042,10510.5,820.4,10.24914676
NM_002867,RAB3B,5,4,82810,12849,69961,17490.25,2569.8,5.444859522
NM_002979,SCP2,16,15,124390,2741,121649,8109.933333,171.3125,44.38124772
NM_015306,USP24,68,67,149009,10870,138139,2061.776119,159.8529412,12.70827967
NM_001193599,SCP2,15,14,124390,2668,121722,8694.428571,177.8666667,45.62293853
NM_001198687,LEPR,19,18,104725,3053,101672,5648.444444,160.6842105,33.30232558
NM_001113411,FGGY,17,16,465779,2103,463676,28979.75,123.7058824,220.4831194
NM_001198688,LEPR,19,18,100547,2954,97593,5421.833333,155.4736842,33.03757617
NM_001206739,ITGB3BP,10,9,82505,1136,81369,9041,113.6,71.62764085
NM_001145511,NFIA,11,10,385516,9337,376179,37617.9,848.8181818,40.28906501
NM_020925,CACHD1,27,26,222267,5301,216966,8344.846154,196.3333333,40.92925863
NM_003368,USP1,9,8,15094,3948,11146,1393.25,438.6666667,2.823201621
NM_001017415,USP1,9,8,15502,3518,11984,1498,390.8888889,3.406480955
NM_002303,LEPR,20,19,216843,4181,212662,11192.73684,209.05,50.86390816
NM_018291,FGGY,16,15,465779,2030,463749,30916.6,126.875,228.4477833
NM_001198689,LEPR,19,18,109741,5119,104622,5812.333333,269.4210526,20.43797617
NM_001145512,NFIA,12,11,380928,9227,371701,33791,768.9166667,40.28405766
NM_001134673,NFIA,11,10,380482,9493,370989,37098.9,863,39.08026967
NM_014288,ITGB3BP,9,8,82505,1018,81487,10185.875,113.1111111,80.04616896
NM_001017416,USP1,9,8,15502,3423,12079,1509.875,380.3333333,3.528775928
NM_005595,NFIA,10,9,380482,9400,371082,41231.33333,940,39.47680851
NM_001003680,LEPR,20,19,209762,3089,206673,10877.52632,154.45,66.90611848
NM_001003679,LEPR,20,19,214778,5155,209623,11032.78947,257.75,40.66401552
NM_020794,LRRC7,25,24,363315,6270,357045,14876.875,250.8,56.94497608
NM_173808,NEGR1,7,6,879654,5676,873978,145663,810.8571429,153.9778013
NM_001160011,ST6GALNAC3,4,3,502505,1152,501353,167117.6667,288,435.2022569
NM_005482,PIGK,11,10,130467,4636,125831,12583.1,421.4545455,27.1421484
NM_152996,ST6GALNAC3,5,4,556282,3264,553018,138254.5,652.8,169.4295343
NM_032270,LRRC8C,3,2,86452,7210,79242,39621,2403.333333,10.99056865
NM_012128,CLCA4,14,13,33675,3222,30453,2342.538462,230.1428571,9.451582868
NM_001134445,DDAH1,7,6,259880,4025,255855,42642.5,575,63.56645963
NM_001006605,FAM69A,5,4,119364,2608,116756,29189,521.6,44.76840491
NM_001252273,FAM69A,5,4,128795,878,127917,31979.25,175.6,145.691344
NM_002061,GCLM,7,6,22424,3081,19343,3223.833333,440.1428571,6.278156443
NM_001252269,FAM69A,4,3,119364,2472,116892,38964,618,47.28640777
NM_001252270,FAM69A,4,3,119364,2430,116934,38978,607.5,48.12098765
NM_001252271,FAM69A,5,4,34992,2651,32341,8085.25,530.2,12.19954734
NM_001113228,NTNG1,8,7,341848,3182,338666,48380.85714,397.75,106.4318039
NM_001113226,NTNG1,8,7,341848,3359,338489,48355.57143,419.875,100.7707651
NM_014917,NTNG1,6,5,341732,2938,338794,67758.8,489.6666667,115.3144997
NM_001042679,RHOC,6,5,5931,1301,4630,926,216.8333333,3.558800922
NM_002884,RAP1A,8,7,93698,1820,91878,13125.42857,227.5,50.48241758
NM_006496,GNAI3,9,8,47270,4741,42529,5316.125,526.7777778,8.970470365
NM_001204269,KCNA2,5,4,37896,1964,35932,8983,392.8,18.29531568
NM_001042678,RHOC,5,4,6278,1333,4945,1236.25,266.6,3.709677419
NM_006608,PHTF1,18,17,61955,3262,58693,3452.529412,181.2222222,17.99294911
NM_175744,RHOC,6,5,6278,1403,4875,975,233.8333333,3.474697078
NM_001010935,RAP1A,9,8,93698,1915,91783,11472.875,212.7777778,47.92845953
NM_001200001,NOTCH2,22,21,134583,4333,130250,6202.380952,196.9545455,30.06000462
NM_024408,NOTCH2,34,33,158143,11500,146643,4443.727273,338.2352941,12.75156522
NM_006784,WDR3,27,26,30679,3904,26775,1029.807692,144.5925926,6.85835041
NM_001037675,NBPF9,21,20,215450,4546,210904,10545.2,216.4761905,46.3933128
NM_001201326,PDZK1,7,6,36542,1903,34639,5773.166667,271.8571429,18.20231214
NM_001201325,PDZK1,9,8,36542,2238,34304,4288,248.6666667,15.3279714
NM_002614,PDZK1,10,9,36542,2310,34232,3803.555556,231,14.81904762
NM_001039703,NBPF10,86,85,1172752,11002,1161750,13667.64706,127.9302326,105.5944374
NM_001037501,NBPF8,20,19,215450,4642,210808,11095.15789,232.1,45.41318397
NM_001037501,NBPF8,20,19,772608,4645,767963,40419.10526,232.25,165.3311087
NM_001277444,NBPF9,25,24,755347,5054,750293,31262.20833,202.16,148.4552829
NM_020205,OTUD7B,12,11,70459,6427,64032,5821.090909,535.5833333,9.962968726
NM_001278267,NBPF20,131,130,2320935,17750,2303185,17716.80769,135.4961832,129.7569014
NM_001278191,TPM3,8,7,22919,3066,19853,2836.142857,383.25,6.475212003
NM_001278190,TPM3,7,6,27947,3156,24791,4131.833333,450.8571429,7.855196451
NM_001278189,TPM3,9,8,27947,3300,24647,3080.875,366.6666667,7.468787879
NM_001278188,TPM3,7,6,27947,3085,24862,4143.666667,440.7142857,8.058995138
NM_153649,TPM3,8,7,27947,3220,24727,3532.428571,402.5,7.679192547
NM_152263,TPM3,10,9,30324,7109,23215,2579.444444,710.9,3.265578844
NM_001043353,TPM3,8,7,27947,4547,23400,3342.857143,568.375,5.146250275
NM_001043352,TPM3,8,7,27947,4547,23400,3342.857143,568.375,5.146250275
NM_001043351,TPM3,8,7,27947,3220,24727,3532.428571,402.5,7.679192547
NM_015327,SMG5,22,21,33607,4585,29022,1382,208.4090909,6.329770992
NM_002585,PBX1,9,8,292465,6912,285553,35694.125,768,41.31264468
NM_001204963,PBX1,9,8,292465,4156,288309,36038.625,461.7777778,69.37175168
NM_001204961,PBX1,8,7,292465,6798,285667,40809.57143,849.75,42.02221242
NM_001136219,FCGR2A,7,6,14157,2436,11721,1953.5,348,4.811576355
NM_021642,FCGR2A,7,6,14157,2433,11724,1954,347.5714286,4.818742293
NM_001163629,MROH9,22,21,129296,3187,126109,6005.190476,144.8636364,39.56981487
NM_015569,DNM3,21,20,571241,7668,563573,28178.65,365.1428571,73.4967397
NM_001278252,DNM3,15,14,291916,2357,289559,20682.78571,157.1333333,122.8506576
NM_001136127,DNM3,20,19,571241,7655,563586,29662.42105,382.75,73.62325278
NM_022093,TNN,19,18,80210,5027,75183,4176.833333,264.5789474,14.95583847
NM_025063,MROH9,15,14,63312,2272,61040,4360,151.4666667,26.86619718
NM_005092,TNFSF18,3,2,9745,751,8994,4497,250.3333333,11.97603196
NM_201568,SMG7,22,21,81824,5810,76014,3619.714286,264.0909091,13.08330465
NM_001174061,SMG7,22,21,81824,6066,75758,3607.52381,275.7272727,12.48895483
NM_201569,SMG7,23,22,81824,4802,77022,3501,208.7826087,16.03956685
NM_021165,BRINP2,8,7,110927,3566,107361,15337.28571,445.75,30.1068424
NM_032360,ACBD6,8,7,214672,1624,213048,30435.42857,203,131.1871921
NM_001137669,RGSL1,22,21,110478,3782,106696,5080.761905,171.9090909,28.21152829
NM_003101,SOAT1,16,15,64967,6938,58029,3868.6,433.625,8.363937734
NM_173156,SMG7,22,21,81824,5948,75876,3613.142857,270.3636364,12.75655683
NM_170692,RASAL2,18,17,385786,10899,374887,22052.17647,605.5,34.39645839
NM_001252512,SOAT1,15,14,64967,6811,58156,4154,454.0666667,8.538540596
NM_001252511,SOAT1,15,14,64967,6878,58089,4149.214286,458.5333333,8.445623728
NM_000963,PTGS2,10,9,8617,4503,4114,457.1111111,450.3,0.913613147
NM_194314,ZBTB41,10,9,46860,8484,38376,4264,848.4,4.523338048
NM_133494,NEK7,10,9,165442,4142,161300,17922.22222,414.2,38.94253984
NM_001271887,SRGAP2D,6,5,22703,1073,21630,4326,178.8333333,20.1584343
NM_001271872,SRGAP2C,7,6,65103,2468,62635,10439.16667,352.5714286,25.37884927
NM_001271870,SRGAP2B,7,6,63872,1237,62635,10439.16667,176.7142857,50.63459984
NM_001167858,PPP1R12B,9,8,89542,1722,87820,10977.5,191.3333333,50.99883856
NM_001167857,PPP1R12B,10,9,89542,1836,87706,9745.111111,183.6,47.77015251
NM_002481,PPP1R12B,24,23,239869,11132,228737,9945.086957,463.8333333,20.54770032
NM_015326,SRGAP2,20,19,121585,5994,115591,6083.736842,299.7,19.28445112
NM_001170637,SRGAP2,20,19,121585,5991,115594,6083.894737,299.55,19.29460858
NM_001170580,HHAT,12,11,347000,3642,343358,31214.36364,303.5,94.27732015
NM_206595,ESRRG,8,7,586401,5253,581148,83021.14286,656.625,110.6316391
NM_206594,ESRRG,9,8,586401,5372,581029,72628.625,596.8888889,108.1587863
NM_001134285,ESRRG,9,8,634511,5328,629183,78647.875,592,118.0899024
NM_001122834,HHAT,12,11,348044,3587,344457,31314.27273,298.9166667,96.02927237
NM_018194,HHAT,12,11,347390,3653,343737,31248.81818,304.4166667,94.0971804
NM_001170564,HHAT,10,9,348044,3174,344870,38318.88889,317.4,108.6546944
NM_001243513,ESRRG,8,7,436429,5290,431139,61591.28571,661.25,81.50075614
NM_001243512,ESRRG,9,8,436429,5271,431158,53894.75,585.6666667,81.79814077
NM_001243511,ESRRG,7,6,436431,5115,431316,71886,730.7142857,84.32375367
NM_001243510,ESRRG,8,7,436431,5234,431197,61599.57143,654.25,82.38383645
NM_001243509,ESRRG,9,8,573726,5706,568020,71002.5,634,99.54784437
NM_001243507,ESRRG,8,7,573726,5614,568112,81158.85714,701.75,101.1955825
NM_001243506,ESRRG,7,6,586401,4836,581565,96927.5,690.8571429,120.2574442
NM_001243505,ESRRG,7,6,586610,4766,581844,96974,680.8571429,122.0822493
NM_001170587,HHAT,11,10,347390,3518,343872,34387.2,319.8181818,97.74644684
NM_018664,BATF3,3,2,13570,984,12586,6293,328,12.79065041
NM_206933,USH2A,72,71,800504,18955,781549,11007.73239,263.2638889,41.23181219
NM_001170588,HHAT,11,10,347390,3457,343933,34393.3,314.2727273,99.48886318
NM_001373,DNAH14,84,83,469642,13872,455770,5491.204819,165.1428571,32.85539216
NM_004446,EPRS,32,31,78060,5047,73013,2355.258065,157.71875,14.46661383
NM_145214,TRIM11,6,5,13142,2697,10445,2089,449.5,3.872821654
NM_018230,NUP133,26,25,67046,4196,62850,2514,161.3846154,14.978551
NM_002924,RGS7,18,17,581718,2513,579205,34070.88235,139.6111111,230.4834859
NM_000254,MTR,33,32,108702,10591,98111,3065.96875,320.9393939,9.263620055
NM_001282773,RGS7,16,15,581718,2379,579339,38622.6,148.6875,243.5220681
NM_000081,LYST,53,52,205898,13550,192348,3699,255.6603774,14.19542435
NM_001282778,RGS7,17,16,581718,2458,579260,36203.75,144.5882353,235.6631408
NM_001282775,RGS7,18,17,581718,2540,579178,34069.29412,141.1111111,228.0228346
NM_032752,ZNF496,9,8,31425,2437,28988,3623.5,270.7777778,11.89495281
NM_018012,KIF26B,15,14,548143,7302,540841,38631.5,486.8,74.06751575
NM_022743,SMYD3,12,11,668074,1475,666599,60599.90909,122.9166667,451.9315254
NM_001167740,SMYD3,12,11,758004,1647,756357,68759.72727,137.25,459.2331512
NM_001001918,OR14C36,1,0,940,940,NA,NA,940,NA
NM_001198994,NADK,14,13,28839,3667,25172,1936.307692,261.9285714,6.864466867
NM_001198993,NADK,12,11,27628,3178,24450,2222.727273,264.8333333,7.693517936
NM_033493,CDK11B,20,19,84677,2440,82237,4328.263158,122,33.70368852
NM_033492,CDK11B,20,19,84677,2467,82210,4326.842105,123.35,33.32387515
NM_033489,CDK11B,21,20,84677,2521,82156,4107.8,120.047619,32.5886553
NM_033488,CDK11B,21,20,84677,2488,82189,4109.45,118.4761905,33.03416399
NM_033487,CDK11B,18,17,84677,2211,82466,4850.941176,122.8333333,37.29805518
NM_033486,CDK11B,20,19,84677,2473,82204,4326.526316,123.65,33.24059846
NM_017900,AURKAIP1,4,3,1710,994,716,238.6666667,248.5,0.720321932
NM_001014980,FAM132A,8,7,4278,1051,3227,461,131.375,3.070409134
NM_023018,NADK,12,11,27240,3247,23993,2181.181818,270.5833333,7.389282415
NM_003036,SKI,7,6,81520,5714,75806,12634.33333,816.2857143,13.26671334
NM_001242672,TTC34,7,6,133425,1782,131643,21940.5,254.5714286,73.87373737
NM_003820,TNFRSF14,8,7,7464,1714,5750,821.4285714,214.25,3.354725788
NM_152492,CCDC27,12,11,19246,2186,17060,1550.909091,182.1666667,7.8042086
NM_001282669,DFFB,7,6,28164,3121,25043,4173.833333,445.8571429,8.024030759
NM_001409,MEGF6,37,36,123555,7476,116079,3224.416667,202.0540541,15.52688604
NM_004402,DFFB,7,6,28164,3049,25115,4185.833333,435.5714286,8.237126927
NM_001042478,AJAP1,6,5,122751,2076,120675,24135,346,58.12861272
NM_018836,AJAP1,6,5,128748,2929,125819,25163.8,488.1666667,42.95629908
NM_015102,NPHP4,30,29,129665,5034,124631,4297.62069,167.8,24.75784664
NM_001199863,KCNAB2,14,13,55081,3688,51393,3953.307692,263.4285714,13.93519523
NM_001199861,KCNAB2,16,15,108897,4282,104615,6974.333333,267.625,24.4313405
NM_001199862,KCNAB2,16,15,55274,4172,51102,3406.8,260.75,12.24880153
NM_001199860,KCNAB2,16,15,66907,4298,62609,4173.933333,268.625,14.56700791
NM_003636,KCNAB2,16,15,75182,4224,70958,4730.533333,264,16.79876894
NM_172130,KCNAB2,15,14,75182,4181,71001,5071.5,278.7333333,16.98182253
NM_001265592,PLEKHG5,22,21,31006,4816,26190,1247.142857,218.9090909,5.438122924
NM_198681,PLEKHG5,22,21,53971,5295,48676,2317.904762,240.6818182,9.192823418
NM_001042663,PLEKHG5,22,21,31334,4783,26551,1264.333333,217.4090909,5.551118545
NM_007274,ACOT7,9,8,129496,1814,127682,15960.25,201.5555556,70.38699008
NM_001242701,CAMTA1,4,3,102879,993,101886,33962,248.25,102.6042296
NM_181864,ACOT7,9,8,121553,1634,119919,14989.875,181.5555556,73.38984088
NM_001561,TNFRSF9,9,8,27296,6002,21294,2661.75,666.8888889,3.547817394
NM_001289861,PER3,23,22,60753,6288,54465,2475.681818,273.3913043,8.661736641
NM_001289862,PER3,22,21,60753,6344,54409,2590.904762,288.3636364,8.576450189
NM_001289863,PER3,23,22,60753,6267,54486,2476.636364,272.4782609,8.694112015
NM_001289864,PER3,22,21,60753,6402,54351,2588.142857,291,8.489690722
NM_016831,PER3,22,21,60753,6317,54436,2592.190476,287.1363636,8.617381669
NM_024980,GPR157,4,3,24755,1157,23598,7866,289.25,20.39585134
NM_001042681,RERE,23,22,465237,8032,457205,20782.04545,349.2173913,56.92293327
NM_012102,RERE,24,23,465237,8218,457019,19870.3913,342.4166667,55.61194938
NM_004285,H6PD,5,4,36533,9120,27413,6853.25,1824,3.005811404
NM_001282587,H6PD,5,4,31493,9032,22461,5615.25,1806.4,2.486824624
NM_015074,KIF1B,47,46,170899,10628,160271,3484.152174,226.1276596,15.08007151
NM_183416,KIF1B,21,20,97893,7685,90208,4510.4,365.952381,11.73819128
NM_006048,UBE4B,27,26,148257,5519,142738,5489.923077,204.4074074,25.86301866
NM_020248,CTNNBIP1,6,5,61984,3001,58983,11796.6,500.1666667,19.65444852
NM_014944,CLSTN1,18,17,95473,5180,90293,5311.352941,287.7777778,17.43108108
NM_001105562,UBE4B,28,27,148257,5907,142350,5272.222222,210.9642857,24.09852717
NM_001009566,CLSTN1,19,18,95473,5211,90262,5014.555556,274.2631579,17.32143543
NM_001012329,CTNNBIP1,5,4,61984,2966,59018,14754.5,593.2,19.89817937
NM_001079843,CASZ1,21,20,160069,7980,152089,7604.45,380,19.05877193
NM_001170754,C1orf127,13,12,35566,2774,32792,2732.666667,213.3846154,11.82119683
NM_002685,EXOSC10,24,23,33264,2756,30508,1326.434783,114.8333333,11.06966618
NM_017766,CASZ1,16,15,149472,4454,145018,9667.866667,278.375,32.55904805
NM_004565,PEX14,9,8,155814,1935,153879,19234.875,215,79.52403101
NM_004958,MTOR,58,57,156022,8783,147239,2583.140351,151.4310345,16.76408972
NM_001001998,EXOSC10,25,24,33264,2832,30432,1268,113.28,10.74576271
NM_001281430,TNFRSF8,14,13,80832,3609,77223,5940.230769,257.7857143,21.39733998
NM_001127660,MFN2,18,17,33336,4550,28786,1693.294118,252.7777778,6.326593407
NM_001040195,AGTRAP,4,3,14688,1131,13557,4519,282.75,11.9867374
NM_001243,TNFRSF8,15,14,80832,3701,77131,5509.357143,246.7333333,20.84058363
NM_001040197,AGTRAP,6,5,14688,1286,13402,2680.4,214.3333333,10.4214619
NM_001040196,AGTRAP,6,5,14688,1265,13423,2684.6,210.8333333,10.61106719
NM_001040194,AGTRAP,5,4,14688,1167,13521,3380.25,233.4,11.58611825
NM_014874,MFN2,19,18,33336,4696,28640,1591.111111,247.1578947,6.098807496
NM_020350,AGTRAP,5,4,14688,1188,13500,3375,237.6,11.36363636
NM_015378,VPS13D,70,69,281987,16398,265589,3849.115942,234.2571429,16.19642639
NM_018156,VPS13D,69,68,281987,16322,265665,3906.838235,236.5507246,16.27649798
NM_001013630,AADACL4,4,3,22533,1579,20954,6984.666667,394.75,13.27042432
NM_201628,KAZN,15,14,519333,6037,513296,36664,402.4666667,85.02501242
NM_015209,KAZN,8,7,469440,3913,465527,66503.85714,489.125,118.969333
NM_001018001,KAZN,8,7,138357,3651,134706,19243.71429,456.375,36.89564503
NM_001017999,KAZN,8,7,122238,3661,118577,16939.57143,457.625,32.38923791
NM_052929,FHAD1,31,30,150856,5121,145735,4857.833333,165.1935484,28.45830892
NM_001018000,KAZN,8,7,144028,3850,140178,20025.42857,481.25,36.40987013
NM_015001,SPEN,15,14,92593,12242,80351,5739.357143,816.1333333,6.563551707
NM_001287811,DNAJC16,14,13,44922,5898,39024,3001.846154,421.2857143,6.616480163
NM_015291,DNAJC16,15,14,44922,6084,38838,2774.142857,405.6,6.383629191
NM_018994,FBXO42,10,9,102391,2986,99405,11045,298.6,33.29035499
NM_017459,MFAP2,9,8,7084,1091,5993,749.125,121.2222222,5.493125573
NM_001135247,MFAP2,9,8,7084,1088,5996,749.5,120.8888889,5.511029412
NM_002403,MFAP2,9,8,6176,1110,5066,633.25,123.3333333,4.563963964
NM_013358,PADI1,16,15,40882,3863,37019,2467.933333,241.4375,9.582966606
NM_007365,PADI2,16,15,52694,4379,48315,3221,273.6875,11.03334095
NM_017940,NBPF1,29,28,51180,5976,45204,1614.428571,206.0689655,7.564257028
NM_001135248,MFAP2,9,8,6176,1107,5069,633.625,123,4.579042457
NM_030812,ACTL8,3,2,71752,1864,69888,34944,621.3333333,37.49356223
NM_001011722,ARHGEF10L,27,26,117324,4288,113036,4347.538462,158.8148148,26.36100746
NM_032880,IGSF21,10,9,270739,1954,268785,29865,195.4,137.5562948
NM_018125,ARHGEF10L,29,28,158042,4523,153519,5482.821429,155.9655172,33.94185275
NM_020765,UBR4,106,105,135748,15988,119760,1140.571429,150.8301887,7.490617963
NM_001282162,CAPZB,9,8,145936,2100,143836,17979.5,233.3333333,68.49333333
NM_001206541,CAPZB,9,8,146870,2208,144662,18082.75,245.3333333,65.51721014
NM_001136265,IFFO2,9,8,52054,5844,46210,5776.25,649.3333333,7.907255305
NM_013945,PAX7,8,7,105134,2262,102872,14696,282.75,45.47833775
NM_002584,PAX7,8,7,105134,2268,102866,14695.14286,283.5,45.35537919
NM_001206540,CAPZB,10,9,146870,1902,144968,16107.55556,190.2,76.21871714
NM_001135254,PAX7,9,8,117862,6062,111800,13975,673.5555556,18.44275817
NM_004930,CAPZB,9,8,146870,1788,145082,18135.25,198.6666667,81.14205817
NM_181719,TMCO4,16,15,117706,2990,114716,7647.733333,186.875,38.36655518
NM_001177520,ALPL,10,9,69049,2325,66724,7413.777778,232.5,28.69849462
NM_001127501,ALPL,11,10,69049,2442,66607,6660.7,222,27.27559378
NM_001198803,EIF4G3,15,14,233515,2212,231303,16521.64286,147.4666667,104.5673599
NM_001198802,EIF4G3,35,34,370598,6460,364138,10709.94118,184.5714286,56.36811146
NM_016287,HP1BP3,13,12,44012,3934,40078,3339.833333,302.6153846,10.18759532
NM_001198801,EIF4G3,35,34,370598,6550,364048,10707.29412,187.1428571,55.57984733
NM_000478,ALPL,12,11,69049,2608,66441,6040.090909,217.3333333,25.47584356
NM_001113348,ECE1,19,18,128296,5155,123141,6841.166667,271.3157895,23.88768186
NM_003760,EIF4G3,32,31,305093,6073,299020,9645.806452,189.78125,49.23760909
NM_001039802,CDC42,7,6,40318,2301,38017,6336.166667,328.7142857,16.52194698
NM_014870,ZBTB40,18,17,79308,8722,70586,4152.117647,484.5555556,8.092868608
NM_005529,HSPG2,97,96,115015,14385,100630,1048.229167,148.2989691,6.995481404
NM_044472,CDC42,6,5,38178,1519,36659,7331.8,253.1666667,24.13364055
NM_001013693,LDLRAD2,5,4,12958,4017,8941,2235.25,803.4,2.225790391
NM_001083621,ZBTB40,19,18,79308,9011,70297,3905.388889,474.2631579,7.801242925
NM_001791,CDC42,6,5,40318,2174,38144,7628.8,362.3333333,17.54553818
NM_033631,LUZP1,5,4,84837,8492,76345,19086.25,1698.4,8.990226095
NM_003196,TCEA3,11,10,43708,1597,42111,4211.1,145.1818182,26.36881653
NM_001142546,LUZP1,4,3,84837,8425,76412,25470.66667,2106.25,9.069673591
NM_004091,E2F2,7,6,24794,5200,19594,3265.666667,742.8571429,3.768076923
NM_001010980,NCMAP,4,3,53253,3994,49259,16419.66667,998.5,12.33324987
NM_173065,IFNLR1,6,5,33120,4438,28682,5736.4,739.6666667,6.462821091
NM_020448,NIPAL3,12,11,57230,5438,51792,4708.363636,453.1666667,9.524089739
NM_173064,IFNLR1,7,6,33120,4483,28637,4772.833333,640.4285714,6.387909882
NM_170743,IFNLR1,7,6,33120,4570,28550,4758.333333,652.8571429,6.24726477
NM_020485,RHCE,10,9,58625,1628,56997,6333,162.8,35.01044226
NM_138618,RHCE,9,8,58625,1493,57132,7141.5,165.8888889,38.26657736
NM_138617,RHCE,7,6,58625,1230,57395,9565.833333,175.7142857,46.66260163
NM_138616,RHCE,7,6,58625,1172,57453,9575.5,167.4285714,49.02133106
NM_020379,MAN1C1,12,11,168741,4653,164088,14917.09091,387.75,35.26499033
NM_018202,TMEM57,11,10,69351,3988,65363,6536.3,362.5454545,16.38991976
NM_001289010,MAN1C1,12,11,168741,4472,164269,14933.54545,372.6666667,36.73278175
NM_001282564,TMEM57,9,8,69351,3305,66046,8255.75,367.2222222,19.98366112
NM_031286,SH3BGRL3,3,2,1802,1118,684,342,372.6666667,0.611806798
NM_024674,LIN28A,4,3,18952,4018,14934,4978,1004.5,3.716774515
NM_002953,RPS6KA1,22,21,45273,3221,42052,2002.47619,146.4090909,13.0555728
NM_001029882,AHDC1,7,6,69389,6503,62886,10481,929,9.670306013
NM_032125,TMEM222,6,5,14257,1620,12637,2527.4,270,7.800617284
NM_001201404,WASF2,8,7,85946,5164,80782,11540.28571,645.5,15.64329977
NM_006990,WASF2,9,8,85946,5680,80266,10033.25,631.1111111,14.13133803
NM_005644,TAF12,6,5,39997,1119,38878,7775.6,186.5,34.743521
NM_001048183,PHACTR4,14,13,130790,6225,124565,9581.923077,444.6428571,20.01044177
NM_001048199,RCC1,12,11,33255,2727,30528,2775.272727,227.25,11.19471947
NM_001135218,TAF12,6,5,39997,1456,38541,7708.2,242.6666667,26.47046703
NM_001195001,PTPRU,30,29,90299,5613,84686,2920.206897,187.1,15.0874755
NM_133178,PTPRU,30,29,90299,5622,84677,2919.896552,187.4,15.06172181
NM_005704,PTPRU,31,30,90299,5653,84646,2821.533333,182.3548387,14.97364231
NM_005626,SRSF4,6,5,34389,2536,31853,6370.6,422.6666667,12.56033123
NM_133177,PTPRU,31,30,90299,5635,84664,2822.133333,181.7741935,15.02466726
NM_002379,MATN1,8,7,12310,3838,8472,1210.285714,479.75,2.207399687
NM_001195101,PTP4A2,4,3,13239,3439,9800,3266.666667,859.75,2.8496656
NM_001195100,PTP4A2,4,3,13239,3457,9782,3260.666667,864.25,2.829621059
NM_080391,PTP4A2,6,5,31968,3935,28033,5606.6,655.8333333,7.124015248
NM_001161708,SYNC,4,3,22856,3417,19439,6479.666667,854.25,5.688908399
NM_001127361,RNF19B,9,8,28238,2612,25626,3203.25,290.2222222,9.810872894
NM_012316,KPNA6,14,13,68526,7386,61140,4703.076923,527.5714286,8.277822908
NM_001256121,S100PBP,7,6,41439,4352,37087,6181.166667,621.7142857,8.521829044
NM_001040441,ZBTB8A,5,4,66772,7338,59434,14858.5,1467.6,8.099482148
NM_022753,S100PBP,7,6,41363,4366,36997,6166.166667,623.7142857,8.473889143
NM_153341,RNF19B,9,8,28238,2565,25673,3209.125,285,10.00896686
NM_004964,HDAC1,14,13,41518,2105,39413,3031.769231,150.3571429,18.72351544
NM_030786,SYNC,5,4,22856,3498,19358,4839.5,699.6,5.53401944
NM_145238,ZSCAN20,8,7,23765,4226,19539,2791.285714,528.25,4.62352106
NM_198040,PHC2,14,13,51972,3887,48085,3698.846154,277.6428571,12.37072292
NM_024874,KIAA0319L,21,20,123948,4833,119115,5955.75,230.1428571,24.6461825
NM_024852,AGO3,19,18,125382,3664,121718,6762.111111,192.8421053,33.21997817
NM_017629,AGO4,18,17,49664,7078,42586,2505.058824,393.2222222,6.016671376
NM_005095,ZMYM4,30,29,152979,7024,145955,5032.931034,234.1333333,20.77947039
NM_177422,AGO3,17,16,125382,3404,121978,7623.625,200.2352941,35.83372503
NM_178548,TFAP2E,7,6,21958,2194,19764,3294,313.4285714,9.008204193
NM_032017,STK40,12,11,46310,3906,42404,3854.909091,325.5,10.85611879
NM_000831,GRIK3,16,15,238718,9235,229483,15298.86667,577.1875,24.84926909
NM_001282547,STK40,11,10,46310,3668,42642,4264.2,333.4545455,11.62540894
NM_001282546,STK40,11,10,46310,3683,42627,4262.7,334.8181818,11.5739886
NM_024640,YRDC,5,4,5253,1841,3412,853,368.2,1.853340576
NM_024700,SNIP1,4,3,19897,4609,15288,5096,1152.25,3.316988501
NM_005540,INPP5B,24,23,86362,4478,81884,3560.173913,186.5833333,18.28584189
NM_022157,RRAGC,7,6,21628,2740,18888,3148,391.4285714,6.893430657
NM_001271851,RRAGC,7,6,21628,2638,18990,3165,376.8571429,7.19863533
NM_012421,RLF,8,7,79554,6258,73296,10470.85714,782.25,11.71236817
NM_001720,BMP8B,7,6,30632,3780,26852,4475.333333,540,7.103703704
NM_181809,BMP8A,7,6,38225,5633,32592,5432,804.7142857,5.785904491
NM_001031694,SCMH1,16,15,134235,3363,130872,8724.8,210.1875,38.91525424
NM_001172221,SCMH1,15,14,135820,3249,132571,9469.357143,216.6,40.80363189
NM_001172220,SCMH1,14,13,214946,3087,211859,16296.84615,220.5,68.62941367
NM_001172219,SCMH1,15,14,214946,3159,211787,15127.64286,210.6,67.04241849
NM_001172218,SCMH1,16,15,214946,3369,211577,14105.13333,210.5625,62.80112793
NM_012236,SCMH1,15,14,214946,3297,211649,15117.78571,219.8,64.19441917
NM_172163,KCNQ4,13,12,56442,3950,52492,4374.333333,303.8461538,13.28911392
NM_001172222,SCMH1,9,8,132736,2650,130086,16260.75,294.4444444,49.0890566
NM_004700,KCNQ4,14,13,56442,4113,52329,4025.307692,293.7857143,12.72283005
NM_001127714,HIVEP3,8,7,412344,12327,400017,57145.28571,1540.875,32.45047457
NM_024503,HIVEP3,9,8,412344,12411,399933,49991.625,1379,32.22407542
NM_001198852,FOXJ3,12,11,158678,5124,153554,13959.45455,427,29.96760343
NM_001198851,FOXJ3,15,14,158428,5367,153061,10932.92857,357.8,28.51891187
NM_001198850,FOXJ3,13,12,159340,5322,154018,12834.83333,409.3846154,28.93987223
NM_014947,FOXJ3,13,12,158695,5244,153451,12787.58333,403.3846154,29.26220442
NM_173642,RIMKLA,5,4,43434,10574,32860,8215,2114.8,3.10762247
NM_001242750,LOC100129924,7,6,10242,990,9252,1542,141.4285714,9.345454545
NM_001195831,WDR65,24,23,82030,4189,77841,3384.391304,174.5416667,18.5822392
NM_001253357,TIE1,23,22,22217,3922,18295,831.5909091,170.5217391,4.664711882
NM_015284,SZT2,71,70,64364,14050,50314,718.7714286,197.8873239,3.581067616
NM_005424,TIE1,23,22,22217,4005,18212,827.8181818,174.1304348,4.547315855
NM_152498,WDR65,11,10,38550,3048,35502,3550.2,277.0909091,11.6476378
NM_001167965,WDR65,11,10,38550,3045,35505,3550.5,276.8181818,11.66009852
NM_001270465,ST3GAL3,8,7,223635,1813,221822,31688.85714,226.625,122.3507998
NM_001270466,ST3GAL3,5,4,223635,1484,222151,55537.75,296.8,149.6974394
NM_174968,ST3GAL3,13,12,223635,2438,221197,18433.08333,187.5384615,90.72887613
NM_174967,ST3GAL3,7,6,223635,1629,222006,37001,232.7142857,136.2836096
NM_024066,ERI3,9,8,134199,1752,132447,16555.875,194.6666667,75.59760274
NM_001270460,ST3GAL3,11,10,223635,2181,221454,22145.4,198.2727273,101.5378267
NM_001270461,ST3GAL3,9,8,223635,1930,221705,27713.125,214.4444444,114.873057
NM_001270463,ST3GAL3,8,7,223635,1787,221848,31692.57143,223.375,124.1454952
NM_006279,ST3GAL3,12,11,223635,2275,221360,20123.63636,189.5833333,97.3010989
NM_014652,IPO13,20,19,21218,4047,17171,903.7368421,202.35,4.242895972
NM_001270462,ST3GAL3,8,7,223635,1836,221799,31685.57143,229.5,120.8055556
NM_001270459,ST3GAL3,12,11,223635,2185,221450,20131.81818,182.0833333,101.3501144
NM_001270464,ST3GAL3,8,7,223635,1742,221893,31699,217.75,127.3783008
NM_174969,ST3GAL3,11,10,223635,2226,221409,22140.9,202.3636364,99.46495957
NM_174970,ST3GAL3,6,5,223635,1580,222055,44411,263.3333333,140.5411392
NM_174966,ST3GAL3,10,9,223635,1979,221656,24628.44444,197.9,112.0040424
NM_174965,ST3GAL3,7,6,223635,1674,221961,36993.5,239.1428571,132.59319
NM_174964,ST3GAL3,12,11,223635,2320,221315,20119.54545,193.3333333,95.39439655
NM_174963,ST3GAL3,13,12,223635,2483,221152,18429.33333,191,89.06645187
NM_174971,ST3GAL3,12,11,223635,2389,221246,20113.27273,199.0833333,92.6102972
NM_001166588,EIF2B3,10,9,112195,1600,110595,12288.33333,160,69.121875
NM_020883,ZSWIM5,14,13,190176,5850,184326,14178.92308,417.8571429,31.50871795
NM_020365,EIF2B3,12,11,136202,2039,134163,12196.63636,169.9166667,65.7984306
NM_001261418,EIF2B3,11,10,136202,1934,134268,13426.8,175.8181818,69.42502585
NM_006845,KIF2C,21,20,27950,2901,25049,1252.45,138.1428571,8.634608756
NM_007170,TESK2,11,10,147287,3087,144200,14420,280.6363636,46.71201814
NM_001135553,MKNK1,13,12,46889,2700,44189,3682.416667,207.6923077,16.3662963
NM_003684,MKNK1,14,13,46889,2824,44065,3389.615385,201.7142857,15.60375354
NM_017739,POMGNT1,22,21,9770,2758,7012,333.9047619,125.3636364,2.542422045
NM_198973,MKNK1,12,11,46889,2613,44276,4025.090909,217.75,16.94450823
NM_001243766,POMGNT1,23,22,31626,2959,28667,1303.045455,128.6521739,9.688070294
NM_001114172,PIK3R3,11,10,92898,5187,87711,8771.1,471.5454545,16.90977444
NM_015112,MAST2,29,28,232513,5767,226746,8098.071429,198.862069,39.3178429
NM_003629,PIK3R3,10,9,92570,5685,86885,9653.888889,568.5,15.28320141
NM_001136140,CMPK1,5,4,45044,2788,42256,10564,557.6,15.15638451
NM_016308,CMPK1,6,5,45044,2936,42108,8421.6,489.3333333,14.34196185
NM_178134,CYP4Z1,12,11,50834,1919,48915,4446.818182,159.9166667,25.48983846
NM_001286239,SPATA6,12,11,176838,4978,171860,15623.63636,414.8333333,34.52390518
NM_001286238,SPATA6,13,12,176838,4973,171865,14322.08333,382.5384615,34.55962196
NM_019073,SPATA6,13,12,176838,5021,171817,14318.08333,386.2307692,34.21967736
NM_001144776,ELAVL4,7,6,97960,1880,96080,16013.33333,268.5714286,51.10638298
NM_001144775,ELAVL4,7,6,95578,1891,93687,15614.5,270.1428571,49.54362771
NM_021952,ELAVL4,7,6,92948,2108,90840,15140,301.1428571,43.09297913
NM_001144777,ELAVL4,7,6,153856,1958,151898,25316.33333,279.7142857,77.57814096
NM_001144774,ELAVL4,7,6,92948,2066,90882,15147,295.1428571,43.9893514
NM_024586,OSBPL9,24,23,172347,3902,168445,7323.695652,162.5833333,43.16888775
NM_001981,EPS15,25,24,165062,5245,159817,6659.041667,209.8,30.47035272
NM_001101662,NRD1,31,30,89745,3851,85894,2863.133333,124.2258065,22.30433654
NM_001080494,TTC39A,18,17,35010,2759,32251,1897.117647,153.2777778,11.68938021
NM_148909,OSBPL9,24,23,172347,3932,168415,7322.391304,163.8333333,42.83189217
NM_148908,OSBPL9,23,22,172347,3862,168485,7658.409091,167.9130435,43.6263594
NM_148906,OSBPL9,23,22,172347,3850,168497,7658.954545,167.3913043,43.76545455
NM_002525,NRD1,33,32,89745,4057,85688,2677.75,122.9393939,21.12102539
NM_001242361,NRD1,33,32,88848,3452,85396,2668.625,104.6060606,24.73812283
NM_001144832,TTC39A,18,17,57857,2733,55124,3242.588235,151.8333333,20.1697768
NM_024646,ZYG11B,14,13,100884,8156,92728,7132.923077,582.5714286,11.36929868
NM_032449,CC2D1B,24,23,15614,5678,9936,432,236.5833333,1.749911941
NM_001009881,ZCCHC11,30,29,129816,5880,123936,4273.655172,196,21.07755102
NM_001004339,ZYG11A,14,13,52066,4285,47781,3675.461538,306.0714286,11.15075846
NM_015269,ZCCHC11,30,29,129816,5877,123939,4273.758621,195.9,21.08882083
NM_007324,ZFYVE9,18,17,204594,5036,199558,11738.70588,279.7777778,39.62629071
NM_004799,ZFYVE9,19,18,204594,5214,199380,11076.66667,274.4210526,38.23935558
NM_016126,HSPB11,6,5,24056,607,23449,4689.8,101.1666667,38.63097199
NM_033300,LRP8,17,16,85782,7285,78497,4906.0625,428.5294118,10.77515443
NM_001168551,NDC1,18,17,73093,4723,68370,4021.764706,262.3888889,14.47596866
NM_147193,GLIS1,10,9,227973,2826,225147,25016.33333,282.6,79.66985138
NM_017522,LRP8,16,15,85782,7005,78777,5251.8,437.8125,11.24582441
NM_018087,NDC1,18,17,73093,4843,68250,4014.705882,269.0555556,14.09250465
NM_001018054,LRP8,18,17,85782,7619,78163,4597.823529,423.2777778,10.25895787
NM_004631,LRP8,19,18,85782,7797,77985,4332.5,410.3684211,10.00192382
NM_001031672,CYB5RL,8,7,27721,3541,24180,3454.285714,442.625,6.828579497
NM_001009955,SSBP3,17,16,180966,3190,177776,11111,187.6470588,55.72915361
NM_147161,ACOT11,16,15,62200,3197,59003,3933.533333,199.8125,18.45573976
NM_145716,SSBP3,18,17,180966,3272,177694,10452.58824,181.7777778,54.30745721
NM_018070,SSBP3,17,16,180966,3211,177755,11109.6875,188.8823529,55.35814388
NM_015547,ACOT11,17,16,86612,2032,84580,5286.25,119.5294118,41.62401575
NM_001278544,C8B,13,12,36932,2304,34628,2885.666667,177.2307692,15.02951389
NM_001278543,C8B,13,12,36932,2397,34535,2877.916667,184.3846154,14.40759282
NM_006252,PRKAA2,9,8,70020,9361,60659,7582.375,1040.111111,6.479970089
NM_003713,PPAP2B,6,5,84840,3314,81526,16305.2,552.3333333,24.6004828
NM_000066,C8B,12,11,36932,2174,34758,3159.818182,181.1666667,15.98804048
NM_001004303,C1orf168,20,19,100894,3480,97414,5127.052632,174,27.99252874
NM_145243,OMA1,9,8,66057,1918,64139,8017.375,213.1111111,33.44056309
NM_015888,HOOK1,22,21,61519,5879,55640,2649.52381,267.2272727,9.464194591
NM_001244714,FGGY,14,13,452654,1665,450989,34691.46154,118.9285714,270.8642643
NM_001278224,FGGY,10,9,247103,1180,245923,27324.77778,118,208.409322
NM_181712,KANK4,10,9,83248,5487,77761,8640.111111,548.7,14.17186076
NM_176877,INADL,43,42,421444,8547,412897,9830.880952,198.7674419,48.30899731
NM_001272001,DOCK7,48,47,233644,7137,226507,4819.297872,148.6875,31.73700434
NM_001272000,DOCK7,49,48,233644,7144,226500,4718.75,145.7959184,31.70492721
NM_033407,DOCK7,49,48,233644,7171,226473,4718.1875,146.3469388,31.58178776
NM_032852,ATG4C,11,10,81166,2735,78431,7843.1,248.6363636,28.67678245
NM_178221,ATG4C,11,10,81166,2687,78479,7847.9,244.2727273,29.20692222
NM_001271999,DOCK7,49,48,233644,7231,226413,4716.9375,147.5714286,31.31143687
NM_002633,PGM1,11,10,66971,2483,64488,6448.8,225.7272727,25.9718083
NM_001172819,PGM1,11,10,66438,2360,64078,6407.8,214.5454545,27.15169492
NM_001172818,PGM1,11,10,37031,2569,34462,3446.2,233.5454545,13.41455819
NM_001083592,ROR1,7,6,369364,2299,367065,61177.5,328.4285714,159.6628969
NM_005012,ROR1,9,8,407491,5863,401628,50203.5,651.4444444,68.50213201
NM_203464,AK4,6,5,84598,6893,77705,15541,1148.833333,11.27303061
NM_002227,JAK1,25,24,133283,5078,128205,5341.875,203.12,25.24714455
NM_001005353,AK4,6,5,84317,7004,77313,15462.6,1167.333333,11.03840662
NM_001256865,DNAJC6,20,19,151177,5936,145241,7644.263158,296.8,24.46782345
NM_001256864,DNAJC6,19,18,106336,5987,100349,5574.944444,315.1052632,16.76114916
NM_018211,RAVER2,12,11,88138,4373,83765,7615,364.4166667,19.15504231
NM_014787,DNAJC6,19,18,151177,5822,145355,8075.277778,306.4210526,24.96650636
NM_013410,AK4,5,4,83980,6886,77094,19273.5,1377.2,11.19575951
NM_001037341,PDE4B,17,16,582071,4320,577751,36109.4375,254.1176471,133.7386574
NM_002600,PDE4B,17,16,581408,4275,577133,36070.8125,251.4705882,135.0018713
NM_001037340,PDE4B,15,14,381874,4282,377592,26970.85714,285.4666667,88.18122373
NM_024763,WDR78,17,16,112000,3861,108139,6758.6875,227.1176471,28.00802901
NM_015640,SERBP1,8,7,22632,6709,15923,2274.714286,838.625,2.373379043
NM_144701,IL23R,11,10,93483,2825,90658,9065.8,256.8181818,32.09132743
NM_001018069,SERBP1,8,7,22632,6727,15905,2272.142857,840.875,2.364352609
NM_001018068,SERBP1,8,7,22632,6754,15878,2268.285714,844.25,2.350903168
NM_001018067,SERBP1,8,7,22632,6772,15860,2265.714286,846.5,2.341996456
NM_015139,SLC35D1,12,11,55067,6472,48595,4417.727273,539.3333333,7.508498146
NM_152665,TCTEX1D1,5,4,26592,2269,24323,6080.75,453.8,10.71970031
NM_207014,WDR78,10,9,87290,1758,85532,9503.555556,175.8,48.65301479
NM_024911,WLS,12,11,107245,2808,104437,9494.272727,234,37.19266382
NM_018841,GNG12,4,3,132008,4413,127595,42531.66667,1103.25,28.91343757
NM_001193334,WLS,11,10,107190,2479,104711,10471.1,225.3636364,42.23920936
NM_001114120,DEPDC1,12,11,23071,5450,17621,1601.909091,454.1666667,3.233211009
NM_017779,DEPDC1,11,10,23071,4597,18474,1847.4,417.9090909,4.018707853
NM_001002292,WLS,12,11,134089,2064,132025,12002.27273,172,63.96560078
NM_030816,ANKRD13C,13,12,95734,5680,90054,7504.5,436.9230769,15.85457746
NM_017768,LRRC40,15,14,60878,2960,57918,4137,197.3333333,19.56689189
NM_198716,PTGER3,4,3,195457,1846,193611,64537,461.5,104.8813651
NM_198714,PTGER3,5,4,195457,1939,193518,48379.5,387.8,99.80299123
NM_198718,PTGER3,4,3,95378,1967,93411,31137,491.75,47.48906965
NM_198717,PTGER3,3,2,195457,1818,193639,96819.5,606,106.5121012
NM_001126044,PTGER3,5,4,95378,2060,93318,23329.5,412,45.3
NM_015978,TNNI3K,25,24,309047,3048,305999,12749.95833,121.92,100.3933727
NM_001199327,FPGT-TNNI3K,24,23,266715,2806,263909,11474.30435,116.9166667,94.05167498
NM_001105659,LRRIQ3,8,7,172171,2870,169301,24185.85714,358.75,58.98989547
NM_001112808,FPGT-TNNI3K,27,26,346222,3355,342867,13187.19231,124.2592593,102.1958271
NM_001002912,C1orf173,15,14,105629,7174,98455,7032.5,478.2666667,13.72386395
NM_001130058,SLC44A5,24,23,408985,3918,405067,17611.6087,163.25,103.3861664
NM_002440,MSH4,20,19,116369,3297,113072,5951.157895,164.85,34.29542008
NM_152697,SLC44A5,24,23,404726,2545,402181,17486.13043,106.0416667,158.0278978
NM_030965,ST6GALNAC5,5,4,196553,2037,194516,48629,407.4,95.49140893
NM_017655,GIPC2,6,5,91525,2829,88696,17739.2,471.5,31.35242135
NM_198549,FAM73A,16,15,99918,6423,93495,6233,401.4375,14.55628211
NM_015534,ZZZ3,15,14,118155,4338,113817,8129.785714,289.2,26.23720609
NM_144573,NEXN,13,12,55380,3402,51978,4331.5,261.6923077,15.27865961
NM_001270384,FAM73A,16,15,99918,6426,93492,6232.8,401.625,14.54901961
NM_001172309,NEXN,12,11,55380,3209,52171,4742.818182,267.4166667,16.25771268
NM_012093,AK5,14,13,277369,3950,273419,21032.23077,282.1428571,69.22
NM_174858,AK5,14,13,277994,3339,274655,21127.30769,238.5,82.25666367
NM_022159,ELTD1,15,14,117048,3634,113414,8101,242.2666667,31.20913594
NM_012302,LPHN2,20,19,192027,5726,186301,9805.315789,286.3,32.53597625
NM_024686,TTLL7,21,20,129778,3669,126109,6305.45,174.7142857,34.37149087
NM_001010971,SAMD13,4,3,52434,1571,50863,16954.33333,392.75,32.37619351
NM_002731,PRKACB,10,9,160438,4523,155915,17323.88889,452.3,34.47158965
NM_001242862,PRKACB,9,8,56840,4219,52621,6577.625,468.7777778,12.47238682
NM_001242860,PRKACB,13,12,73534,4321,69213,5767.75,332.3846154,16.01781995
NM_001242861,PRKACB,11,10,73534,4211,69323,6932.3,382.8181818,16.46236048
NM_001242859,PRKACB,12,11,74118,4304,69814,6346.727273,358.6666667,16.22072491
NM_001242858,PRKACB,10,9,74118,4254,69864,7762.666667,425.4,16.42313117
NM_001242857,PRKACB,13,12,74118,4314,69804,5817,331.8461538,16.18080668
NM_001134664,SAMD13,4,3,48149,1409,46740,15580,352.25,33.17246274
NM_001134663,SAMD13,4,3,49194,1565,47629,15876.33333,391.25,30.43386581
NM_182948,PRKACB,10,9,94231,4493,89738,9970.888889,449.3,19.97284665
NM_001288563,WDR63,22,21,70842,2924,67918,3234.190476,132.9090909,23.22777018
NM_145172,WDR63,23,22,70842,3042,67800,3081.818182,132.2608696,22.28796844
NM_012137,DDAH1,6,5,146723,3992,142731,28546.2,665.3333333,35.75425852
NM_012152,LPAR3,3,2,79812,1724,78088,39044,574.6666667,45.29466357
NM_198077,C1orf52,3,2,9720,3266,6454,3227,1088.666667,1.976117575
NM_153259,MCOLN2,14,13,71532,3058,68474,5267.230769,218.4285714,22.39175932
NM_006536,CLCA2,14,13,32473,4038,28435,2187.307692,288.4285714,7.041852402
NM_152890,COL24A1,60,59,427207,6560,420647,7129.610169,109.3333333,64.12301829
NM_012262,HS2ST1,7,6,195348,6765,188583,31430.5,966.4285714,27.87627494
NM_001134492,HS2ST1,5,4,183792,1583,182209,45552.25,316.6,115.1036008
NM_002053,GBP1,11,10,13058,3061,9997,999.7,278.2727273,3.265926168
NM_006256,PKN2,22,21,152018,6126,145892,6947.238095,278.4545455,23.81521384
NM_052941,GBP4,11,10,17804,6156,11648,1164.8,559.6363636,1.892137752
NM_015350,LRRC8B,6,5,39150,7800,31350,6270,1300,4.019230769
NM_001134476,LRRC8B,8,7,73025,7745,65280,9325.714286,968.125,8.428663654
NM_018103,LRRC8D,3,2,114511,3777,110734,55367,1259,29.31797723
NM_001134479,LRRC8D,3,2,115418,3790,111628,55814,1263.333333,29.45329815
NM_001017975,HFM1,39,38,144105,4970,139135,3661.447368,127.4358974,27.99496982
NM_024813,RPAP2,13,12,89212,3125,86087,7173.916667,240.3846154,27.54784
NM_005665,EVI5,18,17,283710,7421,276289,16252.29412,412.2777778,37.23069667
NM_001164392,MTF2,14,13,59848,3971,55877,4298.230769,283.6428571,14.07126668
NM_001164393,MTF2,13,12,59848,3860,55988,4665.666667,296.9230769,14.50466321
NM_001164391,MTF2,16,15,59848,4064,55784,3718.933333,254,13.72637795
NM_007358,MTF2,15,14,59848,4143,55705,3978.928571,276.2,13.44557084
NM_003567,BCAR3,12,11,120053,3197,116856,10623.27273,266.4166667,36.55176728
NM_017737,FNBP1L,15,14,106532,4055,102477,7319.785714,270.3333333,25.27176326
NM_001261409,BCAR3,12,11,119585,3220,116365,10578.63636,268.3333333,36.13819876
NM_001261408,BCAR3,14,13,285365,3236,282129,21702.23077,231.1428571,87.18448702
NM_001024948,FNBP1L,14,13,106532,5357,101175,7782.692308,382.6428571,18.88650364
NM_001164473,FNBP1L,17,16,106532,4231,102301,6393.8125,248.8823529,24.17891751
NM_206886,CCDC18,28,27,98008,4342,93666,3469.111111,155.0714286,21.5720866
NM_002858,ABCD3,23,22,100288,3639,96649,4393.136364,158.2173913,26.55921957
NM_001114106,SLC44A3,15,14,74907,2412,72495,5178.214286,160.8,30.05597015
NM_001258341,SLC44A3,15,14,74907,2313,72594,5185.285714,154.2,31.38521401
NM_001258340,SLC44A3,15,14,74907,2409,72498,5178.428571,160.6,30.09464508
NM_001258342,SLC44A3,14,13,74907,2303,72604,5584.923077,164.5,31.52583587
NM_152369,SLC44A3,14,13,74705,2346,72359,5566.076923,167.5714286,30.84356351
NM_000350,ABCA4,50,49,128313,7375,120938,2468.122449,147.5,16.39837288
NM_001258343,SLC44A3,14,13,74907,2207,72700,5592.307692,157.6428571,32.94064341
NM_001122674,ABCD3,9,8,60329,976,59353,7419.125,108.4444444,60.8125
NM_001199691,TMEM56-RWDD3,8,7,127032,1497,125535,17933.57143,187.125,83.85771543
NM_021190,PTBP2,14,13,93432,3500,89932,6917.846154,250,25.69485714
NM_001160301,DPYD,6,5,201303,1795,199508,39901.6,299.1666667,111.1465181
NM_000110,DPYD,23,22,843317,4470,838847,38129.40909,194.3478261,187.6615213
NM_152238,SNX7,8,7,98822,1620,97202,13886,202.5,60.00123457
NM_015976,SNX7,9,8,98822,1786,97036,12129.5,198.4444444,54.33146697
NM_033055,HIAT1,12,11,45142,2649,42493,3863,220.75,16.0411476
NM_001166252,LPPR4,6,5,45292,4854,40438,8087.6,809,8.330861145
NM_014839,LPPR4,7,6,45292,5029,40263,6710.5,718.4285714,8.006164247
NM_017734,PALMD,8,7,48668,2586,46082,6583.142857,323.25,17.81979892
NM_001199834,VCAM1,9,8,19407,3026,16381,2047.625,336.2222222,5.413417052
NM_001078,VCAM1,9,8,19407,3212,16195,2024.375,356.8888889,5.042029888
NM_080682,VCAM1,8,7,19407,2935,16472,2353.142857,366.875,5.612265758
NM_033313,CDC14A,11,10,132905,2555,130350,13035,232.2727273,51.01761252
NM_033312,CDC14A,15,14,147000,2461,144539,10324.21429,164.0666667,58.73181633
NM_003672,CDC14A,16,15,167812,4286,163526,10901.73333,267.875,38.1535231
NM_001288823,OLFM3,7,6,194669,3534,191135,31855.83333,504.8571429,54.08460668
NM_058170,OLFM3,6,5,194669,3472,191197,38239.4,578.6666667,55.06826037
NM_001854,COL11A1,67,66,232031,7358,224673,3404.136364,109.8208955,30.53452025
NM_080630,COL11A1,65,64,232031,7008,225023,3515.984375,107.8153846,32.10944635
NM_080629,COL11A1,67,66,232031,7394,224637,3403.590909,110.358209,30.38098458
NM_001190709,COL11A1,66,65,232031,7240,224791,3458.323077,109.6969697,31.04848066
NM_001008219,AMY1C,11,10,8871,1871,7000,700,170.0909091,3.741314805
NM_001008221,AMY1A,11,10,9034,1792,7242,724.2,162.9090909,4.041294643
NM_017619,RNPC3,15,14,29283,1900,27383,1955.928571,126.6666667,14.41210526
NM_004038,AMY1A,11,10,8873,1873,7000,700,170.2727273,3.737319808
NM_001008218,AMY1B,11,10,8849,1849,7000,700,168.0909091,3.785830178
NM_001079874,VAV3,10,9,117346,3118,114228,12692,311.8,36.63502245
NM_006113,VAV3,27,26,393765,4796,388969,14960.34615,177.6296296,81.10279399
NM_001267048,KIAA1324,20,19,92820,6791,86029,4527.842105,339.55,12.66809012
NM_020775,KIAA1324,22,21,92820,7054,85766,4084.095238,320.6363636,12.15849164
NM_007269,STXBP3,19,18,62865,2522,60343,3352.388889,132.7368421,23.92664552
NM_001142550,WDR47,15,14,72014,4389,67625,4830.357143,292.6,15.40783778
NM_013296,GPSM2,15,14,53443,3048,50395,3599.642857,203.2,16.53379265
NM_014969,WDR47,15,14,72014,4368,67646,4831.857143,291.2,15.48672161
NM_001265613,MYBPHL,9,8,14678,1312,13366,1670.75,145.7777778,10.1875
NM_001142551,WDR47,15,14,72014,4365,67649,4832.071429,291,15.49805269
NM_001010985,MYBPHL,9,8,14678,1381,13297,1662.125,153.4444444,9.628530051
NM_001284352,KIAA1324,21,20,92820,6963,85857,4292.85,331.5714286,12.33046101
NM_001201545,RBM15,2,1,7360,3322,4038,4038,1661,1.215532812
NM_022768,RBM15,3,2,7360,3434,3926,1963,1144.666667,1.143273151
NM_146421,GSTM1,7,6,5951,1081,4870,811.6666667,154.4285714,4.505087882
NM_000561,GSTM1,8,7,5951,1193,4758,679.7142857,149.125,3.988264878
NM_001039574,KCNC4,4,3,23340,3751,19589,6529.666667,937.75,5.222340709
NM_004978,KCNC4,4,3,23340,4441,18899,6299.666667,1110.25,4.255573069
NM_178454,DRAM2,9,8,22886,1895,20991,2623.875,210.5555556,11.07704485
NM_001081976,ADORA3,6,5,80629,1169,79460,15892,194.8333333,67.97262618
NM_172198,KCND3,7,6,213325,2643,210682,35113.66667,377.5714286,79.71320469
NM_017744,ST7L,15,14,95901,4542,91359,6525.642857,302.8,20.11426684
NM_018704,CTTNBP2NL,6,5,64988,5906,59082,11816.4,984.3333333,10.00372503
NM_138729,ST7L,14,13,77629,2108,75521,5809.307692,150.5714286,35.82590133
NM_138728,ST7L,14,13,95901,4448,91453,7034.846154,317.7142857,20.56047662
NM_138727,ST7L,15,14,95901,4491,91410,6529.285714,299.4,20.35404142
NM_004980,KCND3,8,7,213325,2701,210624,30089.14286,337.625,77.9800074
NM_001142782,MAGI3,21,20,295072,6557,288515,14425.75,312.2380952,44.00106756
NM_014813,LRIG2,18,17,51513,4033,47480,2792.941176,224.0555556,11.77287379
NM_152900,MAGI3,21,20,295072,7242,287830,14391.5,344.8571429,39.74454571
NM_015906,TRIM33,20,19,118384,8359,110025,5790.789474,417.95,13.16245962
NM_001256404,DENND2C,21,20,85538,4535,81003,4050.15,215.952381,17.86174201
NM_198459,DENND2C,18,17,85538,3992,81546,4796.823529,221.7777778,20.42735471
NM_001010922,BCL2L15,4,3,10735,4977,5758,1919.333333,1244.25,1.15692184
NM_205848,SYT6,8,7,63150,4360,58790,8398.571429,545,13.48394495
NM_033020,TRIM33,19,18,118384,8307,110077,6115.388889,437.2105263,13.25111352
NM_001270805,SYT6,8,7,64560,4378,60182,8597.428571,547.25,13.74645957
NM_005725,TSPAN2,8,7,41490,3220,38270,5467.142857,402.5,11.88509317
NM_001282542,SYCP1,31,30,140568,3480,137088,4569.6,112.2580645,39.39310345
NM_003176,SYCP1,32,31,140568,3553,137015,4419.83871,111.03125,38.56318604
NM_002506,NGF,3,2,52322,1052,51270,25635,350.6666667,48.73574144
NM_001232,CASQ2,11,10,68802,2711,66091,6609.1,246.4545455,24.378827
NM_001282541,SYCP1,32,31,140568,3556,137012,4419.741935,111.125,38.52980877
NM_001007237,IGSF3,11,10,93359,7278,86081,8608.1,661.6363636,11.82756252
NM_001767,CD2,5,4,14767,1536,13231,3307.75,307.2,8.613932292
NM_001542,IGSF3,11,10,92560,7200,85360,8536,654.5454545,11.85555556
NM_018420,SLC22A15,12,11,93558,4732,88826,8075.090909,394.3333333,18.77134404
NM_000701,ATP1A1,23,22,31603,3764,27839,1265.409091,163.6521739,7.396121148
NM_024626,VTCN1,6,5,67375,2644,64731,12946.2,440.6666667,24.4822239
NM_006699,MAN1A2,13,12,158237,5401,152836,12736.33333,415.4615385,28.29772264
NM_001256111,CD101,10,9,34803,3344,31459,3495.444444,334.4,9.407595694
NM_001256109,CD101,10,9,34803,3530,31273,3474.777778,353,8.859206799
NM_001256106,CD101,10,9,34803,3561,31242,3471.333333,356.1,8.773378265
NM_001253850,VTCN1,5,4,67375,2295,65080,16270,459,28.35729847
NM_001253849,VTCN1,6,5,60251,2726,57525,11505,454.3333333,21.10234776
NM_004258,CD101,10,9,34803,3573,31230,3470,357.3,8.740554156
NM_206996,SPAG17,49,48,231562,7174,224388,4674.75,146.4081633,31.27794815
NM_015836,WARS2,6,5,109458,2812,106646,21329.2,468.6666667,37.92532006
NM_016527,HAO2,8,7,25351,1484,23867,3409.571429,185.5,16.0828841
NM_201263,WARS2,6,5,109458,2841,106617,21323.4,473.5,37.5279831
NM_001005783,HAO2,9,8,25351,1705,23646,2955.75,189.4444444,13.8686217
NM_001271887,SRGAP2D,6,5,22677,1073,21604,4320.8,178.8333333,20.13420317
NM_001100910,FAM72B,4,3,16678,2378,14300,4766.666667,594.5,6.013456686
NM_203458,NOTCH2NL,5,4,77159,5323,71836,17959,1064.6,13.49539733
NM_022359,PDE4DIP,7,6,124427,1700,122727,20454.5,242.8571429,72.19235294
NM_001198834,PDE4DIP,44,43,143611,8365,135246,3145.255814,190.1136364,16.16808129
NM_014455,RNF115,9,8,78017,1959,76058,9507.25,217.6666667,38.82491067
NM_001198832,PDE4DIP,46,45,188573,8189,180384,4008.533333,178.0217391,22.027598
NM_153713,LIX1L,6,5,24604,4003,20601,4120.2,667.1666667,5.146390207
NM_014644,PDE4DIP,44,43,143611,8421,135190,3143.953488,191.3863636,16.05391284
NM_001195260,PDE4DIP,5,4,45352,962,44390,11097.5,192.4,46.14345114
NM_001195261,PDE4DIP,5,4,43323,1060,42263,10565.75,212,39.87075472
NM_004892,SEC22B,6,5,20592,1889,18703,3740.6,314.8333333,9.901005823
NM_001002812,PDE4DIP,23,22,104444,4858,99586,4526.636364,211.2173913,20.49938246
NM_001002810,PDE4DIP,4,3,43274,1264,42010,14003.33333,316,33.23575949
NM_001144829,FMO5,9,8,41348,1990,39358,4919.75,221.1111111,19.77788945
NM_001278141,NBPF12,37,36,93784,7146,86638,2406.611111,193.1351351,12.12398545
NM_001461,FMO5,9,8,39392,2639,36753,4594.125,293.2222222,13.92686624
NM_001144830,FMO5,7,6,39392,2504,36888,6148,357.7142857,14.73162939
NM_016334,GPR89B,14,13,65249,2130,63119,4855.307692,152.1428571,29.63333333
NM_001101663,NBPF11,21,20,25250,4652,20598,1029.9,221.5238095,4.427773001
NM_001097616,GPR89C,9,8,40190,1578,38612,4826.5,175.3333333,24.46894804
NM_183372,NBPF11,24,23,50148,5491,44657,1941.608696,228.7916667,8.132762703
NM_004326,BCL9,10,9,84751,6202,78549,8727.666667,620.2,12.66510803
NM_001135789,PPIAL4C,1,0,786,786,NA,NA,786,NA
NM_001143883,PPIAL4B,1,0,786,786,NA,NA,786,NA
NM_178230,PPIAL4A,1,0,661,661,NA,NA,661,NA
NM_025150,TARS2,18,17,20247,2807,17440,1025.882353,155.9444444,6.213038831
NM_207168,ENSA,2,1,2578,758,1820,1820,379,2.401055409
NM_007259,VPS45,15,14,78157,2824,75333,5380.928571,188.2666667,26.6759915
NM_001199739,CTSS,7,6,35763,3964,31799,5299.833333,566.2857143,8.021947528
NM_001279353,VPS45,14,13,78157,2366,75791,5830.076923,169,32.03338969
NM_001279354,VPS45,15,14,77782,2469,75313,5379.5,164.6,30.50344269
NM_001271896,TARS2,14,13,20247,2413,17834,1371.846154,172.3571429,7.390799834
NM_001271895,TARS2,16,15,20247,2559,17688,1179.2,159.9375,6.912075029
NM_001279355,VPS45,12,11,77782,2077,75705,6882.272727,173.0833333,36.44920558
NM_015203,RPRD2,11,10,112053,7829,104224,10422.4,711.7272727,13.31255588
NM_207043,ENSA,4,3,6346,2918,3428,1142.666667,729.5,1.174777245
NM_207042,ENSA,5,4,7501,1292,6209,1552.25,258.4,4.805727554
NM_004436,ENSA,4,3,7501,1243,6258,2086,310.75,5.034593725
NM_004079,CTSS,8,7,35763,4115,31648,4521.142857,514.375,7.690886999
NM_207044,ENSA,3,2,6346,2869,3477,1738.5,956.3333333,1.21192053
NM_030918,SNX27,12,11,86899,7097,79802,7254.727273,591.4166667,11.24446949
NM_001194938,POGZ,18,17,56743,6458,50285,2957.941176,358.7777778,7.786466398
NM_001194937,POGZ,19,18,56743,6618,50125,2784.722222,348.3157895,7.574040496
NM_015100,POGZ,19,18,56743,6645,50098,2783.222222,349.7368421,7.539202408
NM_145796,POGZ,17,16,56743,6358,50385,3149.0625,374,7.924661843
NM_020832,ZNF687,9,8,9592,4517,5075,634.375,501.8888889,1.123533319
NM_020127,TUFT1,13,12,43280,3124,40156,3346.333333,240.3076923,12.85403329
NM_207171,POGZ,17,16,39483,6170,33313,2082.0625,362.9411765,5.399189627
NM_001126337,TUFT1,12,11,43280,3048,40232,3657.454545,254,13.19947507
NM_005060,RORC,11,10,25803,3077,22726,2272.6,279.7272727,7.385765356
NM_001001523,RORC,10,9,20008,3046,16962,1884.666667,304.6,5.568614576
NM_001159484,NUP210L,38,37,162426,5464,156962,4242.216216,143.7894737,28.72657394
NM_020699,GATAD2B,11,10,118250,7487,110763,11076.3,680.6363636,14.79404301
NM_001206612,CHTOP,6,5,12326,2172,10154,2030.8,362,4.674953959
NM_001244664,CHTOP,4,3,12326,1845,10481,3493.666667,461.25,5.680758808
NM_207308,NUP210L,40,39,162426,5922,156504,4012.923077,148.05,26.42755826
NM_015607,CHTOP,6,5,12326,2169,10157,2031.4,361.5,4.682803135
NM_001204087,KCNN3,9,8,172814,13074,159740,19967.5,1452.666667,12.21814288
NM_020524,PBXIP1,11,10,12010,3207,8803,880.3,291.5454545,2.744932959
NM_181359,IL6R,9,8,64259,5829,58430,7303.75,647.6666667,10.02401784
NM_002249,KCNN3,8,7,172814,13028,159786,22826.57143,1628.5,12.26481425
NM_001206866,IL6R,7,6,32894,2044,30850,5141.666667,292,15.09295499
NM_000565,IL6R,10,9,64259,5924,58335,6481.666667,592.4,9.8472316
NM_004952,EFNA3,5,4,8668,1787,6881,1720.25,357.4,3.850587577
NM_170782,KCNN3,8,7,162398,11949,150449,21492.71429,1493.625,12.59092811
NM_001282626,LMNA,12,11,25421,3089,22332,2030.181818,257.4166667,7.229524118
NM_170708,LMNA,11,10,25421,3148,22273,2227.3,286.1818182,7.075285896
NM_001256533,MSTO1,14,13,4799,2464,2335,179.6153846,176,0.947646104
NM_001256532,MSTO1,14,13,4799,2497,2302,177.0769231,178.3571429,0.921906288
NM_170707,LMNA,12,11,25421,3239,22182,2016.545455,269.9166667,6.848410003
NM_018116,MSTO1,14,13,4799,2500,2299,176.8461538,178.5714286,0.9196
NM_018489,ASH1L,28,27,227274,11802,215472,7980.444444,421.5,18.25724453
NM_152280,SYT11,4,3,25732,5284,20448,6816,1321,3.869795609
NM_001257374,LMNA,13,12,13974,2075,11899,991.5833333,159.6153846,5.734457831
NM_005572,LMNA,10,9,23198,2080,21118,2346.444444,208,10.15288462
NM_001282625,LMNA,13,12,55322,2507,52815,4401.25,192.8461538,21.06701237
NM_001282624,LMNA,11,10,11751,1763,9988,998.8,160.2727273,5.665343165
NM_005973,PRCC,7,6,33337,2130,31207,5201.166667,304.2857143,14.65117371
NM_144702,LRRC71,15,14,12458,1986,10472,748,132.4,5.272910373
NM_178229,IQGAP3,38,37,47201,6090,41111,1111.108108,160.2631579,6.750574713
NM_031282,FCRL4,12,11,24333,3471,20862,1896.545455,289.25,6.010371651
NM_005894,CD5L,6,5,10932,2243,8689,1737.8,373.8333333,3.873829692
NM_003126,SPTA1,52,51,76012,8069,67943,1332.215686,155.1730769,8.420250341
NM_001206567,IFI16,11,10,45265,2745,42520,4252,249.5454545,15.48998179
NM_005531,IFI16,11,10,45265,2745,42520,4252,249.5454545,15.48998179
NM_001135050,IGSF9,21,20,18559,4065,14494,724.7,193.5714286,3.565559656
NM_002241,KCNJ10,2,1,32796,5308,27488,27488,2654,5.178598342
NM_001231,CASQ1,11,10,11393,1969,9424,942.4,179,4.786185881
NM_020789,IGSF9,21,20,18559,4017,14542,727.1,191.2857143,3.620114513
NM_001284217,FCRL6,11,10,15748,2015,13733,1373.3,183.1818182,6.815384615
NM_001098398,COPA,33,32,54979,5699,49280,1540,172.6969697,8.647131076
NM_004371,COPA,33,32,54979,5672,49307,1540.84375,171.8787879,8.693053597
NM_001004310,FCRL6,10,9,13876,1953,11923,1324.777778,195.3,6.104966718
NM_016382,CD244,9,8,32744,2519,30225,3778.125,279.8888889,11.99880905
NM_012394,PFDN2,4,3,17522,646,16876,5625.333333,161.5,26.12383901
NM_001166664,CD244,8,7,32744,2242,30502,4357.428571,280.25,13.60481713
NM_001166663,CD244,9,8,32744,2534,30210,3776.25,281.5555556,11.92186267
NM_014697,NOS1AP,10,9,300234,4474,295760,32862.22222,447.4,66.10639249
NM_007348,ATF6,16,15,197828,7562,190266,12684.4,472.625,25.16080402
NM_001164757,NOS1AP,10,9,300234,4459,295775,32863.88889,445.9,66.33213725
NM_031423,NUF2,14,13,33832,1857,31975,2459.615385,132.6428571,17.2186322
NM_006182,DDR2,18,17,148021,3182,144839,8519.941176,176.7777778,45.51822753
NM_145697,NUF2,14,13,33832,2003,31829,2448.384615,143.0714286,15.890664
NM_001254748,RGS5,6,5,179494,5818,173676,34735.2,969.6666667,29.85149536
NM_001014796,DDR2,19,18,148021,3263,144758,8042.111111,171.7368421,44.3634692
NM_006917,RXRG,10,9,44435,2205,42230,4692.222222,220.5,19.15192744
NM_001256570,RXRG,11,10,44435,2264,42171,4217.1,205.8181818,18.62676678
NM_001174069,LMX1A,9,8,154376,3365,151011,18876.375,373.8888889,44.8769688
NM_177398,LMX1A,9,8,154850,3554,151296,18912,394.8888889,42.57062465
NM_012474,UCK2,7,6,84125,4927,79198,13199.66667,703.8571429,16.07428455
NM_001017961,FAM78B,2,1,96704,1483,95221,95221,741.5,64.20836143
NM_052862,RCSD1,7,6,76014,2998,73016,12169.33333,428.2857143,24.35490327
NM_001286377,MAEL,11,10,33125,1844,31281,3128.1,167.6363636,16.96366594
NM_002697,POU2F1,16,15,206518,13921,192597,12839.8,870.0625,13.83499749
NM_001198786,POU2F1,15,14,206518,13731,192787,13770.5,915.4,14.04027383
NM_001198783,POU2F1,16,15,98303,14054,84249,5616.6,878.375,5.994663441
NM_001286378,MAEL,13,12,46632,1712,44920,3743.333333,131.6923077,26.23831776
NM_032858,MAEL,12,11,33125,1938,31187,2835.181818,161.5,16.09236326
NM_015415,MPC2,6,5,20396,2160,18236,3647.2,360,8.442592593
NM_152902,TIPRL,7,6,23270,3126,20144,3357.333333,446.5714286,6.444017914
NM_001198957,DCAF6,21,20,139288,3547,135741,6787.05,168.9047619,38.26924161
NM_001198956,DCAF6,22,21,139288,3641,135647,6459.380952,165.5,37.25542433
NM_018442,DCAF6,20,19,139288,3426,135862,7150.631579,171.3,39.65615879
NM_001937,DPT,4,3,33749,1732,32017,10672.33333,433,18.48556582
NM_001017977,DCAF6,19,18,139288,3365,135923,7551.277778,177.1052632,40.39316493
NM_001143674,MPC2,6,5,20396,2226,18170,3634,371,8.16262354
NM_001677,ATP1B1,6,5,26015,2206,23809,4761.8,367.6666667,10.79283772
NM_197972,NME7,12,11,235435,1620,233815,21255.90909,135,144.3302469
NM_013330,NME7,12,11,235435,1651,233784,21253.09091,137.5833333,141.6014537
NM_003666,BLZF1,8,7,28588,2324,26264,3752,290.5,11.30120482
NM_001204514,KIFAP3,21,20,153411,3182,150229,7511.45,151.5238095,47.21213074
NM_014970,KIFAP3,20,19,153411,3017,150394,7915.473684,150.85,49.84885648
NM_001204517,KIFAP3,20,19,147588,4126,143462,7550.631579,206.3,34.77023752
NM_001204516,KIFAP3,19,18,153411,2884,150527,8362.611111,151.7894737,52.19382802
NM_001136107,METTL11B,4,3,21737,942,20795,6931.666667,235.5,22.07537155
NM_006902,PRRX1,5,4,75230,4076,71154,17788.5,815.2,17.45682041
NM_022716,PRRX1,4,3,75230,4003,71227,23742.33333,1000.75,17.79340495
NM_001185127,VAMP4,8,7,42085,5160,36925,5275,645,7.156007752
NM_002022,FMO4,10,9,27739,2149,25590,2843.333333,214.9,11.90786412
NM_001460,FMO2,9,8,27436,5272,22164,2770.5,585.7777778,4.204097117
NM_003762,VAMP4,8,7,42085,5163,36922,5274.571429,645.375,7.151268642
NM_178527,SLC9C2,28,27,102631,4455,98176,3636.148148,159.1071429,22.0372615
NM_018122,DARS2,17,16,33887,3365,30522,1907.625,197.9411765,9.070430906
NM_172071,RC3H1,19,18,61860,11015,50845,2824.722222,579.7368421,4.615978212
NM_014857,RABGAP1L,21,20,798777,3031,795746,39787.3,144.3333333,262.5357968
NM_001007214,CACYBP,6,5,12594,2881,9713,1942.6,480.1666667,3.37139882
NM_014412,CACYBP,6,5,12273,3066,9207,1841.4,511,3.002935421
NM_001243765,RABGAP1L,9,8,195412,6865,188547,23568.375,762.7777778,27.46496723
NM_001243763,RABGAP1L,4,3,83805,732,83073,27691,183,113.4877049
NM_001035230,RABGAP1L,4,3,82673,807,81866,27288.66667,201.75,101.4448575
NM_003285,TNR,23,22,420819,5213,415606,18891.18182,226.6521739,79.72491847
NM_207108,ASTN1,22,21,296088,3923,292165,13912.61905,178.3181818,74.47489166
NM_021936,PAPPA2,5,4,228036,4375,223661,55915.25,875,51.12251429
NM_020318,PAPPA2,23,22,379665,6943,372722,16941.90909,301.8695652,53.68313409
NM_004319,ASTN1,23,22,303842,7356,296486,13476.63636,319.826087,40.30532898
NM_001286164,ASTN1,23,22,307601,4244,303357,13788.95455,184.5217391,71.47902922
NM_001168237,ABL2,13,12,130359,11931,118428,9869,917.7692308,9.926074931
NM_001168236,ABL2,11,10,130359,12175,118184,11818.4,1106.818182,9.707104723
NM_014864,FAM20B,8,7,50630,5954,44676,6382.285714,744.25,7.503527041
NM_007314,ABL2,12,11,130359,12239,118120,10738.18182,1019.916667,9.651115287
NM_001286247,RALGPS2,19,18,196697,7532,189165,10509.16667,396.4210526,25.11484334
NM_001136001,ABL2,10,9,119105,2150,116955,12995,215,54.39767442
NM_001168238,ABL2,12,11,130359,11867,118492,10772,988.9166667,9.985000421
NM_152663,RALGPS2,20,19,196697,7611,189086,9951.894737,380.55,24.84377874
NM_004841,RASAL2,16,15,138044,9835,128209,8547.266667,614.6875,13.0359939
NM_144696,AXDND1,26,25,189017,3668,185349,7413.96,141.0769231,50.53135224
NM_022347,TOR1AIP2,3,2,18778,7077,11701,5850.5,2359,1.653384202
NM_001199091,TDRD5,17,16,99661,3651,96010,6000.625,214.7647059,26.29690496
NM_001199089,TDRD5,18,17,99420,3686,95734,5631.411765,204.7777778,25.97232773
NM_001199260,TOR1AIP2,7,6,37841,8338,29503,4917.166667,1191.142857,3.538378508
NM_001199085,TDRD5,18,17,99652,3973,95679,5628.176471,220.7222222,24.08230556
NM_145034,TOR1AIP2,6,5,37841,7918,29923,5984.6,1319.666667,3.779110887
NM_014810,CEP350,38,37,160109,13494,146615,3962.567568,355.1052632,10.86519935
NM_033343,LHX4,6,5,44757,1885,42872,8574.4,314.1666667,22.74376658
NM_173533,TDRD5,17,16,99652,3810,95842,5990.125,224.1176471,25.15538058
NM_001194999,MR1,7,6,28515,7732,20783,3463.833333,1104.571429,2.687920331
NM_001195035,MR1,5,4,28515,7484,21031,5257.75,1496.8,2.810128274
NM_001531,MR1,7,6,28515,7867,20648,3441.333333,1123.857143,2.624634549
NM_001135669,XPR1,14,13,258271,8315,249956,19227.38462,593.9285714,30.06085388
NM_001195000,MR1,6,5,28515,7590,20925,4185,1265,2.756916996
NM_004736,XPR1,15,14,258271,8511,249760,17840,567.4,29.34555281
NM_000721,CACNA1E,47,46,323237,15006,308231,6700.673913,319.2765957,20.54051713
NM_001205294,CACNA1E,46,45,323237,14948,308289,6850.866667,324.9565217,20.62409687
NM_001205293,CACNA1E,48,47,323237,15136,308101,6555.340426,315.3333333,20.35551004
NM_002293,LAMC1,28,27,122134,7917,114217,4230.259259,282.75,14.42680308
NM_001357,DHX9,28,27,48680,4564,44116,1633.925926,163,9.666082384
NM_015039,NMNAT2,11,10,170264,5571,164693,16469.3,506.4545455,29.56255609
NM_170706,NMNAT2,11,10,56639,5459,51180,5118,496.2727273,9.375343469
NM_001127394,TSEN15,4,3,22535,1820,20715,6905,455,11.38186813
NM_052965,TSEN15,5,4,22535,1963,20572,5143,392.6,10.47987774
NM_015149,RGL1,19,18,292460,5132,287328,15962.66667,270.1052632,55.98752923
NM_025191,EDEM3,20,19,64418,6652,57766,3040.315789,332.6,8.684004811
NM_017673,SWT1,19,18,134624,3865,130759,7264.388889,203.4210526,33.83156533
NM_052966,FAM129A,14,13,183561,6983,176578,13582.92308,498.7857143,25.28683947
NM_001105518,SWT1,19,18,134723,3814,130909,7272.722222,200.7368421,34.32328264
NM_031935,HMCN1,107,106,456404,18319,438085,4132.877358,171.2056075,23.91424204
NM_017847,C1orf27,14,13,45615,3910,41705,3208.076923,279.2857143,10.66624041
NM_001164246,C1orf27,13,12,45615,3813,41802,3483.5,293.3076923,10.96302124
NM_001164245,C1orf27,13,12,45615,3840,41775,3481.25,295.3846154,10.87890625
NM_024420,PLA2G4A,18,17,160083,2946,157137,9243.352941,163.6666667,53.33910387
NM_199051,BRINP3,8,7,379964,2892,377072,53867.42857,361.5,130.384509
NM_130782,RGS18,5,4,27355,2150,25205,6301.25,430,11.72325581
NM_024529,CDC73,17,16,132856,5956,126900,7931.25,350.3529412,21.3062458
NM_197962,GLRX2,4,3,9015,755,8260,2753.333333,188.75,10.94039735
NM_016066,GLRX2,4,3,9651,1138,8513,2837.666667,284.5,7.480667838
NM_001243399,GLRX2,4,3,9594,980,8614,2871.333333,245,8.789795918
NM_001287820,KCNT2,27,26,382653,5800,376853,14494.34615,214.8148148,64.97465517
NM_198503,KCNT2,28,27,382653,6002,376651,13950.03704,214.3571429,62.75424858
NM_001201550,CFHR4,10,9,30701,2191,28510,3167.777778,219.1,13.01232314
NM_006684,CFHR4,6,5,30701,1446,29255,5851,241,20.23167358
NM_001201551,CFHR4,10,9,30701,2188,28513,3168.111111,218.8,13.03153565
NM_001287819,KCNT2,27,26,382653,5929,376724,14489.38462,219.5925926,63.53921403
NM_144977,DENND1B,16,15,223240,2361,220879,14725.26667,147.5625,93.55315544
NM_001257965,CRB1,15,14,276995,5079,271916,19422.57143,338.6,53.53731049
NM_001257966,CRB1,10,9,210253,3408,206845,22982.77778,340.8,60.6939554
NM_001195215,DENND1B,23,22,270746,8400,262346,11924.81818,365.2173913,31.23166667
NM_001193640,CRB1,10,9,210253,4680,205573,22841.44444,468,43.9258547
NM_201253,CRB1,12,11,210253,5018,205235,18657.72727,418.1666667,40.89976086
NM_080921,PTPRC,30,29,118509,4976,113533,3914.931034,165.8666667,22.81611736
NM_002838,PTPRC,33,32,118509,5462,113047,3532.71875,165.5151515,20.69699744
NM_001276464,NR5A2,7,6,134599,4784,129815,21635.83333,683.4285714,27.13524247
NM_205860,NR5A2,8,7,149822,5092,144730,20675.71429,636.5,28.4230165
NM_003822,NR5A2,7,6,149822,4953,144869,24144.83333,707.5714286,29.24873814
NM_203459,CAMSAP2,17,16,121147,7368,113779,7111.1875,433.4117647,15.44231813
NM_000069,CACNA1S,44,43,73056,6212,66844,1554.511628,141.1818182,10.76046362
NM_001164586,IGFN1,24,23,38129,11834,26295,1143.26087,493.0833333,2.221987494
NM_014875,KIF14,30,29,69239,7307,61932,2135.586207,243.5666667,8.475708225
NM_001193570,CSRP1,6,5,23731,1944,21787,4357.4,324,11.20730453
NM_020443,NAV1,30,29,178654,13053,165601,5710.37931,435.1,12.68681529
NM_001167738,NAV1,27,26,87141,11710,75431,2901.192308,433.7037037,6.441588386
NM_018085,IPO9,24,23,55136,11440,43696,1899.826087,476.6666667,3.81958042
NM_001017404,LGR6,16,15,105608,3057,102551,6836.733333,191.0625,33.54628721
NM_001017403,LGR6,18,17,125773,3476,122297,7193.941176,193.1111111,35.18325662
NM_001256129,ARL8A,6,5,11341,1733,9608,1921.6,288.8333333,5.544143104
NM_021636,LGR6,18,17,115986,3363,112623,6624.882353,186.8333333,33.48884924
NM_138795,ARL8A,7,6,11341,1802,9539,1589.833333,257.4285714,5.293562708
NM_001114309,ELF3,9,8,6627,3256,3371,421.375,361.7777778,1.03531941
NM_001193572,CSRP1,6,5,13045,1924,11121,2224.2,320.6666667,5.78014553
NM_001193571,CSRP1,6,5,23311,1988,21323,4264.6,331.3333333,10.72585513
NM_004433,ELF3,9,8,6627,3142,3485,435.625,349.1111111,1.109166136
NM_004078,CSRP1,6,5,23731,1962,21769,4353.8,327,11.09531091
NM_032104,PPP1R12B,13,12,125828,9657,116171,9680.916667,742.8461538,12.02971937
NM_032103,PPP1R12B,12,11,125828,9475,116353,10577.54545,789.5833333,12.28
NM_006618,KDM5B,27,26,81019,6410,74609,2869.576923,237.4074074,11.63946958
NM_015053,PPFIA4,17,16,27555,5062,22493,1405.8125,297.7647059,4.443500593
NM_177402,SYT2,9,8,119828,7612,112216,14027,845.7777778,14.74198634
NM_001684,ATP2B4,21,20,117296,8763,108533,5426.65,417.2857143,12.38537031
NM_005686,SOX13,14,13,54627,4087,50540,3887.692308,291.9285714,12.36603866
NM_014935,PLEKHA6,23,22,141080,7437,133643,6074.681818,323.3478261,17.97001479
NM_014827,ZC3H11A,20,19,58507,4798,53709,2826.789474,239.9,11.19403918
NM_001001396,ATP2B4,22,21,117296,8942,108354,5159.714286,406.4545455,12.1174234
NM_201630,LRRN2,2,1,68296,3196,65100,65100,1598,20.36921151
NM_015375,DSTYK,13,12,69098,7922,61176,5098,609.3846154,7.72229235
NM_001199052,LEMD1,3,2,40710,699,40011,20005.5,233,57.24034335
NM_001199051,LEMD1,5,4,40710,843,39867,9966.75,168.6,47.29181495
NM_001199050,LEMD1,6,5,40710,967,39743,7948.6,161.1666667,41.09927611
NM_001005389,NFASC,16,15,148494,2526,145968,9731.2,157.875,57.78622328
NM_001005388,NFASC,30,29,194170,10364,183806,6338.137931,345.4666667,17.73504438
NM_001001552,LEMD1,4,3,40710,823,39887,13295.66667,205.75,48.4653706
NM_001160332,NFASC,28,27,194170,10164,184006,6815.037037,363,18.10369933
NM_001160333,NFASC,15,14,148494,2507,145987,10427.64286,167.1333333,58.2317511
NM_015090,NFASC,27,26,194170,10148,184022,7077.769231,375.8518519,18.13381947
NM_006338,LRRN2,3,2,68180,3209,64971,32485.5,1069.666667,20.24649423
NM_199462,DSTYK,12,11,69098,7786,61312,5573.818182,648.8333333,7.874646802
NM_001276320,YOD1,4,3,9133,6295,2838,946,1573.75,0.450833995
NM_005449,FAIM3,8,7,18749,3093,15656,2236.571429,386.625,5.061752344
NM_001193338,FAIM3,7,6,18606,2818,15788,2631.333333,402.5714286,5.602555004
NM_001142473,FAIM3,7,6,18749,2756,15993,2665.5,393.7142857,5.802975327
NM_182664,RASSF5,5,4,81739,3509,78230,19557.5,701.8,22.29410088
NM_182663,RASSF5,6,5,81739,3626,78113,15622.6,604.3333333,21.54247104
NM_025179,PLXNA2,32,31,222079,11475,210604,6793.677419,358.59375,18.35328976
NM_000651,CR1,47,46,145639,10013,135626,2948.391304,213.0425532,13.54499151
NM_000573,CR1,39,38,145639,8655,136984,3604.842105,221.9230769,15.82715194
NM_175710,CR1L,12,11,78580,1849,76731,6975.545455,154.0833333,41.49864792
NM_001146264,SYT14,9,8,226116,5135,220981,27622.625,570.5555556,43.03427459
NM_001146262,SYT14,9,8,226116,5071,221045,27630.625,563.4444444,43.59002169
NM_001146261,SYT14,10,9,226116,5193,220923,24547,519.3,42.54246101
NM_001256006,SYT14,9,8,226116,5219,220897,27612.125,579.8888889,42.32554129
NM_001206696,IRF6,7,6,20554,4263,16291,2715.166667,609,3.821487216
NM_006147,IRF6,9,8,20554,4514,16040,2005,501.5555556,3.553389455
NM_153262,SYT14,8,7,226116,5013,221103,31586.14286,626.625,44.1059246
NM_002238,KCNH1,11,10,455802,8036,447766,44776.6,730.5454545,55.72000996
NM_172362,KCNH1,11,10,455802,8117,447685,44768.5,737.9090909,55.15399778
NM_001199812,INTS7,20,19,95263,4497,90766,4777.157895,224.85,20.18367801
NM_001199811,INTS7,20,19,95263,4515,90748,4776.210526,225.75,20.09922481
NM_001199809,INTS7,19,18,95263,4409,90854,5047.444444,232.0526316,20.60648673
NM_015434,INTS7,20,19,95263,4557,90706,4774,227.85,19.9047619
NM_006243,PPP2R5A,13,12,76328,3141,73187,6098.916667,241.6153846,23.30054123
NM_014873,LPGAT1,8,7,87317,7790,79527,11361,973.75,10.20885751
NM_001136138,RPS6KC1,14,13,222235,4182,218053,16773.30769,298.7142857,52.1408417
NM_012424,RPS6KC1,15,14,222235,4219,218016,15572.57143,281.2666667,51.67480446
NM_001287219,RPS6KC1,15,14,222235,4243,217992,15570.85714,282.8666667,51.376856
NM_001287218,RPS6KC1,15,14,222235,4204,218031,15573.64286,280.2666667,51.86274976
NM_001287221,RPS6KC1,14,13,222235,4097,218138,16779.84615,292.6428571,53.24334879
NM_001287220,RPS6KC1,13,12,222235,4036,218199,18183.25,310.4615385,54.06318137
NM_016343,CENPF,20,19,61384,10316,51068,2687.789474,515.8,4.95036836
NM_002763,PROX1,5,4,53005,8177,44828,11207,1635.4,5.482206188
NM_001270616,PROX1,5,4,53571,8505,45066,11266.5,1701,5.298765432
NM_005401,PTPN14,19,18,202987,13462,189525,10529.16667,708.5263158,14.07851731
NM_014217,KCNK2,7,6,153878,3281,150597,25099.5,468.7142857,45.89972569
NM_001017425,KCNK2,7,6,153878,3405,150473,25078.83333,486.4285714,44.1917768
NM_001017424,KCNK2,7,6,231553,3604,227949,37991.5,514.8571429,63.24889012
NM_016121,KCTD3,18,17,54416,3949,50467,2968.647059,219.3888889,12.77969106
NM_007123,USH2A,21,20,249448,6337,243111,12155.55,301.7619048,38.36373678
NM_001243519,ESRRG,9,8,220228,5551,214677,26834.625,616.7777778,38.67357233
NM_001243518,ESRRG,8,7,220228,5400,214828,30689.71429,675,39.78296296
NM_001243515,ESRRG,9,8,220228,5547,214681,26835.125,616.3333333,38.70218136
NM_001243514,ESRRG,7,6,302123,5446,296677,49446.16667,778,54.47612927
NM_001438,ESRRG,7,6,220228,5250,214978,35829.66667,750,40.94819048
NM_018040,GPATCH2,10,9,200577,2346,198231,22025.66667,234.6,84.49744246
NM_138796,SPATA17,11,10,235791,1246,234545,23454.5,113.2727273,188.2383628
NM_016052,RRP15,5,4,52698,7776,44922,11230.5,1555.2,5.777006173
NM_012414,RAB3GAP2,35,34,124235,7364,116871,3437.382353,210.4,15.87058664
NM_001286128,MARK1,16,15,136276,5224,131052,8736.8,326.5,25.08652374
NM_022746,Mar-01,7,6,27704,2250,25454,4242.333333,321.4285714,11.31288889
NM_001286129,MARK1,3,2,54717,2732,51985,25992.5,910.6666667,19.02818448
NM_001286124,MARK1,18,17,136276,5340,130936,7702.117647,296.6666667,24.51985019
NM_001286126,MARK1,17,16,136276,5291,130985,8186.5625,311.2352941,24.75618976
NM_018650,MARK1,18,17,136276,5337,130939,7702.294118,296.5,24.53419524
NM_007207,DUSP10,4,3,40754,2680,38074,12691.33333,670,14.20671642
NM_144729,DUSP10,3,2,40754,1825,38929,19464.5,608.3333333,21.3309589
NM_144728,DUSP10,3,2,36040,2249,33791,16895.5,749.6666667,15.02489996
NM_198551,MIA3,28,27,49909,8151,41758,1546.592593,291.1071429,5.123052386
NM_032890,DISP1,10,9,190908,4934,185974,20663.77778,493.4,37.69233887
NM_005426,TP53BP2,19,18,66081,4808,61273,3404.055556,253.0526316,12.74396839
NM_017982,SUSD4,9,8,143385,3036,140349,17543.625,337.3333333,46.22826087
NM_001143962,CAPN8,17,16,138466,2118,136348,8521.75,124.5882353,64.37582625
NM_001037175,SUSD4,6,5,129294,1102,128192,25638.4,183.6666667,116.3266788
NM_001031685,TP53BP2,18,17,66081,4675,61406,3612.117647,259.7222222,13.13497326
NM_001145154,DNAH14,11,10,94637,2008,92629,9262.9,182.5454545,46.12998008
NM_152495,CNIH3,6,5,124072,2378,121694,24338.8,396.3333333,51.17493692
NM_001008493,ENAH,15,14,166313,13187,153126,10937.57143,879.1333333,11.6118905
NM_003133,SRP9,3,2,12655,1499,11156,5578,499.6666667,7.442294863
NM_018212,ENAH,14,13,166313,13123,153190,11783.84615,937.3571429,11.67339785
NM_022735,ACBD3,8,7,42045,3573,38472,5496,446.625,10.76742233
NM_001130440,SRP9,4,3,12655,1624,11031,3677,406,6.792487685
NM_002221,ITPKB,8,7,107487,6170,101317,14473.85714,771.25,16.42090762
NM_003607,CDC42BPA,36,35,328262,10542,317720,9077.714286,292.8333333,30.13849364
NM_014826,CDC42BPA,35,34,328262,10298,317964,9351.882353,294.2285714,30.87628666
NM_020247,ADCK3,15,14,47310,2939,44371,3169.357143,195.9333333,15.09731201
NM_001003665,C1orf95,4,3,60416,7709,52707,17569,1927.25,6.83707355
NM_033131,WNT3A,4,3,54251,2976,51275,17091.66667,744,17.22950269
NM_052843,OBSCN,81,80,153122,20513,132609,1657.6125,253.2469136,6.464632184
NM_178549,ZNF678,4,3,98946,8558,90388,30129.33333,2139.5,10.56181351
NM_001271223,OBSCN,116,115,170746,27041,143705,1249.608696,233.112069,5.314337488
NM_001098623,OBSCN,105,104,170746,24165,146581,1409.432692,230.1428571,6.065839023
NM_053052,SNAP47,5,4,46237,2372,43865,10966.25,474.4,18.49283305
NM_001258311,PGBD5,7,6,104284,3361,100923,16820.5,480.1428571,30.02767034
NM_014777,URB2,10,9,33967,5623,28344,3149.333333,562.3,5.040725591
NM_004481,GALNT2,16,15,214921,4475,210446,14029.73333,279.6875,47.02703911
NM_007357,COG2,18,17,51531,2978,48553,2856.058824,165.4444444,16.30389523
NM_024525,TTC13,23,22,72633,3312,69321,3150.954545,144,20.93025362
NM_001122835,TTC13,21,20,72633,3148,69485,3474.25,149.9047619,22.0727446
NM_001145036,COG2,18,17,51531,2975,48556,2856.235294,165.2777778,16.32134454
NM_175876,EXOC8,1,0,5098,5098,NA,NA,5098,NA
NM_001004342,TRIM67,10,9,58642,8532,50110,5567.777778,853.2,5.87318331
NM_001164555,DISC1,3,2,123806,1797,122009,61004.5,599,67.89593767
NM_001012957,DISC1,13,12,414460,7007,407453,33954.41667,539,58.14942201
NM_001012959,DISC1,10,9,239893,2228,237665,26407.22222,222.8,106.6719031
NM_018662,DISC1,13,12,414460,7073,407387,33948.91667,544.0769231,57.59748339
NM_001164556,DISC1,5,4,192431,1558,190873,47718.25,311.6,122.5115533
NM_001164538,DISC1,11,10,382841,2976,379865,37986.5,270.5454545,127.6428091
NM_001164537,DISC1,14,13,414460,7170,407290,31330,512.1428571,56.80474198
NM_001164539,DISC1,10,9,228566,2685,225881,25097.88889,268.5,84.12700186
NM_001164540,DISC1,11,10,414460,6705,407755,40775.5,609.5454545,60.81357196
NM_001164542,DISC1,10,9,332690,2720,329970,36663.33333,272,121.3125
NM_001164541,DISC1,10,9,382841,2914,379927,42214.11111,291.4,130.3798902
NM_001164545,DISC1,8,7,192431,2666,189765,27109.28571,333.25,71.17966992
NM_001164544,DISC1,9,8,192431,2770,189661,23707.625,307.7777778,68.46967509
NM_001164548,DISC1,7,6,192431,2610,189821,31636.83333,372.8571429,72.72835249
NM_001164547,DISC1,8,7,382841,2626,380215,54316.42857,328.25,144.7886519
NM_001164546,DISC1,7,6,332690,2370,330320,55053.33333,338.5714286,139.3755274
NM_001164551,DISC1,4,3,123806,1868,121938,40646,467,65.27730193
NM_001164549,DISC1,6,5,144849,2285,142564,28512.8,380.8333333,62.39124726
NM_014801,PCNXL2,34,33,311579,6851,304728,9234.181818,201.5,44.47934608
NM_173508,SLC35F3,8,7,419585,2899,416686,59526.57143,362.375,143.7343912
NM_001277155,B3GALNT2,8,7,39570,1941,37629,5375.571429,242.625,19.38639876
NM_152490,B3GALNT2,12,11,57278,4760,52518,4774.363636,396.6666667,11.03319328
NM_004485,GNG4,3,2,103071,4871,98200,49100,1623.666667,20.16013139
NM_003193,TBCE,17,16,81610,1983,79627,4976.6875,116.6470588,40.15481594
NM_001287802,TBCE,16,15,81610,1953,79657,5310.466667,122.0625,40.78699437
NM_031371,ARID4B,23,22,161324,5832,155492,7067.818182,253.5652174,26.66186557
NM_016374,ARID4B,24,23,161324,6091,155233,6749.26087,253.7916667,25.48563454
NM_001206794,ARID4B,24,23,160594,5970,154624,6722.782609,248.75,25.9001675
NM_014765,TOMM20,5,4,19600,3390,16210,4052.5,678,4.781710914
NM_001079515,TBCE,17,16,81610,2031,79579,4973.6875,119.4705882,39.18217627
NM_001098722,GNG4,4,3,102310,5110,97200,32400,1277.5,19.02152642
NM_001098721,GNG4,4,3,103071,4984,98087,32695.66667,1246,19.68037721
NM_001287801,TBCE,18,17,81610,2137,79473,4674.882353,118.7222222,37.18905007
NM_080738,EDARADD,6,5,89294,2897,86397,17279.4,482.8333333,29.82292026
NM_145861,EDARADD,6,5,90330,2778,87552,17510.4,463,31.5161987
NM_003272,GPR137B,7,6,66379,2049,64330,10721.66667,292.7142857,31.39580283
NM_002508,NID1,20,19,89351,5901,83450,4392.105263,295.05,14.1416709
NM_201545,LGALS8,12,11,34767,6161,28606,2600.545455,513.4166667,4.643077422
NM_201543,LGALS8,11,10,29542,6164,23378,2337.8,560.3636364,3.792667099
NM_006499,LGALS8,12,11,29542,6291,23251,2113.727273,524.25,3.695914799
NM_018072,HEATR1,45,44,55538,8529,47009,1068.386364,189.5333333,5.51166608
NM_201544,LGALS8,10,9,29254,6220,23034,2559.333333,622,3.703215434
NM_001035,RYR2,105,104,791588,16470,775118,7453.057692,156.8571429,47.06241651
NM_000740,CHRM3,5,4,280346,2750,277596,69399,550,100.944
NM_020066,FMN2,18,17,383306,6447,376859,22168.17647,358.1666667,58.45494028
NM_144625,WDR64,27,26,149856,4397,145459,5594.576923,162.8518519,33.08141915
NM_003679,KMO,15,14,63517,5281,58236,4159.714286,352.0666667,11.02745692
NM_152666,PLD5,11,10,436311,3316,432995,43299.5,301.4545455,130.577503
NM_001195812,PLD5,9,8,361097,2865,358232,44779,318.3333333,125.0373473
NM_001195811,PLD5,10,9,361097,3028,358069,39785.44444,302.8,118.252642
NM_001042404,CEP170,19,18,130980,6909,124071,6892.833333,363.6315789,17.95788102
NM_001042405,CEP170,19,18,130980,6831,124149,6897.166667,359.5263158,18.17435222
NM_005465,AKT3,13,12,343565,7095,336470,28039.16667,545.7692308,47.4235377
NM_001206729,AKT3,14,13,343867,1589,342278,26329.07692,113.5,215.404657
NM_014812,CEP170,20,19,130980,7204,123776,6514.526316,360.2,17.1815658
NM_006642,SDCCAG8,18,17,244088,2635,241453,14203.11765,146.3888889,91.63301708
NM_181690,AKT3,14,13,355051,1748,353303,27177.15385,124.8571429,202.1184211
NM_001130957,C1orf101,22,21,178991,3216,175775,8370.238095,146.1818182,54.65640547
NM_032328,EFCAB2,8,7,117979,1248,116731,16675.85714,156,93.53445513
NM_001242340,C1orf101,19,18,178991,3061,175930,9773.888889,161.1052632,57.47468148
NM_016076,DESI2,5,4,55984,4097,51887,12971.75,819.4,12.66463266
NM_001126,ADSS,13,12,43644,2795,40849,3404.083333,215,14.61502683
NM_001143943,EFCAB2,7,6,154901,3779,151122,25187,539.8571429,39.98994443
NM_173807,C1orf101,21,20,178991,3057,175934,8796.7,145.5714286,57.55119398
NM_015446,AHCTF1,36,35,92326,8667,83659,2390.257143,240.75,9.652590285
NM_001204220,ZNF670,4,3,44177,4199,39978,13326,1049.75,9.520838295
NM_001243740,ZNF124,4,3,50043,2258,47785,15928.33333,564.5,21.16253322
NM_003431,ZNF124,4,3,16117,1678,14439,4813,419.5,8.60488677
NM_033213,ZNF670,4,3,44177,4202,39975,13325,1050.5,9.513326987
NM_152609,CNST,11,10,102247,5244,97003,9700.3,476.7272727,18.49790236
NM_001139459,CNST,9,8,81907,2554,79353,9919.125,283.7777778,31.07008614
NM_001281853,GCSAML,7,6,70634,4070,66564,11094,581.4285714,16.35479115
NM_001281838,GCSAML,5,4,70634,3923,66711,16677.75,784.6,17.00509814
NM_001281836,GCSAML,6,5,70634,3984,66650,13330,664,16.72941767
NM_001281835,GCSAML,6,5,70634,4100,66534,13306.8,683.3333333,16.22780488
NM_001281834,GCSAML,7,6,70634,4217,66417,11069.5,602.4285714,15.74982215
NM_001127462,NLRP3,8,7,31057,4294,26763,3823.285714,536.75,6.23265021
NM_001127461,NLRP3,9,8,32950,4329,28621,3577.625,481,6.611457611
NM_183395,NLRP3,7,6,31057,4122,26935,4489.166667,588.8571429,6.534449296
NM_001079821,NLRP3,11,10,32950,3860,29090,2909,350.9090909,7.53626943
NM_001281837,GCSAML,6,5,59240,3965,55275,11055,660.8333333,13.9407314
NM_145278,GCSAML,5,4,28647,3868,24779,6194.75,773.6,6.406153051
NM_001243133,NLRP3,9,8,31057,4466,26591,3323.875,496.2222222,5.954097627
NM_004895,NLRP3,9,8,31057,4466,26591,3323.875,496.2222222,5.954097627
NM_175911,OR2L13,3,2,163733,1887,161846,80923,629,85.76894542
NM_001005484,OR4F5,1,0,919,919,NA,NA,919,NA
NM_001005277,OR4F16,1,0,940,940,NA,NA,940,NA
NM_001005224,OR4F3,1,0,940,940,NA,NA,940,NA
NM_001005221,OR4F29,1,0,940,940,NA,NA,940,NA
NM_001005277,OR4F16,1,0,940,940,NA,NA,940,NA
NM_001005224,OR4F3,1,0,940,940,NA,NA,940,NA
NM_001005221,OR4F29,1,0,940,940,NA,NA,940,NA
NM_015658,NOC2L,19,18,15098,2819,12279,682.1666667,148.3684211,4.355799929
NM_198317,KLHL17,12,11,5134,2576,2558,232.5454545,214.6666667,0.993012422
NM_032129,PLEKHN1,16,15,8609,2416,6193,412.8666667,151,2.563327815
NM_001160184,PLEKHN1,15,14,8609,2310,6299,449.9285714,154,2.726839827
NM_152486,SAMD11,14,13,18842,2568,16274,1251.846154,183.4285714,6.337227414
NM_021170,HES4,4,3,1212,966,246,82,241.5,0.254658385
NM_198576,AGRN,36,35,35998,7362,28636,818.1714286,204.5,3.889703885
NM_001142467,HES4,3,2,1210,1041,169,84.5,347,0.1623439
NM_005101,ISG15,2,1,1074,668,406,406,334,0.607784431
NM_001205252,RNF223,2,1,2563,1124,1439,1439,562,1.28024911
NM_016176,SDF4,7,6,15161,2029,13132,2188.666667,289.8571429,6.47215377
NM_003327,TNFRSF4,7,6,2844,1111,1733,288.8333333,158.7142857,1.559855986
NM_001130045,TTLL10,16,15,24029,2275,21754,1450.266667,142.1875,9.562197802
NM_148902,TNFRSF18,5,4,3203,1184,2019,504.75,236.8,1.705236486
NM_016547,SDF4,7,6,15161,2145,13016,2169.333333,306.4285714,6.068065268
NM_148901,TNFRSF18,4,3,3203,993,2210,736.6666667,248.25,2.225579053
NM_080605,B3GALT6,1,0,2793,2793,NA,NA,2793,NA
NM_004195,TNFRSF18,5,4,3203,1205,1998,499.5,241,1.658091286
NM_153254,TTLL10,9,8,6168,2122,4046,505.75,235.7777778,1.9066918
NM_030649,ACAP3,24,23,15507,3783,11724,509.7391304,157.625,3.099127676
NM_194315,UBE2J2,8,7,19944,2316,17628,2518.285714,289.5,7.611398964
NM_032348,MXRA8,10,9,6107,2544,3563,395.8888889,254.4,1.400550314
NM_152228,TAS1R3,6,5,3120,2565,555,111,427.5,0.216374269
NM_194458,UBE2J2,7,6,19944,2396,17548,2924.666667,342.2857143,7.323873122
NM_194457,UBE2J2,6,5,19944,2135,17809,3561.8,355.8333333,8.341451991
NM_001256460,CPSF3L,18,17,13104,2281,10823,636.6470588,126.7222222,4.744848751
NM_001256456,CPSF3L,19,18,13104,2648,10456,580.8888889,139.3684211,3.948640483
NM_017871,CPSF3L,17,16,13104,2173,10931,683.1875,127.8235294,5.030372757
NM_001256463,CPSF3L,15,14,13104,1868,11236,802.5714286,124.5333333,6.014989293
NM_001256462,CPSF3L,15,14,13104,1877,11227,801.9285714,125.1333333,5.981353223
NM_001130413,SCNN1D,18,17,11595,3072,8523,501.3529412,170.6666667,2.774414063
NM_058167,UBE2J2,7,6,19944,2267,17677,2946.166667,323.8571429,7.797529775
NM_001127230,AURKAIP1,4,3,1453,816,637,212.3333333,204,0.780637255
NM_001127229,AURKAIP1,4,3,1472,913,559,186.3333333,228.25,0.612267251
NM_004421,DVL1,15,14,13836,2939,10897,778.3571429,195.9333333,3.707723716
NM_153339,PUSL1,8,7,3065,1248,1817,259.5714286,156,1.455929487
NM_001282582,MXRA8,11,10,10854,2323,8531,853.1,211.1818182,3.672406371
NM_001282584,MXRA8,9,8,6107,2240,3867,483.375,248.8888889,1.726339286
NM_001282583,MXRA8,10,9,9090,2741,6349,705.4444444,274.1,2.316307917
NM_001282585,MXRA8,10,9,5860,2018,3842,426.8888889,201.8,1.903865213
NM_001029885,GLTPD1,3,2,4135,2196,1939,969.5,732,0.882969035
NM_199121,VWA1,3,2,7361,4267,3094,1547,1422.333333,0.725099602
NM_001145210,ANKRD65,4,3,3026,2196,830,276.6666667,549,0.377959927
NM_001039211,ATAD3C,12,11,20471,3871,16600,1509.090909,322.5833333,4.288297598
NM_031921,ATAD3B,16,15,24420,2449,21971,1464.733333,153.0625,8.971416905
NM_001039577,CCNL2,6,5,7052,1213,5839,1167.8,202.1666667,4.813685078
NM_001146685,TMEM88B,2,1,1661,494,1167,1167,247,2.362348178
NM_022834,VWA1,3,2,7361,4662,2699,1349.5,1554,0.578936079
NM_001243536,ANKRD65,3,2,3026,1635,1391,695.5,545,0.850764526
NM_001243535,ANKRD65,3,2,3026,1654,1372,686,551.3333333,0.829504232
NM_017971,MRPL20,4,3,5419,737,4682,1560.666667,184.25,6.352781547
NM_030937,CCNL2,11,10,13629,3126,10503,1050.3,284.1818182,3.359884837
NM_006983,MMP23B,8,7,2472,1248,1224,174.8571429,156,0.980769231
NM_080875,MIB2,20,19,15197,3358,11839,623.1052632,167.9,3.525610482
NM_001170536,ATAD3A,16,15,22159,2348,19811,1320.733333,146.75,8.437393526
NM_001170535,ATAD3A,16,15,22546,2518,20028,1335.2,157.375,7.953931692
NM_001170686,MIB2,20,19,15197,3346,11851,623.7368421,167.3,3.541841004
NM_001170688,MIB2,19,18,15197,3162,12035,668.6111111,166.4210526,3.806135357
NM_001170687,MIB2,20,19,15197,3316,11881,625.3157895,165.8,3.582931242
NM_001170689,MIB2,18,17,14747,2954,11793,693.7058824,164.1111111,3.992213947
NM_014188,SSU72,5,4,33211,1308,31903,7975.75,261.6,24.39067278
NM_018188,ATAD3A,16,15,22546,2662,19884,1325.6,166.375,7.469571751
NM_001242659,C1orf233,1,0,2090,2090,NA,NA,2090,NA
NM_001114748,TMEM240,4,3,5584,1121,4463,1487.666667,280.25,3.981266726
NM_182838,SLC35E2,6,5,18616,6300,12316,2463.2,1050,1.954920635
NM_001199787,SLC35E2,7,6,21163,2165,18998,3166.333333,309.2857143,8.775057737
NM_001198995,NADK,10,9,7412,3038,4374,486,303.8,1.439763002
NM_024011,CDK11A,20,19,21623,2647,18976,998.7368421,132.35,7.168870419
NM_033529,CDK11A,20,19,21623,2617,19006,1000.315789,130.85,7.262514329
NM_001110781,SLC35E2B,9,8,31306,6012,25294,3161.75,668,4.207252162
NM_001282538,GNB1,10,9,105834,3058,102776,11419.55556,305.8,33.6088947
NM_002074,GNB1,12,11,105834,3206,102628,9329.818182,267.1666667,32.01122895
NM_001282539,GNB1,11,10,105834,3156,102678,10267.8,286.9090909,32.53422053
NM_001080484,KIAA1751,18,17,50526,4728,45798,2694,262.6666667,9.686548223
NM_138705,CALML6,6,5,2469,1107,1362,272.4,184.5,1.230352304
NM_178545,TMEM52,5,4,1713,963,750,187.5,192.6,0.778816199
NM_000815,GABRD,9,8,11426,1934,9492,1186.5,214.8888889,4.907962771
NM_001146310,C1orf86,8,7,23275,2292,20983,2997.571429,286.5,9.154886562
NM_001282673,C1orf86,4,3,10317,1554,8763,2921,388.5,5.638996139
NM_001282670,C1orf86,8,7,23173,3583,19590,2798.571429,447.875,5.467485347
NM_001256946,C1orf86,4,3,2882,1581,1301,433.6666667,395.25,0.822896901
NM_001256947,C1orf86,3,2,5228,596,4632,2316,198.6666667,7.771812081
NM_001282672,C1orf86,7,6,10317,2241,8076,1346,320.1428571,3.603748327
NM_001282671,C1orf86,8,7,10317,2373,7944,1134.857143,296.625,3.347661188
NM_001256945,C1orf86,3,2,10317,1417,8900,4450,472.3333333,6.280875088
NM_182533,C1orf86,4,3,5228,733,4495,1498.333333,183.25,6.132332879
NM_024848,MORN1,14,13,70299,1655,68644,5280.307692,118.2142857,41.47673716
NM_002617,PEX10,6,5,7771,2020,5751,1150.2,336.6666667,2.847029703
NM_007033,RER1,7,6,13673,3111,10562,1760.333333,444.4285714,3.395049823
NM_153818,PEX10,6,5,7771,2080,5691,1138.2,346.6666667,2.736057692
NM_001010926,HES5,3,2,1502,1309,193,96.5,436.3333333,0.147440794
NM_014638,PLCH2,22,21,29212,4859,24353,1159.666667,220.8636364,5.011936612
NM_018216,PANK4,19,18,18062,2661,15401,855.6111111,140.0526316,5.787673807
NM_033467,MMEL1,24,23,42402,2926,39476,1716.347826,121.9166667,13.49145591
NM_001195740,FAM213B,6,5,4721,2673,2048,409.6,445.5,0.766180322
NM_001195738,FAM213B,7,6,4721,2750,1971,328.5,392.8571429,0.716727273
NM_001195741,FAM213B,6,5,4721,2670,2051,410.2,445,0.768164794
NM_001195737,FAM213B,7,6,4721,2770,1951,325.1666667,395.7142857,0.70433213
NM_001195736,FAM213B,7,6,4721,2836,1885,314.1666667,405.1428571,0.664668547
NM_152371,FAM213B,7,6,4721,2782,1939,323.1666667,397.4285714,0.69698059
NM_080431,ACTRT2,1,0,1423,1423,NA,NA,1423,NA
NM_014448,ARHGEF16,15,14,26532,2919,23613,1686.642857,194.6,8.089414183
NM_001204191,TP73,10,9,45531,4842,40689,4521,484.2,8.403345725
NM_001204190,TP73,10,9,45531,4887,40644,4516,488.7,8.316758748
NM_001204189,TP73,9,8,45531,4747,40784,5098,527.4444444,8.591531494
NM_017818,WRAP73,12,11,19342,1711,17631,1602.818182,142.5833333,10.30450029
NM_001126242,TP73,11,10,45531,4982,40549,4054.9,452.9090909,8.139100763
NM_001126240,TP73,12,11,45531,5132,40399,3672.636364,427.6666667,7.871979735
NM_001204192,TP73,12,11,38157,4965,33192,3017.454545,413.75,6.685196375
NM_001204188,TP73,12,11,83638,4867,78771,7161,405.5833333,16.18471338
NM_001204187,TP73,12,11,83638,4912,78726,7156.909091,409.3333333,16.02728013
NM_001204186,TP73,11,10,83638,4772,78866,7886.6,433.8181818,16.52682313
NM_001204185,TP73,13,12,83638,5007,78631,6552.583333,385.1538462,15.7042141
NM_001204184,TP73,13,12,83638,5062,78576,6548,389.3846154,15.52271829
NM_001126241,TP73,11,10,45531,5037,40494,4049.4,457.9090909,8.039309113
NM_005427,TP73,14,13,83638,5157,78481,6037,368.3571429,15.218344
NM_182752,TPRG1L,5,4,5140,2432,2708,677,486.4,1.113486842
NM_001288583,SMIM1,4,3,3223,524,2699,899.6666667,131,5.150763359
NM_020710,LRRC47,7,6,16286,2655,13631,2271.833333,379.2857143,5.134086629
NM_001163724,SMIM1,4,3,3197,551,2646,882,137.75,4.802177858
NM_014704,CEP104,22,21,45154,6480,38674,1841.619048,294.5454545,5.968209877
NM_207356,C1orf174,4,3,11162,1670,9492,3164,417.5,5.683832335
NM_207396,RNF207,18,17,15172,3989,11183,657.8235294,221.6111111,2.803459514
NM_000983,RPL22,4,3,14601,2089,12512,4170.666667,522.25,5.989468645
NM_015557,CHD5,42,41,78349,9705,68644,1674.243902,231.0714286,7.073055126
NM_181865,ACOT7,9,8,96434,1439,94995,11874.375,159.8888889,66.01459347
NM_181866,ACOT7,9,8,94674,1423,93251,11656.375,158.1111111,65.53127196
NM_207370,GPR153,6,5,13631,4088,9543,1908.6,681.3333333,2.334393346
NM_001024598,HES3,4,3,1388,701,687,229,175.25,0.980028531
NM_020631,PLEKHG5,21,20,25611,4665,20946,1047.3,222.1428571,4.490032154
NM_001042665,PLEKHG5,21,20,19864,4719,15145,757.25,224.7142857,3.209366391
NM_001042664,PLEKHG5,21,20,24490,4736,19754,987.7,225.5238095,4.171030405
NM_001039664,TNFRSF25,5,4,2086,899,1187,296.75,179.8,1.320355951
NM_031475,ESPN,13,12,36158,3544,32614,2717.833333,272.6153846,9.202595937
NM_001265594,PLEKHG5,22,21,24504,4551,19953,950.1428571,206.8636364,4.38431114
NM_019089,HES2,4,3,4687,4264,423,141,1066,0.099202627
NM_001265593,PLEKHG5,21,20,19379,4746,14633,731.65,226,3.083227981
NM_003790,TNFRSF25,10,9,5043,1632,3411,379,163.2,2.090073529
NM_148970,TNFRSF25,5,4,5043,1078,3965,991.25,215.6,3.678107607
NM_148967,TNFRSF25,9,8,5043,1496,3547,443.375,166.2222222,2.370989305
NM_148966,TNFRSF25,9,8,5043,1520,3523,440.375,168.8888889,2.317763158
NM_148965,TNFRSF25,10,9,5043,1659,3384,376,165.9,2.039783002
NM_024654,NOL9,12,11,33253,6724,26529,2411.727273,560.3333333,3.945419393
NM_001278648,ZBTB48,11,10,9291,2295,6996,699.6,208.6363636,3.048366013
NM_001278647,ZBTB48,11,10,9291,2274,7017,701.7,206.7272727,3.085751979
NM_138697,TAS1R1,6,5,24481,2801,21680,4336,466.8333333,7.740092824
NM_014851,KLHL21,4,3,12147,4491,7656,2552,1122.75,1.704742819
NM_005341,ZBTB48,11,10,9291,2361,6930,693,214.6363636,2.93519695
NM_153812,PHF13,4,3,10339,3674,6665,2221.666667,918.5,1.814099075
NM_177540,TAS1R1,5,4,24481,2038,22443,5610.75,407.6,11.01226693
NM_018198,DNAJC11,16,15,67740,3309,64431,4295.4,206.8125,19.47144152
NM_001195753,THAP3,6,5,8719,1390,7329,1465.8,231.6666667,5.272661871
NM_001195752,THAP3,5,4,8434,1296,7138,1784.5,259.2,5.507716049
NM_138350,THAP3,5,4,10438,2100,8338,2084.5,420,3.97047619
NM_001195563,CAMTA1,4,3,86725,736,85989,28663,184,116.8328804
NM_004781,VAMP3,5,4,10165,2210,7955,1988.75,442,3.599547511
NM_006786,UTS2,4,3,5434,574,4860,1620,143.5,8.466898955
NM_021995,UTS2,5,4,5881,639,5242,1310.5,127.8,8.203442879
NM_001123377,PARK7,7,6,23630,910,22720,3786.666667,130,24.96703297
NM_007262,PARK7,7,6,23630,968,22662,3777,138.2857143,23.41115702
NM_018948,ERRFI1,4,3,14616,3133,11483,3827.666667,783.25,3.665177147
NM_001042682,RERE,13,12,71285,6321,64964,5413.666667,486.2307692,10.27748774
NM_001201483,ENO1,9,8,10578,2559,8019,1002.375,284.3333333,3.133645955
NM_001270502,CA6,6,5,29257,1042,28215,5643,173.6666667,27.07773512
NM_001428,ENO1,12,11,18094,2199,15895,1445,183.25,7.228285584
NM_001215,CA6,8,7,29257,1373,27884,3983.428571,171.625,20.30881282
NM_001270500,CA6,8,7,28612,1003,27609,3944.142857,125.375,27.52642074
NM_001270501,CA6,7,6,29257,1192,28065,4677.5,170.2857143,23.54446309
NM_003039,SLC2A5,12,11,32884,2450,30434,2766.727273,204.1666667,12.42204082
NM_001135585,SLC2A5,5,4,28462,1285,27177,6794.25,257,21.14941634
NM_207420,SLC2A7,12,11,23047,1551,21496,1954.181818,129.25,13.85944552
NM_025106,SPSB1,3,2,76651,3120,73531,36765.5,1040,23.56762821
NM_032315,SLC25A33,7,6,43305,1468,41837,6972.833333,209.7142857,28.4993188
NM_001010866,TMEM201,6,5,16090,3913,12177,2435.4,652.1666667,3.111934577
NM_001130924,TMEM201,11,10,26005,3863,22142,2214.2,351.1818182,5.731814652
NM_005026,PIK3CD,24,23,77384,5435,71949,3128.217391,226.4583333,13.23808648
NM_022787,NMNAT1,5,4,42072,3786,38286,9571.5,757.2,10.11251981
NM_032368,LZIC,7,6,13052,1414,11638,1939.666667,202,8.230551627
NM_052960,RBP7,4,3,18825,659,18166,6055.333333,164.75,27.5660091
NM_002631,PGD,13,12,21118,1950,19168,1597.333333,150,9.82974359
NM_213566,DFFA,5,4,12012,3398,8614,2153.5,679.6,2.5350206
NM_199294,APITD1,5,4,12715,1248,11467,2866.75,249.6,9.188301282
NM_199006,APITD1-CORT,4,3,21903,1256,20647,6882.333333,314,16.43869427
NM_198544,APITD1-CORT,5,4,21903,1324,20579,5144.75,264.8,15.54305136
NM_001243768,APITD1-CORT,4,3,21258,1387,19871,6623.666667,346.75,14.32660418
NM_001302,CORT,2,1,2286,1233,1053,1053,616.5,0.854014599
NM_001270517,APITD1-CORT,6,5,21903,1502,20401,4080.2,250.3333333,13.58255659
NM_004401,DFFA,6,5,12012,2044,9968,1993.6,340.6666667,4.876712329
NM_007375,TARDBP,6,5,12872,4223,8649,1729.8,703.8333333,2.048070092
NM_003132,SRM,8,7,5444,1281,4163,594.7142857,160.125,3.24980484
NM_139208,MASP2,5,4,2443,737,1706,426.5,147.4,2.314789688
NM_006610,MASP2,11,10,20718,2466,18252,1825.2,224.1818182,7.401459854
NM_021146,ANGPTL7,5,4,6694,2295,4399,1099.75,459,1.916775599
NM_013319,UBIAD1,2,1,15238,3656,11582,11582,1828,3.167943107
NM_020780,PTCHD2,21,20,58347,5235,53112,2655.6,249.2857143,10.14555874
NM_006341,MAD2L2,9,8,6736,1128,5608,701,125.3333333,4.971631206
NM_198545,DRAXIN,7,6,28557,1780,26777,4462.833333,254.2857143,15.04325843
NM_183413,FBXO44,5,4,8472,2828,5644,1411,565.6,1.995756719
NM_183412,FBXO44,5,4,8954,2939,6015,1503.75,587.8,2.046614495
NM_001127325,MAD2L2,9,8,17143,1161,15982,1997.75,129,13.76571921
NM_012168,FBXO2,6,5,6472,1721,4751,950.2,286.8333333,2.7606043
NM_018438,FBXO6,6,5,10261,1555,8706,1741.2,259.1666667,5.598713826
NM_033182,FBXO44,6,5,8472,2954,5518,1103.6,492.3333333,1.867975626
NM_001014765,FBXO44,7,6,8472,3327,5145,857.5,475.2857143,1.546438233
NM_006172,NPPA,3,2,2075,857,1218,609,285.6666667,1.421236873
NM_001256959,CLCN6,22,21,37050,5654,31396,1495.047619,257,5.552882915
NM_001286,CLCN6,23,22,37050,5721,31329,1424.045455,248.7391304,5.476140535
NM_005957,MTHFR,12,11,20375,7162,13213,1201.181818,596.8333333,1.844875733
NM_002521,NPPB,3,2,1473,701,772,386,233.6666667,1.10128388
NM_000302,PLOD1,19,18,40877,3050,37827,2101.5,160.5263158,12.40229508
NM_138346,KIAA2013,3,2,6842,2826,4016,2008,942,1.42108988
NM_021933,MIIP,10,9,12809,1811,10998,1222,181.1,6.072887907
NM_001066,TNFRSF1B,10,9,42219,3685,38534,4281.555556,368.5,10.45698779
NM_004753,DHRS3,6,5,49883,1812,48071,9614.2,302,26.52924945
NM_152290,C1orf158,4,3,14941,1023,13918,4639.333333,255.75,13.60508309
NM_001080830,PRAMEF12,3,2,3059,1781,1278,639,593.6666667,0.717574396
NM_001103169,AADACL3,3,2,12610,3835,8775,4387.5,1278.333333,2.288135593
NM_001103170,AADACL3,4,3,12610,4053,8557,2852.333333,1013.25,2.111275598
NM_001146344,PRAMEF11,4,3,6798,1843,4955,1651.666667,460.75,2.688551275
NM_001009611,PRAMEF4,4,3,6994,1844,5150,1716.666667,461,2.792841649
NM_023014,PRAMEF2,4,3,4825,1646,3179,1059.666667,411.5,1.931348724
NM_001039361,PRAMEF10,4,3,5369,1522,3847,1282.333333,380.5,2.527595269
NM_001146181,LOC649330,1,0,1003,1003,NA,NA,1003,NA
NM_001013631,HNRNPCL1,2,1,1319,1110,209,209,555,0.188288288
NM_023013,PRAMEF1,4,3,5233,2164,3069,1023,541,1.418207024
NM_001012276,PRAMEF8,4,3,3835,1562,2273,757.6666667,390.5,1.455185659
NM_001010889,PRAMEF6,4,3,9106,1724,7382,2460.666667,431,4.281902552
NM_001100631,PRAMEF22,3,2,2840,1449,1391,695.5,483,0.959972395
NM_001012277,PRAMEF7,4,3,3835,1562,2273,757.6666667,390.5,1.455185659
NM_001136561,HNRNPCP5,2,1,1368,1158,210,210,579,0.18134715
NM_001282323,PRAMEF23,3,2,3844,1434,2410,1205,478,1.680613668
NM_001013407,PRAMEF5,4,3,9239,1859,7380,2460,464.75,3.969876278
NM_001282323,PRAMEF23,3,2,3844,1434,2410,1205,478,1.680613668
NM_001010889,PRAMEF6,4,3,9105,1724,7381,2460.333333,431,4.281322506
NM_001013692,PRAMEF3,3,2,3498,2107,1391,695.5,702.3333333,0.660180351
NM_001013407,PRAMEF5,4,3,9240,1859,7381,2460.333333,464.75,3.970414201
NM_001100631,PRAMEF22,3,2,2840,1449,1391,695.5,483,0.959972395
NM_001098376,PRAMEF15,4,3,7016,1866,5150,1716.666667,466.5,2.759914255
NM_001012276,PRAMEF8,4,3,3835,1562,2273,757.6666667,390.5,1.455185659
NM_001045480,PRAMEF16,3,2,3007,1589,1418,709,529.6666667,0.892385148
NM_001010890,PRAMEF9,4,3,7017,1867,5150,1716.666667,466.75,2.758435994
NM_001099790,PRAMEF19,3,2,3518,2126,1392,696,708.6666667,0.654750706
NM_001099850,PRAMEF18,3,2,3518,2126,1392,696,708.6666667,0.654750706
NM_001024661,PRAMEF13,4,3,5244,2168,3076,1025.333333,542,1.418819188
NM_001012277,PRAMEF7,4,3,3835,1562,2273,757.6666667,390.5,1.455185659
NM_001012276,PRAMEF8,4,3,3835,1562,2273,757.6666667,390.5,1.455185659
NM_001100114,PRAMEF21,3,2,4982,1511,3471,1735.5,503.6666667,2.297154203
NM_001099852,PRAMEF20,4,3,10879,1601,9278,3092.666667,400.25,5.795128045
NM_001098376,PRAMEF15,4,3,7016,1866,5150,1716.666667,466.5,2.759914255
NM_001010890,PRAMEF9,4,3,7017,1867,5150,1716.666667,466.75,2.758435994
NM_001099790,PRAMEF19,3,2,3518,2126,1392,696,708.6666667,0.654750706
NM_001100114,PRAMEF21,3,2,5003,1511,3492,1746,503.6666667,2.311052283
NM_001099852,PRAMEF20,4,3,10898,1601,9297,3099,400.25,5.806995628
NM_001099851,PRAMEF17,3,2,2999,1581,1418,709,527,0.896900696
NM_001099850,PRAMEF18,3,2,3518,2126,1392,696,708.6666667,0.654750706
NM_001010847,LRRC38,2,1,38799,1910,36889,36889,955,19.31361257
NM_006474,PDPN,6,5,34202,2818,31384,6276.8,469.6666667,11.13697658
NM_001006624,PDPN,6,5,32487,2642,29845,5969,440.3333333,11.29636639
NM_001006625,PDPN,6,5,32487,2636,29851,5970.2,439.3333333,11.32435508
NM_198389,PDPN,6,5,34202,2812,31390,6278,468.6666667,11.1628734
NM_012231,PRDM2,10,9,120226,7967,112259,12473.22222,796.7,14.09049831
NM_015866,PRDM2,9,8,83226,7466,75760,9470,829.5555556,10.14733458
NM_001135610,PRDM2,8,7,124841,2710,122131,17447.28571,338.75,45.06678967
NM_001007257,PRDM2,4,3,38700,6201,32499,10833,1550.25,5.240928882
NM_001278501,C1orf195,3,2,3152,456,2696,1348,152,5.912280702
NM_001136216,TMEM51,4,3,67948,2020,65928,21976,505,32.63762376
NM_018022,TMEM51,3,2,66747,1915,64832,32416,638.3333333,33.85483029
NM_001278502,C1orf195,3,2,7430,418,7012,3506,139.3333333,16.77511962
NM_001136218,TMEM51,4,3,66747,1989,64758,21586,497.25,32.55806938
NM_001136217,TMEM51,3,2,67948,1946,66002,33001,648.6666667,33.91675231
NM_001278054,CASP9,5,4,33046,2593,30453,7613.25,518.6,11.74431161
NM_032996,CASP9,9,8,33391,2878,30513,3814.125,319.7777778,10.60215427
NM_033440,CELA2A,8,7,15365,928,14437,2062.428571,116,15.55711207
NM_007272,CTRC,8,7,8217,907,7310,1044.285714,113.375,8.059536935
NM_001229,CASP9,9,8,33046,3047,29999,3749.875,338.5555556,9.845421726
NM_015849,CELA2B,8,7,15301,931,14370,2052.857143,116.375,15.43501611
NM_024329,EFHD2,4,3,20450,2423,18027,6009,605.75,7.439950475
NM_024758,AGMAT,7,6,13413,3161,10252,1708.666667,451.5714286,3.243277444
NM_032341,DDI2,10,9,43601,2690,40911,4545.666667,269,15.20855019
NM_006511,RSC1A1,1,0,1855,1855,NA,NA,1855,NA
NM_017556,FBLIM1,9,8,27831,3358,24473,3059.125,373.1111111,7.287969029
NM_001024216,FBLIM1,5,4,21627,2784,18843,4710.75,556.8,6.768318966
NM_001024215,FBLIM1,6,5,10723,1527,9196,1839.2,254.5,6.022265881
NM_001013641,TMEM82,6,5,5307,1271,4036,807.2,211.8333333,3.1754524
NM_015164,PLEKHM2,20,19,50439,4142,46297,2436.684211,207.1,11.17745051
NM_207348,SLC25A34,5,4,5077,3075,2002,500.5,615,0.651056911
NM_001089591,UQCRHL,1,0,539,539,NA,NA,539,NA
NM_001242884,ZBTB17,15,14,34265,2581,31684,2263.142857,172.0666667,12.27586207
NM_003443,ZBTB17,16,15,34265,2767,31498,2099.866667,172.9375,11.38344778
NM_001042704,CLCNKA,20,19,12061,2553,9508,500.4210526,127.65,3.724245985
NM_001287603,ZBTB17,16,15,34265,2788,31477,2098.466667,174.25,11.29017217
NM_001257139,CLCNKA,19,18,12061,2426,9635,535.2777778,127.6842105,3.97155812
NM_014424,HSPB7,3,2,4764,2895,1869,934.5,965,0.645595855
NM_178840,C1orf64,2,1,2455,923,1532,1532,461.5,1.659804984
NM_000085,CLCNKB,20,19,13592,2646,10946,576.1052632,132.3,4.13681028
NM_001165945,CLCNKB,13,12,8566,2187,6379,531.5833333,168.2307692,2.916780979
NM_004070,CLCNKA,20,19,12061,2556,9505,500.2631579,127.8,3.718701095
NM_001287604,ZBTB17,16,15,34265,2763,31502,2100.133333,172.6875,11.40137532
NM_182623,FAM131C,7,6,15865,1708,14157,2359.5,244,8.288641686
NM_004431,EPHA2,17,16,31752,3981,27771,1735.6875,234.1764706,6.975885456
NM_030907,RSG1,5,4,5479,1565,3914,978.5,313,2.500958466
NM_153213,ARHGEF19,16,15,14507,3045,11462,764.1333333,190.3125,3.764203612
NM_198546,SPATA21,13,12,38783,2028,36755,3062.916667,156,18.12376726
NM_001271869,SZRD1,4,3,31120,3696,27424,9141.333333,924,7.41991342
NM_001114600,SZRD1,4,3,31120,3699,27421,9140.333333,924.75,7.413084617
NM_001282321,FAM231A,1,0,511,511,NA,NA,511,NA
NM_001282321,FAM231A,1,0,511,511,NA,NA,511,NA
NM_001271733,MST1L,15,14,9848,4683,5165,368.9285714,312.2,1.102925475
NM_014675,CROCC,37,36,51031,6693,44338,1231.611111,180.8918919,6.624533094
NM_003000,SDHB,8,7,35442,1153,34289,4898.428571,144.125,29.73894189
NM_001141974,ATP13A2,27,26,25972,3721,22251,855.8076923,137.8148148,5.979844128
NM_001141973,ATP13A2,29,28,25972,4010,21962,784.3571429,138.2758621,5.47680798
NM_022089,ATP13A2,29,28,25972,4025,21947,783.8214286,138.7931034,5.452670807
NM_012387,PADI4,16,15,55807,2281,53526,3568.4,142.5625,23.46602367
NM_016233,PADI3,16,15,35136,3204,31932,2128.8,200.25,9.966292135
NM_207421,PADI6,17,16,29456,2363,27095,1693.4375,139,11.46635633
NM_018715,RCC2,13,12,33001,4135,28866,2405.5,318.0769231,6.9808948
NM_001136204,RCC2,12,11,31810,3965,27845,2531.363636,330.4166667,7.022698613
NM_152375,KLHDC7A,1,0,5058,5058,NA,NA,5058,NA
NM_152232,TAS1R2,6,5,20064,2527,17537,3507.4,421.1666667,6.939849624
NM_001161504,ALDH4A1,15,14,19463,3258,16205,1157.5,217.2,4.973910374
NM_003748,ALDH4A1,15,14,31371,3398,27973,1998.071429,226.5333333,8.232195409
NM_170726,ALDH4A1,16,15,31371,2386,28985,1932.333333,149.125,12.14794635
NM_001040126,PQLC2,8,7,17056,1651,15405,2200.714286,206.375,9.330708661
NM_001040125,PQLC2,8,7,17056,2263,14793,2113.285714,282.875,6.536897923
NM_001287531,PQLC2,8,7,17056,1620,15436,2205.142857,202.5,9.528395062
NM_012067,AKR7A3,7,6,6225,1248,4977,829.5,178.2857143,3.987980769
NM_003689,AKR7A2,7,6,9440,2626,6814,1135.666667,375.1428571,2.594821021
NM_017765,PQLC2,9,8,17056,1894,15162,1895.25,210.4444444,8.005279831
NM_016183,MRTO4,8,7,8549,2281,6268,895.4285714,285.125,2.74791758
NM_001271427,EMC1,23,22,35897,6691,29206,1327.545455,290.9130435,4.364967867
NM_001271429,EMC1,22,21,35897,6627,29270,1393.809524,301.2272727,4.41677984
NM_001271428,EMC1,23,22,35897,6691,29206,1327.545455,290.9130435,4.364967867
NM_015047,EMC1,23,22,35897,6694,29203,1327.409091,291.0434783,4.36256349
NM_001204088,MINOS1-NBL1,5,4,61480,2215,59265,14816.25,443,26.75620767
NM_001204086,NBL1,4,3,12691,2164,10527,3509,541,4.864602588
NM_001204084,NBL1,4,3,14743,2137,12606,4202,534.25,5.898923725
NM_182744,NBL1,4,3,15228,2065,13163,4387.666667,516.25,6.37433414
NM_001204089,MINOS1-NBL1,4,3,61480,2029,59451,19817,507.25,29.30064071
NM_001204085,NBL1,4,3,13085,2055,11030,3676.666667,513.75,5.367396594
NM_000871,HTR6,3,2,15681,3391,12290,6145,1130.333333,3.624299617
NM_001032363,MINOS1,4,3,32846,3730,29116,9705.333333,932.5,7.805898123
NM_001204083,MINOS1,5,4,32846,3972,28874,7218.5,794.4,7.2693857
NM_001204082,MINOS1,3,2,32846,3681,29165,14582.5,1227,7.923118718
NM_001278166,NBL1,4,3,10847,1957,8890,2963.333333,489.25,4.542667348
NM_001278165,NBL1,4,3,15048,2113,12935,4311.666667,528.25,6.121628017
NM_001278164,NBL1,4,3,15228,2046,13182,4394,511.5,6.442815249
NM_005380,NBL1,4,3,14284,2170,12114,4038,542.5,5.582488479
NM_019062,RNF186,1,0,1251,1251,NA,NA,1251,NA
NM_001161729,PLA2G2A,5,4,4230,928,3302,825.5,185.6,3.558189655
NM_001161728,PLA2G2A,5,4,5010,894,4116,1029,178.8,4.604026846
NM_001161727,PLA2G2A,6,5,5010,975,4035,807,162.5,4.138461538
NM_000300,PLA2G2A,6,5,5010,1006,4004,800.8,167.6666667,3.980119284
NM_014589,PLA2G2E,4,3,3312,491,2821,940.3333333,122.75,5.745417515
NM_015207,OTUD3,8,7,30551,6522,24029,3432.714286,815.25,3.684299295
NM_001271814,PLA2G2D,3,2,6918,1866,5052,2526,622,2.707395498
NM_000929,PLA2G5,5,4,21695,1899,19796,4949,379.8,10.42443391
NM_012400,PLA2G2D,4,3,6918,1974,4944,1648,493.5,2.504559271
NM_152376,UBXN10,2,1,7366,2974,4392,4392,1487,1.476798924
NM_001105572,PLA2G2C,3,2,11205,456,10749,5374.5,152,23.57236842
NM_022819,PLA2G2F,5,4,11058,2724,8334,2083.5,544.8,3.059471366
NM_001039500,VWA5B1,22,21,63977,4497,59480,2832.380952,204.4090909,13.22659551
NM_018584,CAMK2N1,2,1,3846,2353,1493,1493,1176.5,0.634509137
NM_024544,MUL1,4,3,8735,2462,6273,2091,615.5,2.547928513
NM_001785,CDA,4,3,29958,963,28995,9665,240.75,30.10903427
NM_207334,FAM43B,1,0,2583,2583,NA,NA,2583,NA
NM_020816,KIF17,15,14,54005,3986,50019,3572.785714,265.7333333,12.54867035
NM_005216,DDOST,11,10,9779,2137,7642,764.2,194.2727273,3.576041179
NM_001103161,SH2D5,10,9,12910,3844,9066,1007.333333,384.4,2.358480749
NM_001122819,KIF17,15,14,54005,3983,50022,3573,265.5333333,12.55887522
NM_001103160,SH2D5,9,8,12910,3714,9196,1149.5,412.6666667,2.476036618
NM_001287212,KIF17,15,14,54005,4113,49892,3563.714286,274.2,12.1303185
NM_001397,ECE1,19,18,73244,5115,68129,3784.944444,269.2105263,13.31945259
NM_001113349,ECE1,18,17,73028,5105,67923,3995.470588,283.6111111,13.30519099
NM_001113347,ECE1,17,16,62445,5258,57187,3574.1875,309.2941176,10.87618866
NM_032264,NBPF3,15,14,44812,3829,40983,2927.357143,255.2666667,10.70331679
NM_001256417,NBPF3,14,13,44812,3618,41194,3168.769231,258.4285714,11.38584854
NM_001256416,NBPF3,15,14,44812,3793,41019,2929.928571,252.8666667,10.81439494
NM_001145658,RAP1GAP,25,24,55642,3326,52316,2179.833333,133.04,15.72940469
NM_001145657,RAP1GAP,27,26,73150,3522,69628,2678,130.4444444,19.76944918
NM_002885,RAP1GAP,25,24,73150,3359,69791,2907.958333,134.36,20.77731468
NM_001032730,USP48,11,10,55351,2423,52928,5292.8,220.2727273,21.84399505
NM_007352,CELA3B,8,7,12431,1011,11420,1631.428571,126.375,11.29574679
NM_005747,CELA3A,8,7,10888,915,9973,1424.714286,114.375,10.89945355
NM_030761,WNT4,5,4,25723,3910,21813,5453.25,782,5.578772379
NM_001006943,EPHA8,5,4,26110,1858,24252,6063,371.6,13.05274489
NM_020526,EPHA8,17,16,40085,5013,35072,2192,294.8823529,6.996209854
NM_015991,C1QA,3,2,3059,1101,1958,979,367,1.778383288
NM_000491,C1QB,3,2,8349,1047,7302,3651,349,6.974212034
NM_001114101,C1QC,3,2,4487,1194,3293,1646.5,398,2.757956449
NM_172369,C1QC,3,2,4487,1171,3316,1658,390.3333333,2.83176772
NM_015013,KDM1A,19,18,64245,3054,61191,3399.5,160.7368421,20.03634578
NM_001009999,KDM1A,21,20,64245,3128,61117,3055.85,148.952381,19.53868286
NM_001242521,C1orf234,3,2,5018,513,4505,2252.5,171,8.781676413
NM_000864,HTR1D,1,0,2836,2836,NA,NA,2836,NA
NM_005826,HNRNPR,11,10,34579,2743,31836,3183.6,249.3636364,11.60627051
NM_001102397,HNRNPR,10,9,34579,2576,32003,3555.888889,257.6,12.42352484
NM_030634,ZNF436,3,2,8940,4318,4622,2311,1439.333333,1.070402964
NM_001102399,HNRNPR,10,9,34579,2585,31994,3554.888889,258.5,12.37678917
NM_001102398,HNRNPR,11,10,34579,2752,31827,3182.7,250.1818182,11.5650436
NM_001077195,ZNF436,4,3,10418,4497,5921,1973.666667,1124.25,1.316655548
NM_001143778,ASAP3,24,23,55696,4126,51570,2242.173913,171.9166667,12.49878817
NM_017707,ASAP3,25,24,55696,4154,51542,2147.583333,166.16,12.40779971
NM_002167,ID3,3,2,1866,1242,624,312,414,0.502415459
NM_003198,TCEB3,11,10,18695,4954,13741,1374.1,450.3636364,2.773718208
NM_000975,RPL11,6,5,4648,640,4008,801.6,106.6666667,6.2625
NM_001199802,RPL11,6,5,4648,637,4011,802.2,106.1666667,6.296703297
NM_020362,PITHD1,6,5,9848,1628,8220,1644,271.3333333,5.049140049
NM_001166059,HMGCL,7,6,23584,1402,22182,3697,200.2857143,15.82168331
NM_007260,LYPLA2,10,9,4385,1634,2751,305.6666667,163.4,1.683598531
NM_000191,HMGCL,9,8,23584,1617,21967,2745.875,179.6666667,13.58503401
NM_000147,FUCA1,8,7,23289,2125,21164,3023.428571,265.625,9.959529412
NM_001008216,GALE,12,11,5207,1578,3629,329.9090909,131.5,2.299746515
NM_001841,CNR2,2,1,39359,1777,37582,37582,888.5,21.14912774
NM_001127621,GALE,11,10,3973,1618,2355,235.5,147.0909091,1.455500618
NM_000403,GALE,12,11,4947,1643,3304,300.3636364,136.9166667,2.010955569
NM_017761,PNRC2,3,2,3650,2417,1233,616.5,805.6666667,0.510136533
NM_001191005,SRSF10,6,5,11382,3059,8323,1664.6,509.8333333,2.720823799
NM_006625,SRSF10,6,5,14018,1982,12036,2407.2,330.3333333,6.072653885
NM_001191009,SRSF10,5,4,14018,1927,12091,3022.75,385.4,6.274519979
NM_001191007,SRSF10,6,5,14018,1979,12039,2407.8,329.8333333,6.083375442
NM_001191006,SRSF10,6,5,14018,2215,11803,2360.6,369.1666667,5.328668172
NM_054016,SRSF10,6,5,11382,3062,8320,1664,510.3333333,2.717178315
NM_021258,IL22RA1,7,6,23516,2969,20547,3424.5,424.1428571,6.920511957
NM_152372,MYOM3,37,36,56136,5837,50299,1397.194444,157.7567568,8.617269145
NM_198174,GRHL3,16,15,45160,2236,42924,2861.6,139.75,19.19677996
NM_021180,GRHL3,16,15,32280,2716,29564,1970.933333,169.75,10.88512518
NM_001199013,STPG1,9,8,56775,2725,54050,6756.25,302.7777778,19.83486239
NM_001195010,GRHL3,16,15,35754,2820,32934,2195.6,176.25,11.6787234
NM_001199014,STPG1,10,9,56775,2870,53905,5989.444444,287,18.78222997
NM_001199012,STPG1,9,8,58100,2813,55287,6910.875,312.5555556,19.65410594
NM_198173,GRHL3,16,15,35998,2885,33113,2207.533333,180.3125,11.47764298
NM_178122,STPG1,8,7,56775,2605,54170,7738.571429,325.625,20.79462572
NM_013441,RCAN3,5,4,34125,2787,31338,7834.5,557.4,11.24434876
NM_001251985,RCAN3,2,1,22708,2184,20524,20524,1092,9.397435897
NM_001251983,RCAN3,4,3,34125,2532,31593,10531,633,12.47748815
NM_001251982,RCAN3,3,2,22708,2359,20349,10174.5,786.3333333,8.62611276
NM_001251980,RCAN3,4,3,22708,2502,20206,6735.333333,625.5,8.075939249
NM_001251978,RCAN3,5,4,29428,2668,26760,6690,533.6,10.02998501
NM_001251984,RCAN3,4,3,34671,2391,32280,10760,597.75,13.50062735
NM_001251981,RCAN3,4,3,34125,2579,31546,10515.33333,644.75,12.23187282
NM_001251979,RCAN3,5,4,34671,2646,32025,8006.25,529.2,12.1031746
NM_001251977,RCAN3,5,4,34125,2754,31371,7842.75,550.8,11.39106754
NM_005839,SRRM1,17,16,30180,3951,26229,1639.3125,232.4117647,6.638572513
NM_001031680,RUNX3,6,5,65501,4346,61155,12231,724.3333333,14.07156006
NM_004350,RUNX3,5,4,30770,4275,26495,6623.75,855,6.197660819
NM_207170,SYF2,6,5,10248,1657,8591,1718.2,276.1666667,5.184671092
NM_015484,SYF2,7,6,10248,1784,8464,1410.666667,254.8571429,4.744394619
NM_001127691,RHD,7,6,57961,2556,55405,9234.166667,365.1428571,21.67644757
NM_016124,RHD,10,9,57961,2847,55114,6123.777778,284.7,19.35862311
NM_014313,TMEM50A,7,6,24065,2309,21756,3626,329.8571429,9.422260719
NM_001282867,RHD,10,9,57961,2843,55118,6124.222222,284.3,19.38726697
NM_020317,C1orf63,5,4,5247,1470,3777,944.25,294,2.569387755
NM_001282871,RHD,9,8,57961,2862,55099,6887.375,318,19.25192173
NM_001282870,RHD,9,8,57961,2772,55189,6898.625,308,19.90945166
NM_001282869,RHD,8,7,57961,2691,55270,7895.714286,336.375,20.53883315
NM_001282868,RHD,8,7,57961,2637,55324,7903.428571,329.625,20.9799014
NM_001282872,RHD,10,9,57961,2943,55018,6113.111111,294.3,18.69452939
NM_015627,LDLRAP1,9,8,25303,2944,22359,2794.875,327.1111111,7.594769022
NM_019557,MTFR1L,7,6,12751,2110,10641,1773.5,301.4285714,5.043127962
NM_178422,PAQR7,2,1,9771,3025,6746,6746,1512.5,2.230082645
NM_020451,SEPN1,13,12,18048,4345,13703,1141.916667,334.2307692,3.153739931
NM_001099627,MTFR1L,7,6,13038,1903,11135,1855.833333,271.8571429,5.851287441
NM_001099626,MTFR1L,7,6,12116,2064,10052,1675.333333,294.8571429,4.870155039
NM_001099625,MTFR1L,7,6,13038,2012,11026,1837.666667,287.4285714,5.480119284
NM_024037,AUNIP,3,2,25454,2165,23289,11644.5,721.6666667,10.75704388
NM_206926,SEPN1,12,11,18048,4242,13806,1255.090909,353.5,3.254596888
NM_001287490,AUNIP,4,3,27547,1396,26151,8717,349,18.73280802
NM_203399,STMN1,5,4,6763,1507,5256,1314,301.4,3.487723955
NM_203401,STMN1,5,4,6039,1719,4320,1080,343.8,2.513089005
NM_005563,STMN1,5,4,6388,1531,4857,1214.25,306.2,3.172436316
NM_000437,PAFAH2,11,10,38392,3592,34800,3480,326.5454545,9.688195991
NM_032513,SLC30A2,7,6,8092,2333,5759,959.8333333,333.2857143,2.468495499
NM_032588,TRIM63,9,8,16331,1779,14552,1819,197.6666667,8.179876335
NM_001004434,SLC30A2,8,7,8092,2481,5611,801.5714286,310.125,2.261588069
NM_001243533,PDIK1L,4,3,13773,4348,9425,3141.666667,1087,2.167663293
NM_001243532,PDIK1L,3,2,14385,4273,10112,5056,1424.333333,2.366487245
NM_004455,EXTL1,11,10,14685,4025,10660,1066,365.9090909,2.648447205
NM_152835,PDIK1L,3,2,13773,4156,9617,4808.5,1385.333333,2.31400385
NM_024869,FAM110D,2,1,3610,1526,2084,2084,763,1.365661861
NM_001281518,CEP85,7,6,9757,2629,7128,1188,375.5714286,2.711297071
NM_001281517,CEP85,13,12,44887,4074,40813,3401.083333,313.3846154,10.01791851
NM_022778,CEP85,14,13,44887,4228,40659,3127.615385,302,9.616603595
NM_198137,CATSPER4,10,9,11916,1429,10487,1165.222222,142.9,7.33869839
NM_015871,ZNF593,3,2,978,652,326,163,217.3333333,0.5
NM_006314,CNKSR1,21,20,12396,2557,9839,491.95,121.7619048,3.847868596
NM_183008,UBXN11,16,15,24424,1869,22555,1503.666667,116.8125,12.06795078
NM_001039775,AIM1L,20,19,32273,5265,27008,1421.473684,263.25,5.129724596
NM_145345,UBXN11,15,14,35985,1863,34122,2437.285714,124.2,18.31561997
NM_001803,CD52,2,1,2605,507,2098,2098,253.5,4.138067061
NM_001077262,UBXN11,11,10,24424,1379,23045,2304.5,125.3636364,16.71138506
NM_001114759,ZNF683,6,5,11143,1659,9484,1896.8,276.5,5.716696805
NM_173574,ZNF683,6,5,11143,1656,9487,1897.4,276,5.728864734
NM_001243564,DHDDS,8,7,39024,3231,35793,5113.285714,403.875,11.07799443
NM_024887,DHDDS,9,8,39024,3337,35687,4460.875,370.7777778,10.69433623
NM_205861,DHDDS,9,8,39024,3334,35690,4461.25,370.4444444,10.70485903
NM_001243565,DHDDS,8,7,39024,3216,35808,5115.428571,402,11.13432836
NM_005517,HMGN2,6,5,4233,1975,2258,451.6,329.1666667,1.143291139
NM_001006665,RPS6KA1,21,20,29179,3133,26046,1302.3,149.1904762,8.3134376
NM_006015,ARID1A,20,19,86081,8605,77476,4077.684211,430.25,9.003602557
NM_017837,PIGV,4,3,10442,2408,8034,2678,602,3.336378738
NM_139135,ARID1A,20,19,86081,7954,78127,4111.947368,397.7,9.822353533
NM_001202554,PIGV,4,3,10217,2734,7483,2494.333333,683.5,2.737015362
NM_022078,GPATCH3,7,6,9985,2136,7849,1308.166667,305.1428571,3.674625468
NM_032283,ZDHHC18,8,7,29012,3147,25865,3695,393.375,8.218938672
NM_018066,GPN2,5,4,10998,1515,9483,2370.75,303,6.259405941
NM_006142,SFN,1,0,1316,1316,NA,NA,1316,NA
NM_021969,NR0B2,2,1,2594,1273,1321,1321,636.5,1.037706206
NM_052943,FAM46B,2,1,7824,2376,5448,5448,1188,2.292929293
NM_152365,C1orf172,4,3,10856,1807,9049,3016.333333,451.75,5.007747648
NM_001013642,TRNP1,2,1,7184,1951,5233,5233,975.5,2.682214249
NM_003047,SLC9A1,12,11,56323,4754,51569,4688.090909,396.1666667,10.84749684
NM_015023,WDTC1,16,15,74119,4832,69287,4619.133333,302,14.33919702
NM_001276252,WDTC1,16,15,74119,4835,69284,4618.933333,302.1875,14.32967942
NM_032872,SYTL1,15,14,11942,1945,9997,714.0714286,129.6666667,5.139845758
NM_207397,CD164L2,5,4,4211,1544,2667,666.75,308.8,1.727331606
NM_001193308,SYTL1,15,14,11942,1981,9961,711.5,132.0666667,5.028268551
NM_005281,GPR3,2,1,3171,2116,1055,1055,1058,0.498582231
NM_004672,MAP3K6,29,28,11669,4357,7312,261.1428571,150.2413793,1.678218958
NM_003665,FCN3,8,7,5716,1040,4676,668,130,4.496153846
NM_173452,FCN3,7,6,5716,1006,4710,785,143.7142857,4.681908549
NM_001042747,FGR,13,12,13952,2498,11454,954.5,192.1538462,4.585268215
NM_001042729,FGR,13,12,14307,2439,11868,989,187.6153846,4.865928659
NM_002038,IFI6,5,4,6154,841,5313,1328.25,168.2,6.317479191
NM_022873,IFI6,5,4,6154,865,5289,1322.25,173,6.114450867
NM_022872,IFI6,5,4,6154,853,5301,1325.25,170.6,6.214536928
NM_005248,FGR,13,12,22928,2455,20473,1706.083333,188.8461538,8.339307536
NM_014110,PPP1R8,7,6,20933,2384,18549,3091.5,340.5714286,7.780620805
NM_152660,FAM76A,9,8,36935,3366,33569,4196.125,374,9.972964944
NM_002713,PPP1R8,6,5,20860,2564,18296,3659.2,427.3333333,7.135725429
NM_001143915,FAM76A,7,6,36935,3124,33811,5635.166667,446.2857143,10.82298335
NM_001143914,FAM76A,8,7,36935,3278,33657,4808.142857,409.75,10.26754118
NM_001143913,FAM76A,9,8,36935,3381,33554,4194.25,375.6666667,9.924282757
NM_001143912,FAM76A,10,9,36935,3469,33466,3718.444444,346.9,9.647160565
NM_138558,PPP1R8,7,6,20860,2666,18194,3032.333333,380.8571429,6.824456114
NM_177424,STX12,9,8,51271,3088,48183,6022.875,343.1111111,15.60330311
NM_014474,SMPDL3B,8,7,24161,1881,22280,3182.857143,235.125,11.84476342
NM_018053,XKR8,3,2,8102,2161,5941,2970.5,720.3333333,2.74919019
NM_001286076,RPA2,9,8,23274,1965,21309,2663.625,218.3333333,10.84427481
NM_001039477,THEMIS2,4,3,14144,1244,12900,4300,311,10.36977492
NM_001105556,THEMIS2,6,5,14144,2730,11414,2282.8,455,4.180952381
NM_001286115,THEMIS2,6,5,14144,2142,12002,2400.4,357,5.603174603
NM_004848,THEMIS2,5,4,14144,1656,12488,3122,331.2,7.541062802
NM_002946,RPA2,9,8,23274,1814,21460,2682.5,201.5555556,11.83020948
NM_001009568,SMPDL3B,7,6,21489,1601,19888,3314.666667,228.7142857,12.4222361
NM_001286113,THEMIS2,7,6,14144,2344,11800,1966.666667,334.8571429,5.034129693
NM_001164721,PTAFR,3,2,46772,4194,42578,21289,1398,10.15212208
NM_178190,ATPIF1,3,2,2016,620,1396,698,206.6666667,2.251612903
NM_000952,PTAFR,2,1,29780,4249,25531,25531,2124.5,6.008707931
NM_016311,ATPIF1,3,2,2016,544,1472,736,181.3333333,2.705882353
NM_001164722,PTAFR,2,1,46772,4111,42661,42661,2055.5,10.37728047
NM_001164723,PTAFR,3,2,29780,4321,25459,12729.5,1440.333333,5.891923166
NM_014280,DNAJC8,9,8,32754,1773,30981,3872.625,197,17.47377327
NM_178191,ATPIF1,2,1,2016,1927,89,89,963.5,0.046185781
NM_017638,MED18,3,2,6967,1872,5095,2547.5,624,2.721688034
NM_031459,SESN2,10,9,23041,3538,19503,2167,353.8,5.512436405
NM_001127350,MED18,3,2,6967,1816,5151,2575.5,605.3333333,2.836453744
NM_023923,PHACTR4,13,12,62222,6207,56015,4667.916667,477.4615385,9.024488481
NM_017846,TRNAU1AP,9,8,25530,1876,23654,2956.75,208.4444444,12.608742
NM_001269,RCC1,10,9,20965,2550,18415,2046.111111,255,7.221568627
NM_001048195,RCC1,11,10,20965,2602,18363,1836.3,236.5454545,7.057263643
NM_001048194,RCC1,11,10,20965,2644,18321,1832.1,240.3636364,6.929273828
NM_152304,RAB42,2,1,2378,1085,1293,1293,542.5,1.191705069
NM_001193532,RAB42,2,1,2083,1135,948,948,567.5,0.835242291
NM_016258,YTHDF2,5,4,33153,3065,30088,7522,613,9.816639478
NM_006582,GMEB1,10,9,46877,2704,44173,4908.111111,270.4,16.33616864
NM_024482,GMEB1,10,9,46877,2671,44206,4911.777778,267.1,16.55035567
NM_001172828,YTHDF2,4,3,32837,2723,30114,10038,680.75,11.05912596
NM_001173128,YTHDF2,6,5,33156,2832,30324,6064.8,472,10.70762712
NM_000911,OPRD1,3,2,51556,1777,49779,24889.5,592.3333333,28.01294316
NM_001171868,TMEM200B,2,1,3078,2564,514,514,1282,0.200468019
NM_001003682,TMEM200B,2,1,4486,2480,2006,2006,1240,0.808870968
NM_016011,MECR,10,9,38303,2549,35754,3972.666667,254.9,14.02667713
NM_001024732,MECR,10,9,38303,2676,35627,3958.555556,267.6,13.31352765
NM_006762,LAPTM5,8,7,25370,2248,23122,3303.142857,281,10.28558719
NM_014654,SDC3,5,4,39169,5126,34043,8510.75,1025.2,6.641240734
NM_024522,NKAIN1,7,6,60144,2929,57215,9535.833333,418.4285714,19.53397064
NM_001282566,ZCCHC17,7,6,67973,1659,66314,11052.33333,237,39.97227245
NM_001282574,ZCCHC17,7,6,67973,1496,66477,11079.5,213.7142857,44.43649733
NM_001282573,ZCCHC17,7,6,67973,1465,66508,11084.66667,209.2857143,45.39795222
NM_001282572,ZCCHC17,6,5,67973,1394,66579,13315.8,232.3333333,47.76111908
NM_001282571,ZCCHC17,7,6,67973,1541,66432,11072,220.1428571,43.10966905
NM_016505,ZCCHC17,8,7,67973,1643,66330,9475.714286,205.375,40.37127206
NM_004814,SNRNP40,10,9,37231,1634,35597,3955.222222,163.4,21.78518972
NM_001282569,ZCCHC17,9,8,67973,1714,66259,8282.375,190.4444444,38.65752625
NM_004102,FABP3,4,3,7825,1101,6724,2241.333333,275.25,6.107175295
NM_001282568,ZCCHC17,8,7,67973,1781,66192,9456,222.625,37.16563728
NM_001282567,ZCCHC17,7,6,67973,1599,66374,11062.33333,228.4285714,41.50969356
NM_001282570,ZCCHC17,7,6,67973,1521,66452,11075.33333,217.2857143,43.68967784
NM_001199039,SERINC2,11,10,20869,2821,18048,1804.8,256.4545455,6.397731301
NM_001199038,SERINC2,11,10,25117,2160,22957,2295.7,196.3636364,10.62824074
NM_001199037,SERINC2,10,9,24508,2082,22426,2491.777778,208.2,10.77137368
NM_018565,SERINC2,10,9,20869,2072,18797,2088.555556,207.2,9.071911197
NM_178865,SERINC2,10,9,21566,2009,19557,2173,200.9,9.734693878
NM_001204415,TINAGL1,11,10,9543,1856,7687,768.7,168.7272727,4.141702586
NM_001204414,TINAGL1,11,10,11203,2155,9048,904.8,195.9090909,4.198607889
NM_012392,PEF1,5,4,15377,1984,13393,3348.25,396.8,6.750504032
NM_001525,HCRTR1,9,8,9620,2010,7610,951.25,223.3333333,3.786069652
NM_022164,TINAGL1,12,11,11203,2249,8954,814,187.4166667,3.981325033
NM_001856,COL16A1,71,70,51922,5655,46267,660.9571429,79.64788732,8.181609195
NM_001703,BAI2,33,32,36932,5448,31484,983.875,165.0909091,5.779001468
NM_144569,SPOCD1,16,15,25631,3978,21653,1443.533333,248.625,5.443187531
NM_001281988,SPOCD1,15,14,25631,2516,23115,1651.071429,167.7333333,9.187201908
NM_001281987,SPOCD1,16,15,25631,3939,21692,1446.133333,246.1875,5.506981467
NM_018056,TMEM39B,9,8,29966,1827,28139,3517.375,203,15.40175151
NM_001160042,IQCC,5,4,3054,2298,756,189,459.6,0.328981723
NM_001099434,DCDC2B,9,8,7104,1358,5746,718.25,150.8888889,4.231222386
NM_032648,FAM167B,2,1,1645,958,687,687,479,0.717118998
NM_024296,CCDC28B,6,5,4791,883,3908,781.6,147.1666667,4.425821065
NM_018134,IQCC,5,4,3054,2058,996,249,411.6,0.483965015
NM_001042771,LCK,13,12,12056,2113,9943,828.5833333,162.5384615,4.705631803
NM_019118,TMEM234,5,4,6130,1087,5043,1260.75,217.4,4.639374425
NM_005356,LCK,13,12,34928,2130,32798,2733.166667,163.8461538,15.39812207
NM_003757,EIF3I,11,10,9236,1469,7767,776.7,133.5454545,5.287270252
NM_175852,TXLNA,11,10,18543,4807,13736,1373.6,437,2.85749948
NM_023009,MARCKSL1,2,1,2412,1564,848,848,782,0.542199488
NM_052841,TSSK3,2,1,2064,1317,747,747,658.5,0.567198178
NM_001143890,BSDC1,9,8,29359,2582,26777,3347.125,286.8888889,10.37064291
NM_001143888,BSDC1,11,10,29359,2920,26439,2643.9,265.4545455,9.054452055
NM_001143889,BSDC1,10,9,29359,2700,26659,2962.111111,270,9.873703704
NM_018045,BSDC1,11,10,29359,2869,26490,2649,260.8181818,9.233182293
NM_001167676,FAM229A,3,2,975,702,273,136.5,234,0.388888889
NM_001145720,ZBTB8B,4,3,22803,4022,18781,6260.333333,1005.5,4.669567379
NM_005610,RBBP4,12,11,35065,7955,27110,2464.545455,662.9166667,3.407919547
NM_001135256,RBBP4,12,11,34855,7855,27000,2454.545455,654.5833333,3.437301082
NM_001135255,RBBP4,12,11,35065,7952,27113,2464.818182,662.6666667,3.409582495
NM_178547,ZBTB8OS,7,6,28880,722,28158,4693,103.1428571,39
NM_020888,KIAA1522,7,6,33061,5419,27642,4607,774.1428571,5.100941133
NM_001198973,KIAA1522,5,4,9338,2656,6682,1670.5,531.2,2.515813253
NM_001198972,KIAA1522,7,6,9338,5334,4004,667.3333333,762,0.750656168
NM_003680,YARS,13,12,42795,3130,39665,3305.416667,240.7692308,12.67252396
NM_002143,HPCA,4,3,8151,1410,6741,2247,352.5,4.780851064
NM_001171940,FNDC5,6,5,8547,2089,6458,1291.6,348.1666667,3.091431307
NM_033504,TMEM54,6,5,6759,999,5760,1152,166.5,5.765765766
NM_001171941,FNDC5,5,4,10226,3035,7191,1797.75,607,2.369357496
NM_153756,FNDC5,6,5,8547,2738,5809,1161.8,456.3333333,2.121621622
NM_013411,AK2,7,6,28973,3678,25295,4215.833333,525.4285714,6.87737901
NM_001199199,AK2,7,6,28973,3654,25319,4219.833333,522,6.929118774
NM_001625,AK2,6,5,25688,2765,22923,4584.6,460.8333333,8.290415913
NM_018207,TRIM62,5,4,36670,3846,32824,8206,769.2,8.534581383
NM_001080438,A3GALT2,5,4,14334,1028,13306,3326.5,205.6,12.94357977
NM_152493,ZNF362,9,8,44148,3115,41033,5129.125,346.1111111,13.17271268
NM_004427,PHC2,7,6,26277,2573,23704,3950.666667,367.5714286,9.212592305
NM_145205,HMGB4,2,1,4318,2345,1973,1973,1172.5,0.841364606
NM_001134734,C1orf94,7,6,42180,3011,39169,6528.166667,430.1428571,13.008635
NM_032884,C1orf94,7,6,52249,2142,50107,8351.166667,306,23.39262372
NM_024009,GJB3,2,1,5177,2219,2958,2958,1109.5,1.333032898
NM_001005752,GJB3,2,1,4058,1764,2294,2294,882,1.300453515
NM_153212,GJB4,2,1,3985,2842,1143,1143,1421,0.402181562
NM_005268,GJB5,2,1,3467,1357,2110,2110,678.5,1.554900516
NM_001164825,SMIM12,2,1,9377,5906,3471,3471,2953,0.587707416
NM_001080418,DLGAP3,10,9,39949,3597,36352,4039.111111,359.7,10.10619961
NM_002060,GJA4,2,1,2751,1624,1127,1127,812,0.693965517
NM_138428,SMIM12,2,1,9456,5763,3693,3693,2881.5,0.640812077
NM_001164824,SMIM12,3,2,8685,6014,2671,1335.5,2004.666667,0.444130362
NM_007167,ZMYM6,16,15,45804,5160,40644,2709.6,322.5,7.876744186
NM_001195156,ZMYM6NB,3,2,3823,928,2895,1447.5,309.3333333,3.119612069
NM_024772,ZMYM1,10,9,36497,4192,32305,3589.444444,419.2,7.70634542
NM_001289088,ZMYM1,11,10,56074,4479,51595,5159.5,407.1818182,11.51931235
NM_001289089,ZMYM1,10,9,36497,4135,32362,3595.777778,413.5,7.826360339
NM_001289090,ZMYM1,11,10,36497,4241,32256,3225.6,385.5454545,7.60575336
NM_001289091,ZMYM1,11,10,36497,4311,32186,3218.6,391.9090909,7.466017165
NM_014284,NCDN,7,6,8989,3712,5277,879.5,530.2857143,1.421605603
NM_001014841,NCDN,7,6,8989,3372,5617,936.1666667,481.7142857,1.665776987
NM_001014839,NCDN,8,7,8989,3441,5548,792.5714286,430.125,1.612321999
NM_001199779,PSMB2,6,5,42011,4381,37630,7526,730.1666667,8.589363159
NM_001199780,PSMB2,5,4,31997,4224,27773,6943.25,844.8,6.575047348
NM_002794,PSMB2,6,5,42304,4749,37555,7511,791.5,7.907980628
NM_001190481,CLSPN,24,23,37840,8316,29524,1283.652174,346.5,3.55026455
NM_152374,C1orf216,2,1,5315,2936,2379,2379,1468,0.810286104
NM_022111,CLSPN,25,24,37840,8509,29331,1222.125,340.36,3.447056058
NM_012199,AGO1,19,18,41091,7497,33594,1866.333333,394.5789474,4.480992397
NM_005202,COL8A2,2,1,5008,4447,561,561,2223.5,0.126152462
NM_014466,TEKT2,10,9,4202,1519,2683,298.1111111,151.9,1.766293614
NM_017825,ADPRHL2,6,5,5082,1697,3385,677,282.8333333,1.994696523
NM_018067,MAP7D1,17,16,24887,3588,21299,1331.1875,211.0588235,5.936176143
NM_014408,TRAPPC3,5,4,12947,1318,11629,2907.25,263.6,8.823216995
NM_001270897,TRAPPC3,3,2,12947,1118,11829,5914.5,372.6666667,10.58050089
NM_001270896,TRAPPC3,5,4,12947,1563,11384,2846,312.6,7.283429303
NM_001270894,TRAPPC3,5,4,12947,1342,11605,2901.25,268.4,8.647540984
NM_001270895,TRAPPC3,5,4,19486,1311,18175,4543.75,262.2,13.86346301
NM_001286366,MAP7D1,18,17,24887,3490,21397,1258.647059,193.8888889,6.130945559
NM_001286365,MAP7D1,16,15,24887,3473,21414,1427.6,217.0625,6.165850849
NM_024676,SH3D21,13,12,14242,2338,11904,992,179.8461538,5.091531223
NM_018166,EVA1B,3,2,2125,1057,1068,534,352.3333333,1.010406812
NM_001162530,SH3D21,16,15,14956,2535,12421,828.0666667,158.4375,4.899802761
NM_031280,MRPS15,8,7,8680,973,7707,1101,121.625,7.920863309
NM_206837,OSCP1,5,4,22187,813,21374,5343.5,162.6,26.2902829
NM_032881,LSM10,2,1,4464,852,3612,3612,426,4.23943662
NM_000760,CSF3R,17,16,17273,3426,13847,865.4375,201.5294118,4.041739638
NM_145047,OSCP1,10,9,32581,1499,31082,3453.555556,149.9,20.73515677
NM_172313,CSF3R,18,17,17273,3007,14266,839.1764706,167.0555556,4.744263385
NM_156039,CSF3R,17,16,17273,3507,13766,860.375,206.2941176,3.925292273
NM_025079,ZC3H12A,6,5,9861,2722,7139,1427.8,453.6666667,2.622703894
NM_022756,MEAF6,8,7,24861,4826,20035,2862.142857,603.25,4.151471198
NM_001270876,MEAF6,6,5,24861,4467,20394,4078.8,744.5,4.565480188
NM_001270875,MEAF6,7,6,24861,4795,20066,3344.333333,685,4.184775808
NM_001038633,RSPO1,9,8,23646,3098,20548,2568.5,344.2222222,6.632666236
NM_003462,DNALI1,6,5,9940,2655,7285,1457,442.5,2.743879473
NM_013285,GNL2,16,15,29175,2418,26757,1783.8,151.125,11.06575682
NM_001242909,RSPO1,8,7,23646,2597,21049,3007,324.625,8.105121294
NM_001242908,RSPO1,8,7,23646,2918,20728,2961.142857,364.75,7.103495545
NM_001242910,RSPO1,7,6,23646,2728,20918,3486.333333,389.7142857,7.667888563
NM_001113482,MANEAL,4,3,7506,2862,4644,1548,715.5,1.622641509
NM_001256875,CDCA8,10,9,17320,2496,14824,1647.111111,249.6,5.939102564
NM_152496,MANEAL,2,1,6120,2401,3719,3719,1200.5,1.548937943
NM_001031740,MANEAL,4,3,7506,2585,4921,1640.333333,646.25,1.903675048
NM_017850,C1orf109,5,4,8952,2360,6592,1648,472,2.793220339
NM_018101,CDCA8,11,10,17320,2400,14920,1492,218.1818182,6.216666667
NM_173641,EPHA10,3,2,4881,2071,2810,1405,690.3333333,1.356832448
NM_001099439,EPHA10,17,16,49180,5528,43652,2728.25,325.1764706,7.896526773
NM_198446,C1orf122,3,2,1655,1321,334,167,440.3333333,0.252838759
NM_005955,MTF1,11,10,50055,7983,42072,4207.2,725.7272727,5.270199173
NM_001142726,C1orf122,3,2,1655,1188,467,233.5,396,0.393097643
NM_006802,SF3A3,17,16,33111,2853,30258,1891.125,167.8235294,10.60567823
NM_001243878,FHL3,5,4,8747,1486,7261,1815.25,297.2,4.886271871
NM_002699,POU3F1,1,0,2929,2929,NA,NA,2929,NA
NM_016037,UTP11L,8,7,12115,2058,10057,1436.714286,257.25,4.886783285
NM_004468,FHL3,6,5,8747,1663,7084,1416.8,277.1666667,4.259771497
NM_012333,MYCBP,5,4,10890,2570,8320,2080,514,3.237354086
NM_017821,RHBDL2,8,7,55979,1845,54134,7733.428571,230.625,29.34092141
NM_030772,GJA9,2,1,7561,2324,5237,5237,1162,2.253442341
NM_001184979,NDUFS5,3,2,8343,570,7773,3886.5,190,13.63684211
NM_024595,AKIRIN1,5,4,14823,2731,12092,3023,546.2,4.427682168
NM_001136275,AKIRIN1,4,3,14823,2595,12228,4076,648.75,4.712138728
NM_004552,NDUFS5,3,2,8343,574,7769,3884.5,191.3333333,13.53484321
NM_015038,KIAA0754,1,0,6980,6980,NA,NA,6980,NA
NM_014571,HEYL,5,4,16247,4119,12128,3032,823.8,2.944403982
NM_001135653,PABPC4,16,15,16038,3220,12818,854.5333333,201.25,3.980745342
NM_001135654,PABPC4,15,14,16038,3132,12906,921.8571429,208.8,4.120689655
NM_003819,PABPC4,16,15,16038,3172,12866,857.7333333,198.25,4.056116015
NM_016257,HPCAL4,4,3,13064,4881,8183,2727.666667,1220.25,1.676500717
NM_001282397,HPCAL4,3,2,12839,4439,8400,4200,1479.666667,1.89231809
NM_006112,PPIE,10,9,17926,4386,13540,1504.444444,438.6,3.087095303
NM_022120,OXCT2,1,0,1825,1825,NA,NA,1825,NA
NM_001195007,PPIE,11,10,25071,1265,23806,2380.6,115,18.81897233
NM_001282396,HPCAL4,5,4,12839,4763,8076,2019,952.6,1.695570019
NM_032526,NT5C1A,6,5,12919,1113,11806,2361.2,185.5,10.60736748
NM_203456,PPIE,10,9,25071,1129,23942,2660.222222,112.9,21.20637733
NM_017646,TRIT1,11,10,42473,2139,40334,4033.4,194.4545455,18.85647499
NM_005376,MYCL,2,1,2405,2042,363,363,1021,0.177766895
NM_001033082,MYCL,3,2,6593,3263,3330,1665,1087.666667,1.020533252
NM_001033081,MYCL,2,1,6593,3626,2967,2967,1813,0.818257033
NM_032793,MFSD2A,14,13,14858,2188,12670,974.6153846,156.2857143,5.790676417
NM_001136493,MFSD2A,14,13,14858,2227,12631,971.6153846,159.0714286,5.671755725
NM_001287808,MFSD2A,12,11,14858,1926,12932,1175.636364,160.5,6.71443406
NM_001287809,MFSD2A,14,13,14858,2071,12787,983.6153846,147.9285714,6.174311927
NM_001105530,CAP1,13,12,32068,2768,29300,2441.666667,212.9230769,10.58526012
NM_006367,CAP1,13,12,32068,2786,29282,2440.166667,214.3076923,10.51040919
NM_001142604,PPT1,6,5,24762,2201,22561,4512.2,366.8333333,10.25034075
NM_000310,PPT1,9,8,24762,2513,22249,2781.125,279.2222222,8.85356148
NM_005857,ZMPSTE24,10,9,36136,3175,32961,3662.333333,317.5,10.38141732
NM_001008740,TMCO2,2,1,3794,743,3051,3051,371.5,4.106325707
NM_022733,SMAP2,10,9,49622,2940,46682,5186.888889,294,15.87823129
NM_001198980,SMAP2,10,9,26528,2513,24015,2668.333333,251.3,9.556307203
NM_001198979,SMAP2,10,9,29983,2582,27401,3044.555556,258.2,10.61231603
NM_001198978,SMAP2,10,9,48695,2498,46197,5133,249.8,18.49359488
NM_001852,COL9A2,32,31,16778,2863,13915,448.8709677,89.46875,4.860286413
NM_022774,EXO5,3,2,7783,2206,5577,2788.5,735.3333333,2.528105168
NM_198494,ZFP69,6,5,18715,2165,16550,3310,360.8333333,7.644341801
NM_023070,ZFP69B,5,4,13055,2036,11019,2754.75,407.2,5.412082515
NM_152373,ZNF684,5,4,16610,2102,14508,3627,420.4,6.901998097
NM_014747,RIMS3,8,7,44974,7237,37737,5391,904.625,5.214453503
NM_001142589,NFYC,9,8,80035,1984,78051,9756.375,220.4444444,39.34022177
NM_001142587,NFYC,10,9,80035,2096,77939,8659.888889,209.6,37.1846374
NM_014223,NFYC,10,9,80035,2099,77936,8659.555556,209.9,37.13006193
NM_001142588,NFYC,11,10,80035,2157,77878,7787.8,196.0909091,36.10477515
NM_001142590,NFYC,15,14,79597,2379,77218,5515.571429,158.6,32.4581757
NM_133467,CITED4,1,0,1292,1292,NA,NA,1292,NA
NM_001168247,SLFNL1,6,5,6130,2123,4007,801.4,353.8333333,1.887423457
NM_144990,SLFNL1,5,4,6160,1998,4162,1040.5,399.6,2.083083083
NM_001905,CTPS1,19,18,33230,3218,30012,1667.333333,169.3684211,9.326289621
NM_001956,EDN2,5,4,5900,1248,4652,1163,249.6,3.727564103
NM_007102,GUCA2B,3,2,2405,600,1805,902.5,200,3.008333333
NM_033553,GUCA2A,3,2,2035,578,1457,728.5,192.6666667,2.520761246
NM_024664,PPCS,3,2,4738,2315,2423,1211.5,771.6666667,1.046652268
NM_032257,ZMYND12,8,7,25939,1782,24157,3451,222.75,13.55611672
NM_001146192,ZMYND12,7,6,25939,1609,24330,4055,229.8571429,15.12119329
NM_001287509,PPCS,3,2,4738,1825,2913,1456.5,608.3333333,1.596164384
NM_001077447,PPCS,3,2,4738,1870,2868,1434,623.3333333,1.53368984
NM_001287506,PPCS,3,2,4891,1894,2997,1498.5,631.3333333,1.582365364
NM_001287508,PPCS,3,2,4738,1966,2772,1386,655.3333333,1.409969481
NM_001287510,PPCS,2,1,4738,2487,2251,2251,1243.5,0.905106554
NM_001287511,PPCS,3,2,16886,944,15942,7971,314.6666667,16.88771186
NM_001287507,PPCS,3,2,4891,2111,2780,1390,703.6666667,1.316911416
NM_001080850,CCDC30,16,15,119777,3114,116663,7777.533333,194.625,37.4640334
NM_001146289,LEPRE1,15,14,20751,2720,18031,1287.928571,181.3333333,6.629044118
NM_001185117,CLDN19,3,2,7163,3520,3643,1821.5,1173.333333,1.034943182
NM_024097,C1orf50,5,4,8499,1020,7479,1869.75,204,7.332352941
NM_001123395,CLDN19,4,3,7163,3606,3557,1185.666667,901.5,0.986411536
NM_006347,PPIH,10,9,18383,810,17573,1952.555556,81,21.69506173
NM_001243246,LEPRE1,14,13,20751,3119,17632,1356.307692,222.7857143,5.65309394
NM_022356,LEPRE1,15,14,20751,2701,18050,1289.285714,180.0666667,6.682710107
NM_004559,YBX1,8,7,19956,1554,18402,2628.857143,194.25,11.84169884
NM_148960,CLDN19,5,4,7163,2864,4299,1074.75,572.8,1.501047486
NM_015911,ZNF691,2,1,5904,1613,4291,4291,806.5,2.660260384
NM_199342,CCDC23,3,2,10338,801,9537,4768.5,267,11.90636704
NM_001017922,ERMAP,12,11,27886,3467,24419,2219.909091,288.9166667,7.043265071
NM_018538,ERMAP,11,10,19413,3362,16051,1605.1,305.6363636,4.774241523
NM_001242739,ZNF691,4,3,5904,1916,3988,1329.333333,479,2.081419624
NM_006516,SLC2A1,10,9,33803,3680,30123,3347,368,8.185597826
NM_001159936,EBNA1BP2,10,9,8398,1514,6884,764.8888889,151.4,4.546895641
NM_006824,EBNA1BP2,9,8,8143,1396,6747,843.375,155.1111111,4.833094556
NM_001101376,FAM183A,4,3,8475,521,7954,2651.333333,130.25,15.26679463
NM_001164829,C1orf210,3,2,3733,1407,2326,1163,469,1.653162758
NM_144626,TMEM125,4,3,4010,1790,2220,740,447.5,1.240223464
NM_182517,C1orf210,3,2,3695,1478,2217,1108.5,492.6666667,1.5
NM_001256402,ELOVL1,7,6,4679,1349,3330,555,192.7142857,2.468495182
NM_201542,MED8,7,6,5906,1996,3910,651.6666667,285.1428571,1.958917836
NM_001256399,ELOVL1,8,7,4343,1634,2709,387,204.25,1.657894737
NM_001256401,ELOVL1,7,6,4679,1459,3220,536.6666667,208.4285714,2.20699109
NM_001255,CDC20,11,10,4249,1685,2564,256.4,153.1818182,1.521661721
NM_001001653,MED8,7,6,5906,2039,3867,644.5,291.2857143,1.896517901
NM_022821,ELOVL1,8,7,4679,1541,3138,448.2857143,192.625,2.036340039
NM_052877,MED8,8,7,5906,1504,4402,628.8571429,188,2.926861702
NM_005373,MPL,12,11,16662,3657,13005,1182.272727,304.75,3.556193601
NM_031207,HYI,8,7,2988,1255,1733,247.5714286,156.875,1.380876494
NM_001243526,HYI,9,8,2988,1331,1657,207.125,147.8888889,1.244928625
NM_001190880,HYI,8,7,2988,1273,1715,245,159.125,1.347211312
NM_014663,KDM4A,22,21,55394,4531,50863,2422.047619,205.9545455,11.22555727
NM_001136215,ARTN,4,3,3922,1799,2123,707.6666667,449.75,1.180100056
NM_057091,ARTN,5,4,3922,1925,1997,499.25,385,1.037402597
NM_057090,ARTN,5,4,3922,1949,1973,493.25,389.8,1.012314007
NM_006934,SLC6A9,13,12,20859,3241,17618,1468.166667,249.3076923,5.43597655
NM_201649,SLC6A9,14,13,20859,3404,17455,1342.692308,243.1428571,5.127790834
NM_001024845,SLC6A9,14,13,35011,3250,31761,2443.153846,232.1428571,9.772615385
NM_001039589,DPH2,5,4,3392,1818,1574,393.5,363.6,0.865786579
NM_001005417,B4GALT2,7,6,10668,2011,8657,1442.833333,287.2857143,4.304823471
NM_152499,CCDC24,9,8,4920,1470,3450,431.25,163.3333333,2.346938776
NM_030587,B4GALT2,7,6,11237,2012,9225,1537.5,287.4285714,4.58499006
NM_001384,DPH2,6,5,3392,2503,889,177.8,417.1666667,0.355173791
NM_001039457,ATP6V0B,7,6,3372,980,2392,398.6666667,140,2.440816327
NM_004047,ATP6V0B,8,7,3372,1030,2342,334.5714286,128.75,2.273786408
NM_003780,B4GALT2,7,6,11971,2211,9760,1626.666667,315.8571429,4.414292175
NM_001261380,SLC6A9,13,12,20859,3196,17663,1471.916667,245.8461538,5.526595745
NM_001034023,DMAP1,11,10,7228,1596,5632,563.2,145.0909091,3.528822055
NM_001034024,DMAP1,11,10,7228,1556,5672,567.2,141.4545455,3.645244216
NM_019100,DMAP1,10,9,7228,1776,5452,605.7777778,177.6,3.06981982
NM_173484,KLF17,4,3,16289,3132,13157,4385.666667,783,4.20083014
NM_024587,TMEM53,3,2,20600,1603,18997,9498.5,534.3333333,11.85090455
NM_001145636,C1orf228,12,11,50871,1697,49174,4470.363636,141.4166667,28.97701827
NM_001136537,BTBD19,8,7,5649,1580,4069,581.2857143,197.5,2.575316456
NM_001013632,TCTEX1D4,2,1,1373,1266,107,107,633,0.084518167
NM_001012,RPS8,6,5,3168,711,2457,491.4,118.5,3.455696203
NM_001166292,PTCH2,23,22,23102,4321,18781,853.6818182,187.8695652,4.346447582
NM_004073,PLK3,15,14,5633,2373,3260,232.8571429,158.2,1.373788453
NM_003738,PTCH2,22,21,20680,3795,16885,804.047619,172.5,4.449275362
NM_153274,BEST4,9,8,4171,2105,2066,258.25,233.8888889,0.981472684
NM_024602,HECTD3,21,20,8809,3649,5160,258,173.7619048,1.414086051
NM_000374,UROD,10,9,3538,1418,2120,235.5555556,141.8,1.49506347
NM_025077,TOE1,8,7,4310,2400,1910,272.8571429,300,0.795833333
NM_001048171,MUTYH,16,15,11230,1904,9326,621.7333333,119,4.898109244
NM_012222,MUTYH,16,15,11230,1937,9293,619.5333333,121.0625,4.797625194
NM_001128425,MUTYH,16,15,11230,1946,9284,618.9333333,121.625,4.770811922
NM_001048172,MUTYH,16,15,10875,1795,9080,605.3333333,112.1875,5.058495822
NM_001048173,MUTYH,16,15,10875,1792,9083,605.5333333,112,5.068638393
NM_001048174,MUTYH,16,15,10717,1711,9006,600.4,106.9375,5.263588545
NM_032756,HPDL,1,0,1803,1803,NA,NA,1803,NA
NM_015506,MMACHC,4,3,10885,2854,8031,2677,713.5,2.81394534
NM_181697,PRDX1,6,5,10905,1021,9884,1976.8,170.1666667,9.680705191
NM_181696,PRDX1,6,5,10905,1215,9690,1938,202.5,7.975308642
NM_002574,PRDX1,6,5,10905,1241,9664,1932.8,206.8333333,7.787268332
NM_001202431,PRDX1,6,5,11857,1024,10833,2166.6,170.6666667,10.57910156
NM_001195193,NASP,13,12,34920,3112,31808,2650.666667,239.3846154,10.22107969
NM_001190182,CCDC17,13,12,4017,2236,1781,148.4166667,172,0.796511628
NM_006066,AKR1A1,10,9,19270,1590,17680,1964.444444,159,11.11949686
NM_153326,AKR1A1,9,8,19270,1461,17809,2226.125,162.3333333,12.18959617
NM_002482,NASP,15,14,34920,3306,31614,2258.142857,220.4,9.56261343
NM_152298,NASP,14,13,34920,2288,32632,2510.153846,163.4285714,14.26223776
NM_001202413,AKR1A1,10,9,19270,1373,17897,1988.555556,137.3,13.03495994
NM_001202414,AKR1A1,11,10,19270,1502,17768,1776.8,136.5454545,11.82956059
NM_001114938,CCDC17,13,12,4017,2263,1754,146.1666667,174.0769231,0.775077331
NM_016486,TMEM69,3,2,6263,1474,4789,2394.5,491.3333333,3.248982361
NM_001145349,IPP,10,9,56489,2118,54371,6041.222222,211.8,25.67091596
NM_005897,IPP,9,8,52080,3262,48818,6102.25,362.4444444,14.96566524
NM_005727,TSPAN1,9,8,10887,1638,9249,1156.125,182,5.646520147
NM_006004,UQCRH,4,3,13069,530,12539,4179.666667,132.5,23.65849057
NM_003579,RAD54L,18,17,30780,3164,27616,1624.470588,175.7777778,8.728192162
NM_001142548,RAD54L,19,18,30780,2568,28212,1567.333333,135.1578947,10.98598131
NM_006369,LRRC41,10,9,24968,2958,22010,2445.555556,295.8,7.440838404
NM_001013615,LURAP1,2,1,17924,1851,16073,16073,925.5,8.683414371
NM_199044,NSUN4,6,5,24977,5117,19860,3972,852.8333333,3.881180379
NM_001441,FAAH,15,14,19583,2110,17473,1248.071429,140.6666667,8.281042654
NM_001256128,NSUN4,6,5,23976,4694,19282,3856.4,782.3333333,4.107797188
NM_001256127,NSUN4,6,5,23976,5062,18914,3782.8,843.6666667,3.736467799
NM_147192,DMBX1,4,3,7220,2888,4332,1444,722,1.5
NM_001097611,KNCN,3,2,5573,2395,3178,1589,798.3333333,1.326931106
NM_172225,DMBX1,4,3,7220,2873,4347,1449,718.25,1.513052558
NM_145279,MOB3C,4,3,7420,2808,4612,1537.333333,702,1.642450142
NM_001243728,ATPAF1,9,8,30841,1699,29142,3642.75,188.7777778,17.15244261
NM_001256418,ATPAF1,10,9,30841,1791,29050,3227.777778,179.1,16.21998883
NM_022745,ATPAF1,9,8,33390,1838,31552,3944,204.2222222,17.16648531
NM_001042546,ATPAF1,7,6,33390,1632,31758,5293,233.1428571,19.45955882
NM_014774,EFCAB14,11,10,43907,5778,38129,3812.9,525.2727273,6.598996192
NM_001145474,TEX38,2,1,1761,861,900,900,430.5,1.045296167
NM_201403,MOB3C,4,3,9178,2826,6352,2117.333333,706.5,2.247699929
NM_000779,CYP4B1,12,11,20353,2167,18186,1653.272727,180.5833333,8.392247347
NM_001099772,CYP4B1,12,11,20353,2170,18183,1653,180.8333333,8.379262673
NM_000778,CYP4A11,12,11,12312,2564,9748,886.1818182,213.6666667,3.801872075
NM_178033,CYP4X1,12,11,27185,2369,24816,2256,197.4166667,10.47530604
NM_005764,PDZK1IP1,4,3,6512,898,5614,1871.333333,224.5,6.251670379
NM_003189,TAL1,4,3,13483,5007,8476,2825.333333,1251.75,1.692830038
NM_001287347,TAL1,5,4,15427,4647,10780,2695,929.4,2.3197762
NM_001010969,CYP4A22,12,11,11421,1680,9741,885.5454545,140,5.798214286
NM_001048166,STIL,17,16,64010,5036,58974,3685.875,296.2352941,11.71048451
NM_003035,STIL,17,16,64010,5033,58977,3686.0625,296.0588235,11.7180608
NM_001282937,STIL,18,17,64010,5192,58818,3459.882353,288.4444444,11.32858243
NM_001282936,STIL,18,17,64010,5243,58767,3456.882353,291.2777778,11.20865916
NM_001282938,STIL,19,18,64010,5106,58904,3272.444444,268.7368421,11.53623188
NM_001282939,STIL,19,18,64010,4917,59093,3282.944444,258.7894737,12.01810047
NM_012186,FOXE3,1,0,1982,1982,NA,NA,1982,NA
NM_004474,FOXD2,1,0,4676,4676,NA,NA,4676,NA
NM_001135181,SLC5A9,15,14,25961,3289,22672,1619.428571,219.2666667,6.893280632
NM_001011547,SLC5A9,14,13,25961,3213,22748,1749.846154,229.5,7.079987551
NM_024603,BEND5,6,5,49009,1334,47675,9535,222.3333333,35.73838081
NM_032110,DMRTA2,3,2,5898,3086,2812,1406,1028.666667,0.911211925
NM_078626,CDKN2C,2,1,4669,1275,3394,3394,637.5,2.661960784
NM_001262,CDKN2C,3,2,5941,2090,3851,1925.5,696.6666667,1.842583732
NM_001136508,C1orf185,5,4,45850,916,44934,11233.5,183.2,49.05458515
NM_014372,RNF11,3,2,37176,3077,34099,17049.5,1025.666667,11.08189795
NM_001159969,EPS15,13,12,67860,4364,63496,5291.333333,335.6923077,14.54995417
NM_148907,OSBPL9,20,19,59407,3492,55915,2942.894737,174.6,16.01231386
NM_148905,OSBPL9,19,18,59407,3518,55889,3104.944444,185.1578947,15.88658329
NM_148904,OSBPL9,20,19,59407,3615,55792,2936.421053,180.75,15.43347165
NM_015913,TXNDC12,7,6,36041,2402,33639,5606.5,343.1428571,14.00457952
NM_001136497,BTF3L4,5,4,34533,4581,29952,7488,916.2,6.538310413
NM_001243767,BTF3L4,5,4,34533,4446,30087,7521.75,889.2,6.767206478
NM_138417,KTI12,1,0,1697,1697,NA,NA,1697,NA
NM_152265,BTF3L4,6,5,34533,4649,29884,5976.8,774.8333333,6.428049043
NM_032864,PRPF38A,10,9,13775,2782,10993,1221.444444,278.2,3.95147376
NM_001190819,ORC1,17,16,31644,3171,28473,1779.5625,186.5294118,8.979186377
NM_001190818,ORC1,17,16,31644,3183,28461,1778.8125,187.2352941,8.941564562
NM_004153,ORC1,17,16,31644,3186,28458,1778.625,187.4117647,8.93220339
NM_015696,GPX7,3,2,6682,1232,5450,2725,410.6666667,4.423701299
NM_023077,COA7,3,2,12026,2117,9909,4954.5,705.6666667,4.680680208
NM_001042693,FAM159A,3,2,23673,701,22972,11486,233.6666667,32.7703281
NM_001198962,ECHDC2,8,7,25866,1454,24412,3487.428571,181.75,16.78954608
NM_001198961,ECHDC2,10,9,25866,1600,24266,2696.222222,160,15.16625
NM_018281,ECHDC2,9,8,25866,1506,24360,3045,167.3333333,16.1752988
NM_001007098,SCP2,11,10,67005,2103,64902,6490.2,191.1818182,30.86162625
NM_006671,SLC1A7,11,10,55455,2707,52748,5274.8,246.0909091,19.48577761
NM_001007099,SCP2,5,4,36681,1433,35248,8812,286.6,24.59734822
NM_001199080,PODN,13,12,23452,3430,20022,1668.5,263.8461538,5.837317784
NM_001287595,SLC1A7,11,10,55455,2884,52571,5257.1,262.1818182,18.22850208
NM_001287596,SLC1A7,4,3,34706,1325,33381,11127,331.25,25.19320755
NM_001199082,PODN,7,6,23452,2752,20700,3450,393.1428571,7.521802326
NM_001199081,PODN,12,11,23291,3078,20213,1837.545455,256.5,6.566926576
NM_001007250,SCP2,4,3,36681,1302,35379,11793,325.5,27.17281106
NM_001287597,SLC1A7,10,9,55455,2509,52946,5882.888889,250.9,21.10243125
NM_153703,PODN,11,10,23452,3182,20270,2027,289.2727273,6.370207417
NM_001007100,SCP2,5,4,36681,1424,35257,8814.25,284.8,24.75912921
NM_002370,MAGOH,5,4,11720,761,10959,2739.75,152.2,14.40078844
NM_017887,C1orf123,8,7,6519,1092,5427,775.2857143,136.5,4.96978022
NM_000098,CPT2,5,4,17770,3099,14671,3667.75,619.8,4.734107777
NM_033067,DMRTB1,4,3,8088,1911,6177,2059,477.75,3.232339089
NM_213593,DIO1,4,3,16900,1672,15228,5076,418,9.107655502
NM_001039716,DIO1,3,2,16900,1663,15237,7618.5,554.3333333,9.162357186
NM_001039715,DIO1,3,2,16900,1719,15181,7590.5,573,8.831297266
NM_000792,DIO1,4,3,16900,1864,15036,5012,466,8.066523605
NM_018982,YIPF1,11,10,38097,1863,36234,3623.4,169.3636364,19.44927536
NM_001276395,LDLRAD1,5,4,10890,2221,8669,2167.25,444.2,3.903196758
NM_001276394,LDLRAD1,4,3,10890,2113,8777,2925.666667,528.25,4.153809749
NM_001276393,LDLRAD1,5,4,10890,2252,8638,2159.5,450.4,3.835701599
NM_001276392,LDLRAD1,4,3,10890,2199,8691,2897,549.75,3.952251023
NM_001010978,LDLRAD1,6,5,10890,2382,8508,1701.6,397,3.571788413
NM_001256409,LRRC42,9,8,21844,1797,20047,2505.875,199.6666667,11.15581525
NM_052940,LRRC42,8,7,21844,1762,20082,2868.857143,220.25,11.39727582
NM_004872,TMEM59,8,7,21764,1704,20060,2865.714286,213,11.77230047
NM_201546,CDCP2,4,3,14013,1963,12050,4016.666667,490.75,6.138563423
NM_016491,MRPL37,7,6,18218,1490,16728,2788,212.8571429,11.22684564
NM_001039464,MROH7,24,23,68514,4399,64115,2787.608696,183.2916667,14.57490339
NM_176782,FAM151A,8,7,14352,1989,12363,1766.142857,248.625,6.215686275
NM_001114108,TTC22,7,6,20191,1986,18205,3034.166667,283.7142857,9.166666667
NM_152607,C1orf177,11,10,36203,1800,34403,3440.3,163.6363636,19.11277778
NM_152268,PARS2,2,1,7657,2388,5269,5269,1194,2.206448911
NM_017904,TTC22,6,5,16719,2225,14494,2898.8,370.8333333,6.514157303
NM_001110533,C1orf177,10,9,36203,1712,34491,3832.333333,171.2,20.14661215
NM_004623,TTC4,10,9,26835,2403,24432,2714.666667,240.3,10.16729089
NM_014762,DHCR24,9,8,37623,4295,33328,4166,477.2222222,7.759720605
NM_174936,PCSK9,12,11,25379,3722,21657,1968.818182,310.1666667,5.818645889
NM_057176,BSND,4,3,9850,1374,8476,2825.333333,343.5,6.168850073
NM_182532,TMEM61,3,2,11503,1100,10403,5201.5,366.6666667,9.457272727
NM_000562,C8A,11,10,63453,2403,61050,6105,218.4545455,25.40574282
NM_002353,TACSTD2,1,0,2073,2073,NA,NA,2073,NA
NM_001085487,MYSM1,20,19,45338,7788,37550,1976.315789,389.4,4.821520288
NM_002228,JUN,1,0,3324,3324,NA,NA,3324,NA
NM_000775,CYP2J2,9,8,33445,1866,31579,3947.375,207.3333333,16.92336549
NM_152377,C1orf87,12,11,83378,2040,81338,7394.363636,170,39.87156863
NM_032027,TM2D1,7,6,44378,1257,43121,7186.833333,179.5714286,34.30469372
NM_001164835,L1TD1,5,4,17529,3995,13534,3383.5,799,3.387734668
NM_019079,L1TD1,4,3,17529,3883,13646,4548.666667,970.75,3.514293072
NM_001272002,DOCK7,16,15,104265,2694,101571,6771.4,168.375,37.70267261
NM_014495,ANGPTL3,7,6,8820,2958,5862,977,422.5714286,1.981744422
NM_012183,FOXD3,1,0,2069,2069,NA,NA,2069,NA
NM_013339,ALG6,15,14,70974,3386,67588,4827.714286,225.7333333,19.96101595
NM_032437,EFCAB7,14,13,49353,2375,46978,3613.692308,169.6428571,19.78021053
NM_152489,UBE2U,9,8,40539,1145,39394,4924.25,127.2222222,34.40524017
NM_017526,LEPROT,4,3,15561,4765,10796,3598.666667,1191.25,2.265687303
NM_001198683,LEPROT,3,2,7563,600,6963,3481.5,200,11.605
NM_001198681,LEPROT,5,4,15293,4630,10663,2665.75,926,2.303023758
NM_001037339,PDE4B,10,9,42471,3886,38585,4287.222222,388.6,9.929233145
NM_005478,INSL5,2,1,3520,720,2800,2800,360,3.888888889
NM_001146112,MIER1,15,14,63726,5601,58125,4151.785714,373.4,10.37761114
NM_001278215,MIER1,5,4,23347,2497,20850,5212.5,499.4,8.350020024
NM_020948,MIER1,15,14,63726,5640,58086,4149,376,10.29893617
NM_001077701,MIER1,13,12,58378,5420,52958,4413.166667,416.9230769,9.770848708
NM_001146113,MIER1,14,13,63726,3609,60117,4624.384615,257.7857143,16.65752286
NM_001146111,MIER1,16,15,63726,3891,59835,3989,243.1875,15.37779491
NM_001146110,MIER1,15,14,63726,5643,58083,4148.785714,376.2,10.29292929
NM_001077704,MIER1,14,13,58378,3611,54767,4212.846154,257.9285714,15.16671282
NM_001077703,MIER1,15,14,63726,3756,59970,4283.571429,250.4,15.96645367
NM_001077702,MIER1,16,15,63726,3831,59895,3993,239.4375,15.63429914
NM_001077700,MIER1,14,13,63726,5565,58161,4473.923077,397.5,10.45121294
NM_001276351,C1orf141,8,7,42797,2185,40612,5801.714286,273.125,18.58672769
NM_001276352,C1orf141,9,8,42797,2212,40585,5073.125,245.7777778,18.34764919
NM_001559,IL12RB2,16,15,89538,4056,85482,5698.8,253.5,21.07544379
NM_001258216,IL12RB2,14,13,89538,3863,85675,6590.384615,275.9285714,22.17835879
NM_001258215,IL12RB2,14,13,89538,3796,85742,6595.538462,271.1428571,22.58746048
NM_001258214,IL12RB2,16,15,89538,4044,85494,5699.6,252.75,21.14094955
NM_001199741,GADD45A,3,2,3163,1281,1882,941,427,1.469164715
NM_001199742,GADD45A,3,2,3163,1145,2018,1009,381.6666667,1.762445415
NM_001924,GADD45A,4,3,3163,1384,1779,593,346,1.285404624
NM_004675,DIRAS3,2,1,4817,1633,3184,3184,816.5,1.949785671
NM_000329,RPE65,14,13,21137,2622,18515,1424.230769,187.2857143,7.061403509
NM_001190987,SRSF11,13,12,46338,2799,43539,3628.25,215.3076923,15.55519829
NM_004768,SRSF11,13,12,46338,2805,43533,3627.75,215.7692308,15.5197861
NM_001031693,HHLA3,3,2,13214,805,12409,6204.5,268.3333333,15.41490683
NM_001902,CTH,12,11,28635,2152,26483,2407.545455,179.3333333,12.30622677
NM_001190463,CTH,11,10,28635,2055,26580,2658,186.8181818,12.93430657
NM_001036646,HHLA3,3,2,13214,801,12413,6206.5,267,15.4968789
NM_001036645,HHLA3,3,2,13214,902,12312,6156,300.6666667,13.64966741
NM_153742,CTH,11,10,28635,2019,26616,2661.6,183.5454545,13.18276374
NM_203350,ZRANB2,10,9,18000,3080,14920,1657.777778,308,4.844155844
NM_198719,PTGER3,4,3,77029,2357,74672,24890.66667,589.25,31.68095036
NM_198715,PTGER3,2,1,41956,7761,34195,34195,3880.5,4.406004381
NM_005455,ZRANB2,11,10,18000,3156,14844,1484.4,286.9090909,4.703422053
NM_001199329,FPGT,4,3,10492,3909,6583,2194.333333,977.25,1.68406242
NM_001199328,FPGT,5,4,10492,3965,6527,1631.75,793,1.646153846
NM_003838,FPGT,4,3,10492,4726,5766,1922,1181.5,1.220059247
NM_001889,CRYZ,9,8,27922,2273,25649,3206.125,252.5555556,11.2842059
NM_138467,TYW3,6,5,33522,3438,30084,6016.8,573,8.7504363
NM_001134759,CRYZ,7,6,27922,1983,25939,4323.166667,283.2857143,13.08068583
NM_001130043,CRYZ,8,7,27922,2170,25752,3678.857143,271.25,11.86728111
NM_001130042,CRYZ,10,9,27922,2313,25609,2845.444444,231.3,11.07176827
NM_001162916,TYW3,5,4,33526,3342,30184,7546,668.4,9.031717534
NM_001256114,LHX8,9,8,26653,1773,24880,3110,197,14.03271292
NM_001001933,LHX8,10,9,33101,2383,30718,3413.111111,238.3,12.89047419
NM_001286044,ACADM,9,8,39333,2361,36972,4621.5,262.3333333,15.65946633
NM_000016,ACADM,12,11,39333,2634,36699,3336.272727,219.5,13.93280182
NM_004582,RABGGTB,9,8,8898,1523,7375,921.875,169.2222222,4.842416284
NM_001286042,ACADM,11,10,39333,2545,36788,3678.8,231.3636364,14.45500982
NM_001286043,ACADM,13,12,39333,2734,36599,3049.916667,210.3076923,13.38661302
NM_001127328,ACADM,12,11,39333,2646,36687,3335.181818,220.5,13.86507937
NM_080868,ASB17,3,2,13560,1110,12450,6225,370,11.21621622
NM_201626,USP33,22,21,48228,2965,45263,2155.380952,134.7727273,15.26576728
NM_201624,USP33,24,23,63892,4376,59516,2587.652174,182.3333333,13.60054845
NM_015017,USP33,25,24,63892,4556,59336,2472.333333,182.24,13.023705
NM_003902,FUBP1,20,19,31188,2904,28284,1488.631579,145.2,9.739669421
NM_007034,DNAJB4,3,2,12361,2240,10121,5060.5,746.6666667,4.518303571
NM_001039585,PTGFR,4,3,49660,5435,44225,14741.66667,1358.75,8.137074517
NM_000959,PTGFR,3,2,49660,5363,44297,22148.5,1787.666667,8.259742681
NM_006820,IFI44L,9,8,25744,5883,19861,2482.625,653.6666667,3.37599864
NM_006417,IFI44,9,8,14288,1735,12553,1569.125,192.7777778,7.235158501
NM_207578,PRKACB,9,8,127236,1853,125383,15672.875,205.8888889,67.66486778
NM_021233,DNASE2B,6,5,16478,1265,15213,3042.6,210.8333333,12.02608696
NM_058248,DNASE2B,4,3,6659,1013,5646,1882,253.25,5.573543929
NM_005274,GNG5,4,3,8258,810,7448,2482.666667,202.5,9.195061728
NM_025065,RPF1,9,8,19115,1984,17131,2141.375,220.4444444,8.634576613
NM_004388,CTBS,7,6,21361,3108,18253,3042.166667,444,5.872908623
NM_001166417,SSX2IP,15,14,46763,6040,40723,2908.785714,402.6666667,6.742218543
NM_014021,SSX2IP,15,14,46852,5912,40940,2924.285714,394.1333333,6.924898512
NM_001166295,SSX2IP,13,12,46763,5856,40907,3408.916667,450.4615385,6.985484973
NM_001166294,SSX2IP,13,12,46852,5728,41124,3427,440.6153846,7.179469274
NM_001166293,SSX2IP,14,13,46852,5861,40991,3153.153846,418.6428571,6.993857703
NM_001253693,MCOLN3,12,11,30460,2694,27766,2524.181818,224.5,10.30660728
NM_018298,MCOLN3,13,12,30460,2863,27597,2299.75,220.2307692,9.639189661
NM_032184,SYDE2,7,6,43374,4718,38656,6442.666667,674,8.193302247
NM_003921,BCL10,3,2,11129,3107,8022,4011,1035.666667,2.581911812
NM_001554,CYR61,5,4,3206,2298,908,227,459.6,0.395126197
NM_017953,ZNHIT6,10,9,59012,6207,52805,5867.222222,620.7,8.507330433
NM_001170670,ZNHIT6,11,10,59012,6091,52921,5292.1,553.7272727,8.688392711
NM_020729,ODF2L,18,17,46250,4347,41903,2464.882353,241.5,9.639521509
NM_001184766,ODF2L,16,15,49520,4087,45433,3028.866667,255.4375,11.11646685
NM_001184765,ODF2L,17,16,49520,4175,45345,2834.0625,245.5882353,10.86107784
NM_001007022,ODF2L,18,17,46250,4388,41862,2462.470588,243.7777778,9.540109389
NM_001285,CLCA1,14,13,31450,3134,28316,2178.153846,223.8571429,9.035098915
NM_001206651,SH3GLB1,10,9,43616,6474,37142,4126.888889,647.4,5.737102255
NM_016009,SH3GLB1,9,8,43616,6386,37230,4653.75,709.5555556,5.829940495
NM_001206653,SH3GLB1,8,7,43616,6243,37373,5339,780.375,5.986384751
NM_001206652,SH3GLB1,11,10,43616,6451,37165,3716.5,586.4545455,5.761122307
NM_203341,Sep-15,4,3,51981,1794,50187,16729,448.5,27.97491639
NM_004261,Sep-15,5,4,51981,1845,50136,12534,369,27.17398374
NM_006769,LMO4,5,4,20458,5411,15047,3761.75,1082.2,2.780816855
NM_001514,GTF2B,7,6,38982,1652,37330,6221.666667,236,22.5968523
NM_001008662,CCBL2,13,12,57189,2065,55124,4593.666667,158.8461538,26.69443099
NM_001008661,CCBL2,14,13,57189,2166,55023,4232.538462,154.7142857,25.40304709
NM_019610,RBMXL1,2,1,13506,4989,8517,8517,2494.5,1.707155743
NM_018284,GBP3,11,10,16191,3051,13140,1314,277.3636364,4.306784661
NM_001162536,RBMXL1,3,2,13506,5090,8416,4208,1696.666667,1.653438114
NM_207398,GBP7,11,10,44291,2465,41826,4182.6,224.0909091,16.96795132
NM_004120,GBP2,11,10,20028,4143,15885,1588.5,376.6363636,3.834178132
NM_052942,GBP5,12,11,13912,4063,9849,895.3636364,338.5833333,2.424070884
NM_001134486,GBP5,11,10,13912,3954,9958,995.8,359.4545455,2.518462317
NM_198460,GBP6,11,10,24285,4878,19407,1940.7,443.4545455,3.978474785
NM_182976,ZNF326,12,11,33418,2734,30684,2789.454545,227.8333333,11.22311631
NM_182975,ZNF326,4,3,11324,1549,9775,3258.333333,387.25,6.310522918
NM_020063,BARHL2,3,2,5217,1499,3718,1859,499.6666667,2.480320213
NM_201269,ZNF644,6,5,106957,5771,101186,20237.2,961.8333333,17.53352972
NM_032186,ZNF644,4,3,106957,2125,104832,34944,531.25,49.33270588
NM_016620,ZNF644,4,3,106210,2095,104115,34705,523.75,49.69689737
NM_001134419,CDC7,12,11,24919,3197,21722,1974.727273,266.4166667,6.794494839
NM_001134420,CDC7,12,11,24658,3325,21333,1939.363636,277.0833333,6.41593985
NM_003503,CDC7,12,11,24919,3231,21688,1971.636364,269.25,6.712472919
NM_001726,BRDT,19,18,62278,3161,59117,3284.277778,166.3684211,18.70199304
NM_001242810,BRDT,19,18,65059,3722,61337,3407.611111,195.8947368,16.47958087
NM_001242808,BRDT,18,17,65059,3227,61832,3637.176471,179.2777778,19.16083049
NM_001242807,BRDT,18,17,65059,3033,62026,3648.588235,168.5,20.45037916
NM_001242806,BRDT,19,18,65059,3378,61681,3426.722222,177.7894737,18.25962108
NM_001242805,BRDT,20,19,65059,3436,61623,3243.315789,171.8,17.93451688
NM_207189,BRDT,19,18,65059,3366,61693,3427.388889,177.1578947,18.32828283
NM_173567,EPHX4,7,6,33562,1450,32112,5352,207.1428571,22.1462069
NM_001287737,SETSIP,1,0,1038,1038,NA,NA,1038,NA
NM_183242,BTBD8,9,8,67541,1456,66085,8260.625,161.7777778,45.38804945
NM_015237,KIAA1107,9,8,17673,4565,13108,1638.5,507.2222222,2.871412924
NM_001012425,C1orf146,6,5,27796,757,27039,5407.8,126.1666667,35.71862616
NM_053274,GLMN,19,18,52613,2051,50562,2809,107.9473684,24.6523647
NM_001127216,GFI1,7,6,11312,2701,8611,1435.166667,385.8571429,3.188078489
NM_001127215,GFI1,7,6,9040,2708,6332,1055.333333,386.8571429,2.338257016
NM_005263,GFI1,7,6,12117,2794,9323,1553.833333,399.1428571,3.336793128
NM_000969,RPL5,8,7,9889,1039,8850,1264.285714,129.875,8.517805582
NM_001167830,TMED5,5,4,30949,6119,24830,6207.5,1223.8,4.05785259
NM_016040,TMED5,4,3,30949,6069,24880,8293.333333,1517.25,4.099522162
NM_001938,DR1,3,2,16672,3211,13461,6730.5,1070.333333,4.192151978
NM_001261410,BCAR3,10,9,52361,2885,49476,5497.333333,288.5,17.14939341
NM_014597,DNTTIP2,7,6,9750,2729,7021,1170.166667,389.8571429,2.572737266
NM_004815,ARHGAP29,23,22,68846,9140,59706,2713.909091,397.3913043,6.53238512
NM_001993,F3,6,5,12683,2399,10284,2056.8,399.8333333,4.286786161
NM_001178096,F3,5,4,12683,2238,10445,2611.25,447.6,4.667113494
NM_001839,CNN3,7,6,30276,2119,28157,4692.833333,302.7142857,13.28787164
NM_001286056,CNN3,7,6,28861,1909,26952,4492,272.7142857,14.11838659
NM_001286055,CNN3,6,5,30276,1980,28296,5659.2,330,14.29090909
NM_144988,ALG14,4,3,90230,1061,89169,29723,265.25,84.04241282
NM_152487,TMEM56,7,6,80269,6827,73442,12240.33333,975.2857143,10.7575802
NM_001199679,TMEM56,7,6,105090,6912,98178,16363,987.4285714,14.20399306
NM_001278247,RWDD3,5,4,13072,1326,11746,2936.5,265.2,8.858220211
NM_001278248,RWDD3,5,4,13072,1373,11699,2924.75,274.6,8.520757465
NM_001128142,RWDD3,3,2,13072,1139,11933,5966.5,379.6666667,10.47673398
NM_001199682,RWDD3,4,3,13072,1192,11880,3960,298,9.966442953
NM_015485,RWDD3,4,3,13072,1239,11833,3944.333333,309.75,9.550443906
NM_001010861,LPPR5,6,5,114650,4006,110644,22128.8,667.6666667,27.61957064
NM_001037317,LPPR5,6,5,114650,4021,110629,22125.8,670.1666667,27.51280776
NM_001013660,FRRS1,17,16,57092,2695,54397,3399.8125,158.5294118,20.18441558
NM_000644,AGL,34,33,73536,7143,66393,2011.909091,210.0882353,9.294834103
NM_000028,AGL,34,33,73536,7483,66053,2001.606061,220.0882353,8.827074703
NM_000646,AGL,34,33,73050,7216,65834,1994.969697,212.2352941,9.123337029
NM_000645,AGL,32,31,62815,7214,55601,1793.580645,225.4375,7.707374549
NM_000643,AGL,34,33,73536,7203,66333,2010.090909,211.8529412,9.20907955
NM_000642,AGL,34,33,73941,7405,66536,2016.242424,217.7941176,8.985280216
NM_012243,SLC35A3,8,7,57191,5880,51311,7330.142857,735,8.726360544
NM_001271685,SLC35A3,8,7,56544,5715,50829,7261.285714,714.375,8.893963255
NM_001271684,SLC35A3,6,5,57191,5625,51566,10313.2,937.5,9.167288889
NM_001256387,LRRC39,9,8,29827,1828,27999,3499.875,203.1111111,15.31673961
NM_001256386,LRRC39,10,9,29827,1886,27941,3104.555556,188.6,14.81495228
NM_001256385,LRRC39,11,10,29827,1957,27870,2787,177.9090909,14.24118549
NM_194292,SASS6,17,16,49411,3914,45497,2843.5625,230.2352941,11.62416965
NM_019083,TRMT13,11,10,17350,3154,14196,1419.6,286.7272727,4.500951173
NM_144620,LRRC39,10,9,29827,1869,27958,3106.444444,186.9,14.9588015
NM_003729,RTCA,11,10,26613,2595,24018,2401.8,235.9090909,9.255491329
NM_001130841,RTCA,12,11,26613,2635,23978,2179.818182,219.5833333,9.099810247
NM_022049,GPR88,2,1,3857,3467,390,390,1733.5,0.112489184
NM_001261440,EXTL2,5,4,22809,3183,19626,4906.5,636.6,6.165881244
NM_001261442,EXTL2,4,3,22809,3150,19659,6553,787.5,6.240952381
NM_001261441,EXTL2,6,5,22809,3211,19598,3919.6,535.1666667,6.103394581
NM_133496,SLC30A7,11,10,85679,8225,77454,7745.4,747.7272727,9.416899696
NM_001033025,EXTL2,5,4,22809,3186,19623,4905.75,637.2,6.15913371
NM_001439,EXTL2,5,4,22809,3222,19587,4896.75,644.4,6.079143389
NM_001144884,SLC30A7,12,11,85681,7912,77769,7069.909091,659.3333333,9.829246714
NM_015958,DPH5,8,7,36184,1797,34387,4912.428571,224.625,19.13578186
NM_001077395,DPH5,8,7,36184,1794,34390,4912.857143,224.25,19.16945373
NM_001077394,DPH5,8,7,36184,1815,34369,4909.857143,226.875,18.93608815
NM_001400,S1PR1,2,1,4773,3052,1721,1721,1526,0.563892529
NM_001288821,OLFM3,6,5,44515,3221,41294,8258.8,536.8333333,12.82024216
NM_001286997,LOC101928436,4,3,107406,531,106875,35625,132.75,201.2711864
NM_020978,AMY2B,12,11,24892,2254,22638,2058,187.8333333,10.04347826
NM_000699,AMY2A,10,9,8403,1642,6761,751.2222222,164.2,4.117539586
NM_001008219,AMY1C,11,10,8872,1871,7001,700.1,170.0909091,3.741849278
NM_001008219,AMY1C,11,10,8871,1871,7000,700,170.0909091,3.741314805
NM_001008221,AMY1A,11,10,9034,1792,7242,724.2,162.9090909,4.041294643
NM_001008218,AMY1B,11,10,8849,1849,7000,700,168.0909091,3.785830178
NM_004038,AMY1A,11,10,8874,1873,7001,700.1,170.2727273,3.737853711
NM_004038,AMY1A,11,10,8873,1873,7000,700,170.2727273,3.737319808
NM_001008221,AMY1A,11,10,9035,1792,7243,724.3,162.9090909,4.041852679
NM_001008218,AMY1B,11,10,8850,1849,7001,700.1,168.0909091,3.786371011
NM_018137,PRMT6,1,0,2651,2651,NA,NA,2651,NA
NM_013386,SLC25A24,10,9,65638,3595,62043,6893.666667,359.5,17.2581363
NM_001143989,NBPF4,15,14,20742,2514,18228,1302,167.6,7.250596659
NM_213651,SLC25A24,10,9,58089,3506,54583,6064.777778,350.6,15.56845408
NM_001143988,NBPF6,15,14,20358,2150,18208,1300.571429,143.3333333,8.468837209
NM_001143987,NBPF6,16,15,20358,2238,18120,1208,139.875,8.096514745
NM_001010883,FAM102B,11,10,78980,5351,73629,7362.9,486.4545455,13.75985797
NM_018061,PRPF38B,6,5,9492,3709,5783,1156.6,618.1666667,1.559180372
NM_001102592,HENMT1,8,7,12836,1706,11130,1590,213.25,6.524032825
NM_001144937,FNDC7,13,12,29813,3073,26740,2228.333333,236.3846154,8.701594533
NM_144584,HENMT1,8,7,13240,1889,11351,1621.571429,236.125,6.008999471
NM_152763,AKNAD1,16,15,41208,3079,38129,2541.933333,192.4375,12.38356609
NM_001278203,CLCC1,7,6,20942,4158,16784,2797.333333,594,4.036556037
NM_015127,CLCC1,12,11,33993,4707,29286,2662.363636,392.25,6.221797323
NM_001048210,CLCC1,12,11,33993,4847,29146,2649.636364,403.9166667,6.013204044
NM_001278202,CLCC1,9,8,20942,4352,16590,2073.75,483.5555556,3.812040441
NM_005645,TAF13,4,3,11628,581,11047,3682.333333,145.25,19.01376936
NM_020141,TMEM167B,3,2,6153,2753,3400,1700,917.6666667,1.235016346
NM_001122961,C1orf194,5,4,7908,736,7172,1793,147.2,9.744565217
NM_032636,PSRC1,8,7,3616,1748,1868,266.8571429,218.5,1.068649886
NM_001005290,PSRC1,8,7,3616,1647,1969,281.2857143,205.875,1.195506982
NM_006513,SARS,11,10,24291,1950,22341,2234.1,177.2727273,11.45692308
NM_001032291,PSRC1,8,7,3616,1753,1863,266.1428571,219.125,1.062749572
NM_001408,CELSR2,34,33,25739,10574,15165,459.5454545,311,1.434178173
NM_001284353,KIAA1324,15,14,20234,6907,13327,951.9285714,460.4666667,1.92949182
NM_001205228,SORT1,20,19,83793,7015,76778,4040.947368,350.75,10.9448325
NM_001199774,PSMA5,9,8,27457,3755,23702,2962.75,417.2222222,6.312117177
NM_001199772,PSMA5,8,7,27419,3767,23652,3378.857143,470.875,6.278736395
NM_001199773,PSMA5,9,8,27430,3743,23687,2960.875,415.8888889,6.328346246
NM_002959,SORT1,20,19,88377,7042,81335,4280.789474,352.1,11.5499858
NM_002790,PSMA5,9,8,27419,3835,23584,2948,426.1111111,6.149674055
NM_001134400,CYB561D1,3,2,6364,5002,1362,681,1667.333333,0.272291084
NM_001134404,CYB561D1,4,3,6364,5118,1246,415.3333333,1279.5,0.243454474
NM_001134403,CYB561D1,4,3,6364,5041,1323,441,1260.25,0.262447927
NM_001134402,CYB561D1,2,1,6407,4807,1600,1600,2403.5,0.33284793
NM_001040709,SYPL2,6,5,15666,3785,11881,2376.2,630.8333333,3.138969617
NM_031936,GPR61,3,2,5963,2826,3137,1568.5,942,1.11004954
NM_020703,AMIGO1,2,1,2892,2473,419,419,1236.5,0.169429842
NM_153340,ATXN7L2,11,10,8861,2393,6468,646.8,217.5454545,2.70288341
NM_182580,CYB561D1,3,2,6364,4936,1428,714,1645.333333,0.289303079
NM_203404,AMPD2,16,15,6630,3410,3220,214.6666667,213.125,0.944281525
NM_001142368,GSTM2,9,8,15977,1487,14490,1811.25,165.2222222,9.744451917
NM_147148,GSTM4,8,7,9427,1380,8047,1149.571429,172.5,5.83115942
NM_000850,GSTM4,8,7,5635,1434,4201,600.1428571,179.25,2.929567643
NM_001257361,AMPD2,18,17,8069,3410,4659,274.0588235,189.4444444,1.36627566
NM_001257360,AMPD2,19,18,12244,4128,8116,450.8888889,217.2631579,1.966085271
NM_139156,AMPD2,18,17,12244,3774,8470,498.2352941,209.6666667,2.244303127
NM_000848,GSTM2,8,7,7266,1209,6057,865.2857143,151.125,5.009925558
NM_005272,GNAT2,8,7,9818,1373,8445,1206.428571,171.625,6.150764749
NM_004037,AMPD2,18,17,11476,3994,7482,440.1176471,221.8888889,1.873309965
NM_024526,EPS8L3,19,18,13944,2247,11697,649.8333333,118.2631579,5.205607477
NM_139053,EPS8L3,19,18,13944,2340,11604,644.6666667,123.1578947,4.958974359
NM_000849,GSTM3,9,8,7108,4136,2972,371.5,459.5555556,0.718568665
NM_000851,GSTM5,8,7,6028,1578,4450,635.7142857,197.25,2.820025349
NM_133181,EPS8L3,19,18,13944,2337,11607,644.8333333,123,4.966623877
NM_000757,CSF1,9,8,20385,4243,16142,2017.75,471.4444444,3.804383691
NM_172211,CSF1,9,8,20385,3349,17036,2129.5,372.1111111,5.086891609
NM_172212,CSF1,9,8,16134,2781,13353,1669.125,309,4.801510248
NM_172210,CSF1,9,8,14593,1752,12841,1605.125,194.6666667,7.3293379
NM_006492,ALX3,4,3,10327,1482,8845,2948.333333,370.5,5.9682861
NM_033088,STRIP1,21,20,20042,3301,16741,837.05,157.1904762,5.071493487
NM_006621,AHCYL1,17,16,38979,3960,35019,2188.6875,232.9411765,8.843181818
NM_001242674,AHCYL1,18,17,22817,3703,19114,1124.352941,205.7222222,5.161760735
NM_001242676,AHCYL1,17,16,19796,4045,15751,984.4375,237.9411765,3.89394314
NM_001242675,AHCYL1,17,16,19796,4056,15740,983.75,238.5882353,3.880670611
NM_001242673,AHCYL1,17,16,38979,4331,34648,2165.5,254.7647059,8
NM_001270768,STRIP1,21,20,23066,3148,19918,995.9,149.9047619,6.327191868
NM_001010898,SLC6A17,12,11,51693,6414,45279,4116.272727,534.5,7.05940131
NM_203412,UBL4B,1,0,1509,1509,NA,NA,1509,NA
NM_032414,PROK1,3,2,6190,1375,4815,2407.5,458.3333333,3.501818182
NM_006402,LAMTOR5,4,3,6671,852,5819,1939.666667,213,6.829812207
NM_004696,SLC16A4,9,8,28233,2638,25595,3199.375,293.1111111,9.70242608
NM_001201549,SLC16A4,8,7,28233,2133,26100,3728.571429,266.625,12.23628692
NM_001201547,SLC16A4,8,7,28233,2504,25729,3675.571429,313,10.27515974
NM_001201546,SLC16A4,8,7,28233,2493,25740,3677.142857,311.625,10.32490975
NM_001201548,SLC16A4,7,6,28233,2379,25854,4309,339.8571429,10.86759142
NM_005549,KCNA10,1,0,1960,1960,NA,NA,1960,NA
NM_004974,KCNA2,3,2,3201,2253,948,474,751,0.420772304
NM_002232,KCNA3,1,0,2583,2583,NA,NA,2583,NA
NM_001006945,LRIF1,3,2,16756,1810,14946,7473,603.3333333,8.257458564
NM_000560,CD53,8,7,26838,1575,25263,3609,196.875,16.04
NM_018372,LRIF1,4,3,16756,3339,13417,4472.333333,834.75,4.018268943
NM_001040033,CD53,9,8,28739,1581,27158,3394.75,175.6666667,17.17773561
NM_024901,DENND2D,12,11,14736,3308,11428,1038.909091,275.6666667,3.454655381
NM_001025199,CHI3L2,10,9,13731,1510,12221,1357.888889,151,8.093377483
NM_004000,CHI3L2,11,10,15783,1481,14302,1430.2,134.6363636,9.656988521
NM_006090,CEPT1,9,8,44893,2222,42671,5333.875,246.8888889,19.20387039
NM_001271833,DENND2D,12,11,18571,3240,15331,1393.727273,270,4.731790123
NM_001025197,CHI3L2,10,9,15783,1450,14333,1592.555556,145,9.884827586
NM_001007794,CEPT1,9,8,45477,2260,43217,5402.125,251.1111111,19.12256637
NM_021797,CHIA,9,8,29716,1382,28334,3541.75,153.5555556,20.50217077
NM_181643,PIFO,6,5,6446,2352,4094,818.8,392,1.740646259
NM_201653,CHIA,12,11,29716,1710,28006,2546,142.5,16.37777778
NM_001258005,CHIA,11,10,29716,1480,28236,2823.6,134.5454545,19.07837838
NM_001258004,CHIA,12,11,29716,1647,28069,2551.727273,137.25,17.04250152
NM_001258003,CHIA,10,9,29716,1413,28303,3144.777778,141.3,20.03043171
NM_001258002,CHIA,8,7,29716,1215,28501,4071.571429,151.875,23.45761317
NM_001258001,CHIA,11,10,29716,1507,28209,2820.9,137,18.71864632
NM_001040623,CHIA,10,9,29716,1340,28376,3152.888889,134,21.1761194
NM_020683,ADORA3,6,5,20775,2156,18619,3723.8,359.3333333,8.635899814
NM_024102,WDR77,10,9,9320,2418,6902,766.8888889,241.8,2.854425145
NM_000677,ADORA3,2,1,4694,2247,2447,2447,1123.5,1.089007566
NM_002557,OVGP1,11,10,13464,2253,11211,1121.1,204.8181818,4.976031957
NM_001688,ATP5F1,7,6,12784,2108,10676,1779.333333,301.1428571,5.064516129
NM_174896,C1orf162,6,5,4532,923,3609,721.8,153.8333333,3.91007584
NM_198926,FAM212B,2,1,33735,5840,27895,27895,2920,4.776541096
NM_007204,DDX20,11,10,12011,3521,8490,849,320.0909091,2.411246805
NM_019099,FAM212B,2,1,17362,5982,11380,11380,2991,1.902373788
NM_001270945,LOC643355,2,1,8275,3037,5238,5238,1518.5,1.72472835
NM_024494,WNT2B,5,4,12542,2475,10067,2516.75,495,4.067474747
NM_004185,WNT2B,6,5,53872,2024,51848,10369.6,337.3333333,25.61660079
NM_020963,MOV10,21,20,26436,3771,22665,1133.25,179.5714286,6.010342084
NM_001130079,MOV10,21,20,26275,3495,22780,1139,166.4285714,6.51788269
NM_006135,CAPZA1,10,9,52168,2750,49418,5490.888889,275,17.97018182
NM_001286072,MOV10,22,21,26436,4520,21916,1043.619048,205.4545455,4.848672566
NM_001004440,FAM19A3,5,4,6669,1138,5531,1382.75,227.6,4.860281195
NM_182759,FAM19A3,5,4,6669,1070,5599,1399.75,214,5.23271028
NM_005167,PPM1J,10,9,5336,1724,3612,401.3333333,172.4,2.09512761
NM_003051,SLC16A1,5,4,44507,3914,40593,10148.25,782.8,10.37123148
NM_001166496,SLC16A1,5,4,44217,4383,39834,9958.5,876.6,9.088295688
NM_012411,PTPN22,19,18,57944,3502,54442,3024.555556,184.3157895,15.54597373
NM_015967,PTPN22,21,20,57944,3669,54275,2713.75,174.7142857,14.79285909
NM_018364,RSBN1,7,6,50618,6600,44018,7336.333333,942.8571429,6.669393939
NM_001193431,PTPN22,21,20,57944,3585,54359,2717.95,170.7142857,15.16290098
NM_198269,HIPK1,15,14,26726,7077,19649,1403.5,471.8,2.776458952
NM_001286353,OLFML3,3,2,2865,1964,901,450.5,654.6666667,0.458757637
NM_001286352,OLFML3,4,3,2865,1988,877,292.3333333,497,0.441146881
NM_006594,AP4B1,11,10,10372,2801,7571,757.1,254.6363636,2.702963227
NM_152696,HIPK1,15,14,42704,3442,39262,2804.428571,229.4666667,11.40674027
NM_198268,HIPK1,16,15,48497,8167,40330,2688.666667,510.4375,4.938165789
NM_001253853,AP4B1,11,10,10372,2673,7699,769.9,243,2.880284325
NM_001253852,AP4B1,10,9,10156,2732,7424,824.8888889,273.2,2.717423133
NM_020190,OLFML3,3,2,2865,1835,1030,515,611.6666667,0.561307902
NM_022836,DCLRE1B,4,3,8795,3792,5003,1667.666667,948,1.31935654
NM_181358,HIPK1,14,13,23994,6885,17109,1316.076923,491.7857143,2.48496732
NM_005872,BCAS2,7,6,14086,1308,12778,2129.666667,186.8571429,9.76911315
NM_025073,SIKE1,5,4,11205,5496,5709,1427.25,1099.2,1.038755459
NM_007158,CSDE1,19,18,41139,4092,37047,2058.166667,215.3684211,9.053519062
NM_001102396,SIKE1,5,4,11205,5508,5697,1424.25,1101.6,1.034313725
NM_001172626,AMPD1,15,14,22521,2409,20112,1436.571429,160.6,8.348692403
NM_000036,AMPD1,16,15,22521,2422,20099,1339.933333,151.375,8.298513625
NM_002524,NRAS,7,6,12432,4461,7971,1328.5,637.2857143,1.786819099
NM_001242893,CSDE1,18,17,41139,3704,37435,2202.058824,205.7777778,10.10664147
NM_001242892,CSDE1,19,18,41139,3798,37341,2074.5,199.8947368,9.831753555
NM_001242891,CSDE1,21,20,41139,4334,36805,1840.25,206.3809524,8.492155053
NM_001130523,CSDE1,20,19,41139,4240,36899,1942.052632,212,8.70259434
NM_001007553,CSDE1,20,19,41139,4186,36953,1944.894737,209.3,8.827759197
NM_001277991,TSHB,1,0,365,365,NA,NA,365,NA
NM_000549,TSHB,3,2,4487,540,3947,1973.5,180,7.309259259
NM_138959,VANGL1,8,7,56273,8699,47574,6796.285714,1087.375,5.468904472
NM_001172412,VANGL1,8,7,55597,8643,46954,6707.714286,1080.375,5.43260442
NM_001172411,VANGL1,8,7,56273,8693,47580,6797.142857,1086.625,5.473369378
NM_005599,NHLH2,3,2,4750,2514,2236,1118,838,0.889419252
NM_001111061,NHLH2,2,1,4336,2502,1834,1834,1251,0.733013589
NM_152367,MAB21L3,7,6,23487,3236,20251,3375.166667,462.2857143,6.258034611
NM_001160234,ATP1A1,23,22,21406,3597,17809,809.5,156.3913043,4.951070336
NM_001160233,ATP1A1,23,22,30909,3788,27121,1232.772727,164.6956522,7.159714889
NM_001144822,CD58,5,4,52395,1400,50995,12748.75,280,36.425
NM_001779,CD58,6,5,56561,1159,55402,11080.4,193.1666667,47.80155306
NM_001013643,C1orf137,4,3,12493,390,12103,4034.333333,97.5,31.03333333
NM_020440,PTGFRN,9,8,80285,6169,74116,9264.5,685.4444444,12.01426487
NM_025188,TRIM45,6,5,10736,3587,7149,1429.8,597.8333333,1.993030388
NM_001145635,TRIM45,6,5,10736,3533,7203,1440.6,588.8333333,2.038777243
NM_003594,TTF2,23,22,42544,4877,37667,1712.136364,212.0434783,7.72339553
NM_017709,FAM46C,2,1,22409,5722,16687,16687,2861,2.916288011
NM_001135589,GDAP2,13,12,52970,3055,49915,4159.583333,235,16.33878887
NM_017686,GDAP2,14,13,66197,8891,57306,4408.153846,635.0714286,6.445394219
NM_152380,TBX15,8,7,106515,3503,103012,14716,437.875,29.40679418
NM_001166120,HSD3B2,4,3,8110,1791,6319,2106.333333,447.75,3.528196538
NM_000198,HSD3B2,4,3,7921,1714,6207,2069,428.5,3.621353559
NM_000862,HSD3B1,4,3,7857,1684,6173,2057.666667,421,3.66567696
NM_001080470,ZNF697,3,2,28392,5083,23309,11654.5,1694.333333,4.585677749
NM_005518,HMGCS2,10,9,20938,2476,18462,2051.333333,247.6,7.45638126
NM_006623,PHGDH,12,11,32432,2027,30405,2764.090909,168.9166667,15
NM_001166107,HMGCS2,9,8,20938,2349,18589,2323.625,261,7.913580247
NM_021794,ADAM30,1,0,2993,2993,NA,NA,2993,NA
NM_001047980,NBPF7,8,7,10117,1619,8498,1214,202.375,5.248919086
NM_032044,REG4,6,5,17564,1349,16215,3243,224.8333333,12.02001483
NM_001159353,REG4,3,2,9259,1179,8080,4040,393,6.853265479
NM_001159352,REG4,7,6,17564,1524,16040,2673.333333,217.7142857,10.52493438
NM_001004340,FCGR1B,3,2,9818,1629,8189,4094.5,543,5.027010436
NM_001244910,FCGR1B,5,4,8299,1586,6713,1678.25,317.2,4.232660782
NM_001017986,FCGR1B,5,4,9818,1907,7911,1977.75,381.4,4.148400629
NM_001123068,PPIAL4G,1,0,739,739,NA,NA,739,NA
NM_207418,FAM72D,4,3,16693,2397,14296,4765.333333,599.25,5.964121819
NM_001287385,FAM72C,4,3,16637,2341,14296,4765.333333,585.25,6.106791969
NM_001135789,PPIAL4C,1,0,786,786,NA,NA,786,NA
NM_001143883,PPIAL4B,1,0,786,786,NA,NA,786,NA
NM_178230,PPIAL4A,1,0,661,661,NA,NA,661,NA
NM_001002811,PDE4DIP,19,18,41776,5698,36078,2004.333333,299.8947368,6.331695332
NM_006472,TXNIP,8,7,4192,2959,1233,176.1428571,369.875,0.416694829
NM_213653,HFE2,4,3,4356,2219,2137,712.3333333,554.75,0.963046417
NM_213652,HFE2,2,1,4356,1471,2885,2885,735.5,1.96125085
NM_145277,HFE2,3,2,4356,2032,2324,1162,677.3333333,1.143700787
NM_202004,HFE2,3,2,4356,1509,2847,1423.5,503,1.88667992
NM_001039888,ANKRD34A,4,3,5141,3616,1525,508.3333333,904,0.421736726
NM_032305,POLR3GL,8,7,14153,1173,12980,1854.285714,146.625,11.06564365
NM_006468,POLR3C,15,14,18281,1866,16415,1172.5,124.4,8.796891747
NM_001184795,PEX11B,4,3,7174,1639,5535,1845,409.75,3.377059182
NM_003637,ITGA10,30,29,18880,5200,13680,471.7241379,173.3333333,2.630769231
NM_006099,PIAS3,14,13,10560,2916,7644,588,208.2857143,2.621399177
NM_001012758,NUDT17,8,7,2944,1099,1845,263.5714286,137.375,1.678798908
NM_001280799,ANKRD35,12,11,19319,3105,16214,1474,258.75,5.221900161
NM_144698,ANKRD35,14,13,19319,3377,15942,1226.307692,241.2142857,4.720758069
NM_005105,RBM8A,6,5,5980,4965,1015,203,827.5,0.204431017
NM_003846,PEX11B,4,3,7569,1833,5736,1912,458.25,3.129296236
NM_007053,CD160,6,5,19843,1639,18204,3640.8,273.1666667,11.10677242
NM_001097612,GPR89A,14,13,62510,1980,60530,4656.153846,141.4285714,30.57070707
NM_001097613,GPR89A,15,14,62510,2027,60483,4320.214286,135.1333333,29.83867785
NM_001097616,GPR89C,9,8,40183,1578,38605,4825.625,175.3333333,24.46451204
NM_183372,NBPF11,24,23,50093,5491,44602,1939.217391,228.7916667,8.122746312
NM_001101663,NBPF11,21,20,25194,4652,20542,1027.1,221.5238095,4.415735168
NM_005399,PRKAB2,8,7,17485,5470,12015,1716.428571,683.75,2.196526508
NM_001256338,CHD1L,17,16,53158,2419,50739,3171.1875,142.2941176,20.97519636
NM_001256337,CHD1L,18,17,53158,2502,50656,2979.764706,139,20.24620304
NM_024568,CHD1L,23,22,53158,3009,50149,2279.5,130.826087,16.66633433
NM_001256336,CHD1L,22,21,53158,2929,50229,2391.857143,133.1363636,17.14885626
NM_004284,CHD1L,23,22,53158,3037,50121,2278.227273,132.0434783,16.50345736
NM_016361,ACP6,10,9,23468,1818,21650,2405.555556,181.8,11.90869087
NM_181703,GJA5,2,1,4384,3158,1226,1226,1579,0.388220393
NM_005266,GJA5,2,1,17136,3161,13975,13975,1580.5,4.421069282
NM_005267,GJA8,2,1,6451,1368,5083,5083,684,3.715643275
NM_001143883,PPIAL4B,1,0,786,786,NA,NA,786,NA
NM_178230,PPIAL4A,1,0,661,661,NA,NA,661,NA
NM_001164262,PPIAL4F,1,0,786,786,NA,NA,786,NA
NM_001164261,PPIAL4D,1,0,786,786,NA,NA,786,NA
NM_001144032,PPIAL4E,1,0,786,786,NA,NA,786,NA
NM_001277444,NBPF9,25,24,96682,5063,91619,3817.458333,202.52,18.09579301
NM_015383,NBPF14,66,65,96509,10152,86357,1328.569231,153.8181818,8.506402679
NM_173638,NBPF15,19,18,35422,4291,31131,1729.5,225.8421053,7.254952226
NM_001170755,NBPF15,22,21,38081,4824,33257,1583.666667,219.2727273,6.89407131
NM_001102663,NBPF16,16,15,18912,3847,15065,1004.333333,240.4375,3.916038472
NM_001102663,NBPF16,16,15,18871,3847,15024,1001.6,240.4375,3.905380816
NM_001164262,PPIAL4F,1,0,786,786,NA,NA,786,NA
NM_001164261,PPIAL4D,1,0,786,786,NA,NA,786,NA
NM_001144032,PPIAL4E,1,0,786,786,NA,NA,786,NA
NM_003516,HIST2H2AA3,1,0,535,535,NA,NA,535,NA
NM_001040874,HIST2H2AA4,1,0,535,535,NA,NA,535,NA
NM_001161334,HIST2H2BF,2,1,29685,1001,28684,28684,500.5,28.65534466
NM_003548,HIST2H4A,1,0,397,397,NA,NA,397,NA
NM_021059,HIST2H3C,1,0,508,508,NA,NA,508,NA
NM_001123375,HIST2H3D,1,0,458,458,NA,NA,458,NA
NM_000566,FCGR1A,6,5,9826,2182,7644,1528.8,363.6666667,3.503208066
NM_001024599,HIST2H2BF,1,0,496,496,NA,NA,496,NA
NM_001034077,HIST2H4B,1,0,397,397,NA,NA,397,NA
NM_001005464,HIST2H3A,1,0,508,508,NA,NA,508,NA
NM_016074,BOLA1,2,1,1195,859,336,336,429.5,0.391152503
NM_001278719,SV2A,3,2,3673,2383,1290,645,794.3333333,0.541334452
NM_005850,SF3B4,6,5,4937,1999,2938,587.6,333.1666667,1.469734867
NM_003517,HIST2H2AC,1,0,438,438,NA,NA,438,NA
NM_003516,HIST2H2AA3,1,0,535,535,NA,NA,535,NA
NM_001040874,HIST2H2AA4,1,0,535,535,NA,NA,535,NA
NM_014849,SV2A,13,12,14564,4427,10137,844.75,340.5384615,2.289812514
NM_003528,HIST2H2BE,1,0,2224,2224,NA,NA,2224,NA
NM_003548,HIST2H4A,1,0,397,397,NA,NA,397,NA
NM_181873,MTMR11,17,16,7725,2365,5360,335,139.1176471,2.266384778
NM_021059,HIST2H3C,1,0,508,508,NA,NA,508,NA
NM_001145862,MTMR11,17,16,8250,2876,5374,335.875,169.1764706,1.868567455
NM_175065,HIST2H2AB,1,0,449,449,NA,NA,449,NA
NM_001034077,HIST2H4B,1,0,397,397,NA,NA,397,NA
NM_001005464,HIST2H3A,1,0,508,508,NA,NA,508,NA
NM_016274,PLEKHO1,6,5,9657,1621,8036,1607.2,270.1666667,4.957433683
NM_001280560,ANP32E,5,4,17789,3237,14552,3638,647.4,4.495520544
NM_001280559,ANP32E,7,6,17789,3457,14332,2388.666667,493.8571429,4.145791148
NM_030920,ANP32E,7,6,17789,3460,14329,2388.166667,494.2857143,4.14132948
NM_001136479,ANP32E,7,6,16311,3136,13175,2195.833333,448,4.201211735
NM_001136478,ANP32E,6,5,17789,3336,14453,2890.6,556,4.332434053
NM_016022,APH1A,6,5,3812,2272,1540,308,378.6666667,0.677816901
NM_001243772,APH1A,6,5,3812,1724,2088,417.6,287.3333333,1.211136891
NM_031901,MRPS21,3,2,15154,1108,14046,7023,369.3333333,12.67689531
NM_012113,CA14,11,10,7264,1752,5512,551.2,159.2727273,3.146118721
NM_144697,CIART,5,4,4274,1747,2527,631.75,349.4,1.446479679
NM_001243771,APH1A,5,4,3812,2100,1712,428,420,0.815238095
NM_018997,MRPS21,2,1,15154,1543,13611,13611,771.5,8.821127673
NM_024579,C1orf54,6,5,8154,533,7621,1524.2,88.83333333,14.29831144
NM_001077628,APH1A,7,6,3812,1935,1877,312.8333333,276.4285714,0.97002584
NM_004698,PRPF3,16,15,31778,2479,29299,1953.266667,154.9375,11.81887858
NM_025008,ADAMTSL4,15,14,9381,2962,6419,458.5,197.4666667,2.167116813
NM_021960,MCL1,3,2,5189,4088,1101,550.5,1362.666667,0.269324853
NM_004425,ECM1,10,9,5780,2154,3626,402.8888889,215.4,1.683379759
NM_001288608,ADAMTSL4,20,19,11569,4343,7226,380.3157895,217.15,1.663826848
NM_001288607,ADAMTSL4,20,19,11569,4157,7412,390.1052632,207.85,1.783016599
NM_001202858,ECM1,10,9,5780,2235,3545,393.8888889,223.5,1.586129754
NM_022664,ECM1,9,8,5780,1778,4002,500.25,197.5555556,2.250843645
NM_182763,MCL1,2,1,5189,3839,1350,1350,1919.5,0.351654077
NM_019032,ADAMTSL4,19,18,11569,4273,7296,405.3333333,224.8947368,1.707465481
NM_207045,ENSA,5,4,7012,1156,5856,1464,231.2,5.065743945
NM_207046,ENSA,4,3,7012,1107,5905,1968.333333,276.75,5.334236676
NM_001197320,MCL1,4,3,5189,3630,1559,519.6666667,907.5,0.429476584
NM_207047,ENSA,3,2,5857,2733,3124,1562,911,1.143066228
NM_032132,HORMAD1,15,14,22831,1913,20918,1494.142857,127.5333333,10.93465761
NM_001199829,HORMAD1,14,13,22831,1891,20940,1610.769231,135.0714286,11.07350608
NM_018178,GOLPH3L,5,4,50973,3176,47797,11949.25,635.2,15.04943325
NM_001286035,ARNT,23,22,67065,4951,62114,2823.363636,215.2608696,12.54574833
NM_178427,ARNT,21,20,67065,4863,62202,3110.1,231.5714286,12.79086983
NM_001668,ARNT,22,21,67065,4909,62156,2959.809524,223.1363636,12.66164188
NM_001197325,ARNT,21,20,67065,4860,62205,3110.25,231.4285714,12.79938272
NM_000396,CTSK,8,7,12235,1818,10417,1488.142857,227.25,5.729922992
NM_001286036,ARNT,22,21,67065,4903,62162,2960.095238,222.8636364,12.67836019
NM_003568,ANXA9,14,13,13617,1838,11779,906.0769231,131.2857143,6.4085963
NM_001145415,SETDB1,22,21,38407,4468,33939,1616.142857,203.0909091,7.596016115
NM_022075,CERS2,11,10,9832,2515,7317,731.7,228.6363636,2.909343936
NM_001163260,FAM63A,10,9,9974,2062,7912,879.1111111,206.2,3.837051406
NM_012432,SETDB1,22,21,38407,4465,33942,1616.285714,202.9545455,7.601791713
NM_181746,CERS2,11,10,9832,2555,7277,727.7,232.2727273,2.8481409
NM_001243491,SETDB1,9,8,18984,1498,17486,2185.75,166.4444444,11.6728972
NM_018379,FAM63A,11,10,11555,2851,8704,870.4,259.1818182,3.052963872
NM_001163259,FAM63A,10,9,9974,2151,7823,869.2222222,215.1,3.636913064
NM_001163258,FAM63A,11,10,11555,2250,9305,930.5,204.5454545,4.135555556
NM_001040217,FAM63A,10,9,10086,2186,7900,877.7777778,218.6,3.613906679
NM_020239,CDC42SE1,5,4,8680,3052,5628,1407,610.4,1.844036697
NM_001159642,BNIPL,10,9,11049,2422,8627,958.5555556,242.2,3.561932287
NM_001178062,SEMA6C,19,18,14979,3921,11058,614.3333333,206.3684211,2.820198929
NM_001178061,SEMA6C,20,19,14979,4042,10937,575.6315789,202.1,2.705838694
NM_030913,SEMA6C,19,18,14979,3945,11034,613,207.6315789,2.796958175
NM_001038707,CDC42SE1,6,5,8680,3189,5491,1098.2,531.5,1.721856381
NM_138278,BNIPL,10,9,11049,2170,8879,986.5555556,217,4.091705069
NM_006818,MLLT11,2,1,8824,2160,6664,6664,1080,3.085185185
NM_017860,C1orf56,2,1,3614,2030,1584,1584,1015,0.780295567
NM_144618,GABPB2,9,8,47929,1962,45967,5745.875,218,23.42864424
NM_001135638,PIP5K1A,16,15,50988,3823,47165,3144.333333,238.9375,12.33716976
NM_001135637,PIP5K1A,14,13,50988,3635,47353,3642.538462,259.6428571,13.02696011
NM_001204856,SCNM1,7,6,4277,2092,2185,364.1666667,298.8571429,1.044455067
NM_001204848,TNFAIP8L2-SCNM1,7,6,13670,1955,11715,1952.5,279.2857143,5.992327366
NM_024041,SCNM1,7,6,4277,2043,2234,372.3333333,291.8571429,1.093489966
NM_005997,VPS72,6,5,13915,1537,12378,2475.6,256.1666667,8.053350683
NM_013353,TMOD4,10,9,6086,1332,4754,528.2222222,133.2,3.569069069
NM_003557,PIP5K1A,15,14,50988,3783,47205,3371.785714,252.2,12.47819191
NM_002810,PSMD4,10,9,12759,1341,11418,1268.666667,134.1,8.514541387
NM_024575,TNFAIP8L2,2,1,3122,1180,1942,1942,590,1.645762712
NM_001271087,VPS72,6,5,13915,1570,12345,2469,261.6666667,7.863057325
NM_001136543,LYSMD1,3,2,6202,1843,4359,2179.5,614.3333333,2.365165491
NM_001135636,PIP5K1A,14,13,50988,3701,47287,3637.461538,264.3571429,12.77681708
NM_001271088,VPS72,6,5,13915,1268,12647,2529.4,211.3333333,9.973974763
NM_212551,LYSMD1,3,2,6148,2457,3691,1845.5,819,1.502238502
NM_002651,PI4KB,13,12,35862,4136,31726,2643.833333,318.1538462,7.670696325
NM_002796,PSMB4,7,6,2373,932,1441,240.1666667,133.1428571,1.546137339
NM_001258288,SELENBP1,11,10,8434,1578,6856,685.6,143.4545455,4.344740177
NM_001198775,PI4KB,10,9,35862,2949,32913,3657,294.9,11.16073245
NM_001198774,PI4KB,11,10,35920,3945,31975,3197.5,358.6363636,8.105196451
NM_001198773,PI4KB,13,12,35862,4264,31598,2633.166667,328,7.410412758
NM_001258289,SELENBP1,12,11,8434,1974,6460,587.2727273,164.5,3.27254306
NM_001025603,RFX5,11,10,6655,3622,3033,303.3,329.2727273,0.837382662
NM_000449,RFX5,11,10,6655,3629,3026,302.6,329.9090909,0.833838523
NM_003944,SELENBP1,12,11,8434,1765,6669,606.2727273,147.0833333,3.778470255
NM_020770,CGN,21,20,27307,5122,22185,1109.25,243.9047619,4.331315892
NM_006862,TDRKH,14,13,18971,2343,16628,1279.076923,167.3571429,7.096884336
NM_031420,MRPL9,7,6,3919,1299,2620,436.6666667,185.5714286,2.016936105
NM_001004432,LINGO4,2,1,5119,2608,2511,2511,1304,0.962806748
NM_001144956,RIIAD1,5,4,8071,460,7611,1902.75,92,16.54565217
NM_016178,OAZ3,5,4,4677,892,3785,946.25,178.4,4.243273543
NM_001083965,TDRKH,13,12,17057,2854,14203,1183.583333,219.5384615,4.976524177
NM_001083964,TDRKH,13,12,17057,2719,14338,1194.833333,209.1538462,5.273262229
NM_001083963,TDRKH,13,12,17057,2829,14228,1185.666667,217.6153846,5.029338989
NM_001134939,OAZ3,5,4,8363,857,7506,1876.5,171.4,8.758459743
NM_001172648,CELF3,13,12,16260,5365,10895,907.9166667,412.6923077,2.030754893
NM_001172649,CELF3,12,11,16350,5047,11303,1027.545455,420.5833333,2.239548246
NM_007185,CELF3,13,12,16758,5606,11152,929.3333333,431.2307692,1.989297182
NM_001136003,C2CD4D,2,1,2696,1715,981,981,857.5,0.572011662
NM_053055,THEM4,6,5,39020,5177,33843,6768.6,862.8333333,6.537183697
NM_182578,THEM5,6,5,6598,1152,5446,1089.2,192,4.727430556
NM_005620,S100A11,3,2,4531,597,3934,1967,199,6.58961474
NM_002966,S100A10,3,2,11330,1058,10272,5136,352.6666667,9.708884688
NM_001008536,TCHHL1,3,2,4922,3606,1316,658,1202,0.36494731
NM_001122965,RPTN,3,2,5635,3572,2063,1031.5,1190.666667,0.577547592
NM_007113,TCHH,3,2,9139,6998,2141,1070.5,2332.666667,0.305944556
NM_002016,FLG,3,2,23030,12750,10280,5140,4250,0.80627451
NM_001009931,HRNR,3,2,12122,9635,2487,1243.5,3211.666667,0.258121432
NM_001014342,FLG2,3,2,11271,9125,2146,1073,3041.666667,0.235178082
NM_016190,CRNN,3,2,5033,1916,3117,1558.5,638.6666667,1.626826722
NM_032563,LCE3D,2,1,1122,612,510,510,306,0.833333333
NM_019060,CRCT1,2,1,1505,697,808,808,348.5,1.159253945
NM_178438,LCE5A,2,1,1335,821,514,514,410.5,0.626065773
NM_178435,LCE3E,2,1,1056,549,507,507,274.5,0.923497268
NM_178356,LCE4A,1,0,389,389,NA,NA,389,NA
NM_014357,LCE2B,2,1,1279,613,666,666,306.5,1.086460033
NM_001024679,C1orf68,1,0,909,909,NA,NA,909,NA
NM_178431,LCE3A,1,0,271,271,NA,NA,271,NA
NM_178430,LCE2D,2,1,1250,596,654,654,298,1.097315436
NM_178429,LCE2C,2,1,1260,595,665,665,297.5,1.117647059
NM_178428,LCE2A,2,1,1080,594,486,486,297,0.818181818
NM_178434,LCE3C,1,0,426,426,NA,NA,426,NA
NM_178433,LCE3B,1,0,289,289,NA,NA,289,NA
NM_001276331,LCE1C,3,2,1798,608,1190,595,202.6666667,1.957236842
NM_001128600,LCE6A,2,1,1131,644,487,487,322,0.75621118
NM_178348,LCE1A,1,0,626,626,NA,NA,626,NA
NM_001025231,KPRP,2,1,4025,2525,1500,1500,1262.5,0.594059406
NM_178354,LCE1F,1,0,599,599,NA,NA,599,NA
NM_178353,LCE1E,2,1,2150,1181,969,969,590.5,0.820491109
NM_178352,LCE1D,2,1,1432,432,1000,1000,216,2.314814815
NM_178351,LCE1C,2,1,1798,697,1101,1101,348.5,1.579626973
NM_178349,LCE1B,1,0,1140,1140,NA,NA,1140,NA
NM_030663,SMCP,2,1,6727,772,5955,5955,386,7.71373057
NM_001199828,SPRR1A,2,1,1728,657,1071,1071,328.5,1.630136986
NM_005987,SPRR1A,2,1,1728,643,1085,1085,321.5,1.687402799
NM_005547,IVL,2,1,3325,2137,1188,1188,1068.5,0.555919513
NM_173080,SPRR4,2,1,1943,768,1175,1175,384,1.529947917
NM_006945,SPRR2D,2,1,1395,684,711,711,342,1.039473684
NM_001024209,SPRR2E,2,1,1392,680,712,712,340,1.047058824
NM_005988,SPRR2A,2,1,1394,679,715,715,339.5,1.053019146
NM_003125,SPRR1B,2,1,1699,621,1078,1078,310.5,1.735909823
NM_005416,SPRR3,3,2,2111,989,1122,561,329.6666667,1.134479272
NM_001097589,SPRR3,2,1,2111,904,1207,1207,452,1.335176991
NM_001017418,SPRR2B,3,2,1368,664,704,352,221.3333333,1.060240964
NM_001014450,SPRR2F,2,1,1378,658,720,720,329,1.094224924
NM_001014291,SPRR2G,2,1,1371,652,719,719,326,1.102760736
NM_001195571,PRR9,2,1,1735,1231,504,504,615.5,0.409423233
NM_001010857,LELP1,2,1,1697,543,1154,1154,271.5,2.125230203
NM_002965,S100A9,3,2,3175,580,2595,1297.5,193.3333333,4.474137931
NM_052891,PGLYRP3,7,6,12858,1180,11678,1946.333333,168.5714286,9.896610169
NM_020393,PGLYRP4,9,8,18427,1842,16585,2073.125,204.6666667,9.003800217
NM_000427,LOR,2,1,2423,1231,1192,1192,615.5,0.96831844
NM_005621,S100A12,3,2,1893,469,1424,712,156.3333333,3.036247335
NM_002964,S100A8,3,2,1158,526,632,316,175.3333333,1.201520913
NM_002963,S100A7,3,2,2919,442,2477,1238.5,147.3333333,5.604072398
NM_001045479,S100A7L2,3,2,3034,483,2551,1275.5,161,5.281573499
NM_176823,S100A7A,3,2,6703,4282,2421,1210.5,1427.333333,0.565390005
NM_020672,S100A14,4,3,2078,1064,1014,338,266,0.953007519
NM_019554,S100A4,4,3,2189,568,1621,540.3333333,142,2.853873239
NM_001024210,S100A13,5,4,15294,901,14393,3598.25,180.2,15.97447281
NM_080388,S100A16,3,2,6149,1071,5078,2539,357,4.741363212
NM_005979,S100A13,4,3,9441,692,8749,2916.333333,173,12.64306358
NM_005978,S100A2,3,2,4723,965,3758,1879,321.6666667,3.894300518
NM_014624,S100A6,3,2,1643,686,957,478.5,228.6666667,1.395043732
NM_002960,S100A3,3,2,1927,741,1186,593,247,1.600539811
NM_002962,S100A5,4,3,4620,714,3906,1302,178.5,5.470588235
NM_002961,S100A4,3,2,2186,515,1671,835.5,171.6666667,3.244660194
NM_001024213,S100A13,3,2,8250,554,7696,3848,184.6666667,13.89169675
NM_001024212,S100A13,3,2,8470,586,7884,3942,195.3333333,13.45392491
NM_001024211,S100A13,3,2,8843,615,8228,4114,205,13.37886179
NM_006271,S100A1,3,2,3642,597,3045,1522.5,199,5.100502513
NM_012437,SNAPIN,4,3,3200,1056,2144,714.6666667,264,2.03030303
NM_023015,INTS3,30,29,45990,4512,41478,1430.275862,150.4,9.192819149
NM_001267809,ILF2,14,13,9242,1920,7322,563.2307692,137.1428571,3.813541667
NM_000906,NPR1,22,21,15306,4207,11099,528.5238095,191.2272727,2.638222011
NM_004515,ILF2,14,13,9242,1901,7341,564.6923077,135.7857143,3.861651762
NM_024330,SLC27A3,10,9,4867,2423,2444,271.5555556,242.3,1.008666942
NM_006694,JTB,5,4,3708,1579,2129,532.25,315.8,1.348321723
NM_014856,DENND4B,28,27,17179,5716,11463,424.5555556,204.1428571,2.005423373
NM_130898,CREB3L4,10,9,6527,1847,4680,520,184.7,2.533838657
NM_001030,RPS27,4,3,1394,355,1039,346.3333333,88.75,2.926760563
NM_014437,SLC39A1,5,4,8635,2465,6170,1542.5,493,2.503042596
NM_002870,RAB13,8,7,4762,1243,3519,502.7142857,155.375,2.831053902
NM_181715,CRTC2,14,13,10986,2692,8294,638,192.2857143,3.080980684
NM_001255979,CREB3L4,10,9,6167,1613,4554,506,161.3,2.823310601
NM_001255978,CREB3L4,10,9,6527,1827,4700,522.2222222,182.7,2.572523262
NM_001255981,CREB3L4,10,9,6167,1553,4614,512.6666667,155.3,2.971023825
NM_001271961,SLC39A1,3,2,4544,2025,2519,1259.5,675,1.243950617
NM_001271959,SLC39A1,4,3,4395,2326,2069,689.6666667,581.5,0.889509888
NM_001271960,SLC39A1,5,4,9087,2219,6868,1717,443.8,3.095087877
NM_001271958,SLC39A1,4,3,4544,2157,2387,795.6666667,539.25,1.106629578
NM_001271957,SLC39A1,4,3,4271,2320,1951,650.3333333,580,0.840948276
NM_001272038,RAB13,8,7,3751,1361,2390,341.4285714,170.125,1.756061719
NM_001255980,CREB3L4,10,9,6527,1767,4760,528.8888889,176.7,2.693831353
NM_015449,C1orf43,6,5,14092,1802,12290,2458,300.3333333,6.820199778
NM_001018837,HAX1,7,6,3318,1042,2276,379.3333333,148.8571429,2.184261036
NM_001010979,C1orf189,4,3,7281,709,6572,2190.666667,177.25,9.269393512
NM_001287815,UBAP2L,25,24,42658,3476,39182,1632.583333,139.04,11.2721519
NM_001287816,UBAP2L,27,26,50663,4022,46641,1793.884615,148.962963,11.59646942
NM_014847,UBAP2L,27,26,50006,4016,45990,1768.846154,148.7407407,11.45169323
NM_138740,C1orf43,5,4,14092,1747,12345,3086.25,349.4,7.066399542
NM_001098616,C1orf43,7,6,14092,1905,12187,2031.166667,272.1428571,6.397375328
NM_006118,HAX1,7,6,3318,1186,2132,355.3333333,169.4285714,1.797639123
NM_001127320,UBAP2L,25,24,43335,3443,39892,1662.166667,137.72,11.5864072
NM_020452,ATP8B2,28,27,23506,5886,17620,652.5925926,210.2142857,2.993544003
NM_080429,AQP10,6,5,4211,1797,2414,482.8,299.5,1.343350028
NM_001005855,ATP8B2,12,11,12288,1528,10760,978.1818182,127.3333333,7.041884817
NM_017582,UBE2Q1,13,12,10071,3236,6835,569.5833333,248.9230769,2.112175525
NM_001098475,TDRD10,12,11,45930,2541,43389,3944.454545,211.75,17.0755608
NM_182499,TDRD10,13,12,45930,2344,43586,3632.166667,180.3076923,18.5947099
NM_001010846,SHE,6,5,22574,6189,16385,3277,1031.5,2.647439005
NM_015841,ADAR,15,14,26192,6551,19641,1402.928571,436.7333333,2.998168219
NM_015840,ADAR,15,14,26192,6608,19584,1398.857143,440.5333333,2.963680387
NM_001193495,ADAR,15,14,24244,6724,17520,1251.428571,448.2666667,2.60559191
NM_001025107,ADAR,15,14,45924,6555,39369,2812.071429,437,6.005949657
NM_000748,CHRNB2,6,5,12098,5724,6374,1274.8,954,1.113556953
NM_001111,ADAR,15,14,26192,6686,19506,1393.285714,445.7333333,2.917439426
NM_006556,PMVK,5,4,12278,1304,10974,2743.5,260.8,8.415644172
NM_001143687,DCST1,16,15,17126,2238,14888,992.5333333,139.875,6.652368186
NM_182690,EFNA4,4,3,5818,1115,4703,1567.666667,278.75,4.21793722
NM_003029,SHC1,13,12,12187,3182,9005,750.4166667,244.7692308,2.829981144
NM_201398,FLAD1,8,7,9819,1803,8016,1145.142857,225.375,4.445923461
NM_001202859,SHC1,13,12,12187,3179,9008,750.6666667,244.5384615,2.83359547
NM_001256455,ZBTB7B,3,2,15897,3783,12114,6057,1261,3.20222046
NM_005227,EFNA4,4,3,5818,1261,4557,1519,315.25,3.613798573
NM_152494,DCST1,17,16,17126,2314,14812,925.75,136.1176471,6.401037165
NM_003815,ADAM15,21,20,11506,2855,8651,432.55,135.952381,3.030122592
NM_018655,LENEP,2,1,731,651,80,80,325.5,0.122887865
NM_001826,CKS1B,3,2,4609,819,3790,1895,273,4.627594628
NM_001252406,ZBTB7B,5,4,15897,4025,11872,2968,805,2.949565217
NM_025207,FLAD1,7,6,9819,2246,7573,1262.166667,320.8571429,3.371772039
NM_138300,PYGO2,3,2,4758,3183,1575,787.5,1061,0.494816211
NM_183001,SHC1,12,11,8451,3490,4961,451,290.8333333,1.421489971
NM_001261465,ADAM15,21,20,11506,2857,8649,432.45,136.047619,3.027301365
NM_001130040,SHC1,12,11,8451,3493,4958,450.7272727,291.0833333,1.419410249
NM_001184892,FLAD1,3,2,5720,1879,3841,1920.5,626.3333333,2.044172432
NM_144622,DCST2,15,14,15256,2434,12822,915.8571429,162.2666667,5.267871816
NM_207197,ADAM15,23,22,11506,3004,8502,386.4545455,130.6086957,2.830226365
NM_207196,ADAM15,23,22,11506,3001,8505,386.5909091,130.4782609,2.834055315
NM_207195,ADAM15,22,21,11506,2928,8578,408.4761905,133.0909091,2.929644809
NM_001261464,ADAM15,21,20,11506,2885,8621,431.05,137.3809524,2.988214905
NM_207194,ADAM15,22,21,11506,2931,8575,408.3333333,133.2272727,2.925622654
NM_207191,ADAM15,20,19,11506,2784,8722,459.0526316,139.2,3.132902299
NM_001130041,SHC1,13,12,12187,3179,9008,750.6666667,244.5384615,2.83359547
NM_001184891,FLAD1,7,6,9819,1917,7902,1317,273.8571429,4.122065728
NM_001261466,ADAM15,15,14,7413,2241,5172,369.4285714,149.4,2.30789826
NM_182689,EFNA4,4,3,5818,1095,4723,1574.333333,273.75,4.313242009
NM_001287586,SLC50A1,5,4,3048,1251,1797,449.25,250.2,1.436450839
NM_001287587,SLC50A1,6,5,3048,1369,1679,335.8,228.1666667,1.226442659
NM_025058,TRIM46,10,9,11186,3251,7935,881.6666667,325.1,2.44078745
NM_002455,MTX1,8,7,5126,1640,3486,498,205,2.125609756
NM_007112,THBS3,23,22,12395,3252,9143,415.5909091,141.3913043,2.811500615
NM_001282378,TRIM46,9,8,11186,2988,8198,1024.75,332,2.743641232
NM_001204297,MUC1,5,4,4408,922,3486,871.5,184.4,3.780911063
NM_001204296,MUC1,7,6,4408,1029,3379,563.1666667,147,3.283770651
NM_001204292,MUC1,7,6,4408,1110,3298,549.6666667,158.5714286,2.971171171
NM_001204291,MUC1,7,6,4408,1116,3292,548.6666667,159.4285714,2.949820789
NM_001204290,MUC1,7,6,4408,1044,3364,560.6666667,149.1428571,3.222222222
NM_001204288,MUC1,8,7,4408,1154,3254,464.8571429,144.25,2.819757366
NM_001204294,MUC1,7,6,4408,1083,3325,554.1666667,154.7142857,3.070175439
NM_001204289,MUC1,7,6,4408,1107,3301,550.1666667,158.1428571,2.981933153
NM_001204287,MUC1,8,7,4408,1240,3168,452.5714286,155,2.55483871
NM_001204286,MUC1,9,8,4408,1847,2561,320.125,205.2222222,1.386572821
NM_001204285,MUC1,9,8,4408,1820,2588,323.5,202.2222222,1.421978022
NM_001204295,MUC1,6,5,4408,959,3449,689.8,159.8333333,3.59645464
NM_001287592,SLC50A1,4,3,3516,1136,2380,793.3333333,284,2.095070423
NM_198883,MTX1,7,6,5136,1556,3580,596.6666667,222.2857143,2.300771208
NM_001256600,TRIM46,11,10,11186,3206,7980,798,291.4545455,2.489082969
NM_001122837,SLC50A1,5,4,3048,1224,1824,456,244.8,1.490196078
NM_001044391,MUC1,5,4,4408,841,3567,891.75,168.2,4.24137931
NM_001287588,SLC50A1,5,4,3048,1242,1806,451.5,248.4,1.45410628
NM_001287590,SLC50A1,5,4,3516,1381,2135,533.75,276.2,1.545981173
NM_001287591,SLC50A1,6,5,3516,1406,2110,422,234.3333333,1.500711238
NM_001282379,TRIM46,9,8,6830,1958,4872,609,217.5555556,2.48825332
NM_001287589,SLC50A1,4,3,3048,1061,1987,662.3333333,265.25,1.872761546
NM_153741,DPM3,2,1,631,387,244,244,193.5,0.630490956
NM_018973,DPM3,1,0,518,518,NA,NA,518,NA
NM_182685,EFNA1,4,3,7039,1504,5535,1845,376,3.68018617
NM_001044393,MUC1,7,6,4408,970,3438,573,138.5714286,3.544329897
NM_001044392,MUC1,5,4,4408,868,3540,885,173.6,4.078341014
NM_001044390,MUC1,7,6,4408,1002,3406,567.6666667,143.1428571,3.399201597
NM_001256599,TRIM46,10,9,11186,3261,7925,880.5555556,326.1,2.430236124
NM_001256601,TRIM46,10,9,10219,3092,7127,791.8888889,309.2,2.304980595
NM_002456,MUC1,8,7,4408,1213,3195,456.4285714,151.625,2.633965375
NM_018845,SLC50A1,6,5,3048,1349,1699,339.8,224.8333333,1.259451446
NM_001122839,SLC50A1,5,4,3048,1186,1862,465.5,237.2,1.569983137
NM_001204293,MUC1,7,6,4408,1090,3318,553,155.7142857,3.044036697
NM_001018017,MUC1,8,7,4408,1159,3249,464.1428571,144.875,2.803278689
NM_001018016,MUC1,8,7,4408,1186,3222,460.2857143,148.25,2.716694772
NM_004428,EFNA1,5,4,7039,1571,5468,1367,314.2,3.480585614
NM_173852,KRTCAP2,5,4,3922,552,3370,842.5,110.4,6.105072464
NM_001252608,THBS3,21,20,12395,2890,9505,475.25,137.6190476,3.288927336
NM_001252607,THBS3,22,21,12395,3224,9171,436.7142857,146.5454545,2.844602978
NM_001171811,GBA,10,9,10416,2410,8006,889.5555556,241,3.321991701
NM_006589,FAM189B,12,11,8280,3202,5078,461.6363636,266.8333333,1.585883823
NM_001278229,RUSC1,9,8,7183,2241,4942,617.75,249,2.205265506
NM_001278228,RUSC1,8,7,7183,2695,4488,641.1428571,336.875,1.665306122
NM_001278227,RUSC1,9,8,7183,2460,4723,590.375,273.3333333,1.919918699
NM_001135822,FDPS,10,9,11920,1348,10572,1174.666667,134.8,7.84272997
NM_001242825,FDPS,9,8,11920,1205,10715,1339.375,133.8888889,8.892116183
NM_000157,GBA,11,10,6832,2335,4497,449.7,212.2727273,1.925910064
NM_001039517,RUSC1-AS1,2,1,3689,1308,2381,2381,654,1.820336391
NM_001171812,GBA,10,9,6829,2184,4645,516.1111111,218.4,2.126831502
NM_001242824,FDPS,10,9,11920,1369,10551,1172.333333,136.9,7.707085464
NM_052837,SCAMP3,8,7,6408,1502,4906,700.8571429,187.75,3.266311585
NM_014328,RUSC1,9,8,7183,2559,4624,578,284.3333333,1.806955842
NM_198264,FAM189B,9,8,8280,2911,5369,671.125,323.4444444,1.844383373
NM_002004,FDPS,11,10,11920,1547,10373,1037.3,140.6363636,6.705235941
NM_001267608,FAM189B,11,10,8280,3147,5133,513.3,286.0909091,1.631077216
NM_001135821,FDPS,11,10,11754,1492,10262,1026.2,135.6363636,6.878016086
NM_020897,HCN3,8,7,12423,3882,8541,1220.142857,485.25,2.20015456
NM_001278230,RUSC1,8,7,6725,2357,4368,624,294.625,1.853203224
NM_001105205,RUSC1,9,8,7183,2516,4667,583.375,279.5555556,1.854928458
NM_001105204,RUSC1,10,9,10271,3177,7094,788.2222222,317.7,2.232924142
NM_001105203,RUSC1,10,9,10271,3495,6776,752.8888889,349.5,1.938769671
NM_000298,PKLR,11,10,12143,3054,9089,908.9,277.6363636,2.976096922
NM_005698,SCAMP3,9,8,6408,1581,4827,603.375,175.6666667,3.05313093
NM_003993,CLK2,13,12,10624,2150,8474,706.1666667,165.3846154,3.941395349
NM_181871,PKLR,11,10,11710,3036,8674,867.4,276,2.857048748
NM_001005741,GBA,12,11,10416,2595,7821,711,216.25,3.013872832
NM_001005742,GBA,12,11,10416,2576,7840,712.7272727,214.6666667,3.043478261
NM_001198902,YY1AP1,10,9,29284,2564,26720,2968.888889,256.4,10.42121685
NM_001198901,YY1AP1,10,9,29588,2597,26991,2999,259.7,10.39314594
NM_139119,YY1AP1,11,10,29334,2746,26588,2658.8,249.6363636,9.682447196
NM_001198906,YY1AP1,11,10,29592,2753,26839,2683.9,250.2727273,9.74900109
NM_001198904,YY1AP1,10,9,29216,3024,26192,2910.222222,302.4,8.661375661
NM_001198903,YY1AP1,10,9,29216,3084,26132,2903.555556,308.4,8.473411154
NM_001198900,YY1AP1,10,9,29337,2707,26630,2958.888889,270.7,9.837458441
NM_033657,DAP3,13,12,49917,2134,47783,3981.916667,164.1538462,22.39128397
NM_001198899,YY1AP1,8,7,20389,2772,17617,2516.714286,346.5,6.355339105
NM_001198905,YY1AP1,11,10,29337,2689,26648,2664.8,244.4545455,9.910003719
NM_001199850,DAP3,12,11,49920,1965,47955,4359.545455,163.75,24.40458015
NM_001199851,DAP3,12,11,49920,1944,47976,4361.454545,162,24.67901235
NM_001199849,DAP3,14,13,49920,2162,47758,3673.692308,154.4285714,22.08973173
NM_018253,YY1AP1,12,11,29337,2831,26506,2409.636364,235.9166667,9.362769339
NM_139121,YY1AP1,11,10,29533,2699,26834,2683.4,245.3636364,9.942200815
NM_139118,YY1AP1,11,10,29592,2673,26919,2691.9,243,10.07070707
NM_004632,DAP3,13,12,49917,2065,47852,3987.666667,158.8461538,23.17288136
NM_001282860,GON4L,32,31,107639,7859,99780,3218.709677,245.59375,12.69627179
NM_001282856,GON4L,32,31,109744,7807,101937,3288.290323,243.96875,13.05712822
NM_032292,GON4L,21,20,92835,5195,87640,4382,247.3809524,16.87006737
NM_001282858,GON4L,32,31,107639,7856,99783,3218.806452,245.5,12.70150204
NM_001282861,GON4L,21,20,92835,5207,87628,4381.4,247.952381,16.82888419
NM_001256821,RIT1,6,5,13109,3327,9782,1956.4,554.5,2.940186354
NM_006912,RIT1,6,5,13596,3449,10147,2029.4,574.8333333,2.942012177
NM_001256820,RIT1,5,4,13596,3299,10297,2574.25,659.8,3.121248863
NM_001162384,ARHGEF2,22,21,31708,4201,27507,1309.857143,190.9545455,6.547726732
NM_001162383,ARHGEF2,22,21,31708,4204,27504,1309.714286,191.0909091,6.542340628
NM_014949,KIAA0907,14,13,21354,2959,18395,1415,211.3571429,6.216627239
NM_004723,ARHGEF2,22,21,31338,4129,27209,1295.666667,187.6818182,6.58973117
NM_181885,RXFP4,1,0,1147,1147,NA,NA,1147,NA
NM_020387,RAB25,5,4,9331,1090,8241,2060.25,218,7.560550459
NM_014017,LAMTOR2,4,3,3786,685,3101,1033.666667,171.25,4.527007299
NM_003145,SSR2,6,5,11921,1130,10791,2158.2,188.3333333,9.549557522
NM_001145264,LAMTOR2,3,2,3786,594,3192,1596,198,5.373737374
NM_020131,UBQLN4,11,10,18426,3518,14908,1490.8,319.8181818,4.23763502
NM_001093725,MEX3A,2,1,9987,6126,3861,3861,3063,0.630264447
NM_024897,PAQR6,7,6,4798,2284,2514,419,326.2857143,1.100700525
NM_007221,PMF1,5,4,27091,1127,25964,6491,225.4,23.03815439
NM_001272113,PAQR6,5,4,4798,1604,3194,798.5,320.8,1.99127182
NM_001272112,PAQR6,5,4,4798,1734,3064,766,346.8,1.767012687
NM_001272111,PAQR6,7,6,4798,1909,2889,481.5,272.7142857,1.513357779
NM_001272110,PAQR6,7,6,4798,1951,2847,474.5,278.7142857,1.459251666
NM_001272109,PAQR6,5,4,4798,1966,2832,708,393.2,1.440488301
NM_001272108,PAQR6,6,5,4798,1702,3096,619.2,283.6666667,1.819036428
NM_001272107,PAQR6,7,6,4798,2213,2585,430.8333333,316.1428571,1.168097605
NM_001272106,PAQR6,6,5,4798,2043,2755,551,340.5,1.348507097
NM_001272105,PAQR6,9,8,4798,2152,2646,330.75,239.1111111,1.229553903
NM_001272104,PAQR6,8,7,4798,2079,2719,388.4285714,259.875,1.307840308
NM_001193300,SEMA4A,15,14,24222,3309,20913,1493.785714,220.6,6.320036265
NM_022367,SEMA4A,15,14,24222,3318,20904,1493.142857,221.2,6.300180832
NM_001193302,SEMA4A,13,12,24175,3002,21173,1764.416667,230.9230769,7.05296469
NM_199173,BGLAP,4,3,1174,549,625,208.3333333,137.25,1.138433515
NM_001199664,PMF1-BGLAP,5,4,30346,799,29547,7386.75,159.8,36.97997497
NM_001199663,PMF1-BGLAP,6,5,30346,811,29535,5907,135.1666667,36.41800247
NM_001199662,PMF1-BGLAP,7,6,30346,1008,29338,4889.666667,144,29.10515873
NM_001199661,PMF1-BGLAP,7,6,30346,947,29399,4899.833333,135.2857143,31.04435058
NM_001199654,PMF1,5,4,27091,1133,25958,6489.5,226.6,22.91085613
NM_001199653,PMF1,5,4,27091,1066,26025,6506.25,213.2,24.41369606
NM_014655,SLC25A44,4,3,18866,3643,15223,5074.333333,910.75,4.178698875
NM_001193301,SEMA4A,15,14,27809,3234,24575,1755.357143,215.6,7.59894867
NM_198406,PAQR6,8,7,4798,2037,2761,394.4285714,254.625,1.355424644
NM_001286184,SLC25A44,4,3,18866,3667,15199,5066.333333,916.75,4.144805018
NM_001256604,C1orf85,6,5,3004,1481,1523,304.6,246.8333333,1.028359217
NM_020407,RHBG,11,10,16035,1825,14212,1421.2,165.9090909,7.78739726
NM_005998,CCT3,14,13,29456,2121,27335,2102.692308,151.5,12.88778878
NM_001256396,RHBG,12,11,16035,1899,14138,1285.272727,158.25,7.444971037
NM_001256609,C1orf85,6,5,3004,1857,1147,229.4,309.5,0.617662897
NM_001256608,C1orf85,5,4,3004,1370,1634,408.5,274,1.19270073
NM_001256605,C1orf85,5,4,3004,1369,1635,408.75,273.8,1.194302411
NM_144627,TSACC,4,3,9682,754,8928,2976,188.5,11.84084881
NM_144580,C1orf85,6,5,3004,1628,1376,275.2,271.3333333,0.845208845
NM_032323,TMEM79,4,3,8166,2205,5961,1987,551.25,2.703401361
NM_001256395,RHBG,12,11,16035,1949,14088,1280.727273,162.4166667,7.228322217
NM_001008800,CCT3,12,11,29456,2005,27451,2495.545455,167.0833333,13.69127182
NM_001004319,VHLL,1,0,1015,1015,NA,NA,1015,NA
NM_001271629,MEF2D,11,10,26880,5694,21186,2118.6,517.6363636,3.720758693
NM_005920,MEF2D,12,11,37123,5997,31126,2829.636364,499.75,5.190261798
NM_006365,C1orf61,7,6,25131,886,24245,4040.833333,126.5714286,27.36455982
NM_015590,GPATCH4,8,7,7181,2089,5092,727.4285714,261.125,2.437529919
NM_021948,BCAN,14,13,17586,3484,14102,1084.769231,248.8571429,4.047646383
NM_198427,BCAN,8,7,11526,2866,8660,1237.142857,358.25,3.021632938
NM_001105669,TTC24,11,10,7045,2016,5029,502.9,183.2727273,2.494543651
NM_021817,HAPLN2,7,6,6433,1778,4655,775.8333333,254,2.618110236
NM_144772,APOA1BP,6,5,2535,1127,1408,281.6,187.8333333,1.249334516
NM_182679,GPATCH4,8,7,7181,2163,5018,716.8571429,270.375,2.319926029
NM_030980,ISG20L2,3,2,5294,2054,3240,1620,684.6666667,1.577409932
NM_001199723,CRABP2,5,4,6210,1048,5162,1290.5,209.6,4.925572519
NM_024540,MRPL24,6,5,3831,892,2939,587.8,148.6666667,3.294843049
NM_145729,MRPL24,6,5,3831,933,2898,579.6,155.5,3.106109325
NM_015997,RRNAD1,8,7,8491,2277,6214,887.7142857,284.625,2.729029425
NM_001126050,HDGF,6,5,10343,2204,8139,1627.8,367.3333333,3.692831216
NM_001878,CRABP2,4,3,6061,1060,5001,1667,265,4.717924528
NM_001142560,RRNAD1,7,6,8491,1791,6700,1116.666667,255.8571429,3.740926857
NM_006617,NES,4,3,8635,5561,3074,1024.666667,1390.25,0.552778277
NM_001126051,HDGF,6,5,10127,2179,7948,1589.6,363.1666667,3.647544745
NM_004494,HDGF,6,5,9646,2393,7253,1450.6,398.8333333,3.030923527
NM_001080471,PEAR1,23,22,22705,4889,17816,809.8181818,212.5652174,3.644098998
NM_001007792,NTRK1,17,16,66102,2588,63514,3969.625,152.2352941,24.54173107
NM_001161444,SH2D2A,8,7,9793,1439,8354,1193.428571,179.875,5.805420431
NM_001161443,SH2D2A,8,7,9906,1531,8375,1196.428571,191.375,5.470280862
NM_001161442,SH2D2A,9,8,10607,1622,8985,1123.125,180.2222222,5.53945746
NM_001161441,SH2D2A,9,8,10607,1683,8924,1115.5,187,5.302436126
NM_014215,INSRR,22,21,18049,4215,13834,658.7619048,191.5909091,3.282087782
NM_002529,NTRK1,17,16,20973,2672,18301,1143.8125,157.1764706,6.849176647
NM_001012331,NTRK1,16,15,20973,2653,18320,1221.333333,165.8125,6.905390124
NM_003975,SH2D2A,9,8,10607,1653,8954,1119.25,183.6666667,5.416817907
NM_198236,ARHGEF11,41,40,110532,6930,103602,2590.05,169.0243902,14.94978355
NM_014784,ARHGEF11,40,39,110532,6809,103723,2659.564103,170.225,15.23322074
NM_005240,ETV3,4,3,5203,1415,3788,1262.666667,353.75,2.677031802
NM_001004341,ETV3L,5,4,7767,1982,5785,1446.25,396.4,2.91876892
NM_001145312,ETV3,5,4,13926,2007,11919,2979.75,401.4,5.938714499
NM_031281,FCRL5,17,16,39145,5407,33738,2108.625,318.0588235,6.239689292
NM_001195388,FCRL5,17,16,39145,5397,33748,2109.25,317.4705882,6.253103576
NM_052939,FCRL3,15,14,22671,3034,19637,1402.642857,202.2666667,6.472313777
NM_001159397,FCRL1,10,9,25748,2981,22767,2529.666667,298.1,7.63737001
NM_001159398,FCRL1,11,10,25748,3106,22642,2264.2,282.3636364,7.289761751
NM_030764,FCRL2,12,11,31401,2601,28800,2618.181818,216.75,11.07266436
NM_052938,FCRL1,11,10,25748,3109,22639,2263.9,282.6363636,7.281762625
NM_001286349,KIRREL,13,12,106991,7533,99458,8288.166667,579.4615385,13.20297358
NM_018240,KIRREL,15,14,106991,7835,99156,7082.571429,522.3333333,12.6555201
NM_001766,CD1D,7,6,6481,3790,2691,448.5,541.4285714,0.710026385
NM_001185115,CD1E,5,4,3859,1816,2043,510.75,363.2,1.125
NM_001185114,CD1E,5,4,3859,1825,2034,508.5,365,1.114520548
NM_001185113,CD1E,4,3,3859,1389,2470,823.3333333,347.25,1.778257739
NM_001042584,CD1E,6,5,3859,2019,1840,368,336.5,0.911342249
NM_001042583,CD1E,6,5,3859,2087,1772,354.4,347.8333333,0.849065644
NM_001042586,CD1E,4,3,3859,1518,2341,780.3333333,379.5,1.542160738
NM_001042585,CD1E,6,5,3859,1922,1937,387.4,320.3333333,1.00780437
NM_030893,CD1E,6,5,3859,2123,1736,347.2,353.8333333,0.817710787
NM_001185112,CD1E,4,3,3859,1554,2305,768.3333333,388.5,1.483268983
NM_001763,CD1A,6,5,4133,2101,2032,406.4,350.1666667,0.967158496
NM_001042587,CD1E,4,3,3859,1450,2409,803,362.5,1.66137931
NM_001185108,CD1E,5,4,3859,1651,2208,552,330.2,1.33737129
NM_001185107,CD1E,5,4,3859,1852,2007,501.75,370.4,1.083693305
NM_001185110,CD1E,4,3,3859,1353,2506,835.3333333,338.25,1.85218034
NM_001764,CD1B,6,5,3583,1402,2181,436.2,233.6666667,1.555634807
NM_001765,CD1C,6,5,5003,2598,2405,481,433,0.925712086
NM_001004476,OR10K2,1,0,940,940,NA,NA,940,NA
NM_001004475,OR10T2,1,0,946,946,NA,NA,946,NA
NM_001004473,OR10K1,1,0,943,943,NA,NA,943,NA
NM_001004472,OR10R2,1,0,1009,1009,NA,NA,1009,NA
NM_001160325,OR6P1,1,0,955,955,NA,NA,955,NA
NM_001005189,OR6Y1,1,0,979,979,NA,NA,979,NA
NM_001004478,OR10Z1,1,0,943,943,NA,NA,943,NA
NM_001004477,OR10X1,1,0,982,982,NA,NA,982,NA
NM_001005327,OR6K3,1,0,949,949,NA,NA,949,NA
NM_001005279,OR6K2,1,0,976,976,NA,NA,976,NA
NM_001005184,OR6K6,1,0,1033,1033,NA,NA,1033,NA
NM_002432,MNDA,7,6,18104,1674,16430,2738.333333,239.1428571,9.814814815
NM_001005185,OR6N1,1,0,940,940,NA,NA,940,NA
NM_001005278,OR6N2,1,0,955,955,NA,NA,955,NA
NM_198929,PYHIN1,8,7,45514,1976,43538,6219.714286,247,22.03340081
NM_198928,PYHIN1,9,8,45514,2075,43439,5429.875,230.5555556,20.93445783
NM_198930,PYHIN1,8,7,45514,1949,43565,6223.571429,243.625,22.35248846
NM_152501,PYHIN1,9,8,45514,2102,43412,5426.5,233.5555556,20.6527117
NM_004833,AIM2,6,5,14374,1490,12884,2576.8,248.3333333,8.646979866
NM_001122951,DARC,1,0,1243,1243,NA,NA,1243,NA
NM_021189,CADM3,10,9,31557,3708,27849,3094.333333,370.8,7.510517799
NM_002036,DARC,2,1,2489,2010,479,479,1005,0.238308458
NM_001127173,CADM3,9,8,31520,3568,27952,3494,396.4444444,7.834080717
NM_002001,FCER1A,6,5,18512,1171,17341,3468.2,195.1666667,14.8087105
NM_001004467,OR10J3,1,0,991,991,NA,NA,991,NA
NM_012351,OR10J1,1,0,1090,1090,NA,NA,1090,NA
NM_001004469,OR10J5,1,0,931,931,NA,NA,931,NA
NM_001639,APCS,2,1,1047,933,114,114,466.5,0.122186495
NM_000567,CRP,2,1,2302,2017,285,285,1008.5,0.141298959
NM_017823,DUSP23,3,2,1576,688,888,444,229.3333333,1.290697674
NM_001277223,TAGLN2,5,4,6446,1384,5062,1265.5,276.8,3.657514451
NM_001277224,TAGLN2,5,4,5612,1608,4004,1001,321.6,2.490049751
NM_001134233,C1orf204,6,5,20875,2507,18368,3673.6,417.8333333,7.326685281
NM_012337,CCDC19,12,11,27754,1807,25947,2358.818182,150.5833333,14.35915883
NM_001013661,VSIG8,7,6,8343,1825,6518,1086.333333,260.7142857,3.571506849
NM_020125,SLAMF8,5,4,10805,3305,7500,1875,661,2.269288956
NM_003564,TAGLN2,5,4,7437,1419,6018,1504.5,283.8,4.241014799
NM_145167,PIGM,1,0,4323,4323,NA,NA,4323,NA
NM_033438,SLAMF9,4,3,2764,1160,1604,534.6666667,290,1.382758621
NM_001146173,SLAMF9,3,2,2764,750,2014,1007,250,2.685333333
NM_001146172,SLAMF9,3,2,2764,886,1878,939,295.3333333,2.119638826
NM_052868,IGSF8,7,6,7312,2311,5001,833.5,330.1428571,2.163998269
NM_144699,ATP1A4,22,21,35417,3869,31548,1502.285714,175.8636364,8.154044973
NM_000702,ATP1A2,23,22,27856,5480,22376,1017.090909,238.2608696,4.083211679
NM_001206665,IGSF8,8,7,7491,2210,5281,754.4285714,276.25,2.38959276
NM_004983,KCNJ9,3,2,7854,3032,4822,2411,1010.666667,1.590369393
NM_001001734,ATP1A4,5,4,9568,891,8677,2169.25,178.2,9.738496072
NM_015726,DCAF8,14,13,46847,3897,42950,3303.846154,278.3571429,11.02129843
NM_002857,PEX19,8,7,8344,3677,4667,666.7142857,459.625,1.269241229
NM_003768,PEA15,4,3,10039,2473,7566,2522,618.25,3.059441973
NM_001193644,PEX19,8,7,8344,3625,4719,674.1428571,453.125,1.301793103
NM_015331,NCSTN,17,16,15681,2952,12729,795.5625,173.6470588,4.31199187
NM_005598,NHLH1,2,1,5779,2561,3218,3218,1280.5,1.256540414
NM_020335,VANGL2,8,7,28106,5360,22746,3249.428571,670,4.243656716
NM_001184882,CD84,6,5,38424,7892,30532,6106.4,1315.333333,3.868727826
NM_001184881,CD84,6,5,38424,8136,30288,6057.6,1356,3.722713864
NM_052931,SLAMF6,8,7,38234,2751,35483,5069,343.875,12.89821883
NM_001184879,CD84,8,7,38424,8287,30137,4305.285714,1035.875,3.636659829
NM_001184716,SLAMF6,7,6,38234,2420,35814,5969,345.7142857,14.79917355
NM_001184715,SLAMF6,8,7,38234,2604,35630,5090,325.5,13.6827957
NM_001184714,SLAMF6,8,7,38234,2754,35480,5068.571429,344.25,12.88307916
NM_003874,CD84,7,6,38424,8235,30189,5031.5,1176.428571,3.665938069
NM_001778,CD48,4,3,33107,1130,31977,10659,282.5,28.29823009
NM_001256030,CD48,3,2,31431,1523,29908,14954,507.6666667,19.63755745
NM_003037,SLAMF1,7,6,37494,2310,35184,5864,330,15.23116883
NM_002348,LY9,10,9,32183,2531,29652,3294.666667,253.1,11.71552746
NM_001282595,SLAMF7,6,5,15763,2361,13402,2680.4,393.5,5.676408302
NM_021181,SLAMF7,7,6,15763,2901,12862,2143.666667,414.4285714,4.433643571
NM_001282596,SLAMF7,5,4,15763,2474,13289,3322.25,494.8,5.371463217
NM_001033667,LY9,3,2,6674,1528,5146,2573,509.3333333,3.367801047
NM_001261457,LY9,9,8,32183,2260,29923,3740.375,251.1111111,13.24026549
NM_001261456,LY9,10,9,32183,2489,29694,3299.333333,248.9,11.93009241
NM_001282589,SLAMF7,5,4,15763,2506,13257,3314.25,501.2,5.290103751
NM_001282588,SLAMF7,4,3,15763,2401,13362,4454,600.25,5.565181175
NM_001282590,SLAMF7,6,5,15763,2579,13184,2636.8,429.8333333,5.112058938
NM_001282594,SLAMF7,6,5,15763,2618,13145,2629,436.3333333,5.021008403
NM_001282593,SLAMF7,4,3,15763,2353,13410,4470,588.25,5.699107522
NM_001282592,SLAMF7,6,5,15763,2796,12967,2593.4,466,4.63769671
NM_001282591,SLAMF7,5,4,15763,2458,13305,3326.25,491.6,5.412937347
NM_080878,ITLN2,8,7,9775,1158,8617,1231,144.75,7.441278066
NM_017625,ITLN1,8,7,8632,1190,7442,1063.142857,148.75,6.253781513
NM_001025598,ARHGAP30,12,11,23030,4437,18593,1690.272727,369.75,4.190443994
NM_007122,USF1,11,10,6730,1820,4910,491,165.4545455,2.697802198
NM_001276373,USF1,11,10,5688,1724,3964,396.4,156.7272727,2.299303944
NM_030916,PVRL4,9,8,18606,3511,15095,1886.875,390.1111111,4.299344916
NM_001287600,ARHGAP30,11,10,23030,4291,18739,1873.9,390.0909091,4.367047308
NM_001287602,ARHGAP30,8,7,23030,3902,19128,2732.571429,487.75,4.902101486
NM_001007255,KLHDC9,4,3,1959,1342,617,205.6666667,335.5,0.45976155
NM_152366,KLHDC9,4,3,1959,1323,636,212,330.75,0.480725624
NM_016946,F11R,10,9,26134,4840,21294,2366,484,4.399586777
NM_001113207,TSTD1,4,3,1354,590,764,254.6666667,147.5,1.294915254
NM_001113206,TSTD1,3,2,1354,466,888,444,155.3333333,1.905579399
NM_001113205,TSTD1,3,2,1354,675,679,339.5,225,1.005925926
NM_207005,USF1,11,10,6730,1789,4941,494.1,162.6363636,2.761878144
NM_181720,ARHGAP30,13,12,23030,3805,19225,1602.083333,292.6923077,5.052562418
NM_001014443,USP21,14,13,6264,2368,3896,299.6923077,169.1428571,1.64527027
NM_016406,UFC1,6,5,5114,1128,3986,797.2,188,3.533687943
NM_001185094,NIT1,7,6,3078,1526,1552,258.6666667,218,1.017038008
NM_001185093,NIT1,6,5,3079,1756,1323,264.6,292.6666667,0.753416856
NM_001185092,NIT1,7,6,7375,2134,5241,873.5,304.8571429,2.455951265
NM_005600,NIT1,7,6,3124,1525,1599,266.5,217.8571429,1.04852459
NM_001039712,DEDD,6,5,11489,2304,9185,1837,384,3.986545139
NM_001039711,DEDD,5,4,11711,2332,9379,2344.75,466.4,4.02186964
NM_001199874,B4GALT3,8,7,6660,2352,4308,615.4285714,294,1.831632653
NM_001122764,PPOX,13,12,4831,1781,3050,254.1666667,137,1.712521056
NM_001199873,B4GALT3,8,7,6660,2423,4237,605.2857143,302.875,1.748658688
NM_001286374,TOMM40L,8,7,4809,2724,2085,297.8571429,340.5,0.765418502
NM_001286373,TOMM40L,9,8,4809,2818,1991,248.875,313.1111111,0.706529454
NM_012475,USP21,13,12,6264,2226,4038,336.5,171.2307692,1.814016173
NM_005099,ADAMTS4,9,8,9309,4341,4968,621,482.3333333,1.144436766
NM_032174,TOMM40L,10,9,4809,2921,1888,209.7777778,292.1,0.646353988
NM_001077481,NR1I3,8,7,8546,1287,7259,1037,160.875,5.64024864
NM_001077482,NR1I3,9,8,8546,1417,7129,891.125,157.4444444,5.031051517
NM_001077476,NR1I3,8,7,8546,1110,7436,1062.285714,138.75,6.699099099
NM_001077475,NR1I3,7,6,8546,977,7569,1261.5,139.5714286,7.747185261
NM_001077474,NR1I3,8,7,8546,1118,7428,1061.142857,139.75,6.644007156
NM_001077473,NR1I3,8,7,8546,1122,7424,1060.571429,140.25,6.616755793
NM_001077479,NR1I3,8,7,8546,1249,7297,1042.428571,156.125,5.842273819
NM_001077480,NR1I3,9,8,8546,1402,7144,893,155.7777778,5.095577746
NM_001077478,NR1I3,9,8,8546,1248,7298,912.25,138.6666667,5.84775641
NM_001077477,NR1I3,8,7,8546,1095,7451,1064.428571,136.875,6.80456621
NM_001077469,NR1I3,9,8,8546,1251,7295,911.875,139,5.831334932
NM_001077470,NR1I3,7,6,8546,1131,7415,1235.833333,161.5714286,6.556145004
NM_001077472,NR1I3,8,7,8546,1264,7282,1040.285714,158,5.761075949
NM_001077471,NR1I3,8,7,8546,1272,7274,1039.142857,159,5.718553459
NM_001643,APOA2,4,3,1337,477,860,286.6666667,119.25,1.80293501
NM_000309,PPOX,13,12,4831,1720,3111,259.25,132.3076923,1.80872093
NM_001166159,NDUFS2,13,12,12249,2079,10170,847.5,159.9230769,4.891774892
NM_032998,DEDD,6,5,11711,2366,9345,1869,394.3333333,3.949704142
NM_005122,NR1I3,9,8,8546,1390,7156,894.5,154.4444444,5.148201439
NM_004550,NDUFS2,15,14,15081,2056,13025,930.3571429,137.0666667,6.335116732
NM_003779,B4GALT3,8,7,6660,2402,4258,608.2857143,300.25,1.772689425
NM_004106,FCER1G,5,4,3953,596,3357,839.25,119.2,5.632550336
NM_003001,SDHC,6,5,50371,2858,47513,9502.6,476.3333333,16.62456263
NM_001102566,PCP4L1,3,2,26725,1427,25298,12649,475.6666667,17.72810091
NM_001035513,SDHC,4,3,50371,2697,47674,15891.33333,674.25,17.67667779
NM_001035512,SDHC,5,4,50371,2755,47616,11904,551,17.28348457
NM_001013625,C1orf192,5,4,3154,788,2366,591.5,157.6,3.002538071
NM_001278172,SDHC,4,3,50371,2590,47781,15927,647.5,18.44826255
NM_000530,MPZ,6,5,5239,1961,3278,655.6,326.8333333,1.671596124
NM_001035511,SDHC,5,4,50371,2693,47678,11919.5,538.6,17.70441886
NM_001127596,FCGR3A,6,5,8864,2156,6708,1341.6,359.3333333,3.111317254
NM_001127595,FCGR3A,6,5,8864,2159,6705,1341,359.8333333,3.105604447
NM_001127593,FCGR3A,6,5,8864,2177,6687,1337.4,362.8333333,3.071658245
NM_001127592,FCGR3A,5,4,8269,2310,5959,1489.75,462,2.57965368
NM_001271035,FCGR3B,5,4,8266,2389,5877,1469.25,477.8,2.460025115
NM_000570,FCGR3B,6,5,8767,2147,6620,1324,357.8333333,3.083372147
NM_001244753,FCGR3B,5,4,8266,2392,5874,1468.5,478.4,2.455685619
NM_002155,HSPA6,1,0,2653,2653,NA,NA,2653,NA
NM_001271037,FCGR3B,4,3,7851,1999,5852,1950.666667,499.75,2.927463732
NM_000569,FCGR3A,5,4,8269,2313,5956,1489,462.6,2.575010808
NM_001271036,FCGR3B,5,4,7851,2258,5593,1398.25,451.6,2.476970771
NM_201563,FCGR2C,7,6,18905,1517,17388,2898,216.7142857,11.46209624
NM_001184871,FCRLA,2,1,7382,1642,5740,5740,821,3.495736906
NM_004001,FCGR2B,8,7,15541,2169,13372,1910.285714,271.125,6.16505302
NM_001288832,FCRLB,5,4,5492,1662,3830,957.5,332.4,2.304452467
NM_032738,FCRLA,5,4,7382,2350,5032,1258,470,2.141276596
NM_007240,DUSP12,6,5,7373,1255,6118,1223.6,209.1666667,4.874900398
NM_001184873,FCRLA,3,2,7382,1796,5586,2793,598.6666667,3.110244989
NM_001184872,FCRLA,3,2,7382,1928,5454,2727,642.6666667,2.828838174
NM_001184870,FCRLA,4,3,7382,1947,5435,1811.666667,486.75,2.791474063
NM_001184867,FCRLA,4,3,7382,2082,5300,1766.666667,520.5,2.545629203
NM_001184866,FCRLA,6,5,7382,2369,5013,1002.6,394.8333333,2.116082735
NM_001190828,FCGR2B,7,6,15541,2147,13394,2232.333333,306.7142857,6.238472287
NM_001288830,FCRLB,5,4,5492,1621,3871,967.75,324.2,2.388032079
NM_001002901,FCRLB,8,7,6601,2004,4597,656.7142857,250.5,2.293912176
NM_001288829,FCRLB,6,5,5492,1643,3849,769.8,273.8333333,2.342665855
NM_001288831,FCRLB,6,5,5492,1684,3808,761.6,280.6666667,2.26128266
NM_001002275,FCGR2B,8,7,15541,2166,13375,1910.714286,270.75,6.174976916
NM_001002274,FCGR2B,7,6,15541,2111,13430,2238.333333,301.5714286,6.361913785
NM_001002273,FCGR2B,7,6,15541,2108,13433,2238.833333,301.1428571,6.372390892
NM_015441,OLFML2B,8,7,40664,3168,37496,5356.571429,396,11.83585859
NM_001085375,C1orf226,2,1,5090,4128,962,962,2064,0.233042636
NM_001135240,C1orf226,3,2,4807,987,3820,1910,329,3.870314083
NM_053282,SH2D1B,4,3,16874,2539,14335,4778.333333,634.75,5.645923592
NM_001126060,NOS1AP,2,1,7042,5561,1481,1481,2780.5,0.266319007
NM_182581,C1orf111,3,2,3131,1176,1955,977.5,392,1.662414966
NM_001184763,UHMK1,8,7,32457,8202,24255,3465,1025.25,2.95720556
NM_144624,UHMK1,7,6,31826,8453,23373,3895.5,1207.571429,2.765053827
NM_175866,UHMK1,8,7,31826,8543,23283,3326.142857,1067.875,2.725389208
NM_003115,UAP1,10,9,38339,2337,36002,4000.222222,233.7,15.40522037
NM_016371,HSD17B7,9,8,22114,1528,20586,2573.25,169.7777778,13.47251309
NM_178550,C1orf110,4,3,14520,1556,12964,4321.333333,389,8.331619537
NM_005613,RGS4,5,4,7830,3376,4454,1113.5,675.2,1.319312796
NM_001102445,RGS4,6,5,8198,3486,4712,942.4,581,1.351692484
NM_001113380,RGS4,5,4,4899,3060,1839,459.75,612,0.600980392
NM_001113381,RGS4,4,3,7550,2928,4622,1540.666667,732,1.578551913
NM_001195303,RGS5,3,2,60876,5757,55119,27559.5,1919,9.574257426
NM_001254749,RGS5,5,4,60876,5944,54932,13733,1188.8,9.241588156
NM_003617,RGS5,5,4,60876,5932,54944,13736,1186.4,9.262306136
NM_001256571,RXRG,9,8,24064,1679,22385,2798.125,186.5555556,13.33234068
NM_001005214,LRRC52,2,1,19709,1124,18585,18585,562,16.53469751
NM_000696,ALDH9A1,11,10,36453,2511,33942,3394.2,228.2727273,13.51732378
NM_004528,MGST3,6,5,25264,1524,23740,4748,254,15.57742782
NM_001256164,TMCO1,7,6,44633,4375,40258,6709.666667,625,9.201828571
NM_001256165,TMCO1,7,6,44633,4677,39956,6659.333333,668.1428571,8.543083173
NM_019026,TMCO1,7,6,44633,4477,40156,6692.666667,639.5714286,8.969399151
NM_053053,TADA1,8,7,19907,2255,17652,2521.714286,281.875,7.827937916
NM_017542,POGK,6,5,14987,3858,11129,2225.8,643,2.884655262
NM_199351,ILDR2,10,9,62122,8137,53985,5998.333333,813.7,6.634509033
NM_005814,GPA33,7,6,37788,2800,34988,5831.333333,400,12.49571429
NM_001080426,DUSP27,5,4,34317,4039,30278,7569.5,807.8,7.496410002
NM_198053,CD247,8,7,87972,1689,86283,12326.14286,211.125,51.08525755
NM_000734,CD247,8,7,87972,1686,86286,12326.57143,210.75,51.17793594
NM_003851,CREG1,4,3,12807,2029,10778,3592.666667,507.25,5.311976343
NM_003953,MPZL1,6,5,69971,5016,64955,12991,836,12.9495614
NM_024569,MPZL1,5,4,69971,4912,65059,16264.75,982.4,13.24491042
NM_001146191,MPZL1,3,2,69971,4563,65408,32704,1521,14.3344291
NM_018417,ADCY10,33,32,104830,5454,99376,3105.5,165.2727273,18.22075541
NM_001167749,ADCY10,30,29,104830,4996,99834,3442.551724,166.5333333,19.98278623
NM_001031800,TIPRL,5,4,13552,942,12610,3152.5,188.4,13.38641189
NM_001267612,GPR161,6,5,56896,7769,49127,9825.4,1294.833333,6.323465053
NM_001267614,GPR161,5,4,58033,7394,50639,12659.75,1478.8,6.848661077
NM_001267613,GPR161,5,4,57167,7661,49506,12376.5,1532.2,6.462080668
NM_001267611,GPR161,6,5,58033,7813,50220,10044,1302.166667,6.427748624
NM_001267610,GPR161,7,6,58127,8227,49900,8316.666667,1175.285714,6.065394433
NM_001267609,GPR161,7,6,58127,8264,49863,8310.5,1180.571429,6.033760891
NM_153832,GPR161,8,7,57167,8222,48945,6992.142857,1027.75,5.95293116
NM_199344,SFT2D2,8,7,16835,864,15971,2281.571429,108,18.4849537
NM_005149,TBX19,8,7,33388,2830,30558,4365.428571,353.75,10.79787986
NM_003175,XCL2,3,2,3234,568,2666,1333,189.3333333,4.693661972
NM_002995,XCL1,3,2,5606,1370,4236,2118,456.6666667,3.091970803
NM_021179,CCDC181,6,5,32558,1872,30686,6137.2,312,16.39209402
NM_006996,SLC19A2,6,5,22061,3642,18419,3683.8,607,5.057386052
NM_000130,F5,25,24,74579,9204,65375,2723.958333,368.16,7.102890048
NM_003005,SELP,17,16,41291,3188,38103,2381.4375,187.5294118,11.95200753
NM_000655,SELL,9,8,21039,2451,18588,2323.5,272.3333333,7.583843329
NM_000450,SELE,14,13,11441,3889,7552,580.9230769,277.7857143,1.941887375
NM_018186,C1orf112,24,23,57681,3387,54294,2360.608696,141.125,16.03011515
NM_181093,SCYL3,14,13,40887,3104,37783,2906.384615,221.7142857,12.17235825
NM_033418,METTL18,2,1,2393,1477,916,916,738.5,0.620176032
NM_020423,SCYL3,13,12,40887,2941,37946,3162.166667,226.2307692,12.90241414
NM_152281,GORAB,5,4,21713,2588,19125,4781.25,517.6,7.389876352
NM_001146039,GORAB,4,3,13668,1711,11957,3985.666667,427.75,6.988310929
NM_006894,FMO3,9,8,26943,2079,24864,3108,231,11.95959596
NM_001002294,FMO3,9,8,26943,2096,24847,3105.875,232.8888889,11.85448473
NM_001282692,FMO1,8,7,28057,2206,25851,3693,275.75,11.71849501
NM_001282693,FMO1,9,8,37509,2201,35308,4413.5,244.5555556,16.04179918
NM_001282694,FMO1,8,7,37509,2011,35498,5071.142857,251.375,17.65191447
NM_002021,FMO1,9,8,37509,2192,35317,4414.625,243.5555556,16.11177007
NM_015172,PRRC2C,34,33,107986,10418,97568,2956.606061,306.4117647,9.365329238
NM_000261,MYOC,3,2,17218,2048,15170,7585,682.6666667,7.407226563
NM_015935,METTL13,8,7,16097,3415,12682,1811.714286,426.875,3.713616398
NM_014955,METTL13,8,7,16097,3090,13007,1858.142857,386.25,4.209385113
NM_001007239,METTL13,8,7,16097,2947,13150,1878.571429,368.375,4.462164913
NM_002642,PIGC,2,1,2635,1502,1133,1133,751,0.754327563
NM_139240,C1orf105,7,6,48143,992,47151,7858.5,141.7142857,47.53125
NM_153747,PIGC,2,1,2635,1479,1156,1156,739.5,0.781609195
NM_001282751,SUCO,22,21,78719,5521,73198,3485.619048,250.9545455,13.25810542
NM_014283,SUCO,24,23,78719,5683,73036,3175.478261,236.7916667,12.85166285
NM_001282750,SUCO,23,22,78719,4569,74150,3370.454545,198.6521739,16.22893412
NM_016227,SUCO,23,22,79488,5941,73547,3343.045455,258.3043478,12.37956573
NM_000639,FASLG,4,3,7829,1863,5966,1988.666667,465.75,3.202361782
NM_003326,TNFSF4,3,2,23603,3496,20107,10053.5,1165.333333,5.751430206
NM_004905,PRDX6,5,4,11462,1675,9787,2446.75,335,5.842985075
NM_001195190,LOC730159,2,1,1613,633,980,980,316.5,1.548183254
NM_198493,ANKRD45,6,5,61528,2677,58851,11770.2,446.1666667,21.98393724
NM_001171182,CENPL,5,4,24584,2152,22432,5608,430.4,10.42379182
NM_014458,KLHL20,12,11,71762,3476,68286,6207.818182,289.6666667,19.64499425
NM_033319,CENPL,6,5,25091,2542,22549,4509.8,423.6666667,8.870574351
NM_001127181,CENPL,7,6,25091,2681,22410,3735,383,8.358821335
NM_032522,ZBTB37,4,3,5287,1374,3913,1304.333333,343.5,2.847889374
NM_001122770,ZBTB37,5,4,18283,2305,15978,3994.5,461,6.931887202
NM_000488,SERPINC1,7,6,13576,1606,11970,1995,229.4285714,7.453300125
NM_005684,GPR52,1,0,1473,1473,NA,NA,1473,NA
NM_001243764,RABGAP1L,7,6,30542,6255,24287,4047.833333,893.5714286,3.882813749
NM_022100,MRPS14,3,2,10499,2148,8351,4175.5,716,3.887802607
NM_014656,KIAA0040,4,3,35828,4588,31240,10413.33333,1147,6.809067132
NM_001162895,KIAA0040,3,2,35828,4513,31315,15657.5,1504.333333,6.938843341
NM_001162894,KIAA0040,4,3,36108,4648,31460,10486.66667,1162,6.768502582
NM_001162893,KIAA0040,5,4,36108,4726,31382,7845.5,945.2,6.64028777
NM_033127,SEC16B,26,25,40810,4050,36760,1470.4,155.7692308,9.07654321
NM_032126,TEX35,9,8,9579,1037,8542,1067.75,115.2222222,8.237222758
NM_001170723,TEX35,9,8,8736,847,7889,986.125,94.11111111,9.314049587
NM_001170724,TEX35,9,8,10425,906,9519,1189.875,100.6666667,10.50662252
NM_001170722,TEX35,9,8,10425,930,9495,1186.875,103.3333333,10.20967742
NM_004673,ANGPTL1,6,5,21547,3552,17995,3599,592,5.06615991
NM_022371,TOR3A,6,5,14019,2128,11891,2378.2,354.6666667,5.58787594
NM_001168239,ABL2,12,11,43764,11580,32184,2925.818182,965,2.779274611
NM_001136000,ABL2,13,12,43764,11644,32120,2676.666667,895.6923077,2.758502233
NM_005158,ABL2,12,11,43764,11952,31812,2892,996,2.661646586
NM_014625,NPHS2,8,7,25412,1879,23533,3361.857143,234.875,12.52421501
NM_001199092,TDRD5,14,13,85047,2492,82555,6350.384615,178,33.12800963
NM_173509,FAM163A,5,4,73037,2914,70123,17530.75,582.8,24.06417296
NM_015602,TOR1AIP1,10,9,38037,4061,33976,3775.111111,406.1,8.366412214
NM_001267578,TOR1AIP1,10,9,38037,4064,33973,3774.777778,406.4,8.359498031
NM_002826,QSOX1,12,11,43203,3328,39875,3625,277.3333333,11.98167067
NM_001004128,QSOX1,13,12,43203,2596,40607,3383.916667,199.6923077,15.64214176
NM_020950,KIAA1614,9,8,32928,4164,28764,3595.5,462.6666667,6.90778098
NM_005819,STX6,8,7,50409,5080,45329,6475.571429,635,8.923031496
NM_001286210,STX6,6,5,50409,4813,45596,9119.2,802.1666667,9.473509246
NM_016545,IER5,1,0,2343,2343,NA,NA,2343,NA
NM_001009992,ZNF648,2,1,7144,3651,3493,3493,1825.5,0.956724185
NM_002065,GLUL,8,7,10504,4728,5776,825.1428571,591,1.221658206
NM_001033044,GLUL,7,6,10504,4371,6133,1022.166667,624.4285714,1.403111416
NM_172000,TEDDM1,1,0,2501,2501,NA,NA,2501,NA
NM_001033056,GLUL,7,6,9702,4073,5629,938.1666667,581.8571429,1.382027989
NM_021133,RNASEL,7,6,15627,4248,11379,1896.5,606.8571429,2.678672316
NM_002928,RGS16,5,4,5792,2437,3355,838.75,487.4,1.376692655
NM_033345,RGS8,6,5,26277,789,25488,5097.6,131.5,32.30418251
NM_001102450,RGS8,7,6,26277,919,25358,4226.333333,131.2857143,27.59303591
NM_001200056,NPL,13,12,40937,2001,38936,3244.666667,153.9230769,19.45827086
NM_001200052,NPL,12,11,40937,2794,38143,3467.545455,232.8333333,13.65175376
NM_001200051,NPL,11,10,40937,1867,39070,3907,169.7272727,20.92662025
NM_030769,NPL,13,12,40937,2880,38057,3171.416667,221.5384615,13.21423611
NM_001200050,NPL,11,10,40937,3038,37899,3789.9,276.1818182,12.47498354
NM_030933,SHCBP1L,10,9,53555,2375,51180,5686.666667,237.5,21.54947368
NM_005562,LAMC2,23,22,59090,5646,53444,2429.272727,245.4782609,9.465816507
NM_018891,LAMC2,22,21,55234,4544,50690,2413.809524,206.5454545,11.15536972
NM_203454,APOBEC4,2,1,7039,2780,4259,4259,1390,1.532014388
NM_001190794,NCF2,14,13,35044,2291,32753,2519.461538,163.6428571,14.29637713
NM_001127651,NCF2,16,15,35361,2265,33096,2206.4,141.5625,14.61192053
NM_000433,NCF2,15,14,35044,2427,32617,2329.785714,161.8,13.43922538
NM_001270439,ARPC5,4,3,9750,2090,7660,2553.333333,522.5,3.66507177
NM_001190789,NCF2,13,12,35044,2182,32862,2738.5,167.8461538,15.06049496
NM_005717,ARPC5,4,3,9750,2081,7669,2556.333333,520.25,3.685247477
NM_015101,COLGALT2,12,11,101899,5194,96705,8791.363636,432.8333333,18.61859838
NM_007212,RNF2,7,6,57191,3558,53633,8938.833333,508.2857143,15.07391793
NM_030934,TRMT1L,15,14,38900,4422,34478,2462.714286,294.8,7.796924469
NM_001202423,TRMT1L,15,14,39014,4030,34984,2498.857143,268.6666667,8.6808933
NM_006469,IVNS1ABP,15,14,20941,4212,16729,1194.928571,280.8,3.971747388
NM_005807,PRG4,13,12,18285,5057,13228,1102.333333,389,2.615780107
NM_001127710,PRG4,10,9,18285,4652,13633,1514.777778,465.2,2.930567498
NM_001127709,PRG4,11,10,18285,4776,13509,1350.9,434.1818182,2.828517588
NM_001127708,PRG4,12,11,18285,4933,13352,1213.818182,411.0833333,2.70666937
NM_022375,OCLM,1,0,885,885,NA,NA,885,NA
NM_003292,TPR,51,50,63673,9757,53916,1078.32,191.3137255,5.525878856
NM_002597,PDC,4,3,17544,1232,16312,5437.333333,308,13.24025974
NM_022576,PDC,3,2,5160,1193,3967,1983.5,397.6666667,3.325230511
NM_001039152,RGS21,5,4,50294,1798,48496,12124,359.6,26.97219132
NM_002927,RGS13,7,6,24174,1569,22605,3767.5,224.1428571,14.40726577
NM_002922,RGS1,5,4,4304,1408,2896,724,281.6,2.056818182
NM_144766,RGS13,6,5,24174,1528,22646,4529.2,254.6666667,14.82068063
NM_002923,RGS2,5,4,3240,1355,1885,471.25,271,1.391143911
NM_001042370,TROVE2,10,9,31904,2090,29814,3312.666667,209,14.26507177
NM_001042369,TROVE2,10,9,31904,2049,29855,3317.222222,204.9,14.57052221
NM_015984,UCHL5,11,10,47029,5119,41910,4191,465.3636364,8.187145927
NM_001199263,UCHL5,11,10,40990,1502,39488,3948.8,136.5454545,26.29027963
NM_001199262,UCHL5,12,11,40990,1578,39412,3582.909091,131.5,24.97591888
NM_001199261,UCHL5,11,10,47029,5116,41913,4191.3,465.0909091,8.192533229
NM_001173525,TROVE2,11,10,31904,2102,29802,2980.2,191.0909091,14.17792578
NM_001173524,TROVE2,9,8,26565,3256,23309,2913.625,361.7777778,7.158783784
NM_004600,TROVE2,9,8,26113,3250,22863,2857.875,361.1111111,7.034769231
NM_003783,B3GALT2,2,1,7885,3550,4335,4335,1775,1.221126761
NM_000186,CFH,22,21,95628,4149,91479,4356.142857,188.5909091,22.04844541
NM_001014975,CFH,10,9,49689,1834,47855,5317.222222,183.4,26.09323882
NM_002113,CFHR1,6,5,12460,1303,11157,2231.4,217.1666667,8.562547966
NM_021023,CFHR3,6,5,19275,1646,17629,3525.8,274.3333333,10.71020656
NM_001166624,CFHR3,5,4,19275,1462,17813,4453.25,292.4,12.18399453
NM_030787,CFHR5,10,9,32138,2838,29300,3255.555556,283.8,10.32417195
NM_005666,CFHR2,5,4,15424,1041,14383,3595.75,208.2,13.81652257
NM_018136,ASPM,28,27,62569,10916,51653,1913.074074,389.8571429,4.731861488
NM_001206846,ASPM,27,26,62569,6160,56409,2169.576923,228.1481481,9.157305195
NM_001994,F13B,12,11,28078,2229,25849,2349.909091,185.75,11.59668013
NM_001195216,DENND1B,3,2,41486,2211,39275,19637.5,737,17.76345545
NM_001024594,C1orf53,3,2,4817,686,4131,2065.5,228.6666667,6.021865889
NM_001014434,LHX9,6,5,17640,2084,15556,3111.2,347.3333333,7.464491363
NM_020204,LHX9,5,4,12758,2520,10238,2559.5,504,4.062698413
NM_133326,ATP6V1G3,5,4,17725,683,17042,4260.5,136.6,24.95168375
NM_133262,ATP6V1G3,4,3,17725,636,17089,5696.333333,159,26.86949686
NM_001267798,PTPRC,4,3,56204,1471,54733,18244.33333,367.75,37.20802175
NM_001281293,ZNF281,2,1,5113,4892,221,221,2446,0.045175797
NM_001281294,ZNF281,3,2,5113,4785,328,164,1595,0.068547544
NM_012482,ZNF281,2,1,5113,4888,225,225,2444,0.046031097
NM_001031725,DDX59,8,7,25963,2328,23635,3376.428571,291,10.15249141
NM_001142569,C1orf106,10,9,20917,4215,16702,1855.777778,421.5,3.962514828
NM_018265,C1orf106,10,9,24239,4151,20088,2232,415.1,4.839315828
NM_005298,GPR25,1,0,1225,1225,NA,NA,1225,NA
NM_017596,KIF21B,34,33,54316,9935,44381,1344.878788,292.2058824,4.467136387
NM_001252103,KIF21B,34,33,54316,9319,44997,1363.545455,274.0882353,4.828522374
NM_001252102,KIF21B,35,34,54316,9359,44957,1322.264706,267.4,4.803611497
NM_001252100,KIF21B,35,34,54316,9975,44341,1304.147059,285,4.445213033
NM_016456,TMEM9,6,5,19786,1597,18189,3637.8,266.1666667,11.38948028
NM_001288565,TMEM9,5,4,19786,2081,17705,4426.25,416.2,8.50792888
NM_001288564,TMEM9,6,5,36813,1579,35234,7046.8,263.1666667,22.31412286
NM_001270601,ASCL5,1,0,1421,1421,NA,NA,1421,NA
NM_001288570,TMEM9,6,5,19786,1606,18180,3636,267.6666667,11.32004981
NM_001288568,TMEM9,6,5,19786,1732,18054,3610.8,288.6666667,10.42378753
NM_001288567,TMEM9,6,5,19786,1894,17892,3578.4,315.6666667,9.446673706
NM_001288566,TMEM9,6,5,19786,1680,18106,3621.2,280,10.77738095
NM_001288569,TMEM9,6,5,19786,1593,18193,3638.6,265.5,11.42059008
NM_001288571,TMEM9,6,5,19786,1672,18114,3622.8,278.6666667,10.83373206
NM_001005337,PKP1,14,13,49543,5398,44145,3395.769231,385.5714286,8.1780289
NM_000299,PKP1,15,14,49543,5462,44081,3148.642857,364.1333333,8.070487001
NM_001276347,TNNT2,16,15,18694,1310,17384,1158.933333,81.875,13.27022901
NM_001276345,TNNT2,17,16,18694,1208,17486,1092.875,71.05882353,14.47516556
NM_000364,TNNT2,16,15,18694,1198,17496,1166.4,74.875,14.60434057
NM_012396,PHLDA3,2,1,3679,1518,2161,2161,759,1.423583663
NM_001276346,TNNT2,15,14,18694,1077,17617,1258.357143,71.8,16.35747447
NM_005558,LAD1,10,9,18705,2849,15856,1761.777778,284.9,5.565461565
NM_003281,TNNI1,8,7,17981,6151,11830,1690,768.875,1.92326451
NM_001001432,TNNT2,14,13,18694,1157,17537,1349,82.64285714,15.15730337
NM_001001431,TNNT2,15,14,18694,1167,17527,1251.928571,77.8,15.01885176
NM_001001430,TNNT2,16,15,18694,1177,17517,1167.8,73.5625,14.88275276
NM_198149,SHISA4,5,4,3912,1658,2254,563.5,331.6,1.35946924
NM_006335,TIMM17A,6,5,15172,1665,13507,2701.4,277.5,8.112312312
NM_012134,LMOD1,3,2,50134,3970,46164,23082,1323.333333,11.62821159
NM_020216,RNPEP,11,10,23511,2424,21087,2108.7,220.3636364,8.699257426
NM_004767,GPR37L1,2,1,6607,2461,4146,4146,1230.5,1.684681024
NM_001199797,PTPN7,10,9,14577,2936,11641,1293.444444,293.6,3.964918256
NM_002832,PTPN7,10,9,14577,3782,10795,1199.444444,378.2,2.854309889
NM_080588,PTPN7,9,8,12980,3274,9706,1213.25,363.7777778,2.964569334
NM_014176,UBE2T,7,6,10311,915,9396,1566,130.7142857,10.26885246
NM_001136504,SYT2,9,8,52858,7622,45236,5654.5,846.8888889,5.934925216
NM_001197131,PPP1R12B,7,6,48457,8603,39854,6642.333333,1229,4.632570034
NM_002871,RABIF,2,1,10977,3229,7748,7748,1614.5,2.399504491
NM_021633,KLHL12,12,11,36143,3350,32793,2981.181818,279.1666667,9.788955224
NM_015999,ADIPOR1,8,7,17566,2183,15383,2197.571429,272.875,7.046724691
NM_016243,CYB5R1,9,8,5405,1652,3753,469.125,183.5555556,2.271791768
NM_138391,TMEM183A,8,7,16665,2228,14437,2062.428571,278.5,6.479802513
NM_001079809,TMEM183B,8,7,16134,1697,14437,2062.428571,212.125,8.50736594
NM_002479,MYOG,3,2,2911,1536,1375,687.5,512,0.895182292
NM_000674,ADORA1,4,3,39699,2923,36776,12258.66667,730.75,12.58159425
NM_001276,CHI3L1,10,9,7865,1847,6018,668.6666667,184.7,3.258256632
NM_001048230,ADORA1,3,2,39699,2767,36932,18466,922.3333333,13.34730755
NM_004997,MYBPH,11,10,8005,1817,6188,618.8,165.1818182,3.405613649
NM_006763,BTG2,2,1,4067,2713,1354,1354,1356.5,0.499078511
NM_003465,CHIT1,11,10,13655,2318,11337,1133.7,210.7272727,4.890854185
NM_001256125,CHIT1,10,9,13655,2260,11395,1266.111111,226,5.042035398
NM_001270509,CHIT1,11,10,13655,2183,11472,1147.2,198.4545455,5.255153459
NM_002023,FMOD,3,2,10810,3260,7550,3775,1086.666667,2.31595092
NM_201348,PRELP,3,2,15598,5812,9786,4893,1937.333333,1.683757743
NM_014359,OPTC,8,7,14808,1452,13356,1908,181.5,9.198347107
NM_002725,PRELP,3,2,15598,5822,9776,4888,1940.666667,1.679148059
NM_001282878,LAX1,5,4,6716,2843,3873,968.25,568.6,1.362293352
NM_001174108,ZBED6,1,0,2941,2941,NA,NA,2941,NA
NM_017773,LAX1,5,4,11198,3283,7915,1978.75,656.6,2.41090466
NM_001136190,LAX1,5,4,11198,3012,8186,2046.5,602.4,2.717795485
NM_003094,SNRPE,5,4,9542,1552,7990,1997.5,310.4,5.148195876
NM_198447,GOLT1A,5,4,15934,888,15046,3761.5,177.6,16.94369369
NM_002256,KISS1,3,2,6152,717,5435,2717.5,239,7.580195258
NM_018208,ETNK2,8,7,21119,2618,18501,2643,327.25,7.06684492
NM_000537,REN,10,9,11523,1475,10048,1116.444444,147.5,6.81220339
NM_002646,PIK3C2B,34,33,67718,7640,60078,1820.545455,224.7058824,7.863612565
NM_032833,PPP1R15B,2,1,8454,5277,3177,3177,2638.5,0.602046617
NM_002393,MDM4,11,10,41743,10088,31655,3165.5,917.0909091,3.137886598
NM_001278517,MDM4,8,7,41743,9791,31952,4564.571429,1223.875,3.263405168
NM_001278516,MDM4,10,9,41743,10019,31724,3524.888889,1001.9,3.166383871
NM_001278519,MDM4,5,4,41743,9413,32330,8082.5,1882.6,3.434611707
NM_001204172,MDM4,3,2,41743,9102,32641,16320.5,3034,3.586134915
NM_001204171,MDM4,10,9,41743,9937,31806,3534,993.7,3.200764818
NM_001278518,MDM4,7,6,41743,9605,32138,5356.333333,1372.142857,3.345965643
NM_001160331,NFASC,27,26,78598,9970,68628,2639.538462,369.2592593,6.883450351
NM_001193273,RBBP5,14,13,35882,4366,31516,2424.307692,311.8571429,7.218506642
NM_001193272,RBBP5,14,13,35882,4311,31571,2428.538462,307.9285714,7.323358849
NM_203376,TMEM81,1,0,1333,1333,NA,NA,1333,NA
NM_005076,CNTN2,23,22,34833,7693,27140,1233.636364,334.4782609,3.527882491
NM_005057,RBBP5,14,13,35882,4425,31457,2419.769231,316.0714286,7.108926554
NM_001242925,TMCC2,5,4,44414,3345,41069,10267.25,669,12.27772795
NM_014858,TMCC2,5,4,45435,4009,41426,10356.5,801.8,10.33325019
NM_030952,NUAK2,7,6,19694,3408,16286,2714.333333,486.8571429,4.778755869
NM_018203,KLHDC8A,6,5,20937,3050,17887,3577.4,508.3333333,5.864590164
NM_001271865,KLHDC8A,8,7,21027,2939,18088,2584,367.375,6.154474311
NM_001271864,KLHDC8A,7,6,21027,2723,18304,3050.666667,389,6.721997797
NM_001271863,KLHDC8A,9,8,21027,3265,17762,2220.25,362.7777778,5.440122511
NM_212503,CDK18,16,15,28239,3208,25031,1668.733333,200.5,7.802680798
NM_002596,CDK18,16,15,28239,3200,25039,1669.266667,200,7.8246875
NM_212502,CDK18,16,15,28239,3118,25121,1674.733333,194.875,8.056767158
NM_001973,ELK4,5,4,24931,11154,13777,3444.25,2230.8,1.235162274
NM_033102,SLC45A3,5,4,22651,3387,19264,4816,677.4,5.68762917
NM_181644,MFSD4,10,9,33936,4098,29838,3315.333333,409.8,7.281112738
NM_021795,ELK4,3,2,13606,3031,10575,5287.5,1010.333333,3.488947542
NM_001135664,RAB7L1,5,4,7498,3059,4439,1109.75,611.8,1.45112782
NM_001135663,RAB7L1,4,3,7498,3426,4072,1357.333333,856.5,1.188558085
NM_022731,NUCKS1,7,6,37427,6471,30956,5159.333333,924.4285714,4.783804667
NM_001135662,RAB7L1,6,5,7498,3213,4285,857,535.5,1.333644569
NM_003929,RAB7L1,6,5,7498,3314,4184,836.8,552.3333333,1.262522631
NM_173854,SLC41A1,11,10,23942,4865,19077,1907.7,442.2727273,3.921274409
NM_052934,SLC26A9,21,20,30413,4819,25594,1279.7,229.4761905,5.311060386
NM_152491,PM20D1,13,12,22128,2196,19932,1661,168.9230769,9.076502732
NM_134325,SLC26A9,22,21,30413,4643,25770,1227.142857,211.0454545,5.55029076
NM_001123168,FAM72A,4,3,16165,1871,14294,4764.666667,467.75,7.639764832
NM_001287385,FAM72C,4,3,16636,2342,14294,4764.666667,585.5,6.103330487
NM_001007544,C1orf186,6,5,49356,1250,48106,9621.2,208.3333333,38.4848
NM_000707,AVPR1B,2,1,7201,1775,5426,5426,887.5,3.056901408
NM_001910,CTSE,9,8,14647,2237,12410,1551.25,248.5555556,5.547608404
NM_148964,CTSE,8,7,14647,2094,12553,1793.285714,261.75,5.994746896
NM_001193321,IKBKE,21,20,26639,3376,23263,1163.15,160.7619048,6.890699052
NM_014002,IKBKE,22,21,26639,3496,23143,1102.047619,158.9090909,6.619851259
NM_001193322,IKBKE,21,20,26639,3382,23257,1162.85,161.047619,6.876700177
NM_006893,EIF2D,15,14,20932,2112,18820,1344.285714,140.8,8.910984848
NM_003582,DYRK3,3,2,13663,2170,11493,5746.5,723.3333333,5.296313364
NM_001201478,EIF2D,13,12,20932,1738,19194,1599.5,133.6923077,11.04372842
NM_182665,RASSF5,5,4,32126,3519,28607,7151.75,703.8,8.129298096
NM_001004023,DYRK3,4,3,13663,2265,11398,3799.333333,566.25,5.032229581
NM_032960,MAPKAPK2,10,9,49267,2990,46277,5141.888889,299,15.47725753
NM_000572,IL10,5,4,4893,1634,3259,814.75,326.8,1.994492044
NM_004759,MAPKAPK2,10,9,49267,3527,45740,5082.222222,352.7,12.96852849
NM_001185158,IL24,5,4,6698,1626,5072,1268,325.2,3.119311193
NM_001185157,IL24,6,5,6698,1826,4872,974.4,304.3333333,2.668127054
NM_013371,IL19,7,6,14106,1839,12267,2044.5,262.7142857,6.670473083
NM_006850,IL24,7,6,6698,1983,4715,785.8333333,283.2857143,2.37771054
NM_153758,IL19,6,5,44113,1038,43075,8615,173,41.49807322
NM_018724,IL20,5,4,3416,1239,2177,544.25,247.8,1.757062147
NM_001185156,IL24,7,6,6698,1986,4712,785.3333333,283.7142857,2.372608258
NM_032029,FCAMR,7,6,12660,1988,10672,1778.666667,284,5.368209256
NM_001170631,FCAMR,8,7,12660,2791,9869,1409.857143,348.875,3.536008599
NM_023938,C1orf116,4,3,14237,5506,8731,2910.333333,1376.5,1.585724664
NM_002644,PIGR,11,10,17946,4286,13660,1366,389.6363636,3.187120859
NM_018566,YOD1,2,1,7230,6267,963,963,3133.5,0.153662039
NM_001083924,C1orf116,3,2,14237,5319,8918,4459,1773,1.676630946
NM_001122979,FCAMR,8,7,12660,1906,10754,1536.285714,238.25,5.642182581
NM_001018053,PFKFB2,15,14,27750,3544,24206,1729,236.2666667,6.83013544
NM_006212,PFKFB2,15,14,24544,7088,17456,1246.857143,472.5333333,2.46275395
NM_000716,C4BPB,6,5,10755,1121,9634,1926.8,186.8333333,8.5941124
NM_000715,C4BPA,12,11,40712,2255,38457,3496.090909,187.9166667,17.054102
NM_001017367,C4BPB,7,6,10711,958,9753,1625.5,136.8571429,10.18058455
NM_001017366,C4BPB,7,6,11127,956,10171,1695.166667,136.5714286,10.63912134
NM_001017365,C4BPB,7,6,11127,959,10168,1694.666667,137,10.60271116
NM_001017364,C4BPB,6,5,10755,1118,9637,1927.4,186.3333333,8.619856887
NM_001114752,CD55,11,10,39496,2925,36571,3657.1,265.9090909,12.50290598
NM_000574,CD55,10,9,39496,2806,36690,4076.666667,280.6,13.07555239
NM_001877,CR2,19,18,35597,4012,31585,1754.722222,211.1578947,7.872632104
NM_001006658,CR2,20,19,35597,4190,31407,1653,209.5,7.495704057
NM_153826,CD46,12,11,43480,3267,40213,3655.727273,272.25,12.30884604
NM_002389,CD46,14,13,43480,3407,40073,3082.538462,243.3571429,11.76196067
NM_172352,CD46,12,11,43480,3315,40165,3651.363636,276.25,12.11613876
NM_172350,CD46,10,9,43480,3156,40324,4480.444444,315.6,12.77693283
NM_172351,CD46,13,12,43480,3361,40119,3343.25,258.5384615,11.936626
NM_172353,CD46,11,10,43480,3221,40259,4025.9,292.8181818,12.49891338
NM_172359,CD46,13,12,43480,3313,40167,3347.25,254.8461538,12.12405675
NM_172361,CD46,10,9,43480,3178,40302,4478,317.8,12.68156073
NM_001025109,CD34,8,7,24802,2624,22178,3168.285714,328,8.451981707
NM_001773,CD34,8,7,24802,2819,21983,3140.428571,352.375,7.798155374
NM_001104548,MIR205HG,4,3,3726,894,2832,944,223.5,3.167785235
NM_001127641,LAMB3,23,22,37458,4058,33400,1518.181818,176.4347826,8.230655495
NM_000228,LAMB3,23,22,37604,4084,33520,1523.636364,177.5652174,8.207639569
NM_020439,CAMK1G,13,12,30241,2483,27758,2313.166667,191,11.17921869
NM_001017402,LAMB3,22,21,36463,4329,32134,1530.190476,196.7727273,7.422961423
NM_015714,G0S2,2,1,1067,965,102,102,482.5,0.105699482
NM_005525,HSD11B1,6,5,30161,1466,28695,5739,244.3333333,19.57366985
NM_152485,C1orf74,2,1,2230,1563,667,667,781.5,0.426743442
NM_181755,HSD11B1,7,6,48772,1447,47325,7887.5,206.7142857,32.70559779
NM_025228,TRAF3IP3,17,16,26293,2285,24008,1500.5,134.4117647,10.50678337
NM_001206741,HSD11B1,7,6,48772,1469,47303,7883.833333,209.8571429,32.20081688
NM_001287754,TRAF3IP3,7,6,11171,1073,10098,1683,153.2857143,9.410997204
NM_014388,DIEXF,12,11,29600,8498,21102,1918.363636,708.1666667,2.483172511
NM_019605,SERTAD4,4,3,10247,2012,8235,2745,503,4.092942346
NM_001136225,RCOR3,11,10,53949,1875,52074,5207.4,170.4545455,27.7728
NM_001136224,RCOR3,11,10,57019,4241,52778,5277.8,385.5454545,12.44470644
NM_001136223,RCOR3,12,11,57019,4484,52535,4775.909091,373.6666667,11.71610169
NM_145759,TRAF5,11,10,28582,3987,24595,2459.5,362.4545455,6.168798595
NM_018254,RCOR3,11,10,56438,4283,52155,5215.5,389.3636364,12.17721223
NM_001033910,TRAF5,11,10,48140,4012,44128,4412.8,364.7272727,10.99900299
NM_004619,TRAF5,11,10,48331,3987,44344,4434.4,362.4545455,11.12214698
NM_183059,RD3,3,2,16397,4269,12128,6064,1423,2.840946357
NM_001164688,RD3,3,2,16397,4266,12131,6065.5,1422,2.843647445
NM_021194,SLC30A1,2,1,3720,2020,1700,1700,1010,0.841584158
NM_002497,NEK2,8,7,12860,2151,10709,1529.857143,268.875,4.978614598
NM_001204182,NEK2,8,7,17375,1726,15649,2235.571429,215.75,9.066628042
NM_001204183,NEK2,7,6,9201,1944,7257,1209.5,277.7142857,3.733024691
NM_001286230,DTL,14,13,69455,4485,64970,4997.692308,320.3571429,14.48606466
NM_016448,DTL,15,14,69455,4612,64843,4631.642857,307.4666667,14.05962706
NM_001286229,DTL,13,12,69455,4380,65075,5422.916667,336.9230769,14.85730594
NM_001198862,TMEM206,9,8,50429,2130,48299,6037.375,236.6666667,22.67558685
NM_001199756,PPP2R5A,13,12,60059,2673,57386,4782.166667,205.6153846,21.46876169
NM_018252,TMEM206,8,7,50453,1970,48483,6926.142857,246.25,24.6106599
NM_013349,NENF,4,3,13494,953,12541,4180.333333,238.25,13.15949633
NM_001030287,ATF3,4,3,55445,1926,53519,17839.66667,481.5,27.78764278
NM_001040619,ATF3,4,3,12151,2391,9760,3253.333333,597.75,4.081974069
NM_153606,FAM71A,1,0,2333,2333,NA,NA,2333,NA
NM_001674,ATF3,4,3,12151,2079,10072,3357.333333,519.75,4.844636845
NM_001206488,ATF3,4,3,12151,2056,10095,3365,514,4.910019455
NM_001206486,ATF3,4,3,5761,2001,3760,1253.333333,500.25,1.87906047
NM_001206484,ATF3,5,4,12151,2040,10111,2527.75,408,4.956372549
NM_001042552,TATDN3,10,9,24999,2598,22401,2489,259.8,8.622401848
NM_001042549,NSL1,7,6,65646,13227,52419,8736.5,1889.571429,3.963030166
NM_001146171,TATDN3,10,9,24999,2619,22380,2486.666667,261.9,8.545246277
NM_001146169,TATDN3,10,9,24999,2585,22414,2490.444444,258.5,8.670793037
NM_001146170,TATDN3,9,8,24999,2534,22465,2808.125,281.5555556,8.86543015
NM_015471,NSL1,6,5,65646,13141,52505,10501,2190.166667,3.995510235
NM_001042553,TATDN3,10,9,24999,2595,22404,2489.333333,259.5,8.633526012
NM_001024601,C1orf227,3,2,17508,507,17001,8500.5,169,33.53254438
NM_014053,FLVCR1,10,9,41110,5949,35161,3906.777778,594.9,5.91040511
NM_024749,VASH2,6,5,41042,4343,36699,7339.8,723.8333333,8.450149666
NM_001136474,VASH2,9,8,41042,4282,36760,4595,475.7777778,8.58477347
NM_001136475,VASH2,7,6,41042,3996,37046,6174.333333,570.8571429,9.270770771
NM_144567,ANGEL2,9,8,23646,4658,18988,2373.5,517.5555556,4.076427651
NM_020197,SMYD2,12,11,55914,1697,54217,4928.818182,141.4166667,31.94873306
NM_001135599,TGFB2,8,7,99287,5962,93325,13332.14286,745.25,15.65330426
NM_003238,TGFB2,7,6,99287,5877,93410,15568.33333,839.5714286,15.89416369
NM_138794,LYPLAL1,5,4,39017,1897,37120,9280,379.4,19.56773853
NM_018713,SLC30A10,4,3,14389,2858,11531,3843.666667,714.5,4.034639608
NM_006085,BPNT1,9,8,32373,2474,29899,3737.375,274.8888889,12.08528698
NM_018060,IARS2,23,22,53930,3572,50358,2289,155.3043478,14.09798432
NM_001286151,BPNT1,8,7,32373,2387,29986,4283.714286,298.375,12.56221198
NM_001286149,BPNT1,8,7,32373,2345,30028,4289.714286,293.125,12.80511727
NM_001286150,BPNT1,8,7,32373,2365,30008,4286.857143,295.625,12.68837209
NM_017898,Mar-02,8,7,35922,1581,34341,4905.857143,197.625,21.72106262
NM_024709,C1orf115,2,1,8873,2974,5899,5899,1487,1.983523874
NM_021958,HLX,4,3,5659,2282,3377,1125.666667,570.5,1.479842244
NM_001201536,TAF1A,12,11,32033,1978,30055,2732.272727,164.8333333,15.19464105
NM_005681,TAF1A,11,10,31627,1925,29702,2970.2,175,15.42961039
NM_024746,HHIPL2,9,8,25844,2583,23261,2907.625,287,9.005420054
NM_139352,TAF1A,11,10,32033,1807,30226,3022.6,164.2727273,16.72717211
NM_207468,FAM177B,6,5,13446,1351,12095,2419,225.1666667,8.952627683
NM_001288580,BROX,12,11,21877,3746,18131,1648.272727,312.1666667,4.840096103
NM_001288581,BROX,12,11,21877,3682,18195,1654.090909,306.8333333,4.941607822
NM_022831,AIDA,10,9,44511,3016,41495,4610.555556,301.6,13.75828912
NM_001288579,BROX,12,11,22645,4040,18605,1691.363636,336.6666667,4.60519802
NM_144695,BROX,13,12,22645,4137,18508,1542.333333,318.2307692,4.473773266
NM_003268,TLR5,6,5,33878,4273,29605,5921,712.1666667,6.92838755
NM_152610,C1orf65,1,0,2099,2099,NA,NA,2099,NA
NM_001748,CAPN2,21,20,63603,3509,60094,3004.7,167.0952381,17.12567683
NM_001146068,CAPN2,21,20,74427,3287,71140,3557,156.5238095,21.64283541
NM_001136115,FBXO28,4,3,47962,5259,42703,14234.33333,1314.75,8.119984788
NM_003676,DEGS1,3,2,10234,2066,8168,4084,688.6666667,3.953533398
NM_015176,FBXO28,5,4,47962,5456,42506,10626.5,1091.2,7.79068915
NM_206840,NVL,22,21,102857,2873,99984,4761.142857,130.5909091,34.80125305
NM_002533,NVL,23,22,102857,2948,99909,4541.318182,128.173913,33.89043419
NM_001243147,NVL,22,21,102857,2674,100183,4770.619048,121.5454545,37.46559461
NM_001243146,NVL,21,20,102857,2622,100235,5011.75,124.8571429,38.22845156
NM_025160,WDR26,14,13,49158,6886,42272,3251.692308,491.8571429,6.138832414
NM_001277198,CNIH4,5,4,20075,1554,18521,4630.25,310.8,11.91827542
NM_001277200,CNIH4,5,4,22642,894,21748,5437,178.8,24.32662192
NM_001277197,CNIH4,4,3,20075,1459,18616,6205.333333,364.75,12.75942426
NM_001277199,CNIH4,5,4,20075,1879,18196,4549,375.8,9.683874401
NM_014184,CNIH4,5,4,20075,1601,18474,4618.5,320.2,11.5390381
NM_001115113,WDR26,14,13,49158,6838,42320,3255.384615,488.4285714,6.188944136
NM_144989,DNAH14,7,6,38265,1111,37154,6192.333333,158.7142857,33.44194419
NM_002296,LBR,14,13,26613,3837,22776,1752,274.0714286,5.935887412
NM_194442,LBR,14,13,27355,3827,23528,1809.846154,273.3571429,6.147896525
NM_001136018,EPHX1,9,8,35467,1671,33796,4224.5,185.6666667,20.22501496
NM_020997,LEFTY1,4,3,2866,1630,1236,412,407.5,0.758282209
NM_000120,EPHX1,9,8,20262,1840,18422,2302.75,204.4444444,10.01195652
NM_014698,TMEM63A,25,24,37189,4478,32711,1362.958333,179.12,7.304823582
NM_001172425,LEFTY2,5,4,4787,2090,2697,674.25,418,1.290430622
NM_152608,SDE2,7,6,16665,4016,12649,2108.166667,573.7142857,3.149651394
NM_013328,PYCR2,7,6,4465,1778,2687,447.8333333,254,1.511248594
NM_003240,LEFTY2,4,3,4787,2191,2596,865.3333333,547.75,1.184847102
NM_001271681,PYCR2,6,5,4465,1555,2910,582,259.1666667,1.871382637
NM_002107,H3F3A,4,3,9297,1066,8231,2743.666667,266.5,7.721388368
NM_001282402,MIXL1,2,1,3439,2032,1407,1407,1016,0.69242126
NM_031944,MIXL1,2,1,3439,2008,1431,1431,1004,0.712649402
NM_001618,PARP1,23,22,47411,4008,43403,1972.863636,174.2608696,10.82909182
NM_012486,PSEN2,13,12,25533,2308,23225,1935.416667,177.5384615,10.06282496
NM_000447,PSEN2,13,12,25533,2311,23222,1935.166667,177.7692308,10.04846387
NM_001161465,JMJD4,6,5,4224,2553,1671,334.2,425.5,0.654524089
NM_023007,JMJD4,6,5,4224,2601,1623,324.6,433.5,0.623990773
NM_183062,PRSS38,5,4,30755,1248,29507,7376.75,249.6,23.64342949
NM_003395,WNT9A,4,3,26513,1244,25269,8423,311,20.31270096
NM_001024228,ARF1,5,4,16064,1990,14074,3518.5,398,7.072361809
NM_001024227,ARF1,5,4,16064,2012,14052,3513,402.4,6.984095427
NM_001024226,ARF1,5,4,16554,1978,14576,3644,395.6,7.369059656
NM_024319,C1orf35,8,7,2596,1298,1298,185.4285714,162.25,1
NM_181465,MRPL55,4,3,2635,582,2053,684.3333333,145.5,3.527491409
NM_181463,MRPL55,5,4,2635,762,1873,468.25,152.4,2.458005249
NM_181462,MRPL55,6,5,2635,871,1764,352.8,145.1666667,2.025258324
NM_181456,MRPL55,5,4,2635,733,1902,475.5,146.6,2.594815825
NM_181455,MRPL55,6,5,2635,692,1943,388.6,115.3333333,2.807803468
NM_181454,MRPL55,6,5,2635,689,1946,389.2,114.8333333,2.824383164
NM_181441,MRPL55,4,3,2635,694,1941,647,173.5,2.796829971
NM_001658,ARF1,5,4,16554,1893,14661,3665.25,378.6,7.744849445
NM_181464,MRPL55,5,4,2635,650,1985,496.25,130,3.053846154
NM_001159391,GUK1,8,7,4253,911,3342,477.4285714,113.875,3.668496158
NM_001242840,GUK1,7,6,8728,910,7818,1303,130,8.591208791
NM_001010867,IBA57,3,2,16531,7907,8624,4312,2635.666667,1.090679145
NM_020435,GJC2,2,1,10114,2383,7731,7731,1191.5,3.244229962
NM_000858,GUK1,9,8,8728,1163,7565,945.625,129.2222222,6.504729149
NM_001242839,GUK1,8,7,8872,937,7935,1133.571429,117.125,8.468516542
NM_001159390,GUK1,8,7,8728,997,7731,1104.428571,124.625,7.754262788
NM_003493,HIST3H3,1,0,482,482,NA,NA,482,NA
NM_001024940,TRIM17,7,6,8949,2056,6893,1148.833333,293.7142857,3.352626459
NM_033445,HIST3H2A,1,0,497,497,NA,NA,497,NA
NM_016102,TRIM17,7,6,8949,2092,6857,1142.833333,298.8571429,3.277724665
NM_001134855,TRIM17,6,5,8110,1788,6322,1264.4,298,3.535794183
NM_001010858,RNF187,4,3,8823,3137,5686,1895.333333,784.25,1.81255977
NM_175055,HIST3H2BB,1,0,453,453,NA,NA,453,NA
NM_001287262,BTNL10,3,2,1931,783,1148,574,261,1.466155811
NM_021205,RHOU,3,2,11594,4375,7219,3609.5,1458.333333,1.650057143
NM_145257,CCSAP,4,3,21938,5125,16813,5604.333333,1281.25,3.280585366
NM_001271998,RAB4A,6,5,34833,2807,32026,6405.2,467.8333333,11.40933381
NM_004578,RAB4A,8,7,34833,3043,31790,4541.428571,380.375,10.44692737
NM_006542,SPHAR,1,0,1123,1123,NA,NA,1123,NA
NM_001100,ACTA1,7,6,2852,1499,1353,225.5,214.1428571,0.902601734
NM_012089,ABCB10,13,12,42115,3870,38245,3187.083333,297.6923077,9.882428941
NM_014409,TAF5L,5,4,32930,3119,29811,7452.75,623.8,9.557871113
NM_001025247,TAF5L,4,3,26855,4143,22712,7570.666667,1035.75,5.482017861
NM_016452,CAPN9,19,18,54590,2503,52087,2893.722222,131.7368421,20.80982821
NM_000029,AGT,5,4,12066,2586,9480,2370,517.2,3.665893271
NM_006615,CAPN9,20,19,54390,2382,52008,2737.263158,119.1,21.83375315
NM_032800,C1orf198,4,3,31439,3765,27674,9224.666667,941.25,7.350332005
NM_001136495,C1orf198,4,3,18919,3547,15372,5124,886.75,4.333803214
NM_001136494,C1orf198,6,5,32472,3825,28647,5729.4,637.5,7.489411765
NM_198552,FAM89A,2,1,21293,1500,19793,19793,750,13.19533333
NM_022786,ARV1,6,5,21658,1451,20207,4041.4,241.8333333,13.92625775
NM_001256615,RP5-1097F14.3,3,2,3530,1350,2180,1090,450,1.614814815
NM_152379,C1orf131,7,6,17417,1442,15975,2662.5,206,11.07836338
NM_014236,GNPAT,16,15,36802,2696,34106,2273.733333,168.5,12.65059347
NM_022051,EGLN1,5,4,61295,7102,54193,13548.25,1420.4,7.630667418
NM_032018,SPRTN,5,4,17089,3585,13504,3376,717,3.766806137
NM_001261462,SPRTN,3,2,17089,4492,12597,6298.5,1497.333333,2.804318789
NM_001010984,SPRTN,4,3,17089,4622,12467,4155.666667,1155.5,2.697317179
NM_005999,TSNAX,6,5,37872,2655,35217,7043.4,442.5,13.26440678
NM_001164554,DISC1,3,2,75748,1710,74038,37019,570,43.29707602
NM_001164553,DISC1,4,3,97261,2710,94551,31517,677.5,34.8896679
NM_001164552,DISC1,5,4,97261,2788,94473,23618.25,557.6,33.88558106
NM_001012958,DISC1,3,2,97261,2639,94622,47311,879.6666667,35.8552482
NM_001164550,DISC1,5,4,97261,2837,94424,23606,567.4,33.28304547
NM_020808,SIPA1L2,21,20,117533,6509,111024,5551.2,309.952381,17.056998
NM_019090,MAP10,1,0,5456,5456,NA,NA,5456,NA
NM_032324,NTPCR,5,4,27851,907,26944,6736,181.4,29.70672547
NM_032435,KIAA1804,10,9,57382,5819,51563,5729.222222,581.9,8.861144527
NM_002245,KCNK1,3,2,58510,2164,56346,28173,721.3333333,26.03789279
NM_005646,TARBP1,30,29,87792,5160,82632,2849.37931,172,16.01395349
NM_001012985,COA6,3,2,10368,648,9720,4860,216,15
NM_001206641,COA6,3,2,10583,701,9882,4941,233.6666667,14.09700428
NM_182972,IRF2BP2,2,1,5258,4665,593,593,2332.5,0.127116827
NM_001077397,IRF2BP2,2,1,5258,4617,641,641,2308.5,0.138834741
NM_001161533,RBM34,5,4,8770,910,7860,1965,182,8.637362637
NM_015014,RBM34,11,10,30075,1864,28211,2821.1,169.4545455,15.13465665
NM_001037277,GGPS1,4,3,16093,2748,13345,4448.333333,687,4.856259098
NM_019891,ERO1LB,16,15,66919,5070,61849,4123.266667,316.875,12.19901381
NM_001278344,ACTN2,23,22,78175,5133,73042,3320.090909,223.173913,14.22988506
NM_001278343,ACTN2,21,20,78175,4934,73241,3662.05,234.952381,14.84414268
NM_001103,ACTN2,21,20,78175,4934,73241,3662.05,234.952381,14.84414268
NM_001276687,MT1HL1,1,0,317,317,NA,NA,317,NA
NM_021186,ZP4,13,12,13060,2487,10573,881.0833333,191.3076923,4.251306795
NM_022469,GREM2,2,1,122591,4185,118406,118406,2092.5,28.29295102
NM_000143,FH,10,9,22230,1877,20353,2261.444444,187.7,10.84336708
NM_014322,OPN3,4,3,47251,2636,44615,14871.66667,659,16.92526555
NM_001821,CHML,1,0,7067,7067,NA,NA,7067,NA
NM_130398,EXO1,16,15,41750,3478,38272,2551.466667,217.375,11.0040253
NM_006027,EXO1,14,13,41210,3208,38002,2923.230769,229.1428571,11.84600998
NM_003686,EXO1,14,13,41210,3206,38004,2923.384615,229,11.85402371
NM_001004343,MAP1LC3C,4,3,3595,1196,2399,799.6666667,299,2.005852843
NM_001278196,ZBTB18,2,1,8541,3748,4793,4793,1874,1.278815368
NM_006352,ZBTB18,1,0,4275,4275,NA,NA,4275,NA
NM_205768,ZBTB18,2,1,6219,3877,2342,2342,1938.5,0.604075316
NM_001276349,C1orf100,4,3,36453,405,36048,12016,101.25,89.00740741
NM_001276348,C1orf100,5,4,36453,483,35970,8992.5,96.6,74.47204969
NM_001012970,C1orf100,5,4,36453,579,35874,8968.5,115.8,61.95854922
NM_198076,COX20,4,3,9722,2620,7102,2367.333333,655,2.710687023
NM_031844,HNRNPU,14,13,14227,6860,7367,566.6923077,490,1.073906706
NM_004501,HNRNPU,14,13,14227,6803,7424,571.0769231,485.9285714,1.091283257
NM_022366,TFB2M,8,7,25704,1794,23910,3415.714286,224.25,13.3277592
NM_016002,SCCPDH,12,11,44064,2487,41577,3779.727273,207.25,16.71773221
NM_001204221,ZNF695,6,5,62548,960,61588,12317.6,160,64.15416667
NM_020394,ZNF695,4,3,22772,3381,19391,6463.666667,845.25,5.735285419
NM_024804,ZNF669,4,3,4412,1984,2428,809.3333333,496,1.223790323
NM_207401,C1orf229,1,0,2259,2259,NA,NA,2259,NA
NM_001142572,ZNF669,4,3,4412,1726,2686,895.3333333,431.5,1.556199305
NM_173858,VN1R5,1,0,1075,1075,NA,NA,1075,NA
NM_198074,OR2C3,2,1,3709,2744,965,965,1372,0.351676385
NM_001004698,OR2W5,1,0,1343,1343,NA,NA,1343,NA
NM_001004492,OR2B11,1,0,955,955,NA,NA,955,NA
NM_001005487,OR13G1,1,0,925,925,NA,NA,925,NA
NM_001001915,OR2G2,1,0,955,955,NA,NA,955,NA
NM_001001914,OR2G3,1,0,931,931,NA,NA,931,NA
NM_001005286,OR6F1,1,0,928,928,NA,NA,928,NA
NM_012353,OR1C1,1,0,946,946,NA,NA,946,NA
NM_001001966,OR14A16,1,0,931,931,NA,NA,931,NA
NM_001005522,OR2T8,1,0,940,940,NA,NA,940,NA
NM_015431,TRIM58,6,5,22939,5162,17777,3555.4,860.3333333,3.443820225
NM_001001959,OR11L1,1,0,970,970,NA,NA,970,NA
NM_001001963,OR2L8,1,0,940,940,NA,NA,940,NA
NM_001001957,OR2W3,1,0,946,946,NA,NA,946,NA
NM_001258284,OR2L5,1,0,940,940,NA,NA,940,NA
NM_001004687,OR2L3,1,0,940,940,NA,NA,940,NA
NM_001004686,OR2L2,1,0,1135,1135,NA,NA,1135,NA
NM_001004491,OR2AK2,1,0,1009,1009,NA,NA,1009,NA
NM_001004690,OR2M5,1,0,940,940,NA,NA,940,NA
NM_001004688,OR2M2,1,0,1045,1045,NA,NA,1045,NA
NM_001004689,OR2M3,1,0,940,940,NA,NA,940,NA
NM_017504,OR2M4,1,0,937,937,NA,NA,937,NA
NM_001004695,OR2T33,1,0,964,964,NA,NA,964,NA
NM_001004692,OR2T12,1,0,964,964,NA,NA,964,NA
NM_001004691,OR2M7,1,0,940,940,NA,NA,940,NA
NM_030904,OR2T1,1,0,1111,1111,NA,NA,1111,NA
NM_001005471,OR2T6,1,0,928,928,NA,NA,928,NA
NM_001005495,OR2T3,1,0,958,958,NA,NA,958,NA
NM_001004696,OR2T4,1,0,1048,1048,NA,NA,1048,NA
NM_001004136,OR2T2,1,0,976,976,NA,NA,976,NA
NM_001004694,OR2T29,1,0,949,949,NA,NA,949,NA
NM_001013355,OR2G6,1,0,952,952,NA,NA,952,NA
NM_001004697,OR2T5,1,0,949,949,NA,NA,949,NA
NM_001004693,OR2T10,1,0,940,940,NA,NA,940,NA
NM_001001821,OR2T34,1,0,958,958,NA,NA,958,NA
NM_001085474,LYPD8,1,0,436,436,NA,NA,436,NA
NM_001004734,OR14I1,1,0,937,937,NA,NA,937,NA
NM_001001964,OR2T11,1,0,952,952,NA,NA,952,NA
NM_001001827,OR2T35,1,0,973,973,NA,NA,973,NA
NM_001001824,OR2T27,1,0,955,955,NA,NA,955,NA
NM_030645,SH3BP5L,7,6,15505,3189,12316,2052.666667,455.5714286,3.862025713
NM_017865,ZNF692,12,11,9114,1989,7125,647.7272727,165.75,3.582202112
NM_001136036,ZNF692,12,11,8924,2205,6719,610.8181818,183.75,3.047165533
NM_024836,ZNF672,4,3,11186,2940,8246,2748.666667,735,2.804761905
NM_001193328,ZNF692,11,10,9114,1756,7358,735.8,159.6363636,4.190205011
NM_170725,PGBD2,3,2,12905,2712,10193,5096.5,904,3.758480826
NM_001017434,PGBD2,3,2,12905,2035,10870,5435,678.3333333,5.341523342
NM_207363,NCKAP5,20,19,896661,7614,889047,46791.94737,380.7,116.7647754
NM_001282735,SPATS2L,13,12,176384,6406,169978,14164.83333,492.7692308,26.5341867
NM_001282743,SPATS2L,12,11,176384,6344,170040,15458.18182,528.6666667,26.80327869
NM_001100424,SPATS2L,12,11,176003,6126,169877,15443.36364,510.5,27.73049298
NM_015535,SPATS2L,13,12,176384,6274,170110,14175.83333,482.6153846,27.11348422
NM_001100423,SPATS2L,13,12,175632,6284,169348,14112.33333,483.3846154,26.94907702
NM_001100422,SPATS2L,13,12,176003,6334,169669,14139.08333,487.2307692,26.78702242
NM_207481,NCKAP5,18,17,896661,3655,893006,52529.76471,203.0555556,244.324487
NM_001282744,SPATS2L,13,12,173315,6135,167180,13931.66667,471.9230769,27.25020375
NM_030797,FAM49A,12,11,116406,4711,111695,10154.09091,392.5833333,23.70940352
NM_001135659,NRXN1,24,23,1114033,9584,1104449,48019.52174,399.3333333,115.2388356
NM_138735,NRXN1,6,5,429253,5581,423672,84734.4,930.1666667,75.91327719
NM_206943,LTBP1,34,33,452208,6186,446022,13515.81818,181.9411765,72.10184287
NM_000627,LTBP1,30,29,264913,5322,259591,8951.413793,177.4,48.77696355
NM_001166266,LTBP1,29,28,264913,5036,259877,9281.321429,173.6551724,51.60385226
NM_001166265,LTBP1,30,29,264913,5163,259750,8956.896552,172.1,50.30989735
NM_001166264,LTBP1,29,28,264913,5195,259718,9275.642857,179.137931,49.99384023
NM_004801,NRXN1,22,21,1114033,9372,1104661,52602.90476,426,117.8682245
NM_002285,AFF3,24,23,595323,8161,587162,25528.78261,340.0416667,71.94731038
NM_001025108,AFF3,24,23,558331,8144,550187,23921.17391,339.3333333,67.55734283
NM_016192,TMEFF2,10,9,244899,1819,243080,27008.88889,181.9,133.6338648
NM_001199143,XIRP2,11,10,371266,3404,367862,36786.2,309.4545455,108.0675676
NM_001079810,XIRP2,10,9,371266,3304,367962,40884.66667,330.4,111.3686441
NM_001005476,PKP4,21,20,224466,4482,219984,10999.2,213.4285714,49.08165997
NM_152381,XIRP2,11,10,371266,12684,358582,35858.2,1153.090909,28.27041943
NM_018557,LRP1B,91,90,1900276,16622,1883654,20929.48889,182.6593407,113.3229455
NM_003628,PKP4,22,21,224466,4612,219854,10469.2381,209.6363636,47.66999133
NM_020864,NYAP2,6,5,253134,4596,248538,49707.6,766,54.0770235
NM_024080,TRPM8,26,25,102125,5647,96478,3859.12,217.1923077,17.0848238
NM_015025,MYT1L,25,24,542162,7161,535001,22291.70833,286.44,74.71037565
NM_018968,SNTG2,17,16,424832,1904,422928,26433,112,222.1260504
NM_002149,HPCAL1,5,4,124715,1767,122948,30737,353.4,69.58007923
NM_001258357,HPCAL1,5,4,97456,1541,95915,23978.75,308.2,62.24205062
NM_001135191,ASAP2,27,26,198920,5609,193311,7435.038462,207.7407407,34.46443216
NM_134421,HPCAL1,6,5,123919,1910,122009,24401.8,318.3333333,63.87905759
NM_003887,ASAP2,28,27,198920,5745,193175,7154.62963,205.1785714,33.62489121
NM_017552,ATAD2B,28,27,178404,8083,170321,6308.185185,288.6785714,21.0715081
NM_001282724,C2orf43,5,4,139118,3607,135511,33877.75,721.4,37.56889382
NM_001282723,C2orf43,6,5,139118,3734,135384,27076.8,622.3333333,36.25709695
NM_001282720,C2orf43,6,5,139118,3825,135293,27058.6,637.5,35.37071895
NM_003385,VSNL1,4,3,115901,2009,113892,37964,502.25,56.69089099
NM_001242338,ATAD2B,28,27,178404,8068,170336,6308.740741,288.1428571,21.11254338
NM_021925,C2orf43,7,6,139118,3970,135148,22524.66667,567.1428571,34.04231738
NM_001282719,C2orf43,6,5,139118,3843,135275,27055,640.5,35.2003643
NM_001282722,C2orf43,5,4,139118,3668,135450,33862.5,733.6,36.92748092
NM_001282721,C2orf43,6,5,139118,3813,135305,27061,635.5,35.48518227
NM_032312,YIPF4,6,5,28702,1971,26731,5346.2,328.5,13.56215119
NM_017727,TMEM214,17,16,8793,3057,5736,358.5,179.8235294,1.876349362
NM_001261840,BRE,12,11,448287,1775,446512,40592,147.9166667,251.5560563
NM_199194,BRE,13,12,448287,1870,446417,37201.41667,143.8461538,238.7256684
NM_199193,BRE,14,13,448287,1943,446344,34334.15385,138.7857143,229.7189913
NM_199192,BRE,13,12,448287,1876,446411,37200.91667,144.3076923,237.9589552
NM_001287527,CLIP4,16,15,68389,4305,64084,4272.266667,269.0625,14.88594657
NM_199191,BRE,12,11,448287,1803,446484,40589.45455,150.25,247.6339434
NM_014600,EHD3,6,5,34382,3912,30470,6094,652,7.788854806
NM_001083590,TMEM214,16,15,8793,2921,5872,391.4666667,182.5625,2.010270455
NM_004899,BRE,13,12,448287,1978,446309,37192.41667,152.1538462,225.6365015
NM_001287528,CLIP4,15,14,77041,2368,74673,5333.785714,157.8666667,31.53420608
NM_024692,CLIP4,16,15,68389,4309,64080,4272,269.3125,14.87119981
NM_016441,CRIM1,17,16,194910,5628,189282,11830.125,331.0588235,33.63219616
NM_001142650,HNRNPLL,14,13,39852,2793,37059,2850.692308,199.5,13.26852846
NM_138394,HNRNPLL,13,12,39852,3048,36804,3067,234.4615385,12.07480315
NM_022436,ABCG5,13,12,26349,2753,23596,1966.333333,211.7692308,8.57101344
NM_000145,FSHR,10,9,192372,2784,189588,21065.33333,278.4,68.09913793
NM_001288955,TTC7A,19,18,134964,5019,129945,7219.166667,264.1578947,25.89061566
NM_001288951,TTC7A,21,20,134964,5251,129713,6485.65,250.047619,24.70253285
NM_181446,FSHR,9,8,192372,2705,189667,23708.375,300.5555556,70.11719039
NM_020458,TTC7A,20,19,134964,5178,129786,6830.842105,258.9,25.06488992
NM_005400,PRKCE,15,14,536088,5535,530553,37896.64286,369,95.85420054
NM_001288953,TTC7A,21,20,160009,5170,154839,7741.95,246.1904762,29.94951644
NM_001135597,CCDC88A,33,32,132081,9846,122235,3819.84375,298.3636364,12.41468617
NM_138448,ACYP2,4,3,190027,1226,188801,62933.66667,306.5,153.997553
NM_001254943,CCDC88A,34,33,132081,9625,122456,3710.787879,283.0882353,12.7227013
NM_018084,CCDC88A,32,31,132081,9764,122317,3945.709677,305.125,12.52734535
NM_001142615,EHBP1,23,22,372637,5020,367617,16709.86364,218.2608696,73.23047809
NM_017567,NAGK,10,9,10592,1811,8781,975.6666667,181.1,4.848702374
NM_133478,SLC4A5,31,30,127167,6379,120788,4026.266667,205.7741935,18.93525631
NM_019617,GKN1,6,5,6409,826,5583,1116.6,137.6666667,6.759079903
NM_021196,SLC4A5,26,25,93593,3475,90118,3604.72,133.6538462,25.93323741
NM_001164883,CTNNA2,17,16,1135930,3870,1132060,70753.75,227.6470588,292.5219638
NM_001282599,CTNNA2,12,11,335486,2941,332545,30231.36364,245.0833333,113.0720843
NM_001282598,CTNNA2,18,17,1125681,3859,1121822,65989.52941,214.3888889,290.7027727
NM_001134745,LRRTM4,4,3,774654,3163,771491,257163.6667,790.75,243.9111603
NM_004389,CTNNA2,18,17,1135930,4006,1131924,66583.76471,222.5555556,282.5571643
NM_001282600,CTNNA2,12,11,343760,2884,340876,30988.72727,240.3333333,118.1955617
NM_001282597,CTNNA2,19,18,1135930,4151,1131779,62876.61111,218.4736842,272.652132
NM_001282924,LRRTM4,4,3,774654,3093,771561,257187,773.25,249.4539282
NM_032827,ATOH8,3,2,37599,5866,31733,15866.5,1955.333333,5.409648824
NM_001370,DNAH6,77,76,303136,12872,290264,3819.263158,167.1688312,22.55003108
NM_001145873,CD8A,9,8,23793,3063,20730,2591.25,340.3333333,6.767874633
NM_001078170,RGPD2,23,22,68570,5525,63045,2865.681818,240.2173913,11.41085973
NM_001024457,RGPD1,23,22,229832,6718,223114,10141.54545,292.0869565,33.21137243
NM_025244,TSGA10,21,20,157465,3706,153759,7687.95,176.4761905,41.48920669
NM_016466,ANKRD39,4,3,10034,902,9132,3044,225.5,10.12416851
NM_015348,TMEM131,41,40,239555,6683,232872,5821.8,163,34.8454287
NM_182911,TSGA10,20,19,144315,3684,140631,7401.631579,184.2,38.17345277
NM_001142621,TGFBRAP1,12,11,65326,5692,59634,5421.272727,474.3333333,10.47680956
NM_001102426,TBC1D8,20,19,144158,4167,139991,7367.947368,208.35,33.59515239
NM_004257,TGFBRAP1,12,11,65326,5695,59631,5421,474.5833333,10.47076383
NM_001288706,IL1R1,12,11,109500,4985,104515,9501.363636,415.4166667,20.96589769
NM_000877,IL1R1,12,11,37100,5165,31935,2903.181818,430.4166667,6.182962246
NM_001178036,DPP10,27,26,1383148,5333,1377815,52992.88462,197.5185185,258.3564598
NM_001178034,DPP10,26,25,682815,4855,677960,27118.4,186.7307692,139.6416066
NM_001178037,DPP10,26,25,780066,4883,775183,31007.32,187.8076923,158.7513823
NM_153712,TTL,7,6,50481,5170,45311,7551.833333,738.5714286,8.764216634
NM_020868,DPP10,26,25,1402429,5279,1397150,55886,203.0384615,264.6618678
NM_001099289,SH3RF3,10,9,516212,5618,510594,56732.66667,561.8,90.88536846
NM_001004360,DPP10,26,25,682644,4928,677716,27108.64,189.5384615,137.523539
NM_002830,PTPN4,27,26,225269,11407,213862,8225.461538,422.4814815,18.74831244
NM_005270,GLI2,13,12,195364,6782,188582,15715.16667,521.6923077,27.80625184
NM_001077637,WTH3DI,1,0,3668,3668,NA,NA,3668,NA
NM_030923,TMEM163,8,7,263243,1901,261342,37334.57143,237.625,137.4760652
NM_015361,R3HDM1,26,25,193817,4732,189085,7563.4,182,39.95879121
NM_001282799,R3HDM1,23,22,193817,4345,189472,8612.363636,188.9130435,43.60690449
NM_001080427,THSD7B,27,26,686827,5872,680955,26190.57692,217.4814815,115.966451
NM_007226,NXPH2,2,1,111086,2562,108524,108524,1281,42.35909446
NM_003937,KYNU,14,13,164692,1686,163006,12538.92308,120.4285714,96.68208778
NM_001199241,KYNU,15,14,164692,1773,162919,11637.07143,118.2,91.88888889
NM_001032998,KYNU,12,11,111913,1300,110613,10055.72727,108.3333333,85.08692308
NM_177964,LYPD6B,7,6,176793,1580,175213,29202.16667,225.7142857,110.8943038
NM_018328,MBD5,15,14,492466,6031,486435,34745.35714,402.0666667,80.65577848
NM_052917,GALNT13,13,12,582065,5677,576388,48032.33333,436.6923077,101.5303858
NM_001278461,COBLL1,13,12,161235,9383,151852,12654.33333,721.7692308,16.18373654
NM_001278460,COBLL1,14,13,161985,9424,152561,11735.46154,673.1428571,16.18856112
NM_001178016,SLC4A10,27,26,360943,5738,355205,13661.73077,212.5185185,61.90397351
NM_001178015,SLC4A10,27,26,360943,5692,355251,13663.5,210.8148148,62.4123331
NM_022058,SLC4A10,26,25,360943,5601,355342,14213.68,215.4230769,63.44259954
NM_014900,COBLL1,14,13,161235,9498,151737,11672.07692,678.4285714,15.97567909
NM_173162,KCNH7,8,7,415502,2459,413043,59006.14286,307.375,167.9719398
NM_013450,BAZ2B,37,36,297571,8182,289389,8038.583333,221.1351351,35.36898069
NM_033272,KCNH7,16,15,467342,4258,463084,30872.26667,266.125,108.7562236
NM_001278458,COBLL1,17,16,161985,9604,152381,9523.8125,564.9411765,15.86640983
NM_001136554,TLK1,21,20,240493,5310,235183,11759.15,252.8571429,44.2905838
NM_133646,ZAK,12,11,151310,7195,144115,13101.36364,599.5833333,20.02988186
NM_001011708,OLA1,10,9,176192,4265,171927,19103,426.5,40.31113716
NM_013233,STK39,18,17,293577,3292,290285,17075.58824,182.8888889,88.17891859
NM_013341,OLA1,11,10,176192,4367,171825,17182.5,397,39.34623311
NM_012290,TLK1,21,20,170079,5751,164328,8216.4,273.8571429,28.57381325
NM_003742,ABCB11,28,27,108386,4803,103583,3836.407407,171.5357143,21.56631272
NM_016653,ZAK,20,19,192174,3882,188292,9910.105263,194.1,48.50386399
NM_172070,UBR3,39,38,256623,7992,248631,6542.921053,204.9230769,31.10998498
NM_001030313,CERKL,11,10,120435,3014,117421,11742.1,274,38.95852687
NM_001030312,CERKL,10,9,120435,2881,117554,13061.55556,288.1,40.80319334
NM_001160277,CERKL,13,12,120435,3169,117266,9772.166667,243.7692308,37.00410224
NM_001113398,ZNF385B,8,7,120606,2627,117979,16854.14286,328.375,44.91016368
NM_001113397,ZNF385B,8,7,304060,2767,301293,43041.85714,345.875,108.8879653
NM_001030311,CERKL,14,13,120435,3302,117133,9010.230769,235.8571429,35.47334949
NM_201548,CERKL,13,12,120435,3223,117212,9767.666667,247.9230769,36.3673596
NM_003659,AGPS,20,19,151095,7685,143410,7547.894737,384.25,18.66102798
NM_001139518,PRKRA,8,7,19216,1635,17581,2511.571429,204.375,10.7529052
NM_001139517,PRKRA,7,6,19345,1913,17432,2905.333333,273.2857143,9.112388918
NM_152520,ZNF385B,10,9,419523,3296,416227,46247.44444,329.6,126.2824636
NM_003690,PRKRA,8,7,19819,1834,17985,2569.285714,229.25,9.806434024
NM_001282725,ZNF385B,10,9,143924,2723,141201,15689,272.3,51.85493941
NM_194250,ZNF804A,4,3,341123,4689,336434,112144.6667,1172.25,71.74962679
NM_182521,ZSWIM2,9,8,21692,2455,19237,2404.625,272.7777778,7.835845214
NM_173651,FSIP2,23,22,94663,21077,73586,3344.818182,916.3913043,3.491293827
NM_015265,SATB2,12,11,201768,5318,196450,17859.09091,443.1666667,36.94057917
NM_020760,HECW2,29,28,393360,6955,386405,13800.17857,239.8275862,55.55787203
NM_001172517,SATB2,12,11,195610,5338,190272,17297.45455,444.8333333,35.64481079
NM_001172509,SATB2,11,10,188598,5741,182857,18285.7,521.9090909,31.85107124
NM_205863,PARD3B,22,21,1074372,7893,1066479,50784.71429,358.7727273,135.1170658
NM_201279,NRP2,16,15,115635,6612,109023,7268.2,413.25,16.48865699
NM_201264,NRP2,9,8,61200,2587,58613,7326.625,287.4444444,22.65674526
NM_201267,NRP2,16,15,94658,4143,90515,6034.333333,258.9375,21.84769491
NM_201266,NRP2,17,16,115635,6679,108956,6809.75,392.8823529,16.31322054
NM_001039845,MDH1B,12,11,27786,2565,25221,2292.818182,213.75,9.832748538
NM_001168221,ALS2CR11,16,15,131763,5722,126041,8402.733333,357.625,22.02743796
NM_018534,NRP2,16,15,94658,4158,90500,6033.333333,259.875,21.76527177
NM_152526,PARD3B,22,21,1074372,8010,1066362,50779.14286,364.0909091,133.128839
NM_152525,ALS2CR11,15,14,131763,2130,129633,9259.5,142,60.86056338
NM_057177,PARD3B,22,21,1074372,7989,1066383,50780.14286,363.1363636,133.4814119
NM_001204,BMPR2,13,12,191426,12083,179343,14945.25,929.4615385,14.84258876
NM_001168216,ALS2CR11,13,12,131763,1784,129979,10831.58333,137.2307692,72.85818386
NM_003872,NRP2,17,16,115635,6664,108971,6810.6875,392,16.35219088
NM_001282940,MDH1B,12,11,27786,2562,25224,2293.090909,213.5,9.845433255
NM_024532,SPAG16,16,15,1126124,2203,1123921,74928.06667,137.6875,510.1774852
NM_001042599,ERBB4,27,26,1162912,11902,1151010,44269.61538,440.8148148,96.70727609
NM_001079526,IKZF2,9,8,151924,9501,142423,17802.875,1055.666667,14.99031681
NM_032504,UNC80,64,63,227309,13626,213683,3391.793651,212.90625,15.68200499
NM_016260,IKZF2,8,7,150649,9431,141218,20174,1178.875,14.97380978
NM_021141,XRCC5,21,20,96998,3451,93547,4677.35,164.3333333,27.1072153
NM_005235,ERBB4,28,27,1162912,11951,1150961,42628.18519,426.8214286,96.3066689
NM_182587,UNC80,63,62,227309,13553,213756,3447.677419,215.1269841,15.77185863
NM_152386,SGPP2,5,4,134297,1205,133092,33273,241,110.4497925
NM_015488,PNKD,10,9,76403,3124,73279,8142.111111,312.4,23.45678617
NM_001257197,CUL3,15,14,115249,6607,108642,7760.142857,440.4666667,16.44346905
NM_022152,TMBIM1,12,11,18365,2361,16004,1454.909091,196.75,6.778483693
NM_004438,EPHA4,18,17,154265,6366,147899,8699.941176,353.6666667,23.23264216
NM_003590,CUL3,16,15,115249,6806,108443,7229.533333,425.375,15.93344108
NM_019850,NGEF,15,14,134557,3199,131358,9382.714286,213.2666667,41.06220694
NM_030926,ITM2C,6,5,14361,2096,12265,2453,349.3333333,5.851622137
NM_001284216,TRIP12,39,38,158174,9104,149070,3922.894737,233.4358974,16.37412127
NM_001012516,ITM2C,5,4,14306,1929,12377,3094.25,385.8,6.416277864
NM_001012514,ITM2C,5,4,14361,1954,12407,3101.75,390.8,6.349539406
NM_001284214,TRIP12,42,41,158174,10061,148113,3612.512195,239.547619,14.72149886
NM_001284215,TRIP12,40,39,116293,9884,106409,2728.435897,247.1,10.76578308
NM_004238,TRIP12,41,40,158174,9916,148258,3706.45,241.8536585,14.95139169
NM_001287241,ITM2C,7,6,14658,2229,12429,2071.5,318.4285714,5.576043069
NM_001287240,ITM2C,6,5,14658,2032,12626,2525.2,338.6666667,6.213582677
NM_005336,HDLBP,28,27,88435,6402,82033,3038.259259,228.6428571,12.81365198
NM_014914,AGAP1,17,16,637713,10708,627005,39187.8125,629.8823529,58.55481883
NM_001037131,AGAP1,18,17,637713,10868,626845,36873.23529,603.7777778,57.67804564
NM_014521,SH3BP4,6,5,103732,5189,98543,19708.6,864.8333333,18.99074966
NM_006037,HDAC4,27,26,352781,9003,343778,13222.23077,333.4444444,38.18482728
NM_001159597,SH3YL1,9,8,45963,1769,44194,5524.25,196.5555556,24.98247598
NM_001282682,SH3YL1,11,10,46732,1876,44856,4485.6,170.5454545,23.91044776
NM_015677,SH3YL1,10,9,45963,1827,44136,4904,182.7,24.15763547
NM_001206744,TPO,17,16,129268,3158,126110,7881.875,185.7647059,39.93350222
NM_012293,PXDN,23,22,112634,6844,105790,4808.636364,297.5652174,15.45733489
NM_001206745,TPO,16,15,129268,2986,126282,8418.8,186.625,42.29135968
NM_000547,TPO,17,16,129268,3163,126105,7881.5625,186.0588235,39.86879545
NM_175722,TPO,15,14,128321,2552,125769,8983.5,170.1333333,49.28252351
NM_175721,TPO,15,14,128321,2939,125382,8955.857143,195.9333333,42.66144947
NM_175719,TPO,16,15,129268,2991,126277,8418.466667,186.9375,42.2189903
NM_016030,TRAPPC12,12,11,99898,2536,97362,8851.090909,211.3333333,38.39195584
NM_199235,COLEC11,8,7,49814,1792,48022,6860.285714,224,26.79799107
NM_024027,COLEC11,7,6,49814,1712,48102,8017,244.5714286,28.09696262
NM_001287444,DCDC2C,11,10,143820,1493,142327,14232.7,135.7272727,95.32953784
NM_001255989,COLEC11,4,3,38594,1264,37330,12443.33333,316,29.53322785
NM_001255988,COLEC11,5,4,38594,1337,37257,9314.25,267.4,27.86611818
NM_001255986,COLEC11,6,5,38594,1410,37184,7436.8,235,26.37163121
NM_001255987,COLEC11,5,4,38594,1337,37257,9314.25,267.4,27.86611818
NM_001255985,COLEC11,8,7,42740,1603,41137,5876.714286,200.375,25.6625078
NM_001255984,COLEC11,5,4,49814,1566,48248,12062,313.2,30.80970626
NM_001255982,COLEC11,6,5,49814,1639,48175,9635,273.1666667,29.39292251
NM_001255983,COLEC11,6,5,49814,1639,48175,9635,273.1666667,29.39292251
NM_003310,TSSC1,9,8,188914,1730,187184,23398,192.2222222,108.1988439
NM_014746,RNF144A,9,8,126788,5748,121040,15130,638.6666667,21.05775922
NM_020738,KIDINS220,30,29,108770,7391,101379,3495.827586,246.3666667,13.71654715
NM_138799,MBOAT2,13,12,147177,3817,143360,11946.66667,293.6153846,37.55829185
NM_198182,GRHL1,16,15,50622,3621,47001,3133.4,226.3125,12.98011599
NM_016207,CPSF3,18,17,49575,2403,47172,2774.823529,133.5,19.63046192
NM_024894,NOL10,21,20,119223,3519,115704,5785.2,167.5714286,32.8797954
NM_144583,ATP6V1C2,13,12,63463,3115,60348,5029,239.6153846,19.37335474
NM_001261394,NOL10,20,19,119223,3368,115855,6097.631579,168.4,34.39875297
NM_001261392,NOL10,20,19,119223,3440,115783,6093.842105,172,33.65784884
NM_001039362,ATP6V1C2,14,13,63463,3254,60209,4631.461538,232.4285714,18.50307314
NM_004850,ROCK2,33,32,162935,6434,156501,4890.65625,194.969697,24.32405968
NM_001261427,LPIN1,21,20,103075,5605,97470,4873.5,266.9047619,17.38983051
NM_001261428,LPIN1,22,21,149830,5635,144195,6866.428571,256.1363636,25.5891748
NM_145693,LPIN1,20,19,80813,5394,75419,3969.421053,269.7,13.98201706
NM_015909,NBAS,52,51,394442,7352,387090,7590,141.3846154,52.65097933
NM_001099218,RAD51AP2,3,2,7722,3592,4130,2065,1197.333333,1.149777283
NM_001199104,NT5C1B-RDH14,11,10,34859,2993,31866,3186.6,272.0909091,10.64684263
NM_001199103,NT5C1B-RDH14,9,8,34859,2542,32317,4039.625,282.4444444,12.71321794
NM_001130009,GEN1,14,13,31220,6381,24839,1910.692308,455.7857143,3.892650055
NM_002252,KCNS3,3,2,54303,2354,51949,25974.5,784.6666667,22.06839422
NM_182625,GEN1,14,13,31457,6240,25217,1939.769231,445.7142857,4.041185897
NM_001282428,KCNS3,3,2,55113,2404,52709,26354.5,801.3333333,21.92554077
NM_020779,WDR35,27,26,79857,6938,72919,2804.576923,256.962963,10.51008936
NM_022460,HS1BP3,7,6,33302,2410,30892,5148.666667,344.2857143,12.81825726
NM_001006657,WDR35,28,27,79857,6972,72885,2699.444444,249,10.45395869
NM_000384,APOB,29,28,42646,14150,28496,1017.714286,487.9310345,2.01385159
NM_052920,KLHL29,14,13,323187,5098,318089,24468.38462,364.1428571,62.39486073
NM_001145710,FAM228B,11,10,46159,1368,44791,4479.1,124.3636364,32.74195906
NM_019595,ITSN2,39,38,157664,6070,151594,3989.315789,155.6410256,24.97429984
NM_024322,CENPO,8,7,28916,4096,24820,3545.714286,512,6.059570313
NM_006277,ITSN2,40,39,157664,6152,151512,3884.923077,153.8,24.62808843
NM_001199803,CENPO,7,6,29072,4118,24954,4159,588.2857143,6.059737737
NM_147152,ITSN2,30,29,140211,4613,135598,4675.793103,153.7666667,29.39475396
NM_147233,NCOA1,21,20,186226,6912,179314,8965.7,329.1428571,25.94241898
NM_147223,NCOA1,22,21,186226,6973,179253,8535.857143,316.9545455,25.70672594
NM_003743,NCOA1,21,20,186226,6915,179311,8965.55,329.2857143,25.9307303
NM_183361,DTNB,18,17,296406,2304,294102,17300.11765,128,127.6484375
NM_183360,DTNB,20,19,296406,2453,293953,15471.21053,122.65,119.8340807
NM_014971,EFR3B,23,22,117033,7481,109552,4979.636364,325.2608696,14.64403155
NM_001256304,DTNB,18,17,275419,2167,273252,16073.64706,120.3888889,126.0969082
NM_001256303,DTNB,20,19,296406,2486,293920,15469.47368,124.3,118.2300885
NM_018263,ASXL2,12,11,139061,7186,131875,11988.63636,598.8333333,18.351656
NM_021907,DTNB,21,20,296406,2508,293898,14694.9,119.4285714,117.1842105
NM_022552,DNMT3A,23,22,108956,4347,104609,4754.954545,189,24.06464228
NM_033148,DTNB,19,18,296406,2326,294080,16337.77778,122.4210526,126.4316423
NM_033147,DTNB,20,19,296406,2417,293989,15473.10526,120.85,121.6338436
NM_001256308,DTNB,18,17,273026,2346,270680,15922.35294,130.3333333,115.3793691
NM_175630,DNMT3A,4,3,61140,1779,59361,19787,444.75,33.36762226
NM_175629,DNMT3A,23,22,109631,4418,105213,4782.409091,192.0869565,23.814622
NM_017877,SLC35F6,6,5,16959,3918,13041,2608.2,653,3.32848392
NM_001281513,HADHB,17,16,45719,2288,43431,2714.4375,134.5882353,18.98208042
NM_001253724,DPYSL5,13,12,101929,5142,96787,8065.583333,395.5384615,18.82283158
NM_001253723,DPYSL5,13,12,102064,5139,96925,8077.083333,395.3076923,18.86067328
NM_001281512,HADHB,15,14,45719,2158,43561,3111.5,143.8666667,20.1858202
NM_033505,EPT1,10,9,49807,8139,41668,4629.777778,813.9,5.119547856
NM_000183,HADHB,16,15,45719,2204,43515,2901,137.75,19.74364791
NM_016131,RAB10,6,5,103596,3791,99805,19961,631.8333333,26.32682669
NM_194248,OTOF,47,46,101497,7203,94294,2049.869565,153.2553191,13.09093433
NM_020134,DPYSL5,13,12,102252,5222,97030,8085.833333,401.6923077,18.58100345
NM_001287489,OTOF,46,45,101497,7004,94493,2099.844444,152.2608696,13.49129069
NM_022128,RBKS,8,7,109034,1279,107755,15393.57143,159.875,84.2494136
NM_187841,TRIM54,9,8,25012,1943,23069,2883.625,215.8888889,11.87287699
NM_001287580,RBKS,9,8,109034,2399,106635,13329.375,266.5555556,44.44977074
NM_032546,TRIM54,10,9,25012,2070,22942,2549.111111,207,11.08309179
NM_013392,NRBP1,18,17,13653,2217,11436,672.7058824,123.1666667,5.158322057
NM_199280,FAM179A,20,19,70934,3568,67366,3545.578947,178.4,18.88060538
NM_001170585,PLB1,57,56,147717,5171,142546,2545.464286,90.71929825,27.56642816
NM_153021,PLB1,58,57,147717,5205,142512,2500.210526,89.74137931,27.37982709
NM_004304,ALK,29,28,728839,6294,722545,25805.17857,217.0344828,114.7990149
NM_024572,GALNT14,15,14,228263,2750,225513,16108.07143,183.3333333,82.00472727
NM_001253827,GALNT14,17,16,219177,2532,216645,13540.3125,148.9411765,85.56279621
NM_001253826,GALNT14,16,15,228263,2766,225497,15033.13333,172.875,81.52458424
NM_182551,LCLAT1,7,6,196970,5067,191903,31983.83333,723.8571429,37.87310045
NM_001002257,LCLAT1,6,5,196956,4860,192096,38419.2,810,39.52592593
NM_015955,MEMO1,9,8,142806,1821,140985,17623.125,202.3333333,77.42174629
NM_199436,SPAST,16,15,94028,5133,88895,5926.333333,320.8125,17.31833236
NM_014946,SPAST,17,16,94028,5230,88798,5549.875,307.6470588,16.97858509
NM_001137602,MEMO1,8,7,142806,1751,141055,20150.71429,218.875,80.55682467
NM_000379,XDH,36,35,80425,5753,74672,2133.485714,159.8055556,12.97966278
NM_001193509,TTC27,20,19,193033,2691,190342,10018,134.55,70.73281308
NM_016252,BIRC6,74,73,261871,15776,246095,3371.164384,213.1891892,15.59932809
NM_017735,TTC27,20,19,193033,2938,190095,10005,146.9,64.70217835
NM_015475,FAM98A,8,7,15635,2753,12882,1840.285714,344.125,4.67925899
NM_170672,RASGRP3,19,18,128384,4713,123671,6870.611111,248.0526316,26.2403989
NM_001177972,VIT,6,5,62987,1424,61563,12312.6,237.3333333,43.23244382
NM_001177971,VIT,14,13,118106,2720,115386,8875.846154,194.2857143,42.42132353
NM_001177969,VIT,15,14,118106,2787,115319,8237.071429,185.8,41.37746681
NM_001177970,VIT,14,13,118106,2723,115383,8875.615385,194.5,42.37348513
NM_005813,PRKD3,18,17,66578,5920,60658,3568.117647,328.8888889,10.24628378
NM_001135652,EIF2AK2,14,13,42683,3695,38988,2999.076923,263.9285714,10.55155616
NM_003162,STRN,18,17,128776,14128,114648,6744,784.8888889,8.114949037
NM_002759,EIF2AK2,17,16,51908,4362,47546,2971.625,256.5882353,10.90004585
NM_053276,VIT,16,15,118106,2833,115273,7684.866667,177.0625,40.68937522
NM_001135651,EIF2AK2,17,16,51908,4128,47780,2986.25,242.8235294,11.5746124
NM_019024,HEATR5B,36,35,103334,6828,96506,2757.314286,189.6666667,14.13386057
NM_006449,CDC42EP3,2,1,30319,5717,24602,24602,2858.5,4.30330593
NM_022374,ATL2,13,12,82405,3379,79026,6585.5,259.9230769,23.38739272
NM_001270437,CDC42EP3,2,1,30319,5082,25237,25237,2541,4.965958284
NM_001135673,ATL2,13,12,82405,2902,79503,6625.25,223.2307692,27.39593384
NM_001270438,CDC42EP3,2,1,30319,5058,25261,25261,2529,4.994266509
NM_001270436,CDC42EP3,2,1,30655,5126,25529,25529,2563,4.980296528
NM_144713,RMDN2,11,10,116691,2011,114680,11468,182.8181818,57.02635505
NM_138801,GALM,7,6,68859,2490,66369,11061.5,355.7142857,26.65421687
NM_198963,DHX57,24,23,78147,4849,73298,3186.869565,202.0416667,15.11610641
NM_001145451,ARHGEF33,16,15,56088,4320,51768,3451.2,270,11.98333333
NM_001270425,MAP4K3,33,32,188048,4332,183716,5741.125,131.2727273,42.40904894
NM_005633,SOS1,23,22,138916,8341,130575,5935.227273,362.6521739,15.65459777
NM_003618,MAP4K3,34,33,188048,4396,183652,5565.212121,129.2941176,41.77707006
NM_001009565,CDKL4,8,7,50987,1575,49412,7058.857143,196.875,31.37269841
NM_025264,THUMPD2,10,9,43218,2234,40984,4553.777778,223.4,18.34556849
NM_021097,SLC8A1,10,9,318160,6063,312097,34677.44444,606.3,51.47567211
NM_001252624,SLC8A1,9,8,318160,6038,312122,39015.25,670.8888889,51.69294468
NM_001112802,SLC8A1,8,7,400291,6040,394251,56321.57143,755,65.27334437
NM_001112801,SLC8A1,8,7,318160,6022,312138,44591.14286,752.75,51.83294587
NM_001112800,SLC8A1,9,8,318160,6047,312113,39014.125,671.8888889,51.6145196
NM_019063,EML4,23,22,163200,5572,157628,7164.909091,242.2608696,28.28930366
NM_020744,MTA3,14,13,141031,2218,138813,10677.92308,158.4285714,62.58476105
NM_001145076,EML4,22,21,163200,5397,157803,7514.428571,245.3181818,29.23902168
NM_001282756,MTA3,17,16,188904,5501,183403,11462.6875,323.5882353,33.33993819
NM_001282755,MTA3,18,17,262380,5850,256530,15090,325,43.85128205
NM_001083953,THADA,38,37,365140,6364,358776,9696.648649,167.4736842,56.37586424
NM_022065,THADA,38,37,365212,6152,359060,9704.324324,161.8947368,58.36475943
NM_172069,PLEKHH2,30,29,130689,6984,123705,4265.689655,232.8,17.71262887
NM_002706,PPM1B,6,5,62613,2628,59985,11997,438,22.82534247
NM_024766,CAMKMT,11,10,410690,1566,409124,40912.4,142.3636364,261.2541507
NM_001033556,PPM1B,3,2,40573,1500,39073,19536.5,500,26.04866667
NM_001042386,PREPL,13,12,42142,5780,36362,3030.166667,444.6153846,6.29100346
NM_133259,LRPPRC,38,37,109783,6657,103126,2787.189189,175.1842105,15.49136248
NM_001171617,PREPL,14,13,44255,6065,38190,2937.692308,433.2142857,6.296784831
NM_001171613,PREPL,14,13,43954,5908,38046,2926.615385,422,6.439742722
NM_001171603,PREPL,15,14,44255,6320,37935,2709.642857,421.3333333,6.002373418
NM_006036,PREPL,14,13,43067,6904,36163,2781.769231,493.1428571,5.237977984
NM_001042385,PREPL,13,12,42142,5792,36350,3029.166667,445.5384615,6.27589779
NM_001033557,PPM1B,6,5,62613,3048,59565,11913,508,19.54232283
NM_001171606,PREPL,15,14,43954,6451,37503,2678.785714,430.0666667,5.813517284
NM_177969,PPM1B,5,4,62613,1767,60846,15211.5,353.4,34.43463497
NM_177968,PPM1B,6,5,65744,3856,61888,12377.6,642.6666667,16.04979253
NM_018079,SRBD1,21,20,222616,3715,218901,10945.05,176.9047619,58.92355316
NM_012249,RHOQ,5,4,41962,4547,37415,9353.75,909.4,8.228502309
NM_001430,EPAS1,16,15,89303,5182,84121,5608.066667,323.875,16.2333076
NM_025133,FBXO11,23,22,81801,3867,77934,3542.454545,168.1304348,20.15360745
NM_001163561,C2orf61,7,6,68389,898,67491,11248.5,128.2857143,75.15701559
NM_001190274,FBXO11,23,22,98875,4078,94797,4308.954545,177.3043478,23.2459539
NM_000251,MSH2,16,15,80163,3225,76938,5129.2,201.5625,23.85674419
NM_001258281,MSH2,17,16,80163,3042,77121,4820.0625,178.9411765,25.35207101
NM_006873,STON1,4,3,68348,5520,62828,20942.66667,1380,11.38188406
NM_006872,GTF2A1L,9,8,61814,1691,60123,7515.375,187.8888889,35.55470136
NM_001198595,STON1,5,4,68348,5638,62710,15677.5,1127.6,11.12273856
NM_001198594,STON1-GTF2A1L,8,7,99024,3630,95394,13627.71429,453.75,26.27933884
NM_001198593,STON1-GTF2A1L,11,10,246594,3801,242793,24279.3,345.5454545,63.87608524
NM_172311,STON1-GTF2A1L,11,10,110591,3841,106750,10675,349.1818182,27.7922416
NM_001193487,GTF2A1L,8,7,61814,1588,60226,8603.714286,198.5,37.9256927
NM_016115,ASB3,10,9,117031,2292,114739,12748.77778,229.2,50.06064572
NM_001201965,ASB3,9,8,116870,2457,114413,14301.625,273,46.56613757
NM_014614,PSME4,47,46,106775,7146,99629,2165.847826,152.0425532,13.94192555
NM_145863,ASB3,9,8,117031,2082,114949,14368.625,231.3333333,55.21085495
NM_001164165,GPR75-ASB3,10,9,189722,1976,187746,20860.66667,197.6,95.01315789
NM_001008708,CHAC2,3,2,7360,1278,6082,3041,426,4.758998435
NM_003128,SPTBN1,36,35,215131,10257,204874,5853.542857,284.9166667,19.97406649
NM_001039753,EML6,41,40,247009,7893,239116,5977.9,192.5121951,30.2946915
NM_152385,CLHC1,13,12,59764,5359,54405,4533.75,412.2307692,10.15208061
NM_178313,SPTBN1,31,30,103916,9106,94810,3160.333333,293.7419355,10.41181638
NM_001135598,CLHC1,11,10,60014,4906,55108,5510.8,446,11.23277619
NM_001039349,EFEMP1,11,10,58203,3064,55139,5513.9,278.5454545,17.99575718
NM_001039348,EFEMP1,12,11,58203,3106,55097,5008.818182,258.8333333,17.73889247
NM_001122964,SMEK2,17,16,70434,5625,64809,4050.5625,330.8823529,11.5216
NM_020463,SMEK2,15,14,70434,5368,65066,4647.571429,357.8666667,12.12108793
NM_001282850,SMEK2,16,15,70434,5528,64906,4327.066667,345.5,11.74131693
NM_001080433,CCDC85A,6,5,202053,3989,198064,39612.8,664.8333333,49.6525445
NM_001130481,VRK2,13,12,113210,1794,111416,9284.666667,138,62.10479376
NM_006296,VRK2,13,12,113280,1999,111281,9273.416667,153.7692308,55.66833417
NM_018062,FANCL,14,13,82139,1731,80408,6185.230769,123.6428571,46.45176199
NM_001130483,VRK2,14,13,113280,2002,111278,8559.846154,143,55.58341658
NM_001130482,VRK2,13,12,113280,1898,111382,9281.833333,146,58.68387777
NM_001130480,VRK2,13,12,113280,1952,111328,9277.333333,150.1538462,57.03278689
NM_001114636,FANCL,14,13,82139,1746,80393,6184.076923,124.7142857,46.0441008
NM_001288837,VRK2,16,15,252271,2515,249756,16650.4,157.1875,99.30656064
NM_001288838,VRK2,16,15,252271,2446,249825,16655,152.875,102.1361406
NM_001288836,VRK2,14,13,113280,2090,111190,8553.076923,149.2857143,53.20095694
NM_001288839,VRK2,12,11,113280,1928,111352,10122.90909,160.6666667,57.75518672
NM_138559,BCL11A,5,4,102333,2363,99970,24992.5,472.6,42.30639018
NM_018014,BCL11A,5,4,102333,3963,98370,24592.5,792.6,24.82210447
NM_022893,BCL11A,4,3,96306,5950,90356,30118.66667,1487.5,15.18588235
NM_032506,KIAA1841,22,21,71808,3138,68670,3270,142.6363636,21.8833652
NM_003400,XPO1,25,24,60351,4855,55496,2312.333333,194.2,11.43069001
NM_014709,USP34,80,79,283261,11390,271871,3441.405063,142.375,23.86927129
NM_001129993,KIAA1841,22,21,58409,4598,53811,2562.428571,209,11.7031318
NM_144709,PUS10,18,17,77819,3828,73991,4352.411765,212.6666667,19.32889237
NM_152516,COMMD1,3,2,230404,716,229688,114844,238.6666667,320.7932961
NM_015910,WDPCP,18,17,467334,3327,464007,27294.52941,184.8333333,139.4670875
NM_001199112,MDH1,8,7,18047,1356,16691,2384.428571,169.5,12.30899705
NM_001199111,MDH1,9,8,18047,1454,16593,2074.125,161.5555556,11.41196699
NM_001142614,EHBP1,23,22,339591,4895,334696,15213.45455,212.826087,68.37507661
NM_015252,EHBP1,25,24,340622,5189,335433,13976.375,207.56,64.64309115
NM_005917,MDH1,9,8,18589,1658,16931,2116.375,184.2222222,10.21170084
NM_001142616,EHBP1,23,22,340622,4974,335648,15256.72727,216.2608696,67.48049859
NM_020651,PELI1,7,6,51821,3774,48047,8007.833333,539.1428571,12.73105458
NM_001001521,UGP2,10,9,50600,2122,48478,5386.444444,212.2,22.84542884
NM_006759,UGP2,10,9,49684,2178,47506,5278.444444,217.8,21.8117539
NM_014755,SERTAD2,2,1,22293,5550,16743,16743,2775,3.016756757
NM_016516,VPS54,23,22,126549,4017,122532,5569.636364,174.6521739,30.50336072
NM_001005739,VPS54,23,22,126549,3981,122568,5571.272727,173.0869565,30.78824416
NM_002398,MEIS1,13,12,137361,3194,134167,11180.58333,245.6923077,42.00594865
NM_019002,ETAA1,6,5,13093,3289,9804,1960.8,548.1666667,2.980845242
NM_001190265,C1D,6,5,20829,1290,19539,3907.8,215,15.14651163
NM_001190263,C1D,6,5,20829,1277,19552,3910.4,212.8333333,15.31088489
NM_006333,C1D,5,4,20829,1212,19617,4904.25,242.4,16.18564356
NM_000945,PPP3R1,6,5,73664,3017,70647,14129.4,502.8333333,23.41630759
NM_173177,C1D,5,4,20829,1199,19630,4907.5,239.8,16.37197665
NM_002056,GFPT1,19,18,67487,8668,58819,3267.722222,456.2105263,6.785763729
NM_032208,ANTXR1,18,17,236185,5911,230274,13545.52941,328.3888889,38.95686009
NM_053034,ANTXR1,15,14,159415,1651,157764,11268.85714,110.0666667,95.55663234
NM_014911,AAK1,22,21,185852,21287,164565,7836.428571,967.5909091,7.730774651
NM_006857,SNRNP27,6,5,11295,1444,9851,1970.2,240.6666667,6.822022161
NM_001244710,GFPT1,20,19,67487,8723,58764,3092.842105,436.15,6.736673163
NM_018153,ANTXR1,13,12,133222,2359,130863,10905.25,181.4615385,55.47392963
NM_001153,ANXA4,13,12,84471,2155,82316,6859.666667,165.7692308,38.19767981
NM_001692,ATP6V1B1,14,13,29565,1953,27612,2124,139.5,14.13824885
NM_001258027,CLEC4F,7,6,11958,2308,9650,1608.333333,329.7142857,4.181109185
NM_173535,CLEC4F,7,6,11957,2480,9477,1579.5,354.2857143,3.821370968
NM_017488,ADD2,17,16,106161,4136,102025,6376.5625,243.2941176,24.66755319
NM_017482,ADD2,13,12,93161,3829,89332,7444.333333,294.5384615,23.33037347
NM_003236,TGFA,6,5,106737,4316,102421,20484.2,719.3333333,23.73053753
NM_003096,SNRPG,4,3,12365,583,11782,3927.333333,145.75,20.20926244
NM_017880,C2orf42,10,9,41136,2534,38602,4289.111111,253.4,15.23362273
NM_001617,ADD2,16,15,106161,4049,102112,6807.466667,253.0625,25.21906644
NM_001099691,TGFA,6,5,106737,4313,102424,20484.8,718.8333333,23.74773939
NM_001185055,ADD2,12,11,93161,3709,89452,8132,309.0833333,24.1175519
NM_001185054,ADD2,16,15,105633,3803,101830,6788.666667,237.6875,26.77622929
NM_001252612,ZNF638,28,27,103308,6858,96450,3572.222222,244.9285714,14.06386702
NM_001130987,DYSF,56,55,220063,6828,213235,3877,121.9285714,31.22949619
NM_001130985,DYSF,55,54,220063,6764,213299,3949.981481,122.9818182,31.53444707
NM_001130981,DYSF,56,55,233142,7060,226082,4110.581818,126.0714286,32.02294618
NM_001130984,DYSF,55,54,220063,6734,213329,3950.537037,122.4363636,31.67938818
NM_001130983,DYSF,56,55,220063,6777,213286,3877.927273,121.0178571,31.47203777
NM_001130982,DYSF,56,55,220063,6807,213256,3877.381818,121.5535714,31.32892611
NM_001130977,DYSF,55,54,233142,6966,226176,4188.444444,126.6545455,32.46856158
NM_001252613,ZNF638,28,27,103308,6479,96829,3586.259259,231.3928571,14.94505325
NM_003494,DYSF,55,54,233142,6945,226197,4188.833333,126.2727273,32.56976242
NM_001014972,ZNF638,28,27,103308,6532,96776,3584.296296,233.2857143,14.81567667
NM_001130986,DYSF,54,53,220063,6670,213393,4026.283019,123.5185185,31.99295352
NM_001130455,DYSF,55,54,220063,6713,213350,3950.925926,122.0545455,31.78161776
NM_001130976,DYSF,54,53,233142,6902,226240,4268.679245,127.8148148,32.77890467
NM_014497,ZNF638,28,27,103308,6542,96766,3583.925926,233.6428571,14.79150107
NM_020459,PAIP2B,4,3,44367,6304,38063,12687.66667,1576,6.037912437
NM_001130980,DYSF,55,54,233142,6996,226146,4187.888889,127.2,32.32504288
NM_001130978,DYSF,56,55,233142,7009,226133,4111.509091,125.1607143,32.26323299
NM_001130979,DYSF,56,55,233142,7039,226103,4110.963636,125.6964286,32.12146612
NM_015189,EXOC6B,22,21,646735,2616,644119,30672.33333,118.9090909,246.2228593
NM_144579,SFXN5,14,13,129802,4154,125648,9665.230769,296.7142857,30.24747232
NM_015120,ALMS1,23,22,224162,12945,211217,9600.772727,562.826087,16.31649285
NM_001287491,TET3,11,10,121773,11398,110375,11037.5,1036.181818,9.683716441
NM_000189,HK2,18,17,60701,7111,53590,3152.352941,395.0555556,7.536211503
NM_001281296,M1AP,10,9,90457,2550,87907,9767.444444,255,34.47333333
NM_001281295,M1AP,7,6,73080,1385,71695,11949.16667,197.8571429,51.76534296
NM_022492,TTC31,13,12,11493,2942,8551,712.5833333,226.3076923,2.906526173
NM_015727,TACR1,4,3,148484,1736,146748,48916,434,84.53225806
NM_001058,TACR1,5,4,153057,4783,148274,37068.5,956.6,31.00020907
NM_138804,M1AP,11,10,90156,2554,87602,8760.2,232.1818182,34.29992169
NM_001201334,GCFC2,17,16,47902,4221,43681,2730.0625,248.2941176,10.34849562
NM_032181,EVA1A,4,3,77406,1819,75587,25195.66667,454.75,41.55415063
NM_001135032,EVA1A,4,3,68650,1859,66791,22263.66667,464.75,35.92845616
NM_003203,GCFC2,17,16,48281,4453,43828,2739.25,261.9411765,9.84235347
NM_003849,SUCLG1,9,8,35941,1466,34475,4309.375,162.8888889,23.51637108
NM_001277053,TRABD2A,7,6,59580,1981,57599,9599.833333,283,29.07571933
NM_031283,TCF7L1,12,11,176930,2930,174000,15818.18182,244.1666667,59.38566553
NM_001135022,ELMOD3,14,13,37034,2431,34603,2661.769231,173.6428571,14.23406006
NM_001080824,TRABD2A,6,5,59580,1833,57747,11549.4,305.5,31.50409165
NM_032213,ELMOD3,11,10,37034,2783,34251,3425.1,253,12.30722242
NM_001256728,USP39,12,11,37183,2100,35083,3189.363636,175,16.70619048
NM_001256727,USP39,13,12,37183,2176,35007,2917.25,167.3846154,16.08777574
NM_001256725,USP39,14,13,33194,2129,31065,2389.615385,152.0714286,14.59135744
NM_006590,USP39,13,12,33194,2291,30903,2575.25,176.2307692,13.48886949
NM_001256726,USP39,12,11,33194,2154,31040,2821.818182,179.5,14.41039926
NM_001135023,ELMOD3,13,12,37034,2386,34648,2887.333333,183.5384615,14.52137469
NM_001135021,ELMOD3,15,14,37034,2616,34418,2458.428571,174.4,13.15672783
NM_001164732,REEP1,5,4,123659,3623,120036,30009,724.6,33.13165885
NM_001164731,REEP1,6,5,123659,3786,119873,23974.6,631,31.66217644
NM_001164730,REEP1,7,6,124088,3744,120344,20057.33333,534.8571429,32.14316239
NM_016079,CHMP3,6,5,60069,3198,56871,11374.2,533,17.78330206
NM_006839,IMMT,15,14,51840,3016,48824,3487.428571,201.0666667,16.18832891
NM_001193517,CHMP3,6,5,60069,3078,56991,11398.2,513,18.51559454
NM_001198954,RNF103-CHMP3,8,7,217694,3381,214313,30616.14286,422.625,63.38745933
NM_001100169,IMMT,15,14,51840,3013,48827,3487.642857,200.8666667,16.20544308
NM_001100170,IMMT,15,14,51840,2983,48857,3489.785714,198.8666667,16.37847804
NM_022912,REEP1,7,6,123659,3860,119799,19966.5,551.4285714,31.03601036
NM_003896,ST3GAL5,7,6,49888,2389,47499,7916.5,341.2857143,19.88237756
NM_001005753,CHMP3,5,4,60069,3136,56933,14233.25,627.2,18.15465561
NM_001024457,RGPD1,23,22,96363,6715,89648,4074.909091,291.9565217,13.35040953
NM_001078170,RGPD2,23,22,98928,5523,93405,4245.681818,240.1304348,16.91200435
NM_016618,KRCC1,4,3,28526,1757,26769,8923,439.25,15.23562891
NM_144563,RPIA,9,8,59278,1843,57435,7179.375,204.7777778,31.16386327
NM_001244676,THNSL2,9,8,16344,2174,14170,1771.25,241.5555556,6.517939282
NM_001244678,THNSL2,6,5,16344,1567,14777,2955.4,261.1666667,9.430121251
NM_018271,THNSL2,8,7,13500,1989,11511,1644.428571,248.625,5.787330317
NM_004836,EIF2AK3,17,16,70837,4665,66172,4135.75,274.4117647,14.18478028
NM_032788,ZNF514,5,4,11865,3209,8656,2164,641.8,2.697413524
NM_144707,PROM2,24,23,16856,3847,13009,565.6086957,160.2916667,3.381596049
NM_001165978,PROM2,24,23,16856,4756,12100,526.0869565,198.1666667,2.544154752
NM_001165977,PROM2,24,23,16856,2947,13909,604.7391304,122.7916667,4.719714964
NM_016044,FAHD2A,8,7,10433,1306,9127,1303.857143,163.25,6.988514548
NM_030805,LMAN2L,8,7,34148,2417,31731,4533,302.125,13.12825817
NM_001008949,ITPRIPL1,3,2,3031,2060,971,485.5,686.6666667,0.471359223
NM_001142292,LMAN2L,9,8,34148,2451,31697,3962.125,272.3333333,12.93227254
NM_020151,STARD7,8,7,23972,3387,20585,2940.714286,423.375,6.077649838
NM_178495,ITPRIPL1,1,0,2158,2158,NA,NA,2158,NA
NM_001163524,ITPRIPL1,2,1,2148,1816,332,332,908,0.182819383
NM_001163523,ITPRIPL1,2,1,3024,1949,1075,1075,974.5,0.551564905
NM_001122646,FAM178B,17,16,110684,2702,107982,6748.875,158.9411765,39.96373057
NM_025190,ANKRD36B,44,43,85169,6030,79139,1840.44186,137.0454545,13.12421227
NM_001164315,ANKRD36,76,75,151026,6344,144682,1929.093333,83.47368421,22.80611602
NM_001008215,COA5,3,2,9197,1770,7427,3713.5,590,4.196045198
NM_144992,VWA3B,28,27,225817,4775,221042,8186.740741,170.5357143,46.29151832
NM_001566,INPP4A,26,25,136965,3349,133616,5344.64,128.8076923,39.89728277
NM_001134225,INPP4A,25,24,146177,6762,139415,5808.958333,270.48,20.61742088
NM_001134224,INPP4A,26,25,146177,6778,139399,5575.96,260.6923077,20.56639127
NM_207362,KIAA1211L,10,9,142377,3879,138498,15388.66667,387.9,35.70456303
NM_004027,INPP4A,26,25,146177,6661,139516,5580.64,256.1923077,20.94520342
NM_015904,EIF5B,24,23,62896,4722,58174,2529.304348,196.75,12.31977975
NM_002518,NPAS2,21,20,176676,4025,172651,8632.55,191.6666667,42.89465839
NM_024065,PDCL3,6,5,13785,1081,12704,2540.8,180.1666667,11.75208141
NM_198461,LONRF2,12,11,49444,13924,35520,3229.090909,1160.333333,2.550991095
NM_001261419,IL1R2,7,6,32914,1211,31703,5283.833333,173,26.17919075
NM_001242560,MAP4K4,31,30,196989,7558,189431,6314.366667,243.8064516,25.06364117
NM_145686,MAP4K4,31,30,196989,7672,189317,6310.566667,247.483871,24.67635558
NM_145687,MAP4K4,31,30,196616,7116,189500,6316.666667,229.5483871,26.63012929
NM_001242559,MAP4K4,30,29,196616,7196,189420,6531.724138,239.8666667,26.3229572
NM_004633,IL1R2,9,8,36580,1465,35115,4389.375,162.7777778,23.96928328
NM_004834,MAP4K4,30,29,196989,7347,189642,6539.37931,244.9,25.81216823
NM_153836,CREG2,4,3,39151,3492,35659,11886.33333,873,10.21162658
NM_003048,SLC9A2,12,11,91645,5454,86191,7835.545455,454.5,15.80326366
NM_144632,TMEM182,5,4,55650,3593,52057,13014.25,718.6,14.48844976
NM_201557,FHL2,6,5,77949,1702,76247,15249.4,283.6666667,44.79847239
NM_032411,C2orf40,4,3,12498,786,11712,3904,196.5,14.90076336
NM_003581,NCK2,5,4,149212,2522,146690,36672.5,504.4,58.16415543
NM_001004722,NCK2,4,3,149212,1799,147413,49137.66667,449.75,81.94163424
NM_001142351,ST6GAL2,6,5,84556,6793,77763,15552.6,1132.166667,11.44751951
NM_032528,ST6GAL2,6,5,85509,6863,78646,15729.2,1143.833333,11.45942008
NM_001142352,ST6GAL2,6,5,74033,1662,72371,14474.2,277,43.54452467
NM_001056,SULT1C2,8,7,21278,2803,18475,2639.285714,350.375,6.591152337
NM_176825,SULT1C2,9,8,21278,2837,18441,2305.125,315.2222222,6.500176243
NM_001193483,LIMS1,10,9,152893,4479,148414,16490.44444,447.9,33.13552132
NM_022336,EDAR,12,11,94903,4226,90677,8243.363636,352.1666667,21.45693327
NM_144978,CCDC138,15,14,89630,2211,87419,6244.214286,147.4,39.538218
NM_000272,NPHP1,20,19,81727,2770,78957,4155.631579,138.5,28.50433213
NM_001128178,NPHP1,20,19,81727,2602,79125,4164.473684,130.1,30.40930054
NM_144710,Sep-10,11,10,71411,3267,68144,6814.4,297,20.85827977
NM_207181,NPHP1,20,19,81727,2767,78960,4155.789474,138.35,28.53632093
NM_001128179,NPHP1,18,17,81727,2411,79316,4665.647059,133.9444444,32.89755288
NM_178584,Sep-10,10,9,71411,3197,68214,7579.333333,319.7,21.33687832
NM_001278617,BUB1,24,23,40411,3489,36922,1605.304348,145.375,10.58240183
NM_001278616,BUB1,24,23,40411,3600,36811,1600.478261,150,10.22527778
NM_001142807,ACOXL,18,17,385651,2391,383260,22544.70588,132.8333333,160.2927645
NM_001123363,RGPD6,24,23,64932,7664,57268,2489.913043,319.3333333,7.472338205
NM_005054,RGPD5,23,22,63282,7188,56094,2549.727273,312.5217391,7.803839733
NM_004336,BUB1,25,24,40411,3661,36750,1531.25,146.44,10.03824092
NM_006343,MERTK,19,18,130756,3645,127111,7061.722222,191.8421053,34.87270233
NM_032494,ZC3H8,9,8,39227,1613,37614,4701.75,179.2222222,23.31928084
NM_032824,TMEM87B,19,18,64097,5231,58866,3270.333333,275.3157895,11.25329765
NM_022662,ANAPC1,48,47,116529,7784,108745,2313.723404,162.1666667,13.97032374
NM_003466,PAX8,12,11,62926,4067,58859,5350.818182,338.9166667,14.47233833
NM_152515,CKAP2L,9,8,26812,3282,23530,2941.25,364.6666667,7.169408897
NM_013992,PAX8,9,8,62926,3652,59274,7409.25,405.7777778,16.2305586
NM_013953,PAX8,10,9,62926,3755,59171,6574.555556,375.5,15.75792277
NM_013952,PAX8,12,11,62926,3988,58938,5358,332.3333333,14.77883651
NM_001277140,ACTR3,12,11,70956,5503,65453,5950.272727,458.5833333,11.89405779
NM_005721,ACTR3,12,11,71620,5712,65908,5991.636364,476,11.53851541
NM_019044,CCDC93,24,23,98687,6953,91734,3988.434783,289.7083333,13.19344168
NM_183240,TMEM37,2,1,6652,1689,4963,4963,844.5,2.938425104
NM_001271049,PCDP1,24,23,112231,2864,109367,4755.086957,119.3333333,38.18680168
NM_001017927,C2orf76,7,6,64240,957,63283,10547.16667,136.7142857,66.12643678
NM_024121,TMEM185B,1,0,5939,5939,NA,NA,5939,NA
NM_020909,EPB41L5,25,24,166095,6632,159463,6644.291667,265.28,24.0444813
NM_001184939,EPB41L5,17,16,93890,4402,89488,5593,258.9411765,20.32894139
NM_001184938,EPB41L5,17,16,93709,4692,89017,5563.5625,276,18.97208014
NM_001184937,EPB41L5,24,23,166095,6500,159595,6938.913043,270.8333333,24.55307692
NM_014553,TFCP2L1,15,14,68616,9301,59315,4236.785714,620.0666667,6.377271261
NM_015282,CLASP1,39,38,311702,8131,303571,7988.710526,208.4871795,37.33501414
NM_001207051,CLASP1,38,37,311702,7947,303755,8209.594595,209.1315789,38.22259972
NM_001142274,CLASP1,38,37,311702,7929,303773,8210.081081,208.6578947,38.31164081
NM_001142273,CLASP1,39,38,311702,7954,303748,7993.368421,203.9487179,38.18808147
NM_130773,CNTNAP5,24,23,890092,5398,884694,38464.95652,224.9166667,163.8929233
NM_001080527,MYO7B,47,46,101927,6762,95165,2068.804348,143.8723404,14.07349896
NM_001145928,SAP130,21,20,86080,4194,81886,4094.3,199.7142857,19.52455889
NM_006609,MAP3K2,16,15,44562,10886,33676,2245.066667,680.375,3.093514606
NM_024545,SAP130,20,19,86080,4088,81992,4315.368421,204.4,20.05675147
NM_025029,MZT2B,3,2,8801,936,7865,3932.5,312,8.402777778
NM_015320,ARHGEF4,14,13,130604,3670,126934,9764.153846,262.1428571,34.58692098
NM_032995,ARHGEF4,12,11,129858,3848,126010,11455.45455,320.6666667,32.7468815
NM_001083538,POTEE,15,14,46494,3455,43039,3074.214286,230.3333333,12.45701881
NM_013310,C2orf27A,4,3,44915,1223,43692,14564,305.75,35.72526574
NM_001508,GPR39,2,1,230024,2823,227201,227201,1411.5,80.48211123
NM_002410,MGAT5,16,15,200364,8161,192203,12813.53333,510.0625,23.55140301
NM_012233,RAB3GAP1,24,23,118446,4941,113505,4935,205.875,22.97207043
NM_138326,ACMSD,10,9,63418,1260,62158,6906.444444,126,49.33174603
NM_032143,ZRANB3,21,20,334269,6751,327518,16375.9,321.4761905,48.51399793
NM_001172435,RAB3GAP1,25,24,118446,4963,113483,4728.458333,198.52,22.86580697
NM_001286569,ZRANB3,22,21,333763,6970,326793,15561.57143,316.8181818,46.8856528
NM_001286568,ZRANB3,21,20,333763,6840,326923,16346.15,325.7142857,47.79576023
NM_001282800,R3HDM1,23,22,138949,4394,134555,6116.136364,191.0434783,30.62243969
NM_002299,LCT,17,16,49337,6291,43046,2690.375,370.0588235,6.842473375
NM_001349,DARS,16,15,78970,2338,76632,5108.8,146.125,32.77673225
NM_001282798,R3HDM1,26,25,138949,4740,134209,5368.36,182.3076923,28.31413502
NM_001001664,SPOPL,11,10,71457,5745,65712,6571.2,522.2727273,11.4381201
NM_018460,ARHGAP15,14,13,639024,1773,637251,49019.30769,126.6428571,359.4196277
NM_024659,GTDC1,10,9,291327,2416,288911,32101.22222,241.6,119.5823675
NM_001164629,GTDC1,12,11,386522,2691,383831,34893.72727,224.25,142.6350799
NM_001171653,ZEB2,9,8,136018,9180,126838,15854.75,1020,13.8167756
NM_014795,ZEB2,10,9,136018,9253,126765,14085,925.3,13.69988112
NM_001006636,GTDC1,12,11,348481,2706,345775,31434.09091,225.5,127.7808574
NM_001284235,GTDC1,7,6,326783,2557,324226,54037.66667,365.2857143,126.7993743
NM_001284238,GTDC1,14,13,386522,2907,383615,29508.84615,207.6428571,131.9625043
NM_001284233,GTDC1,9,8,265567,2367,263200,32900,263,111.1956063
NM_001284234,GTDC1,10,9,386522,2404,384118,42679.77778,240.4,159.7828619
NM_001190879,ORC4,15,14,90352,6725,83627,5973.357143,448.3333333,12.43524164
NM_002552,ORC4,14,13,90365,6608,83757,6442.846154,472,12.6750908
NM_181742,ORC4,14,13,91209,6612,84597,6507.461538,472.2857143,12.79446461
NM_181741,ORC4,14,13,90499,6717,83782,6444.769231,479.7857143,12.47312788
NM_001616,ACVR2A,11,10,85834,5264,80570,8057,478.5454545,15.30585106
NM_001278580,ACVR2A,11,10,86312,5178,81134,8113.4,470.7272727,15.66898416
NM_001278579,ACVR2A,12,11,86312,5376,80936,7357.818182,448,15.05505952
NM_001190882,ORC4,13,12,90342,6485,83857,6988.083333,498.8461538,12.9309175
NM_001190881,ORC4,11,10,90366,6339,84027,8402.7,576.2727273,13.25556081
NM_015630,EPC2,14,13,142578,3655,138923,10686.38462,261.0714286,38.00902873
NM_004522,KIF5C,26,25,250483,6984,243499,9739.96,268.6153846,34.86526346
NM_194317,LYPD6,5,4,143632,4095,139537,34884.25,819,34.07496947
NM_001195685,LYPD6,5,4,144162,4105,140057,35014.25,821,34.11863581
NM_001177665,RIF1,34,33,67258,9984,57274,1735.575758,293.6470588,5.736578526
NM_000726,CACNB4,14,13,266309,7992,258317,19870.53846,570.8571429,32.32194695
NM_018151,RIF1,36,35,67465,9891,57574,1644.971429,274.75,5.820847235
NM_001177664,RIF1,35,34,67462,9715,57747,1698.441176,277.5714286,5.944107051
NM_001177663,RIF1,35,34,67465,9812,57653,1695.676471,280.3428571,5.87576437
NM_001271208,NEB,183,182,249150,26490,222660,1223.406593,144.7540984,8.405436014
NM_001145798,CACNB4,13,12,266309,7805,258504,21542,600.3846154,33.1203075
NM_001164507,NEB,182,181,249150,26384,222766,1230.751381,144.967033,8.443223166
NM_001164508,NEB,182,181,249150,26384,222766,1230.751381,144.967033,8.443223166
NM_004543,NEB,149,148,249150,20747,228403,1543.263514,139.2416107,11.00896515
NM_001005746,CACNB4,14,13,265951,7942,258009,19846.84615,567.2857143,32.48665324
NM_001005747,CACNB4,13,12,141201,8079,133122,11093.5,621.4615385,16.47753435
NM_052905,FMNL2,26,25,314599,5601,308998,12359.92,215.4230769,55.16836279
NM_152522,ARL6IP6,4,3,43362,2830,40532,13510.66667,707.5,14.32226148
NM_001260508,KCNJ3,2,1,159773,4525,155248,155248,2262.5,34.30895028
NM_002239,KCNJ3,3,2,159773,4743,155030,77515,1581,32.68606367
NM_001083112,GPD2,17,16,150952,6046,144906,9056.625,355.6470588,23.96725108
NM_000408,GPD2,17,16,150017,5820,144197,9012.3125,342.3529412,24.77611684
NM_001111033,ACVR1C,7,6,102122,8412,93710,15618.33333,1201.714286,11.14003804
NM_001111032,ACVR1C,8,7,102122,8644,93478,13354,1080.5,10.81420639
NM_001171637,CCDC148,8,7,168167,1455,166712,23816,181.875,114.5786942
NM_145259,ACVR1C,9,8,102122,8885,93237,11654.625,987.2222222,10.49375352
NM_001105,ACVR1,11,10,138667,3056,135611,13561.1,277.8181818,44.37532723
NM_001135098,UPP2,9,8,140977,2418,138559,17319.875,268.6666667,57.30314309
NM_138803,CCDC148,14,13,285398,2860,282538,21733.69231,204.2857143,98.78951049
NM_001111067,ACVR1,11,10,139418,2875,136543,13654.3,261.3636364,47.49321739
NM_173355,UPP2,7,6,34286,2419,31867,5311.166667,345.5714286,13.17362547
NM_001145909,TANC1,27,26,264026,7515,256511,9865.807692,278.3333333,34.13320027
NM_033394,TANC1,27,26,264026,7534,256492,9865.076923,279.037037,34.04459782
NM_002349,LY75,35,34,101401,6965,94436,2777.529412,199,13.55865039
NM_001198760,LY75-CD302,38,37,136130,8789,127341,3441.648649,231.2894737,14.48867903
NM_001282390,ITGB6,14,13,100649,4448,96201,7400.076923,317.7142857,21.62792266
NM_001282389,ITGB6,15,14,100649,4529,96120,6865.714286,301.9333333,21.22322809
NM_001282388,ITGB6,14,13,100649,4621,96028,7386.769231,330.0714286,20.78078338
NM_001282355,ITGB6,13,12,100649,4379,96270,8022.5,336.8461538,21.98447134
NM_001282354,ITGB6,13,12,100649,4415,96234,8019.5,339.6153846,21.79705549
NM_001282353,ITGB6,16,15,100649,4596,96053,6403.533333,287.25,20.89926023
NM_007366,PLA2R1,30,29,121868,5663,116205,4007.068966,188.7666667,20.52004238
NM_001195641,PLA2R1,30,29,121868,5657,116211,4007.275862,188.5666667,20.54286724
NM_002897,RBMS1,14,13,221658,4291,217367,16720.53846,306.5,50.65649033
NM_016836,RBMS1,14,13,221658,4300,217358,16719.84615,307.1428571,50.54837209
NM_000888,ITGB6,15,14,100649,4702,95947,6853.357143,313.4666667,20.4055721
NM_001198759,LY75-CD302,39,38,136130,8958,127172,3346.631579,229.6923077,14.19647243
NM_001007267,PLA2R1,27,26,116802,5192,111610,4292.692308,192.2962963,21.49653313
NM_133484,TANK,4,3,68026,675,67351,22450.33333,168.75,99.77925926
NM_005805,PSMD14,12,11,103444,1729,101715,9246.818182,144.0833333,58.82880278
NM_004180,TANK,8,7,99218,2097,97121,13874.42857,262.125,46.31425846
NM_001935,DPP4,26,25,82299,3926,78373,3134.92,151,19.96255731
NM_004460,FAP,26,25,72847,2806,70041,2801.64,107.9230769,24.96115467
NM_018086,FIGN,3,2,128397,4538,123859,61929.5,1512.666667,27.29374174
NM_004490,GRB14,14,13,129039,2401,126638,9741.384615,171.5,52.74385673
NM_024969,CSRNP3,5,4,117073,11692,105381,26345.25,2338.4,9.013085871
NM_001199148,SLC38A11,11,10,57328,1801,55527,5552.7,163.7272727,30.83120489
NM_021007,SCN2A,27,26,98481,8887,89594,3445.923077,329.1481481,10.08146731
NM_001040143,SCN2A,26,25,96539,8581,87958,3518.32,330.0384615,10.25032048
NM_001172173,CSRNP3,7,6,219762,11795,207967,34661.16667,1685,17.63179313
NM_001040142,SCN2A,27,26,152910,8821,144089,5541.884615,326.7037037,16.3347693
NM_173512,SLC38A11,10,9,57328,1734,55594,6177.111111,173.4,32.06113033
NM_002977,SCN9A,27,26,180802,9787,171015,6577.5,362.4814815,17.47368959
NM_006920,SCN1A,26,25,84481,8126,76355,3054.2,312.5384615,9.396381984
NM_001202435,SCN1A,28,27,159974,8370,151604,5614.962963,298.9285714,18.11278375
NM_001165963,SCN1A,26,25,84481,8159,76322,3052.88,313.8076923,9.354332639
NM_001165964,SCN1A,26,25,84481,8075,76406,3056.24,310.5769231,9.462043344
NM_020981,B3GALT1,2,1,52186,2170,50016,50016,1085,23.04884793
NM_020675,SPC25,7,6,19545,1353,18192,3032,193.2857143,13.44567627
NM_203463,CERS6,10,9,318887,6837,312050,34672.22222,683.7,45.64136317
NM_001256126,CERS6,11,10,318887,6862,312025,31202.5,623.8181818,45.4714369
NM_024622,FASTKD1,15,14,44171,3027,41144,2938.857143,201.8,13.59233565
NM_001281476,FASTKD1,14,13,44171,2897,41274,3174.923077,206.9285714,14.24715223
NM_003142,SSB,12,11,13251,1718,11533,1048.454545,143.1666667,6.713038417
NM_001085447,CCDC173,9,8,48998,2178,46820,5852.5,242,21.49678604
NM_004525,LRP2,79,78,235505,15814,219691,2816.551282,200.1772152,13.89218414
NM_001083615,MYO3B,34,33,477021,6165,470856,14268.36364,181.3235294,76.3756691
NM_000817,GAD1,17,16,44461,3491,40970,2560.625,205.3529412,11.73589229
NM_138995,MYO3B,35,34,477021,6247,470774,13846.29412,178.4857143,75.36001281
NM_001003845,SP5,2,1,2643,1949,694,694,974.5,0.356080041
NM_199227,METAP1D,10,9,80785,1544,79241,8804.555556,154.4,51.32189119
NM_024770,METTL8,10,9,117401,8144,109257,12139.66667,814.4,13.41564342
NM_007023,RAPGEF4,31,30,317097,4379,312718,10423.93333,141.2580645,71.41310802
NM_001282901,RAPGEF4,25,24,124689,3737,120952,5039.666667,149.48,32.36606904
NM_001282899,RAPGEF4,28,27,192856,4007,188849,6994.407407,143.1071429,47.1297729
NM_001100397,RAPGEF4,28,27,231307,4135,227172,8413.777778,147.6785714,54.93881499
NM_001282900,RAPGEF4,27,26,192856,3952,188904,7265.538462,146.3703704,47.79959514
NM_001256092,ATF2,13,12,95958,4092,91866,7655.5,314.7692308,22.45014663
NM_001256094,ATF2,8,7,53965,1380,52585,7512.142857,172.5,38.10507246
NM_001822,CHN1,13,12,205941,2536,203405,16950.41667,195.0769231,80.20701893
NM_001256091,ATF2,14,13,95958,4150,91808,7062.153846,296.4285714,22.12240964
NM_001256090,ATF2,15,14,95958,4226,91732,6552.285714,281.7333333,21.70657832
NM_001256093,ATF2,13,12,95958,4124,91834,7652.833333,317.2307692,22.26818623
NM_001025201,CHN1,13,12,206067,2459,203608,16967.33333,189.1538462,82.80113867
NM_001077269,WIPF1,8,7,123327,4657,118670,16952.85714,582.125,25.48207
NM_001880,ATF2,14,13,95958,4190,91768,7059.076923,299.2857143,21.90167064
NM_004882,CIR1,10,9,47567,1803,45764,5084.888889,180.3,25.38214088
NM_001080458,EVX2,3,2,3857,1620,2237,1118.5,540,1.380864198
NM_030650,KIAA1715,13,12,76610,5778,70832,5902.666667,444.4615385,12.25891312
NM_006164,NFE2L2,5,4,34830,2860,31970,7992.5,572,11.17832168
NM_001145413,NFE2L2,5,4,33588,2726,30862,7715.5,545.2,11.32134996
NM_001145412,NFE2L2,5,4,33588,2747,30841,7710.25,549.4,11.2271569
NM_032523,OSBPL6,25,24,204954,7248,197706,8237.75,289.92,27.27731788
NM_001077196,PDE11A,17,16,265491,7796,257695,16105.9375,458.5882353,33.05477168
NM_001077197,PDE11A,21,20,485091,8330,476761,23838.05,396.6666667,57.23421369
NM_016953,PDE11A,20,19,449507,9298,440209,23168.89474,464.9,47.34448268
NM_001077358,PDE11A,19,18,293439,1888,291551,16197.27778,99.36842105,154.4231992
NM_001201482,OSBPL6,24,23,204954,7139,197815,8600.652174,297.4583333,27.70906289
NM_001201481,OSBPL6,24,23,204954,7154,197800,8600,298.0833333,27.64886777
NM_001201480,OSBPL6,26,25,204954,7324,197630,7905.2,281.6923077,26.98388859
NM_133437,TTN,192,191,281434,82795,198639,1039.994764,431.2239583,2.399166616
NM_133432,TTN,192,191,281434,82594,198840,1041.04712,430.1770833,2.407438797
NM_133378,TTN,312,311,281434,101830,179604,577.5048232,326.3782051,1.763763135
NM_003319,TTN,191,190,281434,82218,199216,1048.505263,430.460733,2.423021723
NM_001256850,TTN,313,312,281435,104613,176822,566.7371795,334.2268371,1.690248822
NM_001267550,TTN,363,362,281435,109586,171849,474.7209945,301.8898072,1.568165642
NM_178123,SESTD1,18,17,162933,10466,152467,8968.647059,581.4444444,14.56783872
NM_173648,CCDC141,24,23,220304,9151,211153,9180.565217,381.2916667,23.07430882
NM_001278555,UBE2E3,6,5,83044,1356,81688,16337.6,226,60.24188791
NM_001278554,UBE2E3,6,5,82305,1548,80757,16151.4,258,52.16860465
NM_006357,UBE2E3,6,5,82848,1587,81261,16252.2,264.5,51.20415879
NM_182678,UBE2E3,7,6,83044,1389,81655,13609.16667,198.4285714,58.78689705
NM_001261425,PPP1R1C,6,5,145560,3038,142522,28504.4,506.3333333,46.91310072
NM_001261424,PPP1R1C,6,5,145560,3059,142501,28500.2,509.8333333,46.58417784
NM_001258313,PDE1A,14,13,259163,2352,256811,19754.69231,168,109.1883503
NM_001258312,PDE1A,16,15,382812,4919,377893,25192.86667,307.4375,76.82313478
NM_001080545,PPP1R1C,5,4,131934,1083,130851,32712.75,216.6,120.8227147
NM_005019,PDE1A,15,14,382576,4933,377643,26974.5,328.8666667,76.55442935
NM_001003683,PDE1A,15,14,354960,2174,352786,25199,144.9333333,162.275069
NM_013436,NCKAP1,31,30,114009,5028,108981,3632.7,162.1935484,21.674821
NM_205842,NCKAP1,32,31,114009,5047,108962,3514.903226,157.71875,21.58945908
NM_018981,DNAJC10,24,23,63984,5943,58041,2523.521739,247.625,9.766279657
NM_138285,NUP35,9,8,37331,1646,35685,4460.625,182.8888889,21.67982989
NM_001271581,DNAJC10,23,22,63984,5804,58180,2644.545455,252.3478261,10.0241213
NM_001287584,NUP35,10,9,44196,1750,42446,4716.222222,175,24.25485714
NM_001287585,NUP35,10,9,37331,1770,35561,3951.222222,177,20.09096045
NM_177454,FAM171B,8,7,69725,3563,66162,9451.714286,445.375,18.56918327
NM_005795,CALCRL,15,14,106333,6170,100163,7154.5,411.3333333,16.23387358
NM_006287,TFPI,8,7,90263,3923,86340,12334.28571,490.375,22.00866684
NM_001032281,TFPI,7,6,75916,1156,74760,12460,165.1428571,64.67128028
NM_001271751,CALCRL,14,13,106333,6004,100329,7717.615385,428.8571429,16.71035976
NM_016315,GULP1,12,11,304258,3510,300748,27340.72727,292.5,85.68319088
NM_001252669,GULP1,9,8,304258,3198,301060,37632.5,355.3333333,94.14008755
NM_001252668,GULP1,13,12,304258,3522,300736,25061.33333,270.9230769,85.38784781
NM_001289409,PMS1,11,10,93546,3246,90300,9030,295.0909091,27.81885397
NM_001289408,PMS1,12,11,93546,3430,90116,8192.363636,285.8333333,26.2728863
NM_144708,ANKAR,23,22,70667,4439,66228,3010.363636,193,14.91957648
NM_032168,WDR75,21,20,34107,2695,31412,1570.6,128.3333333,11.65565863
NM_000534,PMS1,13,12,93546,3534,90012,7501,271.8461538,25.47028862
NM_001128144,PMS1,12,11,93546,3047,90499,8227.181818,253.9166667,29.70101739
NM_001128143,PMS1,12,11,93546,3416,90130,8193.636364,284.6666667,26.38466042
NM_000393,COL5A2,54,53,147966,6984,140982,2660.037736,129.3333333,20.18642612
NM_002194,INPP1,6,5,28197,2025,26172,5234.4,337.5,12.92444444
NM_001128928,INPP1,7,6,28197,2170,26027,4337.833333,310,11.99400922
NM_014905,GLS,18,17,84725,4850,79875,4698.529412,269.4444444,16.46907216
NM_017694,MFSD6,8,7,93962,4805,89157,12736.71429,600.625,18.55504683
NM_198047,HIBCH,13,12,115413,1918,113495,9457.916667,147.5384615,59.17361835
NM_014362,HIBCH,14,13,115413,1953,113460,8727.692308,139.5,58.0952381
NM_001256310,GLS,15,14,54470,4503,49967,3569.071429,300.2,11.09638019
NM_012223,MYO1B,29,28,180010,4950,175060,6252.142857,170.6896552,35.36565657
NM_001031716,NABP1,6,5,10389,3855,6534,1306.8,642.5,1.694941634
NM_001254736,NABP1,6,5,10452,3454,6998,1399.6,575.6666667,2.026056746
NM_001130158,MYO1B,31,30,180010,5126,174884,5829.466667,165.3548387,34.11705033
NM_001161819,MYO1B,31,30,179863,4964,174899,5829.966667,160.1290323,35.23348106
NM_018897,DNAH7,65,64,331111,12459,318652,4978.9375,191.6769231,25.57604944
NM_004226,STK17B,8,7,38031,5315,32716,4673.714286,664.375,6.155409219
NM_024989,PGAP1,27,26,93728,11140,82588,3176.461538,412.5925926,7.413644524
NM_001080539,CCDC150,28,27,93176,3713,89463,3313.444444,132.6071429,24.09453272
NM_012086,GTF3C3,18,17,36738,4367,32371,1904.176471,242.6111111,7.412640256
NM_001206774,GTF3C3,9,8,19681,1854,17827,2228.375,206,9.615426106
NM_001195144,ANKRD44,28,27,324137,6132,318005,11777.96296,219,51.8599152
NM_153697,ANKRD44,10,9,211328,1648,209680,23297.77778,164.8,127.2330097
NM_144629,RFTN2,9,8,105059,3122,101937,12742.125,346.8888889,32.65118514
NM_006226,PLCL1,6,5,345184,6614,338570,67714,1102.333333,51.18990021
NM_001039693,TYW5,8,7,26827,5378,21449,3064.142857,672.25,3.988285608
NM_033355,CASP8,10,9,54270,2776,51494,5721.555556,277.6,18.54971182
NM_173822,FAM126B,12,11,97953,9345,88608,8055.272727,778.75,9.481861958
NM_001162407,CLK1,13,12,11554,2226,9328,777.3333333,171.2307692,4.19047619
NM_001202516,CFLAR,8,7,56536,10526,46010,6572.857143,1315.75,4.371081132
NM_003879,CFLAR,10,9,56536,10633,45903,5100.333333,1063.3,4.317031882
NM_001228,CASP8,10,9,54270,2921,51349,5705.444444,292.1,17.57925368
NM_001159,AOX1,35,34,85488,4968,80520,2368.235294,141.9428571,16.20772947
NM_033358,CASP8,8,7,48474,1131,47343,6763.285714,141.375,41.85941645
NM_001080124,CASP8,9,8,54270,2756,51514,6439.25,306.2222222,18.691582
NM_001127184,CFLAR,6,5,25448,1304,24144,4828.8,217.3333333,18.51533742
NM_001202519,CFLAR,9,8,56536,11053,45483,5685.375,1228.111111,4.114991405
NM_001202517,CFLAR,9,8,56536,10214,46322,5790.25,1134.888889,4.535147836
NM_015049,TRAK2,16,15,74391,6543,67848,4523.2,408.9375,10.36955525
NM_004071,CLK1,13,12,11737,1946,9791,815.9166667,149.6923077,5.031346351
NM_001277372,LOC100652824,22,21,123910,4051,119859,5707.571429,184.1363636,29.58750926
NM_020919,ALS2,34,33,80911,6952,73959,2241.181818,204.4705882,10.63852129
NM_152388,TMEM237,12,11,22762,5604,17158,1559.818182,467,3.061741613
NM_003507,FZD7,1,0,3852,3852,NA,NA,3852,NA
NM_015934,NOP58,15,14,37871,1980,35891,2563.642857,132,18.12676768
NM_001044385,TMEM237,12,11,23347,5439,17908,1628,453.25,3.292517007
NM_001135745,ALS2,4,3,21716,2896,18820,6273.333333,724,6.498618785
NM_024744,CARF,17,16,74269,6270,67999,4249.9375,368.8235294,10.84513557
NM_001114132,NBEAL1,55,54,203117,9113,194004,3592.666667,165.6909091,21.28870844
NM_213589,RAPH1,14,13,101655,9747,91908,7069.846154,696.2142857,9.429362881
NM_005759,ABI2,10,9,103936,6535,97401,10822.33333,653.5,14.90451415
NM_001104586,CARF,16,15,74269,5372,68897,4593.133333,335.75,12.82520477
NM_173511,FAM117B,8,7,134581,5781,128800,18400,722.625,22.27988237
NM_138468,ICA1L,14,13,98837,8347,90490,6960.769231,596.2142857,10.84102073
NM_001288624,ICA1L,4,3,9630,882,8748,2916,220.5,9.918367347
NM_001288623,ICA1L,13,12,98324,8164,90160,7513.333333,628,11.04360608
NM_001288622,ICA1L,13,12,98837,8219,90618,7551.5,632.2307692,11.02542888
NM_203365,RAPH1,16,15,93868,2785,91083,6072.2,174.0625,32.7048474
NM_001282910,CARF,15,14,74269,5143,69126,4937.571429,342.8666667,13.44079331
NM_001282912,CARF,14,13,74269,5021,69248,5326.769231,358.6428571,13.79167497
NM_001282911,CARF,16,15,74269,5225,69044,4602.933333,326.5625,13.21416268
NM_001282926,ABI2,10,9,103936,6631,97305,10811.66667,663.1,14.67425728
NM_001282925,ABI2,11,10,103936,6650,97286,9728.6,604.5454545,14.62947368
NM_001282932,ABI2,10,9,103936,6645,97291,10810.11111,664.5,14.64123401
NM_006139,CD28,4,3,32440,4890,27550,9183.333333,1222.5,5.63394683
NM_005214,CTLA4,4,3,6174,1979,4195,1398.333333,494.75,2.119757453
NM_001243077,CD28,4,3,32440,4599,27841,9280.333333,1149.75,6.053707328
NM_001243078,CD28,3,2,32440,4532,27908,13954,1510.666667,6.157987643
NM_001037631,CTLA4,3,2,6174,1868,4306,2153,622.6666667,2.305139186
NM_003812,ADAM23,26,25,177488,6251,171237,6849.48,240.4230769,27.39353703
NM_134442,CREB1,9,8,75670,9788,65882,8235.25,1087.555556,6.730894973
NM_001270943,KLF7,4,3,93110,7993,85117,28372.33333,1998.25,10.64894282
NM_001270942,KLF7,5,4,92720,8025,84695,21173.75,1605,10.55389408
NM_003709,KLF7,4,3,91880,8436,83444,27814.66667,2109,9.891417734
NM_004379,CREB1,8,7,75670,9745,65925,9417.857143,1218.125,6.765007696
NM_001080475,PLEKHM3,8,7,204274,9815,194459,27779.85714,1226.875,19.81242995
NM_015040,PIKFYVE,42,41,92486,9943,82543,2013.243902,236.7380952,8.30161923
NM_005048,PTH2R,13,12,87678,2727,84951,7079.25,209.7692308,31.15181518
NM_002374,MAP2,15,14,154433,9460,144973,10355.21429,630.6666667,15.32484144
NM_001039538,MAP2,15,14,310065,5859,304206,21729,390.6,51.92114695
NM_031847,MAP2,13,12,154433,5483,148950,12412.5,421.7692308,27.16578515
NM_031845,MAP2,12,11,154433,5389,149044,13549.45455,449.0833333,27.65707924
NM_152519,KANSL1L,15,14,150618,5425,145193,10370.92857,361.6666667,26.76368664
NM_079422,MYL1,7,6,13473,869,12604,2100.666667,124.1428571,14.50402762
NM_079420,MYL1,7,6,25029,1059,23970,3995,151.2857143,22.63456091
NM_001122633,CPS1,39,38,201427,5764,195663,5149.026316,147.7948718,33.94569743
NM_001025436,SPAG16,5,4,33608,1275,32333,8083.25,255,25.35921569
NM_015657,ABCA12,45,44,100546,8130,92416,2100.363636,180.6666667,11.36728167
NM_001282545,BARD1,7,6,84067,4160,79907,13317.83333,594.2857143,19.20841346
NM_001282543,BARD1,10,9,84067,5459,78608,8734.222222,545.9,14.39970691
NM_001282549,BARD1,5,4,84067,3972,80095,20023.75,794.4,20.16490433
NM_001282548,BARD1,6,5,84067,4102,79965,15993,683.6666667,19.4941492
NM_001080500,VWC2L,4,3,164194,912,163282,54427.33333,228,179.0372807
NM_000465,BARD1,11,10,84067,5517,78550,7855,501.5454545,14.2378104
NM_173076,ABCA12,53,52,206887,9153,197734,3802.576923,172.6981132,21.60319021
NM_212476,FN1,44,43,75614,8300,67314,1565.44186,188.6363636,8.110120482
NM_212478,FN1,46,45,75614,8404,67210,1493.555556,182.6956522,7.997382199
NM_212474,FN1,44,43,75614,7940,67674,1573.813953,180.4545455,8.523173804
NM_002026,FN1,46,45,75614,8479,67135,1491.888889,184.326087,7.91779691
NM_018441,PECR,8,7,43430,1882,41548,5935.428571,235.25,22.07651435
NM_212482,FN1,46,45,75614,8845,66769,1483.755556,192.2826087,7.548784624
NM_001127207,SMARCAL1,18,17,70303,3101,67202,3953.058824,172.2777778,21.67107385
NM_020814,Mar-04,4,3,114167,4454,109713,36571,1113.5,24.6324652
NM_014140,SMARCAL1,18,17,70639,3287,67352,3961.882353,182.6111111,20.49041679
NM_022648,TNS1,33,32,144286,10309,133977,4186.78125,312.3939394,12.9961199
NM_015690,STK36,27,26,30693,4962,25731,989.6538462,183.7777778,5.185610641
NM_020935,USP37,26,25,118112,8058,110054,4402.16,309.9230769,13.65773145
NM_001243313,STK36,27,26,30693,4899,25794,992.0769231,181.4444444,5.265156154
NM_000784,CYP27A1,9,8,33546,2302,31244,3905.5,255.7777778,13.57254561
NM_005876,SPEG,41,40,58656,10691,47965,1199.125,260.7560976,4.486483958
NM_052902,STK11IP,25,24,18579,3626,14953,623.0416667,145.04,4.12382791
NM_001127366,PAX3,9,8,99111,3363,95748,11968.5,373.6666667,28.47100803
NM_181457,PAX3,8,7,97285,2040,95245,13606.42857,255,46.68872549
NM_181460,PAX3,9,8,99111,2948,96163,12020.375,327.5555556,32.6197422
NM_181458,PAX3,9,8,99111,3366,95745,11968.125,374,28.44474153
NM_181461,PAX3,8,7,99111,3118,95993,13713.28571,389.75,30.78672226
NM_181459,PAX3,10,9,99111,3196,95915,10657.22222,319.6,30.01095119
NM_005687,FARSB,17,16,84667,2250,82417,5151.0625,132.3529412,36.62977778
NM_203372,ACSL3,16,15,82389,4270,78119,5207.933333,266.875,18.29484778
NM_004457,ACSL3,17,16,82389,4378,78011,4875.6875,257.5294118,17.81886706
NM_020830,WDFY1,12,11,69989,4619,65370,5942.727273,384.9166667,14.15241394
NM_001039569,AP1S3,5,4,82274,4007,78267,19566.75,801.4,19.53256801
NM_014689,DOCK10,56,55,277525,7487,270038,4909.781818,133.6964286,36.06758381
NM_001277068,MFF,8,7,29160,1638,27522,3931.714286,204.75,16.8021978
NM_001277066,MFF,6,5,32687,1699,30988,6197.6,283.1666667,18.2389641
NM_001277063,MFF,8,7,32687,1888,30799,4399.857143,236,16.31302966
NM_001277061,MFF,11,10,32687,2288,30399,3039.9,208,13.28627622
NM_032276,RHBDD1,7,6,163254,4863,158391,26398.5,694.7142857,32.57063541
NM_001167608,RHBDD1,9,8,163254,5166,158088,19761,574,30.60162602
NM_000092,COL4A4,48,47,161850,10389,151461,3222.574468,216.4375,14.57897776
NM_020194,MFF,11,10,30326,2025,28301,2830.1,184.0909091,13.97580247
NM_001277062,MFF,9,8,32687,2033,30654,3831.75,225.8888889,15.07820954
NM_001277067,MFF,8,7,29160,1718,27442,3920.285714,214.75,15.97322468
NM_001277065,MFF,7,6,32687,1812,30875,5145.833333,258.8571429,17.03918322
NM_001277064,MFF,8,7,32687,1873,30814,4402,234.125,16.45168179
NM_000091,COL4A3,52,51,150229,8149,142080,2785.882353,156.7115385,17.43526813
NM_001142644,SPHKAP,12,11,201693,6925,194768,17706.18182,577.0833333,28.12534296
NM_030623,SPHKAP,11,10,201693,6837,194856,19485.6,621.5454545,28.50021939
NM_139072,DNER,13,12,356943,3285,353658,29471.5,252.6923077,107.6584475
NM_017933,PID1,4,3,247370,2826,244544,81514.66667,706.5,86.53361642
NM_001100818,PID1,3,2,247370,2614,244756,122378,871.3333333,93.63274675
NM_016289,CAB39,9,8,108235,3838,104397,13049.625,426.4444444,27.20088588
NM_003113,SP100,25,24,100375,3695,96680,4028.333333,147.8,26.16508796
NM_138402,SP140L,19,18,76553,2687,73866,4103.666667,141.4210526,27.4901377
NM_001206701,SP100,23,22,91992,2331,89661,4075.5,101.3478261,38.46460746
NM_080424,SP110,19,18,51184,2596,48588,2699.333333,136.6315789,18.7164869
NM_001130849,CAB39,9,8,107529,3960,103569,12946.125,440,26.15378788
NM_001130850,CAB39,9,8,107529,3704,103825,12978.125,411.5555556,28.03050756
NM_001185015,SP110,16,15,49257,2134,47123,3141.533333,133.375,22.08200562
NM_004509,SP110,18,17,51184,2523,48661,2862.411765,140.1666667,19.28695997
NM_004510,SP110,15,14,43640,2097,41543,2967.357143,139.8,19.81068193
NM_174899,FBXO36,4,3,90620,2819,87801,29267,704.75,31.14615112
NM_001080391,SP100,29,28,129448,5484,123964,4427.285714,189.1034483,22.60466813
NM_025139,ARMC9,21,20,146617,2282,144335,7216.75,108.6666667,63.24934268
NM_001191037,PSMD1,24,23,115964,3256,112708,4900.347826,135.6666667,34.61547912
NM_001282949,COPS7B,6,5,27585,2461,25124,5024.8,410.1666667,10.20885819
NM_139073,SPATA3,5,4,11162,875,10287,2571.75,175,11.75657143
NM_006056,NMUR1,3,2,7313,3277,4036,2018,1092.333333,1.231614281
NM_002807,PSMD1,25,24,115964,3350,112614,4692.25,134,33.6161194
NM_022730,COPS7B,7,6,22873,2583,20290,3381.666667,369,7.855207123
NM_001271466,ARMC9,25,24,175314,4999,170315,7096.458333,199.96,34.06981396
NM_001282952,COPS7B,6,5,22873,2506,20367,4073.4,417.6666667,8.127294493
NM_001282951,COPS7B,5,4,27585,2473,25112,6278,494.6,10.15446826
NM_001282950,COPS7B,8,7,22873,2637,20236,2890.857143,329.625,7.673871824
NM_001276337,EIF4E2,6,5,33060,3416,29644,5928.8,569.3333333,8.677985948
NM_001276336,EIF4E2,7,6,33060,3552,29508,4918,507.4285714,8.307432432
NM_152383,DIS3L2,21,20,375617,3523,372094,18604.7,167.7619048,105.618507
NM_001257282,DIS3L2,7,6,169301,1148,168153,28025.5,164,146.4747387
NM_001257281,DIS3L2,14,13,382387,2495,379892,29222.46154,178.2142857,152.2613226
NM_001103147,GIGYF2,31,30,163276,7980,155296,5176.533333,257.4193548,19.46065163
NM_001103148,GIGYF2,28,27,163276,7760,155516,5759.851852,277.1428571,20.04072165
NM_001103146,GIGYF2,29,28,163276,7845,155431,5551.107143,270.5172414,19.81274697
NM_015575,GIGYF2,31,30,163276,7987,155289,5176.3,257.6451613,19.44271942
NM_001282958,EIF4E2,8,7,33060,3632,29428,4204,454,8.102422907
NM_005541,INPP5D,26,25,191515,4856,186659,7466.36,186.7692308,38.43883855
NM_003648,DGKD,29,28,83945,6258,77687,2774.535714,215.7931034,12.41403004
NM_001282963,HJURP,6,5,17867,2940,14927,2985.4,490,5.077210884
NM_021027,UGT1A9,5,4,101409,2381,99028,24757,476.2,41.59092818
NM_152879,DGKD,30,29,117592,6324,111268,3836.827586,210.8,17.5945604
NM_205862,UGT1A6,6,5,81626,1697,79929,15985.8,282.8333333,47.10017678
NM_001072,UGT1A6,5,4,80441,2489,77952,19488,497.8,31.31860185
NM_019077,UGT1A7,5,4,91363,2338,89025,22256.25,467.6,38.0774166
NM_018410,HJURP,9,8,17867,3198,14669,1833.625,355.3333333,4.586929331
NM_019076,UGT1A8,5,4,155656,2401,153255,38313.75,480.2,63.82965431
NM_019075,UGT1A10,5,4,136830,2390,134440,33610,478,56.25104603
NM_000541,SAG,16,15,39394,1765,37629,2508.6,110.3125,21.31954674
NM_001017915,INPP5D,26,25,191515,4859,186656,7466.24,186.8846154,38.41448858
NM_001282962,HJURP,7,6,17867,3034,14833,2472.166667,433.4285714,4.888925511
NM_005737,ARL4C,1,0,4009,4009,NA,NA,4009,NA
NM_001282431,ARL4C,2,1,4013,3839,174,174,1919.5,0.045324303
NM_001244888,AGAP1,10,9,359115,2175,356940,39660,217.5,164.1103448
NM_024726,IQCA1,19,18,183390,3297,180093,10005.16667,173.5263158,54.6232939
NM_212556,ASB18,6,5,69475,1407,68068,13613.6,234.5,48.37810945
NM_001270585,IQCA1,19,18,179552,3088,176464,9803.555556,162.5263158,57.14507772
NM_001270584,IQCA1,18,17,183390,3173,180217,10601,176.2777778,56.7970375
NM_001278308,UBE2F,9,8,75838,2152,73686,9210.75,239.1111111,34.24070632
NM_001278307,UBE2F,8,7,75838,2118,73720,10531.42857,264.75,34.80642115
NM_001278305,UBE2F,10,9,73990,2145,71845,7982.777778,214.5,33.49417249
NM_024101,MLPH,16,15,68101,3788,64313,4287.533333,236.75,16.9780887
NM_001042467,MLPH,15,14,68101,3703,64398,4599.857143,246.8666667,17.39076425
NM_001281474,MLPH,14,13,68910,3507,65403,5031,250.5,18.64927288
NM_001281473,MLPH,13,12,68101,3425,64676,5389.666667,263.4615385,18.88350365
NM_080678,UBE2F,10,9,75838,2216,73622,8180.222222,221.6,33.22292419
NM_057167,COL6A3,43,42,90197,10006,80191,1909.309524,232.6976744,8.014291425
NM_001137551,LRRFIP1,12,11,89485,3604,85881,7807.363636,300.3333333,23.82935627
NM_001137550,LRRFIP1,24,23,154068,4126,149942,6519.217391,171.9166667,36.34076587
NM_001278306,UBE2F,9,8,75838,2081,73757,9219.625,231.2222222,35.44305622
NM_057166,COL6A3,41,40,90197,8801,81396,2034.9,214.6585366,9.248494489
NM_057165,COL6A3,8,7,42592,4075,38517,5502.428571,509.375,9.45202454
NM_057164,COL6A3,7,6,42592,3471,39121,6520.166667,495.8571429,11.27081533
NM_005855,RAMP1,3,2,52570,912,51658,25829,304,56.64254386
NM_004369,COL6A3,44,43,90197,10625,79572,1850.511628,241.4772727,7.489129412
NM_001040445,ASB1,5,4,25267,6838,18429,4607.25,1367.6,2.695086283
NM_004544,NDUFA10,10,9,68032,4925,63107,7011.888889,492.5,12.81360406
NM_024861,C2orf54,5,4,5992,1966,4026,1006.5,393.2,2.047812818
NM_002712,PPP1R7,10,9,33994,2758,31236,3470.666667,275.8,11.32559826
NM_001282411,PPP1R7,8,7,17521,1669,15852,2264.571429,208.625,9.497902936
NM_001282410,PPP1R7,9,8,17521,1799,15722,1965.25,199.8888889,8.739299611
NM_001282409,PPP1R7,9,8,33994,2628,31366,3920.75,292,11.93531202
NM_001195381,GPR35,6,5,25853,2278,23575,4715,379.6666667,10.34899034
NM_001195382,GPR35,6,5,25853,2164,23689,4737.8,360.6666667,10.94685767
NM_001282412,PPP1R7,10,9,34079,2004,32075,3563.888889,200.4,16.00548902
NM_001080437,SNED1,32,31,95390,6866,88524,2855.612903,214.5625,12.89309642
NM_001282771,ANKMY1,18,17,78601,3456,75145,4420.294118,192,21.74334491
NM_016552,ANKMY1,17,16,78601,3292,75309,4706.8125,193.6470588,22.87636695
NM_001244008,KIF1A,49,48,106546,9272,97274,2026.541667,189.2244898,10.49115617
NM_017844,ANKMY1,14,13,78601,2513,76088,5852.923077,179.5,30.27775567
NM_001085437,C2orf54,5,4,10110,2530,7580,1895,506,2.996047431
NM_005301,GPR35,2,1,6016,1637,4379,4379,818.5,2.675015272
NM_004321,KIF1A,46,45,84050,8779,75271,1672.688889,190.8478261,8.573983369
NM_001282414,PPP1R7,8,7,17606,915,16691,2384.428571,114.375,18.24153005
NM_001282413,PPP1R7,9,8,34079,1874,32205,4025.625,208.2222222,17.18516542
NM_001282780,ANKMY1,14,13,78601,2522,76079,5852.230769,180.1428571,30.16613799
NM_001282781,ANKMY1,17,16,78601,2471,76130,4758.125,145.3529412,30.80938891
NM_001282921,C2orf54,5,4,5992,2023,3969,992.25,404.6,1.961937716
NM_014808,FARP2,27,26,138595,4073,134522,5173.923077,150.8518519,33.02774368
NM_001282983,FARP2,18,17,109789,2652,107137,6302.176471,147.3333333,40.39856712
NM_001282984,FARP2,18,17,109789,2438,107351,6314.764706,135.4444444,44.03240361
NM_001077710,FAM110C,2,1,7776,3965,3811,3811,1982.5,0.961160151
NM_001282687,SH3YL1,12,11,38206,1983,36223,3293,165.25,18.26676752
NM_007099,ACP1,6,5,13415,1557,11858,2371.6,259.5,7.615928067
NM_001040649,ACP1,3,2,7614,661,6953,3476.5,220.3333333,10.51891074
NM_004300,ACP1,6,5,13415,1557,11858,2371.6,259.5,7.615928067
NM_001002919,FAM150B,6,5,8749,1404,7345,1469,234,5.231481481
NM_152834,TMEM18,5,4,9468,2129,7339,1834.75,425.8,3.44715829
NM_018269,ADI1,4,3,21662,1680,19982,6660.666667,420,11.89404762
NM_002936,RNASEH1,8,7,13481,1873,11608,1658.285714,234.125,6.197544047
NM_001011,RPS7,7,6,5658,735,4923,820.5,105,6.697959184
NM_001286834,RNASEH1,8,7,13481,1873,11608,1658.285714,234.125,6.197544047
NM_001286837,RNASEH1,8,7,13481,2111,11370,1624.285714,263.875,5.386072951
NM_018436,ALLC,12,11,44476,1456,43020,3910.909091,121.3333333,29.5467033
NM_003108,SOX11,1,0,8720,8720,NA,NA,8720,NA
NM_001256477,CMPK2,4,3,15171,2153,13018,4339.333333,538.25,6.046446818
NM_001256478,CMPK2,4,3,25268,1245,24023,8007.666667,311.25,19.29558233
NM_080657,RSAD2,6,5,20569,3518,17051,3410.2,586.3333333,4.846787948
NM_207315,CMPK2,5,4,17512,3019,14493,3623.25,603.8,4.800596224
NM_002166,ID2,3,2,2472,1367,1105,552.5,455.6666667,0.808339429
NM_022334,ITGB1BP1,6,5,17830,1784,16046,3209.2,297.3333333,8.994394619
NM_004763,ITGB1BP1,7,6,17830,1935,15895,2649.166667,276.4285714,8.214470284
NM_003183,ADAM17,19,18,66508,3572,62936,3496.444444,188,17.61926092
NM_001039613,IAH1,6,5,13923,912,13011,2602.2,152,14.26644737
NM_006826,YWHAQ,6,5,47090,2260,44830,8966,376.6666667,19.83628319
NM_005680,TAF1B,15,14,90976,2314,88662,6333,154.2666667,38.31547105
NM_003597,KLF11,4,3,11283,4034,7249,2416.333333,1008.5,1.796975706
NM_001037160,CYS1,3,2,23614,2722,20892,10446,907.3333333,7.675238795
NM_001177718,KLF11,4,3,10593,4037,6556,2185.333333,1009.25,1.623978202
NM_001177716,KLF11,4,3,11009,3889,7120,2373.333333,972.25,1.830804834
NM_182626,C2orf48,3,2,68963,731,68232,34116,243.6666667,93.34062927
NM_001034,RRM2,10,9,8685,3276,5409,601,327.6,1.651098901
NM_001165931,RRM2,10,9,8853,3444,5409,601,344.4,1.570557491
NM_001258359,HPCAL1,5,4,58855,1947,56908,14227,389.4,29.22855675
NM_002539,ODC1,12,11,8185,2312,5873,533.9090909,192.6666667,2.540224913
NM_001258358,HPCAL1,5,4,58941,1553,57388,14347,310.6,36.9529942
NM_001287190,ODC1,12,11,7430,2050,5380,489.0909091,170.8333333,2.624390244
NM_001287188,ODC1,12,11,8185,2212,5973,543,184.3333333,2.700271248
NM_001287189,ODC1,12,11,7430,2204,5226,475.0909091,183.6666667,2.371143376
NM_001282707,PDIA6,14,13,29450,2525,26925,2071.153846,180.3571429,10.66336634
NM_001282706,PDIA6,14,13,49096,2550,46546,3580.461538,182.1428571,18.25333333
NM_001282705,PDIA6,14,13,54588,2720,51868,3989.846154,194.2857143,19.06911765
NM_001282704,PDIA6,15,14,49096,2699,46397,3314.071429,179.9333333,17.1904409
NM_005742,PDIA6,13,12,29450,2346,27104,2258.666667,180.4615385,11.55328218
NM_002236,KCNF1,1,0,2290,2290,NA,NA,2290,NA
NM_152391,PQLC3,7,6,23502,1835,21667,3611.166667,262.1428571,11.80762943
NM_182500,C2orf50,4,3,13739,1060,12679,4226.333333,265,11.96132075
NM_001282712,PQLC3,4,3,23502,1665,21837,7279,416.25,13.11531532
NM_001282711,PQLC3,6,5,23502,1713,21789,4357.8,285.5,12.71978984
NM_001282710,PQLC3,6,5,23502,1792,21710,4342,298.6666667,12.11495536
NM_212540,E2F6,7,6,21804,3177,18627,3104.5,453.8571429,5.863078376
NM_001278278,E2F6,6,5,21804,3197,18607,3721.4,532.8333333,5.820143885
NM_001278277,E2F6,9,8,21804,3459,18345,2293.125,384.3333333,5.303555941
NM_001278276,E2F6,8,7,21804,3387,18417,2631,423.375,5.437555359
NM_001278275,E2F6,8,7,21804,3325,18479,2639.857143,415.625,5.557593985
NM_198256,E2F6,7,6,21804,3253,18551,3091.833333,464.7142857,5.702735936
NM_148903,GREB1,10,9,48277,2333,45944,5104.888889,233.3,19.69309901
NM_014668,GREB1,33,32,108672,8515,100157,3129.90625,258.030303,11.76241926
NM_033090,GREB1,11,10,49423,2358,47065,4706.5,214.3636364,19.95971162
NM_001261429,LPIN1,10,9,59973,2149,57824,6424.888889,214.9,26.90739879
NM_012344,NTSR2,4,3,12027,1612,10415,3471.666667,403,6.460918114
NM_021643,TRIB2,3,2,25862,4409,21453,10726.5,1469.666667,4.86572919
NM_145175,FAM84A,2,1,7360,6355,1005,1005,3177.5,0.158143194
NM_004939,DDX1,26,25,39492,2767,36725,1469,106.4230769,13.27249729
NM_005378,MYCN,3,2,6448,2608,3840,1920,869.3333333,1.472392638
NM_024624,SMC6,27,26,90019,5199,84820,3262.307692,192.5555556,16.3146759
NM_001142286,SMC6,28,27,90019,5287,84732,3138.222222,188.8214286,16.02648005
NM_001105569,MSGN1,1,0,583,583,NA,NA,583,NA
NM_020905,RDH14,2,1,5972,1602,4370,4370,801,2.7278402
NM_001199086,NT5C1B,10,9,26711,2829,23882,2653.555556,282.9,8.441852245
NM_033253,NT5C1B,9,8,26711,2699,24012,3001.5,299.8888889,8.896628381
NM_001199088,NT5C1B,10,9,26711,2886,23825,2647.222222,288.6,8.255370755
NM_001199087,NT5C1B,10,9,26711,2931,23780,2642.222222,293.1,8.113271921
NM_001002006,NT5C1B,10,9,26711,2880,23831,2647.888889,288,8.274652778
NM_145260,OSR1,3,2,7128,1897,5231,2615.5,632.3333333,2.757511861
NM_001008237,TTC32,3,2,5232,822,4410,2205,274,5.364963504
NM_002381,MATN3,8,7,20644,2591,18053,2579,323.875,6.967580085
NM_014713,LAPTM4A,7,6,19380,1772,17608,2934.666667,253.1428571,9.936794582
NM_002997,SDC1,5,4,24371,3206,21165,5291.25,641.2,6.601684342
NM_001006946,SDC1,6,5,24638,3299,21339,4267.8,549.8333333,6.468323734
NM_001282790,PUM2,19,18,78696,5896,72800,4044.444444,310.3157895,12.34735414
NM_001282752,PUM2,20,19,102160,6271,95889,5046.789474,313.55,15.2908627
NM_015317,PUM2,21,20,102160,6381,95779,4788.95,303.8571429,15.01002978
NM_001282791,PUM2,20,19,78696,6022,72674,3824.947368,301.1,12.06808369
NM_004040,RHOB,1,0,2368,2368,NA,NA,2368,NA
NM_182828,GDF7,2,1,4828,1996,2832,2832,998,1.418837675
NM_181713,UBXN2A,7,6,60319,1900,58419,9736.5,271.4285714,30.74684211
NM_001080473,MFSD2B,13,12,14194,1521,12673,1056.083333,117,8.332018409
NM_025203,C2orf44,4,3,18092,3898,14194,4731.333333,974.5,3.641354541
NM_016047,SF3B14,4,3,8862,775,8087,2695.666667,193.75,10.43483871
NM_199346,PFN4,5,4,7909,780,7129,1782.25,156,9.13974359
NM_001142319,C2orf44,3,2,18092,3779,14313,7156.5,1259.666667,3.787509923
NM_147184,TP53I3,6,5,7784,1641,6143,1228.6,273.5,3.743449116
NM_001206802,TP53I3,4,3,6900,957,5943,1981,239.25,6.210031348
NM_054033,FKBP1B,4,3,13968,1000,12968,4322.666667,250,12.968
NM_004881,TP53I3,5,4,7784,2039,5745,1436.25,407.8,2.817557626
NM_004116,FKBP1B,4,3,13968,955,13013,4337.666667,238.75,13.62617801
NM_001040710,FAM228A,6,5,16597,1780,14817,2963.4,296.6666667,8.324157303
NM_001013663,PTRHD1,2,1,3117,574,2543,2543,287,4.430313589
NM_004036,ADCY3,21,20,100018,4417,95601,4780.05,210.3333333,21.64387593
NM_016544,DNAJC27,7,6,28460,4999,23461,3910.166667,714.1428571,4.693138628
NM_001198559,DNAJC27,6,5,28460,4837,23623,4724.6,806.1666667,4.88381228
NM_001035256,POMC,4,3,7839,1299,6540,2180,324.75,5.034642032
NM_000939,POMC,3,2,7839,1248,6591,3295.5,416,5.28125
NM_153759,DNMT3A,19,18,19356,3627,15729,873.8333333,190.8947368,4.336641853
NM_002254,KIF3C,8,7,55990,5439,50551,7221.571429,679.875,9.294171723
NM_000182,HADHA,20,19,54092,3057,51035,2686.052632,152.85,16.6944717
NM_001168241,GAREML,6,5,16574,4167,12407,2481.4,694.5,2.977441805
NM_001191033,GAREML,6,5,8949,5163,3786,757.2,860.5,0.733294596
NM_001145168,GPR113,13,12,9107,3253,5854,487.8333333,250.2307692,1.799569628
NM_001145169,GPR113,13,12,10931,4409,6522,543.5,339.1538462,1.479246995
NM_153835,GPR113,12,11,38646,4130,34516,3137.818182,344.1666667,8.357384988
NM_145038,DRC1,17,16,54797,2508,52289,3268.0625,147.5294118,20.84888357
NM_194322,OTOF,29,28,20841,5137,15704,560.8571429,177.137931,3.057037181
NM_194323,OTOF,29,28,20841,4785,16056,573.4285714,165,3.355485893
NM_004802,OTOF,30,29,20841,4984,15857,546.7931034,166.1333333,3.181581059
NM_001029881,CIB4,7,6,60140,752,59388,9898,107.4285714,78.97340426
NM_001105519,C2orf70,4,3,16916,699,16217,5405.666667,174.75,23.20028612
NM_002246,KCNK3,2,1,38487,3980,34507,34507,1990,8.670100503
NM_001042426,CENPA,4,3,8574,1354,7220,2406.666667,338.5,5.332348597
NM_001809,CENPA,5,4,8575,1434,7141,1785.25,286.8,4.979776848
NM_012326,MAPRE3,7,6,56564,1877,54687,9114.5,268.1428571,29.13532232
NM_001035507,AGBL5,11,10,7914,2448,5466,546.6,222.5454545,2.232843137
NM_007046,EMILIN1,8,7,7832,3940,3892,556,492.5,0.987817259
NM_006488,KHK,8,7,14010,2423,11587,1655.285714,302.875,4.78208832
NM_001134693,OST4,3,2,1227,488,739,369.5,162.6666667,1.514344262
NM_000221,KHK,8,7,14010,2423,11587,1655.285714,302.875,4.78208832
NM_032604,ABHD1,9,8,7025,1455,5570,696.25,161.6666667,3.828178694
NM_006569,CGREF1,6,5,18535,1936,16599,3319.8,322.6666667,8.573863636
NM_013388,PREB,9,8,3919,2173,1746,218.25,241.4444444,0.803497469
NM_178553,C2orf53,3,2,2619,2066,553,276.5,688.6666667,0.267666989
NM_021831,AGBL5,15,14,19001,3252,15749,1124.928571,216.8,4.842865929
NM_001166241,CGREF1,7,6,11751,1415,10336,1722.666667,202.1428571,7.30459364
NM_001166239,CGREF1,6,5,18313,1785,16528,3305.6,297.5,9.259383754
NM_001166240,CGREF1,6,5,19776,1129,18647,3729.4,188.1666667,16.51638618
NM_175769,TCF23,3,2,3876,789,3087,1543.5,263,3.912547529
NM_003459,SLC30A3,8,7,8522,2101,6421,917.2857143,262.625,3.056163732
NM_021095,SLC5A6,17,16,12722,3269,9453,590.8125,192.2941176,2.891710003
NM_080592,ATRAID,7,6,5149,1265,3884,647.3333333,180.7142857,3.070355731
NM_001170795,ATRAID,7,6,4829,945,3884,647.3333333,135,4.11005291
NM_016085,ATRAID,7,6,4829,1085,3744,624,155,3.450691244
NM_004341,CAD,44,43,26398,7152,19246,447.5813953,162.5454545,2.690995526
NM_173650,DNAJC5G,7,6,6009,2013,3996,666,287.5714286,1.98509687
NM_015636,EIF2B4,13,12,6107,1773,4334,361.1666667,136.3846154,2.444444444
NM_014748,SNX17,15,14,7039,2490,4549,324.9285714,166,1.826907631
NM_144631,ZNF513,4,3,3515,2162,1353,451,540.5,0.625809436
NM_003353,UCN,2,1,867,617,250,250,308.5,0.405186386
NM_001201459,ZNF513,3,2,3215,2084,1131,565.5,694.6666667,0.542706334
NM_001267061,SNX17,15,14,7039,2325,4714,336.7142857,155,2.027526882
NM_001267059,SNX17,15,14,7039,2454,4585,327.5,163.6,1.868378158
NM_177983,PPM1G,10,9,28486,2312,26174,2908.222222,231.2,11.32093426
NM_001034116,EIF2B4,13,12,6107,1776,4331,360.9166667,136.6153846,2.438626126
NM_001521,GTF3C2,20,19,31187,3978,27209,1432.052632,198.9,6.839869281
NM_002437,MPV17,8,7,13611,1015,12596,1799.428571,126.875,12.40985222
NM_001267060,SNX17,14,13,7039,2414,4625,355.7692308,172.4285714,1.915907208
NM_001035521,GTF3C2,19,18,31187,3901,27286,1515.888889,205.3157895,6.994616765
NM_172195,EIF2B4,12,11,5702,1731,3971,361,144.25,2.294049682
NM_015662,IFT172,48,47,45333,5408,39925,849.4680851,112.6666667,7.382581361
NM_022823,FNDC4,7,6,3378,1678,1700,283.3333333,239.7142857,1.013110846
NM_001486,GCKR,19,18,26846,2207,24639,1368.833333,116.1578947,11.16402356
NM_001168364,KRTCAP3,7,6,4117,963,3154,525.6666667,137.5714286,3.275181724
NM_173853,KRTCAP3,7,6,1933,894,1039,173.1666667,127.7142857,1.162192394
NM_032434,ZNF512,14,13,40248,3616,36632,2817.846154,258.2857143,10.13053097
NM_032266,C2orf16,1,0,6202,6202,NA,NA,6202,NA
NM_024584,CCDC121,2,1,3394,2363,1031,1031,1181.5,0.436309776
NM_001145049,GPN1,12,11,22200,1632,20568,1869.818182,136,12.60294118
NM_001145048,GPN1,14,13,22200,1741,20459,1573.769231,124.3571429,11.75129236
NM_001145047,GPN1,15,14,22200,1810,20390,1456.428571,120.6666667,11.26519337
NM_007266,GPN1,14,13,21852,1848,20004,1538.769231,132,10.82467532
NM_001282731,SUPT7L,6,5,13033,4583,8450,1690,763.8333333,1.843770456
NM_014860,SUPT7L,6,5,13033,4528,8505,1701,754.6666667,1.878312721
NM_001142683,CCDC121,2,1,3241,2764,477,477,1382,0.172575977
NM_018158,SLC4A1AP,14,13,31511,2984,28527,2194.384615,213.1428571,9.559986595
NM_001271318,ZNF512,15,14,40248,3718,36530,2609.285714,247.8666667,9.825174825
NM_001271289,ZNF512,13,12,40248,3517,36731,3060.916667,270.5384615,10.44384419
NM_001271288,ZNF512,13,12,40248,3553,36695,3057.916667,273.3076923,10.32789192
NM_001271286,ZNF512,13,12,40248,3528,36720,3060,271.3846154,10.40816327
NM_001271287,ZNF512,13,12,40248,3556,36692,3057.666667,273.5384615,10.31833521
NM_001282732,SUPT7L,5,4,13033,4122,8911,2227.75,824.4,2.161814653
NM_001282729,SUPT7L,6,5,13033,4533,8500,1700,755.5,1.875137878
NM_001282730,SUPT7L,6,5,13033,4741,8292,1658.4,790.1666667,1.748998102
NM_145330,MRPL33,3,2,8026,414,7612,3806,138,18.38647343
NM_004891,MRPL33,4,3,8026,522,7504,2501.333333,130.5,14.37547893
NM_005253,FOSL2,4,3,21739,3995,17744,5914.666667,998.75,4.44155194
NM_182756,SPDYA,8,7,39777,1824,37953,5421.857143,228,20.80756579
NM_001142634,SPDYA,7,6,39777,1749,38028,6338,249.8571429,21.74271012
NM_001008779,SPDYA,5,4,24814,1213,23601,5900.25,242.6,19.45671888
NM_206876,PPP1CB,9,8,51194,4790,46404,5800.5,532.2222222,9.687682672
NM_017910,TRMT61B,7,6,20489,1850,18639,3106.5,264.2857143,10.07513514
NM_002709,PPP1CB,8,7,51182,4994,46188,6598.285714,624.25,9.248698438
NM_015131,WDR43,18,17,53549,3519,50030,2942.941176,195.5,14.21710713
NM_001029883,C2orf71,2,1,12573,7048,5525,5525,3524,0.783910329
NM_001127400,YPEL5,4,3,13651,2560,11091,3697,640,4.332421875
NM_001127399,YPEL5,4,3,13651,2324,11327,3775.666667,581,4.873924269
NM_001127401,YPEL5,5,4,13651,2622,11029,2757.25,524.4,4.206331045
NM_016061,YPEL5,3,2,13651,2262,11389,5694.5,754,5.034924845
NM_030915,LBH,3,2,28504,2941,25563,12781.5,980.3333333,8.691941516
NM_144575,CAPN13,23,22,84675,2704,81971,3725.954545,117.5652174,30.31471893
NM_001145122,CAPN14,22,21,44491,3844,40647,1935.571429,174.7272727,10.57414152
NM_000348,SRD5A2,5,4,56386,2450,53936,13484,490,22.01469388
NM_032574,DPY30,5,4,15874,805,15069,3767.25,161,18.71925466
NM_001193515,SLC30A6,13,12,58273,4771,53502,4458.5,367,11.21400126
NM_021209,NLRC4,9,8,41296,3383,37913,4739.125,375.8888889,11.20691694
NM_001199139,NLRC4,9,8,41173,3252,37921,4740.125,361.3333333,11.66082411
NM_001199138,NLRC4,9,8,40433,3369,37064,4633,374.3333333,11.00148412
NM_017964,SLC30A6,14,13,58273,4859,53414,4108.769231,347.0714286,10.99279687
NM_001193514,SLC30A6,13,12,58273,4789,53484,4457,368.3846154,11.16809355
NM_001193513,SLC30A6,15,14,58273,4980,53293,3806.642857,332,10.70140562
NM_015376,RASGRP3,17,16,50858,4353,46505,2906.5625,256.0588235,10.68343671
NM_001139488,RASGRP3,18,17,88479,4799,83680,4922.352941,266.6111111,17.43696603
NM_001042548,FEZ2,9,8,45930,2101,43829,5478.625,233.4444444,20.86101856
NM_005102,FEZ2,8,7,45930,2019,43911,6273,252.375,21.74888559
NM_001278505,GPATCH11,7,6,14795,3644,11151,1858.5,520.5714286,3.060098793
NM_174931,GPATCH11,9,8,14795,3915,10880,1360,435,2.779054917
NM_001032377,SULT6B1,7,6,20729,941,19788,3298,134.4285714,21.02869288
NM_005760,CEBPZ,16,15,29967,3343,26624,1774.933333,208.9375,7.964104098
NM_144736,NDUFAF7,10,9,17531,2221,15310,1701.111111,222.1,6.89329131
NM_001083946,NDUFAF7,8,7,17531,1925,15606,2229.428571,240.625,8.107012987
NM_012413,QPCT,7,6,28714,1710,27004,4500.666667,244.2857143,15.79181287
NM_001170792,RMDN2,11,10,88984,1940,87044,8704.4,176.3636364,44.86804124
NM_001170793,RMDN2,10,9,67290,1436,65854,7317.111111,143.6,45.85933148
NM_001170791,RMDN2,11,10,92424,1869,90555,9055.5,169.9090909,48.45104334
NM_000104,CYP1B1,3,2,8579,5156,3423,1711.5,1718.666667,0.663886734
NM_001195446,SRSF7,7,6,7897,2460,5437,906.1666667,351.4285714,2.210162602
NM_001031684,SRSF7,8,7,7897,2497,5400,771.4285714,312.125,2.162595114
NM_024775,GEMIN6,3,2,3781,695,3086,1543,231.6666667,4.44028777
NM_001145450,MORN2,5,4,6749,746,6003,1500.75,149.2,8.04691689
NM_152390,TMEM178A,4,3,52071,1691,50380,16793.33333,422.75,29.79302188
NM_001167959,TMEM178A,4,3,52468,1354,51114,17038,338.5,37.75036928
NM_001242815,C2orf91,4,3,18437,3725,14712,4904,931.25,3.949530201
NM_138370,PKDCC,7,6,10509,2508,8001,1333.5,358.2857143,3.190191388
NM_004718,COX7A2L,3,2,10713,1117,9596,4798,372.3333333,8.590868397
NM_172344,KCNG3,2,1,52082,3793,48289,48289,1896.5,12.73108358
NM_133329,KCNG3,2,1,52082,3826,48256,48256,1913,12.61265029
NM_148962,OXER1,1,0,1764,1764,NA,NA,1764,NA
NM_012205,HAAO,10,9,25524,1294,24230,2692.222222,129.4,18.72488408
NM_006887,ZFP36L2,2,1,4206,3695,511,511,1847.5,0.138294993
NM_001101330,LOC728819,1,0,1171,1171,NA,NA,1171,NA
NM_001271644,THADA,17,16,39955,3083,36872,2304.5,181.3529412,11.95977944
NM_001271643,THADA,18,17,43908,3316,40592,2387.764706,184.2222222,12.24125452
NM_016008,DYNC2LI1,13,12,35973,1412,34561,2880.083333,108.6153846,24.4766289
NM_001193464,DYNC2LI1,13,12,35973,1415,34558,2879.833333,108.8461538,24.42261484
NM_015522,DYNC2LI1,6,5,21140,1147,19993,3998.6,191.1666667,17.43068875
NM_022437,ABCG8,13,12,39504,2678,36826,3068.833333,206,13.75130695
NM_000341,SLC3A1,10,9,45367,2330,43037,4781.888889,233,18.47081545
NM_005413,SIX3,2,1,4181,2525,1656,1656,1262.5,0.655841584
NM_016932,SIX2,2,1,4220,2156,2064,2064,1078,0.957328386
NM_001145051,TMEM247,3,2,4862,683,4179,2089.5,227.6666667,6.118594436
NM_080653,ATP6V1E2,2,1,8112,1981,6131,6131,990.5,3.094901565
NM_002643,PIGF,6,5,35840,1034,34806,6961.2,172.3333333,33.6615087
NM_014171,CRIPT,5,4,13006,6371,6635,1658.75,1274.2,1.041437765
NM_173074,PIGF,7,6,35840,1140,34700,5783.333333,162.8571429,30.43859649
NM_014011,SOCS5,2,1,63830,4424,59406,59406,2212,13.42811935
NM_144949,SOCS5,2,1,63580,4512,59068,59068,2256,13.09131206
NM_001171508,MCFD2,4,3,39987,4328,35659,11886.33333,1082,8.239140481
NM_001171507,MCFD2,4,3,14244,4176,10068,3356,1044,2.41091954
NM_001171511,MCFD2,3,2,39987,4172,35815,17907.5,1390.666667,8.584611697
NM_001171510,MCFD2,3,2,14244,4020,10224,5112,1340,2.543283582
NM_001171509,MCFD2,3,2,14000,4034,9966,4983,1344.666667,2.470500744
NM_001171506,MCFD2,5,4,14000,4285,9715,2428.75,857,2.267211202
NM_139279,MCFD2,4,3,14000,4190,9810,3270,1047.5,2.341288783
NM_001743,CALM2,6,5,16521,1308,15213,3042.6,218,11.63073394
NM_173649,C2orf61,5,4,26932,2144,24788,6197,428.8,11.56156716
NM_002354,EPCAM,9,8,17882,1727,16155,2019.375,191.8888889,9.354371743
NM_022055,KCNK12,2,1,49557,1426,48131,48131,713,33.75245442
NM_001281494,MSH6,10,9,23000,4073,18927,2103,407.3,4.646943285
NM_001281493,MSH6,9,8,23873,4167,19706,2463.25,463,4.729061675
NM_000179,MSH6,10,9,23873,4338,19535,2170.555556,433.8,4.503227294
NM_001281492,MSH6,8,7,23873,3946,19927,2846.714286,493.25,5.049923974
NM_002158,FOXN2,7,6,64641,5470,59171,9861.833333,781.4285714,10.81736746
NM_152994,PPP1R21,21,20,74625,3164,71461,3573.05,150.6666667,22.58565107
NM_001193475,PPP1R21,20,19,74625,3070,71555,3766.052632,153.5,23.30781759
NM_001135629,PPP1R21,22,21,74625,3198,71427,3401.285714,145.3636364,22.33489681
NM_000233,LHCGR,11,10,68969,3104,65865,6586.5,282.1818182,21.21939433
NM_006794,GPR75,2,1,7122,2161,4961,4961,1080.5,2.295696437
NM_001127397,ERLEC1,13,12,31890,2517,29373,2447.75,193.6153846,11.66984505
NM_015701,ERLEC1,14,13,31890,2596,29294,2253.384615,185.4285714,11.28428351
NM_001127398,ERLEC1,13,12,31890,2433,29457,2454.75,187.1538462,12.10727497
NM_001003937,TSPYL6,1,0,3096,3096,NA,NA,3096,NA
NM_001100396,C2orf73,5,4,30645,1926,28719,7179.75,385.2,14.91121495
NM_007008,RTN4,7,6,38145,1786,36359,6059.833333,255.1428571,20.35778275
NM_153828,RTN4,7,6,78409,2392,76017,12669.5,341.7142857,31.77968227
NM_020532,RTN4,9,8,78409,4851,73558,9194.75,539,15.16347145
NM_207521,RTN4,9,8,77001,4109,72892,9111.5,456.5555556,17.73959601
NM_207520,RTN4,8,7,78409,2450,75959,10851.28571,306.25,31.00367347
NM_001135592,RPS27A,6,5,3952,976,2976,595.2,162.6666667,3.049180328
NM_002954,RPS27A,6,5,3450,1074,2376,475.2,179,2.212290503
NM_001005369,MTIF2,17,16,32561,2966,29595,1849.6875,174.4705882,9.978084963
NM_002453,MTIF2,16,15,32630,2544,30086,2005.733333,159,11.82625786
NM_001177413,RPS27A,5,4,3177,899,2278,569.5,179.8,2.533926585
NM_001282761,CCDC104,11,10,25487,1394,24093,2409.3,126.7272727,17.28335725
NM_080667,CCDC104,10,9,25487,1318,24169,2685.444444,131.8,18.33763278
NM_033109,PNPT1,28,27,59849,4641,55208,2044.740741,165.75,11.89571213
NM_022894,PAPOLG,22,21,45858,7408,38450,1830.952381,336.7272727,5.190334773
NM_002908,REL,11,10,41428,2603,38825,3882.5,236.6363636,14.91548214
NM_002618,PEX13,4,3,34315,4519,29796,9932,1129.75,6.593494136
NM_001143959,C2orf74,4,3,2337,891,1446,482,222.75,1.622895623
NM_001143960,C2orf74,4,3,19723,864,18859,6286.333333,216,21.8275463
NM_152392,AHSA2,6,5,10133,3037,7096,1419.2,506.1666667,2.336516299
NM_032180,FAM161A,6,5,29297,3698,25599,5119.8,616.3333333,6.922390481
NM_001256721,CCT4,13,12,20546,2272,18274,1522.833333,174.7692308,8.043133803
NM_006430,CCT4,14,13,20546,2363,18183,1398.692308,168.7857143,7.694879391
NM_001201543,FAM161A,7,6,29297,3867,25430,4238.333333,552.4285714,6.576157228
NM_006577,B3GNT2,2,1,28606,2751,25855,25855,1375.5,9.398400582
NM_198276,TMEM17,4,3,6250,1929,4321,1440.333333,482.25,2.240020736
NM_001199770,OTX1,5,4,7776,2861,4915,1228.75,572.2,1.717930793
NM_014562,OTX1,5,4,7031,2861,4170,1042.5,572.2,1.457532331
NM_014181,LGALSL,5,4,7192,3832,3360,840,766.4,0.876826722
NM_017657,AFTPH,9,8,68701,4048,64653,8081.625,449.7777778,15.97159091
NM_203437,AFTPH,10,9,68701,4130,64571,7174.555556,413,15.6346247
NM_001002243,AFTPH,9,8,68701,4045,64656,8082,449.4444444,15.984178
NM_001193493,SLC1A4,7,6,35423,3741,31682,5280.333333,534.4285714,8.468858594
NM_003038,SLC1A4,8,7,34507,4610,29897,4271,576.25,6.485249458
NM_015543,RAB1A,4,3,43449,2419,41030,13676.66667,604.75,16.96155436
NM_015147,CEP68,7,6,30649,5869,24780,4130,838.4285714,4.222184358
NM_004161,RAB1A,6,5,43449,2649,40800,8160,441.5,15.40203851
NM_001005386,ACTR2,10,9,43563,3947,39616,4401.777778,394.7,10.03699012
NM_005722,ACTR2,9,8,43563,3931,39632,4954,436.7777778,10.081913
NM_001128210,SPRED2,6,5,55948,4095,51853,10370.6,682.5,12.66251526
NM_181784,SPRED2,6,5,121673,4448,117225,23445,741.3333333,26.35454137
NM_138458,WDR92,8,7,27413,2288,25125,3589.285714,286,10.98120629
NM_001256476,WDR92,7,6,23469,1599,21870,3645,228.4285714,13.67729831
NM_020143,PNO1,7,6,18091,1988,16103,2683.833333,284,8.100100604
NM_015463,CNRIP1,3,2,27043,2001,25042,12521,667,12.51474263
NM_001111101,CNRIP1,3,2,35882,1298,34584,17292,432.6666667,26.6440678
NM_002664,PLEK,9,8,32265,2861,29404,3675.5,317.8888889,10.27752534
NM_001024680,FBXO48,4,3,4887,2716,2171,723.6666667,679,0.799337261
NM_173545,APLF,10,9,112605,3859,108746,12082.88889,385.9,28.17983934
NM_138964,PROKR1,2,1,9756,1184,8572,8572,592,7.239864865
NM_014882,ARHGAP25,10,9,52026,2938,49088,5454.222222,293.8,16.7079646
NM_001007231,ARHGAP25,11,10,92046,3002,89044,8904.4,272.9090909,29.66155896
NM_001166276,ARHGAP25,10,9,52026,2941,49085,5453.888889,294.1,16.68990139
NM_001166277,ARHGAP25,10,9,92046,2881,89165,9907.222222,288.1,30.94932315
NM_014482,BMP10,2,1,6038,1586,4452,4452,793,2.807061791
NM_182536,GKN2,6,5,7740,806,6934,1386.8,134.3333333,8.602977667
NM_015700,NFU1,8,7,41517,1202,40315,5759.285714,150.25,33.53993344
NM_001002755,NFU1,8,7,41517,1112,40405,5772.142857,139,36.33543165
NM_001002756,NFU1,7,6,41517,1065,40452,6742,152.1428571,37.98309859
NM_178439,GMCL1,14,13,49911,2360,47551,3657.769231,168.5714286,20.14872881
NM_002357,MXD1,6,5,27905,5622,22283,4456.6,937,3.963536108
NM_001202513,MXD1,6,5,27905,5619,22286,4457.2,936.5,3.966186154
NM_152792,ASPRV1,1,0,2175,2175,NA,NA,2175,NA
NM_001202514,MXD1,5,4,27905,5591,22314,5578.5,1118.2,3.991057056
NM_006196,PCBP1,1,0,1751,1751,NA,NA,1751,NA
NM_016297,PCYOX1,6,5,23088,5383,17705,3541,897.1666667,3.289058146
NM_022037,TIA1,12,11,39205,4632,34573,3143,386,7.463946459
NM_022173,TIA1,13,12,39205,4666,34539,2878.25,358.9230769,7.402271753
NM_032822,FAM136A,3,2,6114,1810,4304,2152,603.3333333,2.377900552
NM_001004311,FIGLA,5,4,13335,727,12608,3152,145.4,17.34250344
NM_015717,CD207,6,5,5612,1878,3734,746.8,313,1.98828541
NM_012476,VAX2,3,2,32857,1149,31708,15854,383,27.59617058
NM_024933,ANKRD53,7,6,7056,2127,4929,821.5,303.8571429,2.317348378
NM_001115116,ANKRD53,6,5,7056,1999,5057,1011.4,333.1666667,2.529764882
NM_144582,TEX261,6,5,8935,3373,5562,1112.4,562.1666667,1.648977172
NM_032601,MCEE,3,2,20590,873,19717,9858.5,291,22.58533792
NM_005791,MPHOSPH10,11,10,19790,2496,17294,1729.4,226.9090909,6.928685897
NM_019885,CYP26B1,6,5,18626,4562,14064,2812.8,760.3333333,3.082858395
NM_001277742,CYP26B1,5,4,18626,4336,14290,3572.5,867.2,3.295664207
NM_003124,SPR,3,2,4779,1462,3317,1658.5,487.3333333,2.26880985
NM_004097,EMX1,3,2,17418,2191,15227,7613.5,730.3333333,6.949794614
NM_015470,RAB11FIP5,5,4,39638,4347,35291,8822.75,869.4,8.11847251
NM_032319,PRADC1,5,4,5224,1088,4136,1034,217.6,3.801470588
NM_001965,EGR4,2,1,2774,2375,399,399,1187.5,0.168
NM_001009570,CCT7,7,6,18788,1331,17457,2909.5,190.1428571,13.11570248
NM_001080410,FBXO41,12,11,14950,6940,8010,728.1818182,578.3333333,1.154178674
NM_006429,CCT7,12,11,18788,1948,16840,1530.909091,162.3333333,8.64476386
NM_006062,SMYD5,13,12,12991,2580,10411,867.5833333,198.4615385,4.035271318
NM_001134462,NOTO,3,2,8956,1451,7505,3752.5,483.6666667,5.172294969
NM_001166285,CCT7,13,12,18788,2045,16743,1395.25,157.3076923,8.187286064
NM_001166284,CCT7,10,9,18788,1685,17103,1900.333333,168.5,10.15014837
NM_003960,NAT8,2,1,1689,1075,614,614,537.5,0.571162791
NM_016058,TPRKB,5,4,7562,757,6805,1701.25,151.4,8.989431968
NM_003584,DUSP11,9,8,17961,1648,16313,2039.125,183.1111111,9.898665049
NM_016347,NAT8B,1,0,833,833,NA,NA,833,NA
NM_001080474,C2orf78,3,2,32960,3048,29912,14956,1016,9.813648294
NM_006463,STAMBP,11,10,38183,6397,31786,3178.6,581.5454545,4.968891668
NM_080918,DGUOK,5,4,32137,885,31252,7813,177,35.31299435
NM_080916,DGUOK,7,6,32137,1151,30986,5164.333333,164.4285714,26.92093831
NM_213622,STAMBP,10,9,38172,6719,31453,3494.777778,671.9,4.68120256
NM_201647,STAMBP,10,9,38254,6287,31967,3551.888889,628.7,5.084619055
NM_001199893,ACTG2,8,7,26689,1210,25479,3639.857143,151.25,21.05702479
NM_001615,ACTG2,9,8,26689,1340,25349,3168.625,148.8888889,18.91716418
NM_006636,MTHFD2,8,7,16736,2195,14541,2077.285714,274.375,6.624601367
NM_001035505,BOLA3,3,2,12513,468,12045,6022.5,156,25.73717949
NM_018221,MOB1A,6,5,22786,1335,21451,4290.2,222.5,16.06816479
NM_212552,BOLA3,4,3,12513,558,11955,3985,139.5,21.42473118
NM_031288,INO80B,5,4,2939,1266,1673,418.25,253.2,1.321484992
NM_001190837,DCTN1,31,30,19203,4510,14693,489.7666667,145.483871,3.257871397
NM_001146158,MOGS,5,4,4355,2574,1781,445.25,514.8,0.691919192
NM_033046,RTKN,13,12,14724,2634,12090,1007.5,202.6153846,4.589977221
NM_053050,MRPL53,3,2,859,658,201,100.5,219.3333333,0.305471125
NM_032118,WDR54,10,9,3999,1129,2870,318.8888889,112.9,2.542072631
NM_023019,DCTN1,27,26,13583,4190,9393,361.2692308,155.1851852,2.24176611
NM_012477,WBP1,4,3,2493,1227,1266,422,306.75,1.031784841
NM_001145054,C2orf81,4,3,3543,2233,1310,436.6666667,558.25,0.586654725
NM_001135041,DCTN1,26,25,13583,4174,9409,376.36,160.5384615,2.254192621
NM_001135040,DCTN1,28,27,19203,4453,14750,546.2962963,159.0357143,3.312373681
NM_001015056,RTKN,12,11,14724,2206,12518,1138,183.8333333,5.674524025
NM_001015055,RTKN,12,11,16074,2203,13871,1261,183.5833333,6.296413981
NM_032779,CCDC142,9,8,10400,4348,6052,756.5,483.1111111,1.391904324
NM_001190836,DCTN1,28,27,30935,4396,26539,982.9259259,157,6.037079163
NM_006302,MOGS,4,3,4355,2899,1456,485.3333333,724.75,0.502242152
NM_004082,DCTN1,32,31,19203,4532,14671,473.2580645,141.625,3.237202118
NM_032603,LOXL3,14,13,21707,3724,17983,1383.307692,266,4.828947368
NM_001289165,LOXL3,10,9,17406,3002,14404,1600.444444,300.2,4.798134577
NM_001289164,LOXL3,12,11,21707,3287,18420,1674.545455,273.9166667,5.603894128
NM_016170,TLX2,3,2,2681,2155,526,263,718.3333333,0.244083527
NM_001009812,LBX2,2,1,5801,1454,4347,4347,727,2.989683631
NM_032673,PCGF1,9,8,2653,915,1738,217.25,101.6666667,1.899453552
NM_133637,DQX1,12,11,8152,2646,5506,500.5454545,220.5,2.080876795
NM_001197260,DOK1,5,4,8533,1981,6552,1638,396.2,3.307420495
NM_013247,HTRA2,8,7,4153,2558,1595,227.8571429,319.75,0.623534011
NM_181575,AUP1,12,11,3201,1615,1586,144.1818182,134.5833333,0.982043344
NM_001381,DOK1,5,4,3168,2258,910,227.5,451.6,0.403011515
NM_145074,HTRA2,6,5,4153,2265,1888,377.6,377.5,0.833554084
NM_001282430,LBX2,2,1,2043,1030,1013,1013,515,0.983495146
NM_001271662,SEMA4F,13,12,29628,6021,23607,1967.25,463.1538462,3.92077728
NM_001271661,SEMA4F,10,9,29628,5652,23976,2664,565.2,4.242038217
NM_004263,SEMA4F,14,13,29628,6121,23507,1808.230769,437.2142857,3.840385558
NM_019896,POLE4,4,3,11086,700,10386,3462,175,14.83714286
NM_014763,MRPL19,6,5,15427,7833,7594,1518.8,1305.5,0.969488063
NM_001201335,GCFC2,3,2,9204,1168,8036,4018,389.3333333,6.880136986
NM_024993,LRRTM4,3,2,5717,3626,2091,1045.5,1208.666667,0.576668505
NM_001282928,LRRTM4,2,1,5709,3466,2243,2243,1733,0.647143681
NM_198448,REG3G,6,5,2820,861,1959,391.8,143.5,2.275261324
NM_001270040,REG3G,5,4,2820,822,1998,499.5,164.4,2.430656934
NM_001008387,REG3G,6,5,2820,961,1859,371.8,160.1666667,1.934443288
NM_138938,REG3A,5,4,2749,1101,1648,412,220.2,1.496821072
NM_138937,REG3A,6,5,2750,792,1958,391.6,132,2.472222222
NM_006507,REG1B,6,5,3003,812,2191,438.2,135.3333333,2.698275862
NM_002909,REG1A,6,5,2963,814,2149,429.8,135.6666667,2.64004914
NM_002580,REG3A,6,5,2750,815,1935,387,135.8333333,2.374233129
NM_178839,LRRTM1,2,1,2486,2214,272,272,1107,0.122854562
NM_021103,TMSB10,3,2,1038,485,553,276.5,161.6666667,1.140206186
NM_020122,KCMF1,7,6,88366,7560,80806,13467.66667,1080,10.68862434
NM_006464,TGOLN2,4,3,10280,6370,3910,1303.333333,1592.5,0.613814757
NM_001206844,TGOLN2,5,4,10280,6197,4083,1020.75,1239.4,0.658867194
NM_001206840,TGOLN2,4,3,10280,6428,3852,1284,1607,0.599253267
NM_001206841,TGOLN2,4,3,10280,6387,3893,1297.666667,1596.75,0.609519336
NM_017750,RETSAT,11,10,12745,3322,9423,942.3,302,2.83654425
NM_198482,SH2D6,5,4,2236,899,1337,334.25,179.8,1.487208009
NM_001747,CAPG,10,9,15951,1596,14355,1595,159.6,8.994360902
NM_001256139,CAPG,10,9,19328,1306,18022,2002.444444,130.6,13.79938744
NM_001256140,CAPG,10,9,15951,1551,14400,1600,155.1,9.284332689
NM_001013649,C2orf68,4,3,6805,4269,2536,845.3333333,1067.25,0.594050129
NM_016494,RNF181,5,4,1996,721,1275,318.75,144.2,1.768377254
NM_006634,VAMP5,3,2,8982,668,8314,4157,222.6666667,12.44610778
NM_001031738,TMEM150A,8,7,4154,1562,2592,370.2857143,195.25,1.659411012
NM_000821,GGCX,15,14,16681,7477,9204,657.4285714,498.4666667,1.23097499
NM_001142269,GGCX,14,13,16681,7305,9376,721.2307692,521.7857143,1.283504449
NM_005911,MAT2A,9,8,6304,3015,3289,411.125,335,1.090878939
NM_003761,VAMP8,3,2,4544,779,3765,1882.5,259.6666667,4.833119384
NM_198843,SFTPB,12,11,11426,2852,8574,779.4545455,237.6666667,3.00631136
NM_006433,GNLY,5,4,4463,749,3714,928.5,149.8,4.958611482
NM_012483,GNLY,6,5,4463,994,3469,693.8,165.6666667,3.489939638
NM_000542,SFTPB,12,11,11426,3679,7747,704.2727273,306.5833333,2.105735254
NM_001042437,ST3GAL5,7,6,28523,2243,26280,4380,320.4285714,11.71645118
NM_017952,PTCD3,24,23,35977,6758,29219,1270.391304,281.5833333,4.323616455
NM_015425,POLR1A,34,33,79829,6671,73158,2216.909091,196.2058824,10.96657173
NM_016622,MRPL35,4,3,13923,3315,10608,3536,828.75,3.2
NM_145644,MRPL35,5,4,13923,1504,12419,3104.75,300.8,8.25731383
NM_001146688,KDM3A,26,25,51257,4647,46610,1864.4,178.7307692,10.03012696
NM_018433,KDM3A,26,25,51570,4916,46654,1866.16,189.0769231,9.490235964
NM_001198952,RNF103,3,2,7462,2957,4505,2252.5,985.6666667,1.523503551
NM_001198951,RNF103,5,4,20486,2516,17970,4492.5,503.2,7.142289348
NM_005667,RNF103,4,3,20486,3503,16983,5661,875.75,4.848130174
NM_022780,RMND5A,9,8,57752,6192,51560,6445,688,8.326873385
NM_001768,CD8A,6,5,7111,2918,4193,838.6,486.3333333,1.436943112
NM_171827,CD8A,5,4,7111,2806,4305,1076.25,561.2,1.534212402
NM_001178100,CD8B,4,3,46589,938,45651,15217,234.5,48.6684435
NM_004931,CD8B,6,5,20360,1439,18921,3784.2,239.8333333,13.14871438
NM_172213,CD8B,6,5,46589,1067,45522,9104.4,177.8333333,42.66354264
NM_172102,CD8B,5,4,46589,976,45613,11403.25,195.2,46.73463115
NM_172101,CD8B,7,6,46589,1122,45467,7577.833333,160.2857143,40.52317291
NM_002665,PLGLB2,4,3,11387,3018,8369,2789.666667,754.5,2.773028496
NM_001032392,PLGLB1,4,3,11383,3014,8369,2789.666667,753.5,2.776708693
NM_002665,PLGLB2,4,3,11390,3019,8371,2790.333333,754.75,2.772772441
NM_001032392,PLGLB1,4,3,11386,3015,8371,2790.333333,753.75,2.776451078
NM_198274,SMYD1,10,9,45605,4439,41166,4574,443.9,9.273710295
NM_001443,FABP1,4,3,5144,567,4577,1525.666667,141.75,8.072310406
NM_152670,TEX37,4,3,4936,800,4136,1378.666667,200,5.17
NM_001135649,FOXI3,2,1,4329,1264,3065,3065,632,2.424841772
NM_001286559,TEKT4,6,5,5398,2224,3174,634.8,370.6666667,1.427158273
NM_144705,TEKT4,6,5,5398,1521,3877,775.4,253.5,2.548980934
NM_002371,MAL,4,3,28339,1141,27198,9066,285.25,23.8369851
NM_022440,MAL,2,1,28339,845,27494,27494,422.5,32.53727811
NM_022439,MAL,3,2,28339,972,27367,13683.5,324,28.15534979
NM_022438,MAL,3,2,28339,1014,27325,13662.5,338,26.94773176
NM_031902,MRPS5,12,11,34804,1673,33131,3011.909091,139.4166667,19.80334728
NM_021088,ZNF2,5,4,18904,3979,14925,3731.25,795.8,3.750942448
NM_001282398,ZNF2,4,3,18904,3864,15040,5013.333333,966,3.892339545
NM_001017396,ZNF2,4,3,18904,3906,14998,4999.333333,976.5,3.839733743
NM_013434,KCNIP3,9,8,88755,2923,85832,10729,324.7777778,29.36435169
NM_001034914,KCNIP3,8,7,39059,2729,36330,5190,341.125,13.31256871
NM_001164464,TRIM43B,7,6,7766,1675,6091,1015.166667,239.2857143,3.63641791
NM_138800,TRIM43,7,6,7705,1632,6073,1012.166667,233.1428571,3.72120098
NM_207328,GPAT2,22,21,13035,2846,10189,485.1904762,129.3636364,3.580112439
NM_000682,ADRA2B,1,0,3267,3267,NA,NA,3267,NA
NM_004418,DUSP2,4,3,2273,1689,584,194.6666667,422.25,0.345766726
NM_001002036,ASTL,9,8,14588,1305,13283,1660.375,145,10.17854406
NM_004804,CIAO1,7,6,8018,4043,3975,662.5,577.5714286,0.983180806
NM_014014,SNRNP200,45,44,31235,7264,23971,544.7954545,161.4222222,3.299972467
NM_017849,TMEM127,4,3,15807,4597,11210,3736.666667,1149.25,2.438546878
NM_001193304,TMEM127,4,3,15807,4574,11233,3744.333333,1143.5,2.455837341
NM_015341,NCAPH,18,17,41356,6077,35279,2075.235294,337.6111111,5.805331578
NM_001281712,NCAPH,17,16,41356,5823,35533,2220.8125,342.5294118,6.102181006
NM_001281711,NCAPH,18,17,41356,6005,35351,2079.470588,333.6111111,5.88692756
NM_001281710,NCAPH,18,17,41356,6044,35312,2077.176471,335.7777778,5.842488418
NM_212481,ARID5A,7,6,15909,2213,13696,2282.666667,316.1428571,6.188883868
NM_001285486,NEURL3,6,5,7744,1759,5985,1197,293.1666667,3.402501421
NM_001285485,NEURL3,4,3,7744,1493,6251,2083.666667,373.25,4.18687207
NM_001113382,FER1L5,52,51,62052,6529,55523,1088.686275,125.5576923,8.504058815
NM_001115016,KANSL3,21,20,45226,5261,39965,1998.25,250.5238095,7.59646455
NM_017623,CNNM3,8,7,19132,4924,14208,2029.714286,615.5,2.885458976
NM_144994,ANKRD23,9,8,6109,2591,3518,439.75,287.8888889,1.35777692
NM_199078,CNNM3,7,6,19132,4779,14353,2392.166667,682.7142857,3.003347981
NM_020184,CNNM4,7,6,50991,4807,46184,7697.333333,686.7142857,9.607655502
NM_017789,SEMA4C,15,14,10264,3567,6697,478.3571429,237.8,1.877488085
NM_016490,FAM178B,5,4,22253,1009,21244,5311,201.8,21.05450942
NM_001172667,FAM178B,5,4,19282,891,18391,4597.75,178.2,20.64085297
NM_199336,FAHD2B,8,7,11261,1273,9988,1426.857143,159.125,7.846032993
NM_005735,ACTR1B,11,10,8161,2269,5892,589.2,206.2727273,2.596738651
NM_001862,COX5B,4,3,2138,509,1629,543,127.25,3.200392927
NM_001079,ZAP70,14,13,26294,2443,23851,1834.692308,174.5,9.762996316
NM_207519,ZAP70,6,5,5456,1453,4003,800.6,242.1666667,2.754989677
NM_001079878,CNGA3,7,6,52448,3801,48647,8107.833333,543,12.79847409
NM_001298,CNGA3,8,7,52448,3856,48592,6941.714286,482,12.60165975
NM_014044,UNC50,6,5,9937,1148,8789,1757.8,191.3333333,7.655923345
NM_012214,MGAT4A,16,15,112022,8398,103624,6908.266667,524.875,12.33912836
NM_001160154,MGAT4A,13,12,44369,3724,40645,3387.083333,286.4615385,10.91433942
NM_145199,LIPT1,2,1,8197,1293,6904,6904,646.5,5.339520495
NM_145198,LIPT1,4,3,8197,1537,6660,2220,384.25,4.333116461
NM_145197,LIPT1,4,3,8197,1549,6648,2216,387.25,4.291801162
NM_145212,MRPL30,6,5,18480,4542,13938,2787.6,757,3.068692206
NM_015929,LIPT1,3,2,8197,1420,6777,3388.5,473.3333333,4.772535211
NM_001204830,LIPT1,3,2,8078,1618,6460,3230,539.3333333,3.992583436
NM_138798,MITD1,7,6,11768,917,10851,1808.5,131,11.83315158
NM_144706,C2orf15,4,3,9745,1412,8333,2777.666667,353,5.901558074
NM_175735,LYG2,6,5,12861,874,11987,2397.4,145.6666667,13.71510297
NM_005783,TXNDC9,5,4,17375,1535,15840,3960,307,10.31921824
NM_174898,LYG1,7,6,16940,997,15943,2657.166667,142.4285714,15.99097292
NM_016316,REV1,23,22,89544,4757,84787,3853.954545,206.826087,17.82362834
NM_001037872,REV1,23,22,89544,4754,84790,3854.090909,206.6956522,17.83550694
NM_004854,CHST10,7,6,25810,2861,22949,3824.833333,408.7142857,8.021321216
NM_001011717,NMS,10,9,12800,495,12305,1367.222222,49.5,24.85858586
NM_000993,RPL31,5,4,4196,512,3684,921,102.4,7.1953125
NM_001099693,RPL31,4,3,4196,789,3407,1135.666667,197.25,4.318124208
NM_001098577,RPL31,5,4,17466,1134,16332,4083,226.8,14.4021164
NM_017546,CNOT11,7,6,17435,2525,14910,2485,360.7142857,5.904950495
NM_173647,RNF149,7,6,33117,2975,30142,5023.666667,425,10.13176471
NM_001145664,RFX8,12,11,77344,1741,75603,6873,145.0833333,43.42504308
NM_003854,IL1RL2,12,11,52380,1976,50404,4582.181818,164.6666667,25.50809717
NM_001282399,IL18R1,11,10,42494,3482,39012,3901.2,316.5454545,11.2039058
NM_001282408,IL1RL1,7,6,34600,3579,31021,5170.166667,511.2857143,8.66750489
NM_003855,IL18R1,11,10,42494,3672,38822,3882.2,333.8181818,10.57244009
NM_016232,IL1RL1,11,10,40537,2069,38468,3846.8,188.0909091,18.59255679
NM_003856,IL1RL1,8,7,8852,3900,4952,707.4285714,487.5,1.26974359
NM_001011552,SLC9A4,12,11,60671,4150,56521,5138.272727,345.8333333,13.61951807
NM_003853,IL18RAP,12,11,33772,2679,31093,2826.636364,223.25,11.60619634
NM_032718,MFSD9,6,5,19673,2712,16961,3392.2,452,6.254056047
NM_006236,POU3F3,1,0,1504,1504,NA,NA,1504,NA
NM_182640,MRPS9,11,10,61937,1469,60468,6046.8,133.5454545,41.16269571
NM_007227,GPR45,1,0,1726,1726,NA,NA,1726,NA
NM_201555,FHL2,8,7,38400,1884,36516,5216.571429,235.5,19.38216561
NM_001039492,FHL2,7,6,38294,1528,36766,6127.666667,218.2857143,24.06151832
NM_001450,FHL2,6,5,38400,1710,36690,7338,285,21.45614035
NM_001286537,C2orf49,5,4,11457,4250,7207,1801.75,850,1.695764706
NM_024093,C2orf49,4,3,11457,4375,7082,2360.666667,1093.75,1.618742857
NM_001004720,NCK2,4,3,42528,2411,40117,13372.33333,602.75,16.63915388
NM_025076,UXS1,15,14,101038,2099,98939,7067.071429,139.9333333,47.13625536
NM_001253876,UXS1,10,9,45580,2246,43334,4814.888889,224.6,19.29385574
NM_001253875,UXS1,15,14,101038,2114,98924,7066,140.9333333,46.79470199
NM_001144013,RGPD3,23,22,63667,5896,57771,2625.954545,256.3478261,9.798337856
NM_182588,RGPD4,23,22,65614,7195,58419,2655.409091,312.826087,8.119388464
NM_021815,SLC5A7,9,8,27450,5154,22296,2787,572.6666667,4.325960419
NM_001008743,SULT1C3,7,6,18158,922,17236,2872.666667,131.7142857,18.69414317
NM_006588,SULT1C4,7,6,9851,1671,8180,1363.333333,238.7142857,4.895272292
NM_181453,GCC2,23,22,60279,7000,53279,2421.772727,304.3478261,7.611285714
NM_001193482,LIMS1,10,9,80087,4334,75753,8417,433.4,17.4787725
NM_004987,LIMS1,10,9,98947,4364,94583,10509.22222,436.4,21.67346471
NM_001193484,LIMS1,10,9,66002,4455,61547,6838.555556,445.5,13.81526375
NM_001193488,LIMS1,10,9,98782,4402,94380,10486.66667,440.2,21.44025443
NM_001193485,LIMS1,10,9,32436,4684,27752,3083.555556,468.4,5.924850555
NM_006267,RANBP2,29,28,66332,11740,54592,1949.714286,404.8275862,4.650085179
NM_023016,SOWAHC,1,0,4655,4655,NA,NA,4655,NA
NM_032260,RGPD5,20,19,40263,3324,36939,1944.157895,166.2,11.11281588
NM_001037866,RGPD6,20,19,40263,3324,36939,1944.157895,166.2,11.11281588
NM_001123363,RGPD6,24,23,64949,7664,57285,2490.652174,319.3333333,7.474556367
NM_005054,RGPD5,23,22,63299,7188,56111,2550.5,312.5217391,7.806204786
NM_001205288,LIMS3L,3,2,8026,1219,6807,3403.5,406.3333333,5.584085316
NM_033514,LIMS3,3,2,8026,1219,6807,3403.5,406.3333333,5.584085316
NM_005434,MALL,4,3,32698,3065,29633,9877.666667,766.25,9.668189233
NM_001205288,LIMS3L,3,2,8026,1219,6807,3403.5,406.3333333,5.584085316
NM_033514,LIMS3,3,2,8026,1219,6807,3403.5,406.3333333,5.584085316
NM_032260,RGPD5,20,19,40246,3324,36922,1943.263158,166.2,11.10770156
NM_001037866,RGPD6,20,19,40246,3324,36922,1943.263158,166.2,11.10770156
NM_001204106,BCL2L11,4,3,47533,4833,42700,14233.33333,1208.25,8.835092075
NM_001204112,BCL2L11,5,4,47533,4945,42588,10647,989,8.612335693
NM_001204111,BCL2L11,4,3,47533,4819,42714,14238,1204.75,8.863664661
NM_001204110,BCL2L11,5,4,47533,4966,42567,10641.75,993.2,8.571687475
NM_001204109,BCL2L11,4,3,47533,5124,42409,14136.33333,1281,8.276541764
NM_001204107,BCL2L11,6,5,47533,5032,42501,8500.2,838.6666667,8.446144674
NM_001204113,BCL2L11,6,5,25372,956,24416,4883.2,159.3333333,25.53974895
NM_001204108,BCL2L11,5,4,47533,5236,42297,10574.25,1047.2,8.078113063
NM_138627,BCL2L11,3,2,47533,4728,42805,21402.5,1576,9.053510998
NM_138626,BCL2L11,3,2,47533,4998,42535,21267.5,1666,8.510404162
NM_138624,BCL2L11,5,4,47533,5137,42396,10599,1027.4,8.253065992
NM_138621,BCL2L11,4,3,47533,5103,42430,14143.33333,1275.75,8.314716833
NM_006538,BCL2L11,5,4,47533,4924,42609,10652.25,984.8,8.653330626
NM_207003,BCL2L11,5,4,47533,4959,42574,10643.5,991.8,8.585198629
NM_138625,BCL2L11,5,4,47533,4950,42583,10645.75,990,8.602626263
NM_138623,BCL2L11,6,5,47533,5050,42483,8496.6,841.6666667,8.412475248
NM_138622,BCL2L11,5,4,47533,5229,42304,10576,1045.8,8.090265825
NM_207002,BCL2L11,4,3,7934,726,7208,2402.666667,181.5,9.928374656
NM_001128165,FBLN7,7,6,49831,2168,47663,7943.833333,309.7142857,21.9847786
NM_153214,FBLN7,8,7,49831,2307,47524,6789.142857,288.375,20.59991331
NM_198581,ZC3H6,12,11,64464,11551,52913,4810.272727,962.5833333,4.580815514
NM_001164463,RGPD8,23,22,65278,7322,57956,2634.363636,318.3478261,7.915323682
NM_005054,RGPD5,23,22,65144,7188,57956,2634.363636,312.5217391,8.062882582
NM_001282777,POLR1B,16,15,35239,5519,29720,1981.333333,344.9375,5.385033521
NM_001282776,POLR1B,12,11,35239,4975,30264,2751.272727,414.5833333,6.08321608
NM_001282772,POLR1B,16,15,35118,5077,30041,2002.733333,317.3125,5.917077014
NM_032309,CHCHD5,4,3,4583,677,3906,1302,169.25,5.76957164
NM_019014,POLR1B,15,14,35239,5426,29813,2129.5,361.7333333,5.494471065
NM_001137604,POLR1B,14,13,35239,5257,29982,2306.307692,375.5,5.703252806
NM_001282774,POLR1B,13,12,35239,4875,30364,2530.333333,375,6.228512821
NM_001282779,POLR1B,15,14,35239,5355,29884,2134.571429,357,5.580578898
NM_005415,SLC20A1,11,10,17968,3388,14580,1458,308,4.303423849
NM_000576,IL1B,7,6,7021,1505,5516,919.3333333,215,3.665116279
NM_000575,IL1A,7,6,11481,2935,8546,1424.333333,419.2857143,2.911754685
NM_014440,IL36A,4,3,2174,481,1693,564.3333333,120.25,3.51975052
NM_173202,IL37,4,3,5912,712,5200,1733.333333,178,7.303370787
NM_173203,IL37,3,2,5912,591,5321,2660.5,197,9.003384095
NM_173205,IL37,4,3,3690,655,3035,1011.666667,163.75,4.633587786
NM_173204,IL37,4,3,5912,655,5257,1752.333333,163.75,8.025954198
NM_014439,IL37,5,4,5912,776,5136,1284,155.2,6.618556701
NM_019618,IL36G,5,4,7655,1217,6438,1609.5,243.4,5.290057518
NM_001278568,IL36G,4,3,7655,1111,6544,2181.333333,277.75,5.890189019
NM_012275,IL36RN,5,4,5637,2700,2937,734.25,540,1.087777778
NM_032556,IL1F10,4,3,3534,1370,2164,721.3333333,342.5,1.579562044
NM_173843,IL1RN,6,5,16125,1928,14197,2839.4,321.3333333,7.363589212
NM_173842,IL1RN,4,3,6457,1747,4710,1570,436.75,2.696050372
NM_173841,IL1RN,6,5,16125,1820,14305,2861,303.3333333,7.85989011
NM_173178,IL36B,5,4,25436,1057,24379,6094.75,211.4,23.06433302
NM_173161,IL1F10,5,4,7882,1025,6857,1714.25,205,6.689756098
NM_014438,IL36B,6,5,30778,1192,29586,5917.2,198.6666667,24.8204698
NM_000577,IL1RN,5,4,16125,1756,14369,3592.25,351.2,8.182801822
NM_173170,IL36RN,5,4,6107,2672,3435,858.75,534.4,1.285553892
NM_012455,PSD4,17,16,29119,5056,24063,1503.9375,297.4117647,4.759295886
NM_012184,FOXD4L1,1,0,2068,2068,NA,NA,2068,NA
NM_172003,CBWD2,15,14,58515,1842,56673,4048.071429,122.8,30.76710098
NM_007082,RABL2A,10,9,16160,1136,15024,1669.333333,113.6,13.22535211
NM_013412,RABL2A,9,8,16160,2179,13981,1747.625,242.1111111,6.416245984
NM_025181,SLC35F5,16,15,44033,4428,39605,2640.333333,276.75,8.944218609
NM_006773,DDX18,14,13,17700,3779,13921,1070.846154,269.9285714,3.683778777
NM_016133,INSIG2,6,5,21549,2589,18960,3792,431.5,7.323290846
NM_001426,EN1,2,1,6014,2964,3050,3050,1482,1.029014845
NM_006770,MARCO,17,16,52493,1852,50641,3165.0625,108.9411765,27.34395248
NM_182528,C1QL2,2,1,2654,2051,603,603,1025.5,0.294002925
NM_018234,STEAP3,6,5,41845,3943,37902,7580.4,657.1666667,9.612477809
NM_182915,STEAP3,6,5,41845,4290,37555,7511,715,8.754079254
NM_001008410,STEAP3,5,4,41845,3874,37971,9492.75,774.8,9.801497161
NM_001282633,DBI,5,4,5629,746,4883,1220.75,149.2,6.545576408
NM_001178043,DBI,4,3,5629,659,4970,1656.666667,164.75,7.541729894
NM_001178042,DBI,5,4,5629,711,4918,1229.5,142.2,6.917018284
NM_001178017,DBI,4,3,5295,763,4532,1510.666667,190.75,5.939711664
NM_001079862,DBI,4,3,5629,629,5000,1666.666667,157.25,7.949125596
NM_001178041,DBI,5,4,5629,756,4873,1218.25,151.2,6.445767196
NM_020548,DBI,5,4,5629,741,4888,1222,148.2,6.596491228
NM_001079863,DBI,4,3,4873,744,4129,1376.333333,186,5.549731183
NM_001282636,DBI,4,3,5505,659,4846,1615.333333,164.75,7.353566009
NM_001282635,DBI,5,4,5505,746,4759,1189.75,149.2,6.379356568
NM_001282634,DBI,5,4,5629,716,4913,1228.25,143.2,6.861731844
NM_002980,SCTR,13,12,84611,1836,82775,6897.916667,141.2307692,45.08442266
NM_030577,TMEM177,2,1,2953,1399,1554,1554,699.5,1.110793424
NM_001105199,TMEM177,2,1,2953,1348,1605,1605,674,1.190652819
NM_001105198,TMEM177,2,1,2953,1740,1213,1213,870,0.697126437
NM_002193,INHBB,2,1,5666,3205,2461,2461,1602.5,0.767862715
NM_002881,RALB,5,4,41874,2266,39608,9902,453.2,17.47925861
NM_032390,NIFK,7,6,9984,1745,8239,1373.166667,249.2857143,4.721489971
NM_001261401,TSN,5,4,12309,3332,8977,2244.25,666.4,2.694177671
NM_004622,TSN,6,5,12309,3413,8896,1779.2,568.8333333,2.606504541
NM_016815,GYPC,3,2,40742,1195,39547,19773.5,398.3333333,33.09372385
NM_001256584,GYPC,5,4,40742,2072,38670,9667.5,414.4,18.66312741
NM_002101,GYPC,4,3,40742,1253,39489,13163,313.25,31.51556265
NM_139348,BIN1,15,14,59306,2351,56955,4068.214286,156.7333333,24.22586134
NM_139347,BIN1,16,15,59306,2460,56846,3789.733333,153.75,23.10813008
NM_139351,BIN1,13,12,59306,2130,57176,4764.666667,163.8461538,26.84319249
NM_139350,BIN1,14,13,59306,2221,57085,4391.153846,158.6428571,25.70238631
NM_139349,BIN1,15,14,59306,2330,56976,4069.714286,155.3333333,24.45321888
NM_139346,BIN1,16,15,59306,2397,56909,3793.933333,149.8125,23.74176053
NM_139345,BIN1,16,15,59306,2424,56882,3792.133333,151.5,23.46617162
NM_139344,BIN1,18,17,59306,2558,56748,3338.117647,142.1111111,22.18451916
NM_139343,BIN1,19,18,59306,2688,56618,3145.444444,141.4736842,21.06324405
NM_004305,BIN1,15,14,59306,2267,57039,4074.214286,151.1333333,25.16056462
NM_000122,ERCC3,15,14,36888,2765,34123,2437.357143,184.3333333,12.34104882
NM_001001665,CYP27C1,8,7,21933,4693,17240,2462.857143,586.625,3.673556361
NM_000312,PROC,9,8,10828,1789,9039,1129.875,198.7777778,5.05254332
NM_017969,IWS1,14,13,45706,3014,42692,3284,215.2857143,14.16456536
NM_001161404,LIMS2,10,9,43366,2352,41014,4557.111111,235.2,17.43792517
NM_001161403,LIMS2,10,9,36770,2062,34708,3856.444444,206.2,16.83220175
NM_001161417,GPR17,2,1,6776,2307,4469,4469,1153.5,1.937147811
NM_017980,LIMS2,10,9,26173,2173,24000,2666.666667,217.3,11.04463875
NM_001256542,LIMS2,7,6,9834,1751,8083,1347.166667,250.1428571,4.616219303
NM_001161416,GPR17,3,2,6776,2537,4239,2119.5,845.6666667,1.670871108
NM_001161415,GPR17,4,3,6776,2603,4173,1391,650.75,1.603150211
NM_001136037,LIMS2,11,10,36770,2129,34641,3464.1,193.5454545,16.27101926
NM_005291,GPR17,3,2,6776,2373,4403,2201.5,791,1.855457227
NM_001006623,WDR33,8,7,75809,3606,72203,10314.71429,450.75,20.02301719
NM_001006622,WDR33,6,5,48703,3173,45530,9106,528.8333333,14.34919634
NM_032740,SFT2D3,1,0,2812,2812,NA,NA,2812,NA
NM_018383,WDR33,22,21,106955,6321,100634,4792.095238,287.3181818,15.92058219
NM_001199140,AMMECR1L,8,7,24309,4681,19628,2804,585.125,4.193121128
NM_031445,AMMECR1L,8,7,23229,4653,18576,2653.714286,581.625,3.992263056
NM_004805,POLR2D,4,3,11891,2329,9562,3187.333333,582.25,4.105624732
NM_020120,UGGT1,41,40,104497,10820,93677,2341.925,263.902439,8.657763401
NM_004807,HS6ST1,2,1,53119,3954,49165,49165,1977,12.4342438
NM_032144,RAB6C,1,0,3078,3078,NA,NA,3078,NA
NM_001171083,SMPD4,17,16,30367,3631,26736,1671,213.5882353,7.36326081
NM_017951,SMPD4,20,19,30367,3940,26427,1390.894737,197,6.707360406
NM_017751,SMPD4,19,18,30367,3852,26515,1473.055556,202.7368421,6.883437175
NM_001258307,CCDC74B,8,7,5853,1363,4490,641.4285714,170.375,3.294203962
NM_001099771,POTEF,17,16,55689,4354,51335,3208.4375,256.1176471,11.79030776
NM_207310,CCDC74B,8,7,5853,1561,4292,613.1428571,195.125,2.749519539
NM_207312,TUBA3E,5,4,6718,1545,5173,1293.25,309,3.348220065
NM_033416,IMP4,9,8,3710,1058,2652,331.5,117.5555556,2.506616257
NM_001142370,PTPN18,11,10,19404,3359,16045,1604.5,305.3636364,4.776719262
NM_014369,PTPN18,15,14,19404,3684,15720,1122.857143,245.6,4.267100977
NM_032357,CCDC115,5,4,4452,1993,2459,614.75,398.6,1.233818364
NM_001277406,POTEI,15,14,46421,3243,43178,3084.142857,216.2,13.31421523
NM_001079530,CFC1B,6,5,6900,1166,5734,1146.8,194.3333333,4.917667238
NM_001277083,POTEJ,15,14,46506,3292,43214,3086.714286,219.4666667,13.12697448
NM_001270420,CFC1,5,4,7412,1562,5850,1462.5,312.4,3.745198464
NM_001270421,CFC1,4,3,7412,1451,5961,1987,362.75,4.108201241
NM_032545,CFC1,6,5,7412,1678,5734,1146.8,279.6666667,3.41716329
NM_001079530,CFC1B,6,5,6900,1166,5734,1146.8,194.3333333,4.917667238
NM_152698,AMER3,2,1,12632,6254,6378,6378,3127,1.019827311
NM_207364,GPR148,1,0,1268,1268,NA,NA,1268,NA
NM_001105195,AMER3,2,1,11845,6171,5674,5674,3085.5,0.919462
NM_001105194,AMER3,2,1,11845,6174,5671,5671,3087,0.918529316
NM_001105193,AMER3,2,1,12485,6238,6247,6247,3119,1.00144277
NM_001009993,FAM168B,7,6,45557,5413,40144,6690.666667,773.2857143,7.416220211
NM_001267068,PLEKHB2,6,5,45007,4181,40826,8165.2,696.8333333,9.764649605
NM_001267067,PLEKHB2,6,5,45007,4184,40823,8164.6,697.3333333,9.756931166
NM_001267066,PLEKHB2,7,6,45007,4206,40801,6800.166667,600.8571429,9.700665716
NM_001267065,PLEKHB2,8,7,45007,4340,40667,5809.571429,542.5,9.370276498
NM_001267064,PLEKHB2,8,7,45007,4337,40670,5810,542.125,9.37744985
NM_001267063,PLEKHB2,9,8,45007,4356,40651,5081.375,484,9.332185491
NM_001267062,PLEKHB2,9,8,45007,4359,40648,5081,484.3333333,9.325074558
NM_017958,PLEKHB2,8,7,45007,4313,40694,5813.428571,539.125,9.435195919
NM_001100623,PLEKHB2,8,7,45007,4316,40691,5813,539.5,9.427942539
NM_080386,TUBA3D,5,4,6929,1637,5292,1323,327.4,3.232742822
NM_001085365,MZT2A,3,2,8533,696,7837,3918.5,232,11.26005747
NM_138770,CCDC74A,8,7,5834,1550,4284,612,193.75,2.763870968
NM_001258306,CCDC74A,8,7,5834,1352,4482,640.2857143,169,3.315088757
NM_001258305,CCDC74A,7,6,5834,1356,4478,746.3333333,193.7142857,3.302359882
NM_001258304,CCDC74A,8,7,5834,1541,4293,613.2857143,192.625,2.785853342
NM_214461,C2orf27B,3,2,6702,1328,5374,2687,442.6666667,4.046686747
NM_001077427,LYPD1,3,2,26735,1977,24758,12379,659,12.52301467
NM_144586,LYPD1,3,2,26146,2686,23460,11730,895.3333333,8.734177215
NM_025052,MAP3K19,10,9,60189,4387,55802,6200.222222,438.7,12.71985411
NM_001018044,MAP3K19,8,7,60189,4046,56143,8020.428571,505.75,13.876174
NM_001241,CCNT2,10,9,40525,6832,33693,3743.666667,683.2,4.931645199
NM_001018046,MAP3K19,9,8,60189,1932,58257,7282.125,214.6666667,30.15372671
NM_001282883,MAP3K19,8,7,60189,1781,58408,8344,222.625,32.79505896
NM_001018047,MAP3K19,9,8,60189,1788,58401,7300.125,198.6666667,32.66275168
NM_058241,CCNT2,9,8,40525,6932,33593,4199.125,770.2222222,4.846076168
NM_014607,UBXN4,13,12,43446,4027,39419,3284.916667,309.7692308,9.788676434
NM_005915,MCM6,17,16,36853,3804,33049,2065.5625,223.7647059,8.687960042
NM_001008540,CXCR4,1,0,1896,1896,NA,NA,1896,NA
NM_003467,CXCR4,2,1,3808,1676,2132,2132,838,1.272076372
NM_001024075,HNMT,3,2,17442,910,16532,8266,303.3333333,18.16703297
NM_001024074,HNMT,2,1,3208,741,2467,2467,370.5,3.32928475
NM_006895,HNMT,6,5,52128,3373,48755,9751,562.1666667,14.45449155
NM_015702,MMADHC,8,7,18185,1445,16740,2391.428571,180.625,11.58477509
NM_001254738,RND3,5,4,19504,2812,16692,4173,562.4,5.93598862
NM_005168,RND3,6,5,19501,2717,16784,3356.8,452.8333333,6.177401546
NM_198557,RBM43,4,3,13663,3918,9745,3248.333333,979.5,2.487238387
NM_004688,NMI,8,7,19450,1487,17963,2566.142857,185.875,12.0800269
NM_007115,TNFAIP6,6,5,22458,1430,21028,4205.6,238.3333333,14.7048951
NM_012097,ARL5A,6,5,27531,3175,24356,4871.2,529.1666667,7.671181102
NM_001037174,ARL5A,6,5,27531,2919,24612,4922.4,486.5,8.431654676
NM_177985,ARL5A,6,5,27531,2917,24614,4922.8,486.1666667,8.438121358
NM_005843,STAM2,14,13,59193,5715,53478,4113.692308,408.2142857,9.357480315
NM_017892,PRPF40A,26,25,65870,7554,58316,2332.64,290.5384615,7.719883505
NM_019845,RPRM,1,0,1472,1472,NA,NA,1472,NA
NM_001256368,AC009227.2,5,4,21587,2367,19220,4805,473.4,8.119983101
NM_001260510,KCNJ3,1,0,1012,1012,NA,NA,1012,NA
NM_001260509,KCNJ3,2,1,11271,1147,10124,10124,573.5,8.826503923
NM_006186,NR4A2,8,7,8345,3539,4806,686.5714286,442.375,1.358010737
NM_020711,ERMN,3,2,7293,3778,3515,1757.5,1259.333333,0.930386448
NM_001009959,ERMN,4,3,9023,3711,5312,1770.666667,927.75,1.431420102
NM_014568,GALNT5,10,9,53575,3141,50434,5603.777778,314.1,16.05666985
NM_004288,CYTIP,8,7,29475,2218,27257,3893.857143,277.25,12.2889991
NM_001111031,ACVR1C,9,8,70795,8770,62025,7753.125,974.4444444,7.072405929
NM_001017920,DAPL1,4,3,20669,547,20122,6707.333333,136.75,36.78610603
NM_001128213,WDSUB1,11,10,50801,1939,48862,4886.2,176.2727273,25.19958742
NM_001128212,WDSUB1,11,10,50934,1849,49085,4908.5,168.0909091,26.54678204
NM_152528,WDSUB1,11,10,50761,1831,48930,4893,166.4545455,26.72310213
NM_014880,CD302,6,5,29629,3985,25644,5128.8,664.1666667,6.435131744
NM_022826,Mar-07,10,9,56128,3530,52598,5844.222222,353,14.90028329
NM_001198764,CD302,5,4,29629,3873,25756,6439,774.6,6.650142009
NM_001198763,CD302,5,4,29629,3810,25819,6454.75,762,6.77664042
NM_001282807,Mar-07,9,8,34694,3404,31290,3911.25,378.2222222,9.19212691
NM_001282806,Mar-07,8,7,56128,3311,52817,7545.285714,413.875,15.95197825
NM_001282805,Mar-07,12,11,56128,3660,52468,4769.818182,305,14.33551913
NM_001199135,TANK,8,7,75746,2048,73698,10528.28571,256,35.98535156
NM_006593,TBR1,6,5,8955,3192,5763,1152.6,532,1.805451128
NM_002054,GCG,6,5,9537,1300,8237,1647.4,216.6666667,6.336153846
NM_022168,IFIH1,16,15,51631,3616,48015,3201,226,13.27848451
NM_012198,GCA,8,7,18567,3233,15334,2190.571429,404.125,4.742963192
NM_006922,SCN3A,28,27,116549,9153,107396,3977.62963,326.8928571,11.73342074
NM_001081677,SCN3A,28,27,116549,9006,107543,3983.074074,321.6428571,11.94126138
NM_001081676,SCN3A,28,27,116549,9006,107543,3983.074074,321.6428571,11.94126138
NM_004482,GALNT3,11,10,46492,3278,43214,4321.4,298,13.18303844
NM_024753,TTC21B,29,28,80478,5506,74972,2677.571429,189.862069,13.61641845
NM_002976,SCN7A,25,24,83400,7211,76189,3174.541667,288.44,10.56566357
NM_001199145,XIRP2,8,7,72470,2900,69570,9938.571429,362.5,23.98965517
NM_001199144,XIRP2,9,8,72470,12280,60190,7523.75,1364.444444,4.901465798
NM_001039724,NOSTRIN,16,15,62751,1963,60788,4052.533333,122.6875,30.96688742
NM_001171631,NOSTRIN,21,20,78802,2840,75962,3798.1,135.2380952,26.7471831
NM_001171632,NOSTRIN,15,14,62751,1878,60873,4348.071429,125.2,32.41373802
NM_052946,NOSTRIN,15,14,62744,1869,60875,4348.214286,124.6,32.57089353
NM_001081686,G6PC2,4,3,8762,2969,5793,1931,742.25,1.951162007
NM_021176,G6PC2,5,4,8762,3086,5676,1419,617.2,1.839274141
NM_199204,DHRS9,6,5,29134,1923,27211,5442.2,320.5,14.15028601
NM_001142270,DHRS9,6,5,23594,1748,21846,4369.2,291.3333333,12.49771167
NM_001142271,DHRS9,5,4,15062,1470,13592,3398,294,9.246258503
NM_005771,DHRS9,8,7,31380,2872,28508,4072.571429,359,9.926183844
NM_001289763,DHRS9,5,4,29134,1657,27477,6869.25,331.4,16.58237779
NM_152384,BBS5,12,11,27161,3169,23992,2181.090909,264.0833333,7.570842537
NM_006063,KLHL41,6,5,16562,2470,14092,2818.4,411.6666667,5.705263158
NM_004792,PPIG,14,13,53406,2720,50686,3898.923077,194.2857143,18.63455882
NM_144711,KLHL23,4,3,18042,4079,13963,4654.333333,1019.75,3.423142927
NM_001199290,PHOSPHO2-KLHL23,6,5,57434,4212,53222,10644.4,702,12.63580247
NM_001199288,PHOSPHO2,4,3,7256,1059,6197,2065.666667,264.75,5.851746931
NM_001199287,PHOSPHO2,5,4,7256,1259,5997,1499.25,251.8,4.76330421
NM_001199286,PHOSPHO2,4,3,7256,1259,5997,1999,314.75,4.76330421
NM_001199285,PHOSPHO2,4,3,7256,1040,6216,2072,260,5.976923077
NM_001008489,PHOSPHO2,4,3,7256,1140,6116,2038.666667,285,5.364912281
NM_014168,METTL5,7,6,13087,945,12142,2023.666667,135,12.84867725
NM_013445,GAD1,7,6,26071,1262,24809,4134.833333,180.2857143,19.65847861
NM_001289947,ERICH2,5,4,15187,606,14581,3645.25,121.2,24.06105611
NM_001201428,GORASP2,10,9,38697,2432,36265,4029.444444,243.2,14.91159539
NM_015530,GORASP2,10,9,38609,3187,35422,3935.777778,318.7,11.11452777
NM_001136555,TLK1,19,18,76152,5079,71073,3948.5,267.3157895,13.99350266
NM_025000,DCAF17,14,13,50803,5842,44961,3458.538462,417.2857143,7.696165697
NM_001164821,DCAF17,12,11,50803,5639,45164,4105.818182,469.9166667,8.009221493
NM_001127383,CYBRD1,3,2,35779,4151,31628,15814,1383.666667,7.619368827
NM_024843,CYBRD1,4,3,35779,4361,31418,10472.66667,1090.25,7.204310938
NM_001256909,CYBRD1,4,3,35888,4023,31865,10621.66667,1005.75,7.920705941
NM_001378,DYNC1I2,18,17,62751,4432,58319,3430.529412,246.2222222,13.15861913
NM_001271787,DYNC1I2,16,15,62488,4389,58099,3873.266667,274.3125,13.23741171
NM_001271786,DYNC1I2,16,15,62751,4406,58345,3889.666667,275.375,13.24216977
NM_001271785,DYNC1I2,18,17,62488,4415,58073,3416.058824,245.2777778,13.15356738
NM_001271790,DYNC1I2,16,15,62751,4349,58402,3893.466667,271.8125,13.42883421
NM_001271789,DYNC1I2,16,15,62488,4335,58153,3876.866667,270.9375,13.41476355
NM_001271788,DYNC1I2,16,15,62751,4352,58399,3893.266667,272,13.41888787
NM_003705,SLC25A12,18,17,110903,4016,106887,6287.470588,223.1111111,26.61528884
NM_003642,HAT1,11,10,69667,1681,67986,6798.6,152.8181818,40.44378346
NM_001038493,DLX1,2,1,4195,2184,2011,2011,1092,0.920787546
NM_004405,DLX2,3,2,3314,2307,1007,503.5,769,0.436497616
NM_178120,DLX1,3,2,4195,2385,1810,905,795,0.758909853
NM_000210,ITGA6,26,25,78869,5836,73033,2921.32,224.4615385,12.51422207
NM_001079818,ITGA6,25,24,78869,5705,73164,3048.5,228.2,12.82453988
NM_001278549,PDK1,12,11,43167,4730,38437,3494.272727,394.1666667,8.126215645
NM_002610,PDK1,11,10,43167,4669,38498,3849.8,424.4545455,8.245448704
NM_031942,CDCA7,10,9,14159,2820,11339,1259.888889,282,4.020921986
NM_145810,CDCA7,9,8,14159,2582,11577,1447.125,286.8888889,4.48373354
NM_001172712,SP3,7,6,59245,6357,52888,8814.666667,908.1428571,8.319647633
NM_003111,SP3,7,6,59245,6366,52879,8813.166667,909.4285714,8.306471882
NM_001017371,SP3,5,4,57762,6013,51749,12937.25,1202.6,8.606186596
NM_001145250,SP9,2,1,2449,1457,992,992,728.5,0.680851064
NM_001033045,GPR155,17,16,55518,7570,47948,2996.75,445.2941176,6.333949802
NM_001193528,SCRN3,8,7,33848,2970,30878,4411.142857,371.25,10.396633
NM_001267051,GPR155,15,14,55518,7335,48183,3441.642857,489,6.568916155
NM_001267050,GPR155,17,16,55518,7467,48051,3003.1875,439.2352941,6.435114504
NM_024583,SCRN3,8,7,33848,3061,30787,4398.142857,382.625,10.05782424
NM_152529,GPR155,16,15,55518,7420,48098,3206.533333,463.75,6.482210243
NM_003387,WIPF1,8,7,75007,4593,70414,10059.14286,574.125,15.33072066
NM_001039523,CHRNA1,10,9,16879,2066,14813,1645.888889,206.6,7.169893514
NM_000079,CHRNA1,9,8,16879,1990,14889,1861.125,221.1111111,7.481909548
NM_001206602,CHN1,7,6,48306,2301,46005,7667.5,328.7142857,19.9934811
NM_001190329,ATP5G3,4,3,5506,3297,2209,736.3333333,824.25,0.670003033
NM_001689,ATP5G3,5,4,5506,2644,2862,715.5,528.8,1.082450832
NM_001002258,ATP5G3,4,3,5407,2733,2674,891.3333333,683.25,0.978412001
NM_019558,HOXD8,2,1,2957,2585,372,372,1292.5,0.143907157
NM_002148,HOXD10,2,1,3180,1806,1374,1374,903,0.760797342
NM_006898,HOXD3,3,2,9023,2302,6721,3360.5,767.3333333,2.9196351
NM_001199747,HOXD8,3,2,3003,1611,1392,696,537,0.86405959
NM_001199746,HOXD8,2,1,2957,2582,375,375,1291,0.145236251
NM_021192,HOXD11,2,1,2234,1465,769,769,732.5,0.524914676
NM_021193,HOXD12,2,1,960,815,145,145,407.5,0.17791411
NM_024501,HOXD1,2,1,2330,1977,353,353,988.5,0.178553364
NM_014621,HOXD4,2,1,1838,1298,540,540,649,0.416024653
NM_014213,HOXD9,2,1,2234,1887,347,347,943.5,0.183889772
NM_000523,HOXD13,2,1,3136,2329,807,807,1164.5,0.346500644
NM_006554,MTX2,10,9,68632,1398,67234,7470.444444,139.8,48.09298999
NM_194247,HNRNPA3,11,10,11265,5819,5446,544.6,529,0.935899639
NM_152275,TTC30A,1,0,4670,4670,NA,NA,4670,NA
NM_152517,TTC30B,1,0,2645,2645,NA,NA,2645,NA
NM_152945,RBM45,10,9,17202,1794,15408,1712,179.4,8.588628763
NM_145739,OSBPL6,24,23,79191,6835,72356,3145.913043,284.7916667,10.58610095
NM_001042702,DFNB59,7,6,9949,1531,8418,1403,218.7142857,5.49836708
NM_181342,FKBP7,4,3,14966,2908,12058,4019.333333,727,4.146492435
NM_019091,PLEKHA3,8,7,24585,2477,22108,3158.285714,309.625,8.925312878
NM_001135212,FKBP7,4,3,14966,2905,12061,4020.333333,726.25,4.151807229
NM_133379,TTN,46,45,63016,18262,44754,994.5333333,397,2.450662578
NM_020943,CWC22,20,19,62178,3299,58879,3098.894737,164.95,17.84752955
NM_000885,ITGA4,28,27,80851,6104,74747,2768.407407,218,12.24557667
NM_002500,NEUROD1,2,1,4561,3004,1557,1557,1502,0.518308921
NM_006751,SSFA2,17,16,39023,5220,33803,2112.6875,307.0588235,6.475670498
NM_001287505,SSFA2,2,1,2983,2647,336,336,1323.5,0.126936154
NM_001130445,SSFA2,18,17,39023,5339,33684,1981.411765,296.6111111,6.309046638
NM_001287503,SSFA2,17,16,39023,5272,33751,2109.4375,310.1176471,6.40193475
NM_001287504,SSFA2,16,15,39023,5221,33802,2253.466667,326.3125,6.474238652
NM_001258314,PDE1A,13,12,74178,2028,72150,6012.5,156,35.57692308
NM_001463,FRZB,6,5,33495,2773,30722,6144.4,462.1666667,11.07897584
NM_001142314,DUSP19,3,2,21437,5215,16222,8111,1738.333333,3.110642378
NM_080876,DUSP19,4,3,21437,5369,16068,5356,1342.25,2.992736077
NM_018471,ZC3H15,10,9,23204,2143,21061,2340.111111,214.3,9.827811479
NM_001145000,ITGAV,28,27,90841,6953,83888,3106.962963,248.3214286,12.06500791
NM_002210,ITGAV,30,29,90841,7063,83778,2888.896552,235.4333333,11.86153193
NM_001144999,ITGAV,30,29,80699,6779,73920,2548.965517,225.9666667,10.90426317
NM_052952,DIRC1,2,1,56368,1456,54912,54912,728,37.71428571
NM_000090,COL3A1,51,50,38375,5541,32834,656.68,108.6470588,5.92564519
NM_014585,SLC40A1,8,7,20223,3363,16860,2408.571429,420.375,5.01338091
NM_019048,ASNSD1,6,5,9434,2477,6957,1391.4,412.8333333,2.808639483
NM_016467,ORMDL1,5,4,14106,2187,11919,2979.75,437.4,5.449931413
NM_022353,OSGEPL1,9,8,16540,2325,14215,1776.875,258.3333333,6.113978495
NM_001128150,ORMDL1,4,3,14106,2076,12030,4010,519,5.794797688
NM_005259,MSTN,3,2,7031,2822,4209,2104.5,940.6666667,1.491495393
NM_001042521,C2orf88,3,2,65726,4006,61720,30860,1335.333333,15.40688967
NM_001042519,C2orf88,2,1,22623,4037,18586,18586,2018.5,4.603913797
NM_001042520,C2orf88,2,1,53240,3993,49247,49247,1996.5,12.33333333
NM_032321,C2orf88,2,1,22531,3964,18567,18567,1982,4.683905146
NM_001142645,TMEM194B,9,8,27851,3646,24205,3025.625,405.1111111,6.638782227
NM_005966,NAB1,10,9,43646,4479,39167,4351.888889,447.9,8.744585845
NM_007315,STAT1,25,24,45216,4333,40883,1703.458333,173.32,9.435264251
NM_139266,STAT1,23,22,38715,2821,35894,1631.545455,122.6521739,12.72385679
NM_003151,STAT4,24,23,121686,2850,118836,5166.782609,118.75,41.69684211
NM_001243835,STAT4,24,23,122022,2799,119223,5183.608696,116.625,42.59485531
NM_004657,SDPR,2,1,12976,3252,9724,9724,1626,2.990159902
NM_001127257,SLC39A10,10,9,80896,5381,75515,8390.555556,538.1,14.03363687
NM_020342,SLC39A10,10,9,80576,5332,75244,8360.444444,533.2,14.11177794
NM_213608,C2orf66,3,2,5863,2259,3604,1802,753,1.595396193
NM_012433,SF3B1,25,24,43075,4317,38758,1614.916667,172.68,8.977993977
NM_001005526,SF3B1,5,4,16252,623,15629,3907.25,124.6,25.08667737
NM_199440,HSPD1,12,11,13692,2313,11379,1034.454545,192.75,4.919584955
NM_199482,MOB4,8,7,38130,3793,34337,4905.285714,474.125,9.052728711
NM_025147,COQ10B,5,4,21622,1979,19643,4910.75,395.8,9.925720061
NM_015387,MOB4,8,7,37658,3783,33875,4839.285714,472.875,8.954533439
NM_002157,HSPE1,4,3,3468,957,2511,837,239.25,2.623824451
NM_002156,HSPD1,12,11,13334,2333,11001,1000.090909,194.4166667,4.715387913
NM_001204094,MOB4,8,7,37403,3737,33666,4809.428571,467.125,9.008830613
NM_001100819,MOB4,7,6,37658,3719,33939,5656.5,531.2857143,9.12584028
NM_001202485,HSPE1-MOB4,9,8,53704,4288,49416,6177,476.4444444,11.52425373
NM_138395,MARS2,1,0,3088,3088,NA,NA,3088,NA
NM_001284361,BOLL,12,11,58133,2999,55134,5012.181818,249.9166667,18.38412804
NM_033030,BOLL,11,10,58473,2849,55624,5562.4,259,19.52404352
NM_197970,BOLL,11,10,59337,2786,56551,5655.1,253.2727273,20.2982771
NM_001284358,BOLL,9,8,59435,2751,56684,7085.5,305.6666667,20.60487096
NM_001284362,BOLL,11,10,58133,2936,55197,5519.7,266.9090909,18.80006812
NM_153689,C2orf69,2,1,17019,3730,13289,13289,1865,3.562734584
NM_024520,C2orf47,6,5,8809,1517,7292,1458.4,252.8333333,4.806855636
NM_001160033,SGOL2,9,8,57955,4544,53411,6676.375,504.8888889,11.75418134
NM_001160046,SGOL2,9,8,54528,4038,50490,6311.25,448.6666667,12.50371471
NM_152387,KCTD18,7,6,21110,2944,18166,3027.666667,420.5714286,6.170516304
NM_152524,SGOL2,9,8,57955,4551,53404,6675.5,505.6666667,11.73456383
NM_001207068,BZW1,12,11,9912,1508,8404,764,125.6666667,5.572944297
NM_001207067,BZW1,12,11,12302,3395,8907,809.7272727,282.9166667,2.623564065
NM_014670,BZW1,12,11,12302,3197,9105,827.7272727,266.4166667,2.847982484
NM_001207069,BZW1,12,11,11663,3075,8588,780.7272727,256.25,2.792845528
NM_032472,PPIL3,7,6,18172,1185,16987,2831.166667,169.2857143,14.3350211
NM_130906,PPIL3,7,6,18172,1173,16999,2833.166667,167.5714286,14.49190111
NM_021824,NIF3L1,7,6,14549,1638,12911,2151.833333,234,7.882173382
NM_006190,ORC2,18,17,53532,3153,50379,2963.470588,175.1666667,15.97811608
NM_001142356,NIF3L1,5,4,12016,1280,10736,2684,256,8.3875
NM_001142355,NIF3L1,7,6,14607,1435,13172,2195.333333,205,9.179094077
NM_001136039,NIF3L1,7,6,14607,1486,13121,2186.833333,212.2857143,8.82974428
NM_002491,NDUFB3,3,2,14013,758,13255,6627.5,252.6666667,17.48680739
NM_001257102,NDUFB3,4,3,14013,782,13231,4410.333333,195.5,16.91943734
NM_032974,CASP10,10,9,46510,2317,44193,4910.333333,231.7,19.07337074
NM_032977,CASP10,10,9,38764,5916,32848,3649.777778,591.6,5.55240027
NM_001202515,CFLAR,6,5,32415,9723,22692,4538.4,1620.5,2.333847578
NM_001206524,CASP10,8,7,38764,5713,33051,4721.571429,714.125,5.785226676
NM_032976,CASP10,9,8,38764,5823,32941,4117.625,647,5.657049631
NM_001206542,CASP10,8,7,46510,2186,44324,6332,273.25,20.27630375
NM_001127183,CFLAR,10,9,54144,10661,43483,4831.444444,1066.1,4.078698058
NM_001202518,CFLAR,8,7,39725,10788,28937,4133.857143,1348.5,2.682332221
NM_001230,CASP10,8,7,38764,5785,32979,4711.285714,723.125,5.700777874
NM_001080125,CASP8,9,8,29682,2944,26738,3342.25,327.1111111,9.082201087
NM_001127391,ALS2CR12,15,14,68956,1959,66997,4785.5,130.6,34.19959163
NM_033356,CASP8,8,7,27213,2660,24553,3507.571429,332.5,9.230451128
NM_139163,ALS2CR12,15,14,68956,2028,66928,4780.571429,135.2,33.00197239
NM_018571,STRADB,12,11,29184,2310,26874,2443.090909,192.5,11.63376623
NM_001206864,STRADB,12,11,29184,2334,26850,2440.909091,194.5,11.50385604
NM_001168217,ALS2CR11,13,12,84864,3272,81592,6799.333333,251.6923077,24.93643032
NM_033066,MPP4,22,21,53822,2480,51342,2444.857143,112.7272727,20.70241935
NM_001261435,CDK15,14,13,88973,3673,85300,6561.538462,262.3571429,23.22352301
NM_001261436,CDK15,13,12,82875,2290,80585,6715.416667,176.1538462,35.18995633
NM_139158,CDK15,14,13,89123,3601,85522,6578.615385,257.2142857,23.74951402
NM_003352,SUMO1,5,4,32421,1532,30889,7722.25,306.4,20.16253264
NM_001005782,SUMO1,4,3,32421,1456,30965,10321.66667,364,21.26717033
NM_001005781,SUMO1,6,5,32421,1084,31337,6267.4,180.6666667,28.90867159
NM_018256,WDR12,13,12,31628,2295,29333,2444.416667,176.5384615,12.78126362
NM_177538,CYP20A1,13,12,67401,10956,56445,4703.75,842.7692308,5.151971522
NM_001282927,ABI2,9,8,65291,6123,59168,7396,680.3333333,9.663236975
NM_012092,ICOS,5,4,24829,2648,22181,5545.25,529.6,8.376510574
NM_017759,INO80D,11,10,92463,14147,78316,7831.6,1286.090909,5.53587333
NM_021121,EEF1B2,7,6,3337,843,2494,415.6666667,120.4285714,2.958481613
NM_001199984,NDUFS1,19,18,36117,3412,32705,1816.944444,179.5789474,9.585287222
NM_001199983,NDUFS1,18,17,36442,3399,33043,1943.705882,188.8333333,9.721388644
NM_001199982,NDUFS1,16,15,36442,3212,33230,2215.333333,200.75,10.34557908
NM_001199981,NDUFS1,18,17,36442,3383,33059,1944.647059,187.9444444,9.772095773
NM_005279,GPR1,3,2,42731,2319,40412,20206,773,17.42647693
NM_001959,EEF1B2,6,5,3337,1116,2221,444.2,186,1.990143369
NM_001037663,EEF1B2,7,6,3337,889,2448,408,127,2.753655793
NM_001098199,GPR1,3,2,42731,2315,40416,20208,771.6666667,17.45831533
NM_001261455,GPR1,3,2,38312,2157,36155,18077.5,719,16.76170607
NM_001261454,GPR1,3,2,38312,2161,36151,18075.5,720.3333333,16.72882925
NM_001261453,GPR1,4,3,42731,2571,40160,13386.66667,642.75,15.62038117
NM_001261452,GPR1,4,3,42731,2567,40164,13388,641.75,15.6462797
NM_005006,NDUFS1,19,18,36442,3492,32950,1830.555556,183.7894737,9.435853379
NM_001285549,ZDBF2,7,6,39400,10206,29194,4865.666667,1458,2.860474231
NM_020923,ZDBF2,5,4,39787,10311,29476,7369,2062.2,2.858694598
NM_001093730,DYTN,12,11,66777,2063,64714,5883.090909,171.9166667,31.36888027
NM_001102659,AC010731.4,3,2,7033,1379,5654,2827,459.6666667,4.100072516
NM_014929,FASTKD2,12,11,30801,6847,23954,2177.636364,570.5833333,3.498466482
NM_001136194,FASTKD2,12,11,30801,6955,23846,2167.818182,579.5833333,3.428612509
NM_001136193,FASTKD2,12,11,30801,6940,23861,2169.181818,578.3333333,3.438184438
NM_173077,CPO,9,8,29922,1218,28704,3588,135.3333333,23.56650246
NM_001270944,KLF7,4,3,60001,7957,52044,17348,1989.25,6.540656026
NM_001127395,METTL21A,4,3,16136,4809,11327,3775.666667,1202.25,2.355375338
NM_145280,METTL21A,4,3,15859,4752,11107,3702.333333,1188,2.33733165
NM_001142300,CCNYL1,8,7,44634,3766,40868,5838.285714,470.75,10.85183218
NM_003468,FZD5,2,1,6835,6566,269,269,3283,0.040968626
NM_152523,CCNYL1,11,10,44634,3670,40964,4096.4,333.6363636,11.16185286
NM_020989,CRYGC,3,2,1695,632,1063,531.5,210.6666667,1.681962025
NM_006891,CRYGD,3,2,2984,710,2274,1137,236.6666667,3.202816901
NM_014617,CRYGA,3,2,2835,609,2226,1113,203,3.655172414
NM_001099334,C2orf80,9,8,24704,1223,23481,2935.125,135.8888889,19.1995094
NM_005210,CRYGB,3,2,3582,629,2953,1476.5,209.6666667,4.694753577
NM_005896,IDH1,10,9,18918,2402,16516,1835.111111,240.2,6.875936719
NM_001282387,IDH1,10,9,18078,2470,15608,1734.222222,247,6.31902834
NM_001282386,IDH1,10,9,18233,2313,15920,1768.888889,231.3,6.882836144
NM_001178000,PIKFYVE,12,11,39282,2340,36942,3358.363636,195,15.78717949
NM_152671,PIKFYVE,10,9,39282,2047,37235,4137.222222,204.7,18.1900342
NM_006916,RPE,6,5,19697,3233,16464,3292.8,538.8333333,5.092483761
NM_001278282,RPE,7,6,19697,3265,16432,2738.666667,466.4285714,5.032771822
NM_001278289,RPE,7,6,19697,3329,16368,2728,475.5714286,4.916791829
NM_001278288,RPE,5,4,19697,3178,16519,4129.75,635.6,5.197923222
NM_001278283,RPE,8,7,19697,3346,16351,2335.857143,418.25,4.886730424
NM_199229,RPE,6,5,19697,3259,16438,3287.6,543.1666667,5.04387849
NM_001278286,RPE,6,5,19697,3188,16509,3301.8,531.3333333,5.178481807
NM_001278285,RPE,5,4,19697,3171,16526,4131.5,634.2,5.211605172
NM_001608,ACADL,11,10,37501,2501,35000,3500,227.3636364,13.99440224
NM_001136575,LANCL1,10,9,45528,4518,41010,4556.666667,451.8,9.077025232
NM_006055,LANCL1,10,9,45520,4612,40908,4545.333333,461.2,8.869904597
NM_001136574,LANCL1,10,9,45458,4523,40935,4548.333333,452.3,9.050409021
NM_001875,CPS1,38,37,122510,5798,116712,3154.378378,152.5789474,20.1296999
NM_001122634,CPS1,28,27,85754,4809,80945,2997.962963,171.75,16.8319817
NM_001242575,AC079610.2,3,2,7654,1729,5925,2962.5,576.3333333,3.426836322
NM_004044,ATIC,16,15,37819,2100,35719,2381.266667,131.25,17.00904762
NM_054034,FN1,13,12,21409,2396,19013,1584.416667,184.3076923,7.935308848
NM_018000,MREG,5,4,71034,3218,67816,16954,643.6,21.07395898
NM_001142310,TMEM169,4,3,20919,3465,17454,5818,866.25,5.037229437
NM_138390,TMEM169,3,2,20919,3374,17545,8772.5,1124.666667,5.200059277
NM_001142312,TMEM169,3,2,20919,3372,17547,8773.5,1124,5.203736655
NM_001142311,TMEM169,3,2,20919,3378,17541,8770.5,1126,5.192717584
NM_000998,RPL37A,4,3,2670,422,2248,749.3333333,105.5,5.327014218
NM_000597,IGFBP2,4,3,31033,1433,29600,9866.666667,358.25,20.6559665
NM_000599,IGFBP5,4,3,23446,6243,17203,5734.333333,1560.75,2.755566234
NM_003284,TNP1,2,1,602,403,199,199,201.5,0.493796526
NM_198483,RUFY4,13,12,21568,2774,18794,1566.166667,213.3846154,6.775054074
NM_001168298,CXCR2,4,3,11965,2666,9299,3099.666667,666.5,3.487996999
NM_001557,CXCR2,3,2,11242,2873,8369,4184.5,957.6666667,2.912982945
NM_001077191,GPBAR1,2,1,2846,2005,841,841,1002.5,0.419451372
NM_152862,ARPC2,11,10,37256,1516,35740,3574,137.8181818,23.57519789
NM_001087,AAMP,11,10,6043,1804,4239,423.9,164,2.349778271
NM_001077194,GPBAR1,2,1,2846,1497,1349,1349,748.5,0.901135605
NM_001077399,PNKD,3,2,2557,761,1796,898,253.6666667,2.360052562
NM_000634,CXCR1,2,1,4150,2488,1662,1662,1244,0.668006431
NM_005731,ARPC2,10,9,36953,1420,35533,3948.111111,142,25.02323944
NM_170699,GPBAR1,2,1,2846,1384,1462,1462,692,1.056358382
NM_198559,CATIP,10,9,11240,1333,9907,1100.777778,133.3,7.432108027
NM_022572,PNKD,9,8,23616,2996,20620,2577.5,332.8888889,6.882510013
NM_021198,CTDSP1,7,6,6188,2645,3543,590.5,377.8571429,1.339508507
NM_001206878,CTDSP1,7,6,7605,2381,5224,870.6666667,340.1428571,2.194036119
NM_000578,SLC11A1,15,14,14867,3867,11000,785.7142857,257.8,2.844582364
NM_182642,CTDSP1,7,6,6188,2642,3546,591,377.4285714,1.342165026
NM_007127,VIL1,20,19,30412,2758,27654,1455.473684,137.9,10.02683104
NM_001257344,BCS1L,8,7,3789,1519,2270,324.2857143,189.875,1.494404213
NM_001079866,BCS1L,8,7,3789,1462,2327,332.4285714,182.75,1.591655267
NM_001105537,ZNF142,10,9,21625,5934,15691,1743.444444,593.4,2.644253455
NM_032726,PLCD4,16,15,29423,3253,26170,1744.666667,203.3125,8.044881648
NM_005444,RQCD1,8,7,27857,3442,24415,3487.857143,430.25,7.093259733
NM_022453,RNF25,10,9,8196,1571,6625,736.1111111,157.1,4.217059198
NM_001271634,RQCD1,9,8,27857,3539,24318,3039.75,393.2222222,6.871432608
NM_001271635,RQCD1,8,7,25277,1442,23835,3405,180.25,16.52912621
NM_001257343,BCS1L,9,8,3789,1645,2144,268,182.7777778,1.303343465
NM_001257342,BCS1L,9,8,3789,1593,2196,274.5,177,1.378531073
NM_004328,BCS1L,9,8,3789,1672,2117,264.625,185.7777778,1.266148325
NM_014640,TTLL4,20,19,44572,5016,39556,2081.894737,250.8,7.885964912
NM_025216,WNT10A,4,3,13398,2379,11019,3673,594.75,4.631778058
NM_006522,WNT6,4,3,14410,1704,12706,4235.333333,426,7.45657277
NM_017431,PRKAG3,14,13,9408,2313,7095,545.7692308,165.2142857,3.067444877
NM_194302,CCDC108,35,34,38707,6016,32691,961.5,171.8857143,5.434009309
NM_002181,IHH,3,2,6098,2075,4023,2011.5,691.6666667,1.938795181
NM_001278296,CCDC108,12,11,15005,3282,11723,1065.727273,273.5,3.571907374
NM_001278295,CCDC108,13,12,15005,3332,11673,972.75,256.3076923,3.503301321
NM_003936,CDK5R2,1,0,2529,2529,NA,NA,2529,NA
NM_152389,CCDC108,4,3,7861,2291,5570,1856.666667,572.75,2.431252728
NM_017521,FEV,3,2,4572,1882,2690,1345,627.3333333,1.429330499
NM_057094,CRYBA2,5,4,3217,696,2521,630.25,139.2,3.622126437
NM_057093,CRYBA2,4,3,3217,889,2328,776,222.25,2.618672666
NM_001144889,SLC23A3,12,11,8638,2406,6232,566.5454545,200.5,2.590191189
NM_001144890,SLC23A3,12,11,8638,2430,6208,564.3636364,202.5,2.55473251
NM_024782,NHEJ1,8,7,85543,2111,83432,11918.85714,263.875,39.52250118
NM_024293,FAM134A,9,8,7260,4623,2637,329.625,513.6666667,0.570408825
NM_015680,CNPPD1,8,7,5085,2082,3003,429,260.25,1.442363112
NM_144712,SLC23A3,11,10,8638,2054,6584,658.4,186.7272727,3.205452775
NM_001278552,TUBA4A,4,3,4899,2503,2396,798.6666667,625.75,0.957251298
NM_006000,TUBA4A,4,3,4237,2080,2157,719,520,1.037019231
NM_005689,ABCB6,19,18,9226,3037,6189,343.8333333,159.8421053,2.037866315
NM_001008910,STK16,8,7,4869,2861,2008,286.8571429,357.625,0.701852499
NM_001282792,ANKZF1,11,10,6914,2196,4718,471.8,199.6363636,2.14845173
NM_024085,ATG9A,15,14,10310,3785,6525,466.0714286,252.3333333,1.723910172
NM_001042410,ANKZF1,14,13,6783,2520,4263,327.9230769,180,1.691666667
NM_001039550,DNAJB2,10,9,7584,1984,5600,622.2222222,198.4,2.822580645
NM_001077198,ATG9A,16,15,10310,3838,6472,431.4666667,239.875,1.686294945
NM_001199763,PTPRN,22,21,19952,3719,16233,773,169.0454545,4.364883033
NM_001199764,PTPRN,23,22,19386,3577,15809,718.5909091,155.5217391,4.419625384
NM_006736,DNAJB2,9,8,7584,3134,4450,556.25,348.2222222,1.419910657
NM_002846,PTPRN,23,22,19952,3807,16145,733.8636364,165.5217391,4.240872078
NM_018089,ANKZF1,14,13,6914,2593,4321,332.3846154,185.2142857,1.666409564
NM_138802,ZFAND2B,9,8,2869,1332,1537,192.125,148,1.153903904
NM_001270999,ZFAND2B,9,8,2869,1079,1790,223.75,119.8888889,1.658943466
NM_001270998,ZFAND2B,10,9,2869,1209,1660,184.4444444,120.9,1.373035567
NM_001007089,RESP18,7,6,5770,802,4968,828,114.5714286,6.194513716
NM_001286427,GLB1L,14,13,7035,2241,4794,368.7692308,160.0714286,2.139223561
NM_001286423,GLB1L,17,16,8833,2727,6106,381.625,160.4117647,2.239090576
NM_024506,GLB1L,17,16,8833,2715,6118,382.375,159.7058824,2.253406998
NM_001173476,SPEG,5,4,6052,1437,4615,1153.75,287.4,3.211551844
NM_012100,DNPEP,15,14,14484,2453,12031,859.3571429,163.5333333,4.904606604
NM_001927,DES,9,8,8364,2257,6107,763.375,250.7777778,2.705804165
NM_015311,OBSL1,21,20,20820,6133,14687,734.35,292.047619,2.394749715
NM_002191,INHA,2,1,3483,1433,2050,2050,716.5,1.430565248
NM_205847,GMPPA,13,12,8103,1849,6254,521.1666667,142.2307692,3.382368848
NM_182847,ASIC4,9,8,24604,2853,21751,2718.875,317,7.623904662
NM_001005209,TMEM198,5,4,6574,2223,4351,1087.75,444.6,1.957264957
NM_001173431,OBSL1,14,13,16398,5807,10591,814.6923077,414.7857143,1.823833305
NM_001173408,OBSL1,9,8,9832,3569,6263,782.875,396.5555556,1.754833287
NM_013335,GMPPA,13,12,8133,1568,6565,547.0833333,120.6153846,4.186862245
NM_001195731,CHPF,4,3,4152,2639,1513,504.3333333,659.75,0.573323228
NM_001286811,LOC100996693,4,3,1934,819,1115,371.6666667,204.75,1.361416361
NM_024536,CHPF,4,3,4820,2995,1825,608.3333333,748.75,0.609348915
NM_201574,SLC4A3,23,22,14412,4264,10148,461.2727273,185.3913043,2.379924953
NM_005070,SLC4A3,23,22,14412,4243,10169,462.2272727,184.4782609,2.396653311
NM_000438,PAX3,4,3,5368,1508,3860,1286.666667,377,2.559681698
NM_153038,CCDC140,2,1,7072,1701,5371,5371,850.5,3.15755438
NM_013942,PAX3,5,4,5368,1100,4268,1067,220,3.88
NM_058165,MOGAT1,6,5,38194,1102,37092,7418.4,183.6666667,33.65880218
NM_080671,KCNE4,2,1,3711,3179,532,532,1589.5,0.167348223
NM_003469,SCG2,2,1,5561,2574,2987,2987,1287,1.16045066
NM_022915,MRPL44,4,3,10312,1752,8560,2853.333333,438,4.885844749
NM_006216,SERPINE2,9,8,64273,2268,62005,7750.625,252,27.33906526
NM_001136530,SERPINE2,9,8,63594,2195,61399,7674.875,243.8888889,27.97220957
NM_001136528,SERPINE2,9,8,64273,2265,62008,7751,251.6666667,27.37660044
NM_001122779,FAM124B,2,1,23298,2471,20827,20827,1235.5,8.428571429
NM_024785,FAM124B,3,2,23298,2597,20701,10350.5,865.6666667,7.971120524
NM_001257198,CUL3,16,15,99677,6489,93188,6212.533333,405.5625,14.36091848
NM_005544,IRS1,2,1,67475,8738,58737,58737,4369,6.722018769
NM_024795,TM4SF20,4,3,17150,2298,14852,4950.666667,574.5,6.463011314
NM_001135187,AGFG1,14,13,89052,8746,80306,6177.384615,624.7142857,9.182026069
NM_001135189,AGFG1,12,11,89052,8558,80494,7317.636364,713.1666667,9.405702267
NM_001135188,AGFG1,13,12,89052,8673,80379,6698.25,667.1538462,9.26772743
NM_004504,AGFG1,13,12,89052,8679,80373,6697.75,667.6153846,9.260629105
NM_025243,SLC19A3,6,5,32821,3773,29048,5809.6,628.8333333,7.698913332
NM_001162483,C2orf83,4,3,23232,2091,21141,7047,522.75,10.11047346
NM_020161,C2orf83,3,2,23232,1995,21237,10618.5,665,10.64511278
NM_001130046,CCL20,4,3,3724,843,2881,960.3333333,210.75,3.417556346
NM_004591,CCL20,4,3,3724,846,2878,959.3333333,211.5,3.401891253
NM_178821,DAW1,13,12,52701,1682,51019,4251.583333,129.3846154,30.33234245
NM_152527,SLC16A14,5,4,34027,4403,29624,7406,880.6,6.728139905
NM_001278453,SP140,24,23,87487,2932,84555,3676.304348,122.1666667,28.83867667
NM_001278452,SP140,25,24,87487,3095,84392,3516.333333,123.8,27.26720517
NM_001278451,SP140,26,25,87487,3195,84292,3371.68,122.8846154,26.38247261
NM_001005176,SP140,4,3,13348,841,12507,4169,210.25,14.87158145
NM_007237,SP140,27,26,87487,3277,84210,3238.846154,121.3703704,25.6972841
NM_001206703,SP100,14,13,54381,1937,52444,4034.153846,138.3571429,27.07485803
NM_001206702,SP100,15,14,54381,2022,52359,3739.928571,134.8,25.89465875
NM_001206704,SP100,16,15,53781,2058,51723,3448.2,128.625,25.13265306
NM_005683,GPR55,2,1,17900,3830,14070,14070,1915,3.673629243
NM_000867,HTR2B,4,3,16876,2236,14640,4880,559,6.547406082
NM_001144994,C2orf72,3,2,12148,3582,8566,4283,1194,2.391401452
NM_145236,B3GNT7,2,1,5542,3627,1915,1915,1813.5,0.52798456
NM_005381,NCL,14,13,9748,2731,7017,539.7692308,195.0714286,2.569388502
NM_152614,C2orf57,1,0,1421,1421,NA,NA,1421,NA
NM_002601,PDE6D,5,4,48829,1123,47706,11926.5,224.6,42.48085485
NM_001099285,PTMA,5,4,5017,1212,3805,951.25,242.4,3.139438944
NM_002823,PTMA,5,4,5017,1209,3808,952,241.8,3.149710505
NM_024409,NPPC,3,2,4235,704,3531,1765.5,234.6666667,5.015625
NM_031313,ALPPL2,11,10,3874,2505,1369,136.9,227.7272727,0.546506986
NM_001632,ALPP,11,10,4253,2878,1375,137.5,261.6363636,0.477762335
NM_001256657,CHRND,11,10,10507,2929,7578,757.8,266.2727273,2.587231137
NM_145702,TIGD1,1,0,2449,2449,NA,NA,2449,NA
NM_005199,CHRNG,12,11,6603,2199,4404,400.3636364,183.25,2.002728513
NM_000751,CHRND,12,11,10507,2975,7532,684.7272727,247.9166667,2.531764706
NM_004846,EIF4E2,7,6,18626,1077,17549,2924.833333,153.8571429,16.29433612
NM_001631,ALPI,11,10,3911,2561,1350,135,232.8181818,0.527137837
NM_001195129,PRSS56,13,12,5254,2170,3084,257,166.9230769,1.421198157
NM_004826,ECEL1,18,17,7997,2877,5120,301.1764706,159.8333333,1.779631561
NM_001243252,EFHD1,4,3,76726,1601,75125,25041.66667,400.25,46.92379763
NM_025202,EFHD1,4,3,49286,1994,47292,15764,498.5,23.71715145
NM_001172417,KCNJ13,3,2,10765,3379,7386,3693,1126.333333,2.185853803
NM_002242,KCNJ13,3,2,10765,3612,7153,3576.5,1204,1.9803433
NM_001172416,KCNJ13,3,2,10765,3376,7389,3694.5,1125.333333,2.188684834
NM_001114090,NGEF,13,12,49467,2825,46642,3886.833333,217.3076923,16.51044248
NM_206895,C2orf82,3,2,6115,468,5647,2823.5,156,12.06623932
NM_005383,NEU2,2,1,2387,1145,1242,1242,572.5,1.084716157
NM_030803,ATG16L1,18,17,44105,3423,40682,2393.058824,190.1666667,11.88489629
NM_001190267,ATG16L1,18,17,44105,3419,40686,2393.294118,189.9444444,11.89997075
NM_001190266,ATG16L1,18,17,44105,3421,40684,2393.176471,190.0555556,11.89242911
NM_198890,ATG16L1,14,13,44105,2930,41175,3167.307692,209.2857143,14.05290102
NM_017974,ATG16L1,17,16,44105,3365,40740,2546.25,197.9411765,12.10698366
NM_018218,USP40,31,30,90073,5648,84425,2814.166667,182.1935484,14.94776912
NM_001001394,DNAJB3,1,0,1267,1267,NA,NA,1267,NA
NM_001287395,MROH2A,42,41,57746,5366,52380,1277.560976,127.7619048,9.761461051
NM_007120,UGT1A4,5,4,54509,2379,52130,13032.5,475.8,21.91256831
NM_019078,UGT1A5,5,4,60309,2350,57959,14489.75,470,24.66340426
NM_019093,UGT1A3,5,4,44174,2350,41824,10456,470,17.79744681
NM_000463,UGT1A1,5,4,13028,2362,10666,2666.5,472.4,4.515664691
NM_006944,SPP2,8,7,26432,1027,25405,3629.285714,128.375,24.73709834
NM_001485,GBX2,2,1,2347,1337,1010,1010,668.5,0.755422588
NM_020311,ACKR3,2,1,12616,2102,10514,10514,1051,5.00190295
NM_006710,COPS8,8,7,13407,2266,11141,1591.571429,283.25,4.916593116
NM_198189,COPS8,9,8,13407,2332,11075,1384.375,259.1111111,4.749142367
NM_022449,RAB17,6,5,16806,2005,14801,2960.2,334.1666667,7.382044888
NM_015893,PRLH,2,1,603,266,337,337,133,1.266917293
NM_001137553,LRRFIP1,8,7,73753,4334,69419,9917,541.75,16.01730503
NM_001137552,LRRFIP1,11,10,73753,4505,69248,6924.8,409.5454545,15.37136515
NM_004735,LRRFIP1,10,9,73753,4432,69321,7702.333333,443.2,15.64101986
NM_001080504,RBM44,16,15,44065,4299,39766,2651.066667,268.6875,9.250058153
NM_194312,ESPNL,9,8,32979,4692,28287,3535.875,521.3333333,6.028772379
NM_198582,KLHL30,8,7,14186,3693,10493,1499,461.625,2.841321419
NM_016510,SCLY,12,11,38491,2539,35952,3268.363636,211.5833333,14.15990547
NM_018645,HES6,4,3,1859,1458,401,133.6666667,364.5,0.275034294
NM_001282434,HES6,4,3,1859,1418,441,147,354.5,0.31100141
NM_030768,ILKAP,12,11,33283,1455,31828,2893.454545,121.25,21.87491409
NM_001142853,HES6,4,3,1859,1452,407,135.6666667,363,0.28030303
NM_022817,PER2,23,22,44530,6365,38165,1734.772727,276.7391304,5.99607227
NM_015650,TRAF3IP1,17,16,80358,4193,76165,4760.3125,246.6470588,18.16479847
NM_001139490,TRAF3IP1,15,14,80358,3993,76365,5454.642857,266.2,19.12471826
NM_001271893,TWIST2,2,1,75566,964,74602,74602,482,77.3879668
NM_057179,TWIST2,2,1,39222,1178,38044,38044,589,32.29541596
NM_001005853,OR6B2,1,0,940,940,NA,NA,940,NA
NM_001080835,PRR21,1,0,1171,1171,NA,NA,1171,NA
NM_173351,OR6B3,1,0,997,997,NA,NA,997,NA
NM_001163424,MYEOV2,3,2,5507,449,5058,2529,149.6666667,11.26503341
NM_138336,MYEOV2,5,4,9786,764,9022,2255.5,152.8,11.80890052
NM_148961,OTOS,4,3,1629,570,1059,353,142.5,1.857894737
NM_002081,GPC1,9,8,32382,3695,28687,3585.875,410.5555556,7.763734777
NM_023085,CAPN10,10,9,12395,2189,10206,1134,218.9,4.662402924
NM_023083,CAPN10,12,11,12395,2656,9739,885.3636364,221.3333333,3.666792169
NM_001033575,DUSP28,3,2,3962,1558,2404,1202,519.3333333,1.543003851
NM_018226,RNPEPL1,11,10,10147,3029,7118,711.8,275.3636364,2.349950479
NM_001102467,AQP12B,3,2,6484,1117,5367,2683.5,372.3333333,4.804834378
NM_198998,AQP12A,4,3,6640,1088,5552,1850.666667,272,5.102941176
NM_000030,AGXT,11,10,10376,1609,8767,876.7,146.2727273,5.448725917
NM_001252119,PASK,18,17,43407,4611,38796,2282.117647,256.1666667,8.413793103
NM_015148,PASK,18,17,43407,4590,38817,2283.352941,255,8.456862745
NM_001252124,PASK,14,13,35871,4888,30983,2383.307692,349.1428571,6.338584288
NM_001252122,PASK,18,17,43407,4485,38922,2289.529412,249.1666667,8.67826087
NM_001252120,PASK,19,18,43882,4744,39138,2174.333333,249.6842105,8.25
NM_182501,MTERFD2,4,3,6768,1641,5127,1709,410.25,3.124314442
NM_203346,HDLBP,28,27,45566,6342,39224,1452.740741,226.5,6.184799748
NM_001243900,HDLBP,28,27,45566,6266,39300,1455.555556,223.7857143,6.271943824
NM_001001891,ANO7,25,24,36869,4153,32716,1363.166667,166.12,7.877678786
NM_001001666,ANO7,4,3,7658,895,6763,2254.333333,223.75,7.556424581
NM_001008491,Sep-02,14,13,38841,3731,35110,2700.769231,266.5,9.410345752
NM_001008492,Sep-02,14,13,38167,3413,34754,2673.384615,243.7857143,10.18283035
NM_006155,Sep-02,13,12,38841,3629,35212,2934.333333,279.1538462,9.702948471
NM_001282973,Sep-02,17,16,38167,3689,34478,2154.875,217,9.346164272
NM_001282972,Sep-02,14,13,38167,3462,34705,2669.615385,247.2857143,10.02455228
NM_004404,Sep-02,13,12,38167,3327,34840,2903.333333,255.9230769,10.4718966
NM_001282308,STK25,11,10,13990,2408,11582,1158.2,218.9090909,4.809800664
NM_001271980,STK25,11,10,13990,2307,11683,1168.3,209.7272727,5.064152579
NM_001271979,STK25,11,10,13990,2369,11621,1162.1,215.3636364,4.905445336
NM_001271978,STK25,11,10,13655,2572,11083,1108.3,233.8181818,4.309097978
NM_001271977,STK25,12,11,13990,2601,11389,1035.363636,216.75,4.3787005
NM_006374,STK25,12,11,13990,2539,11451,1041,211.5833333,4.510043324
NM_001282305,STK25,11,10,14867,2567,12300,1230,233.3636364,4.791585508
NM_001282307,STK25,11,10,13990,2470,11520,1152,224.5454545,4.663967611
NM_001282306,STK25,12,11,13990,2551,11439,1039.909091,212.5833333,4.484123873
NM_013325,ATG4B,13,12,36246,2890,33356,2779.666667,222.3076923,11.54186851
NM_001164356,THAP4,5,4,33098,790,32308,8077,158,40.89620253
NM_032515,BOK,5,4,15409,2652,12757,3189.25,530.4,4.810331825
NM_015963,THAP4,6,5,52907,2234,50673,10134.6,372.3333333,22.68263205
NM_178326,ATG4B,13,12,36246,2910,33336,2778,223.8461538,11.4556701
NM_001165031,DTYMK,5,4,11228,1142,10086,2521.5,228.4,8.831873905
NM_012145,DTYMK,5,4,11228,1214,10014,2503.5,242.8,8.248764415
NM_001287249,D2HGDH,9,8,34239,2247,31992,3999,249.6666667,14.2376502
NM_032329,ING5,8,7,27442,5206,22236,3176.571429,650.75,4.271225509
NM_022134,GAL3ST2,4,3,27464,1453,26011,8670.333333,363.25,17.90158293
NM_152783,D2HGDH,10,9,34239,2632,31607,3511.888889,263.2,12.0087386
NM_173821,CXXC11,2,1,3598,1800,1798,1798,900,0.998888889
NM_001167599,NEU4,4,3,6711,2357,4354,1451.333333,589.25,1.847263471
NM_001167601,NEU4,4,3,8581,2040,6541,2180.333333,510,3.206372549
NM_001167600,NEU4,4,3,8581,2037,6544,2181.333333,509.25,3.212567501
NM_080741,NEU4,4,3,6711,2354,4357,1452.333333,588.5,1.850892099
NM_001167602,NEU4,5,4,6711,2536,4175,1043.75,507.2,1.646293375
NM_005018,PDCD1,5,4,9027,2117,6910,1727.5,423.4,3.264052905
NM_001042400,CEP63,13,12,78975,5305,73670,6139.166667,408.0769231,13.88689915
NM_001042384,CEP63,12,11,89282,1907,87375,7943.181818,158.9166667,45.8180388
NM_025180,CEP63,16,15,78825,6070,72755,4850.333333,379.375,11.98599671
NM_001042383,CEP63,12,11,79297,5338,73959,6723.545455,444.8333333,13.85518921
NM_001200032,HYAL3,3,2,6642,1092,5550,2775,364,5.082417582
NM_001200031,HYAL3,4,3,6642,1183,5459,1819.666667,295.75,4.614539307
NM_001200030,HYAL3,3,2,6642,1858,4784,2392,619.3333333,2.574811625
NM_001200029,HYAL3,4,3,6036,1735,4301,1433.666667,433.75,2.478962536
NM_017886,ULK4,37,36,715572,4396,711176,19754.88889,118.8108108,161.77798
NM_003549,HYAL3,4,3,6642,1949,4693,1564.333333,487.25,2.407901488
NM_001207044,CLASP2,33,32,163196,6754,156442,4888.8125,204.6666667,23.16286645
NM_015097,CLASP2,39,38,221968,7182,214786,5652.263158,184.1538462,29.90615427
NM_012190,ALDH1L1,23,22,77243,3312,73931,3360.5,144,22.32216184
NM_018189,DPPA4,7,6,11433,2824,8609,1434.833333,403.4285714,3.048512748
NM_001270365,ALDH1L1,21,20,77243,3007,74236,3711.8,143.1904762,24.68772863
NM_001270364,ALDH1L1,23,22,77627,3210,74417,3382.590909,139.5652174,23.18286604
NM_015429,ABI3BP,35,34,244157,4508,239649,7048.5,128.8,53.1608252
NM_001009921,VPS8,47,46,240473,5094,235379,5116.934783,108.3829787,46.2071064
NM_014879,P2RY14,3,2,66327,2491,63836,31918,830.3333333,25.62665596
NM_001197113,IQCJ-SCHIP1,11,10,828116,2476,825640,82564,225.0909091,333.457189
NM_001197108,SCHIP1,7,6,624121,1941,622180,103696.6667,277.2857143,320.5461103
NM_001197107,SCHIP1,8,7,624121,2599,621522,88788.85714,324.875,239.1388996
NM_014575,SCHIP1,8,7,624121,2638,621483,88783.28571,329.75,235.5887036
NM_013363,PCOLCE2,9,8,71345,2039,69306,8663.25,226.5555556,33.99019127
NM_053002,MED12L,43,42,349791,10392,339399,8080.928571,241.6744186,32.65964203
NM_015303,VPS8,47,46,240473,5088,235385,5117.065217,108.2553191,46.26277516
NM_014498,GOLIM4,16,15,85765,2854,82911,5527.4,178.375,29.05080589
NM_001197114,IQCJ-SCHIP1,10,9,828116,2394,825722,91746.88889,239.4,344.9131161
NM_000564,IL5RA,13,12,44052,5821,38231,3185.916667,447.7692308,6.567771861
NM_001243099,IL5RA,11,10,44052,5665,38387,3838.7,515,6.776169462
NM_014674,EDEM1,12,11,32293,6165,26128,2375.272727,513.75,4.23811841
NM_181874,GRM7,11,10,880418,4250,876168,87616.8,386.3636364,206.1571765
NM_000844,GRM7,10,9,880418,4157,876261,97362.33333,415.7,210.7916767
NM_175728,IL5RA,10,9,20203,1663,18540,2060,166.3,11.14852676
NM_175727,IL5RA,9,8,18566,1992,16574,2071.75,221.3333333,8.320281124
NM_175725,IL5RA,11,10,20203,1733,18470,1847,157.5454545,10.65781881
NM_175724,IL5RA,10,9,18566,2062,16504,1833.777778,206.2,8.003879728
NM_175726,IL5RA,12,11,44052,5751,38301,3481.909091,479.25,6.659885237
NM_001683,ATP2B2,20,19,181563,8847,172716,9090.315789,442.35,19.52255002
NM_001195279,C3orf83,4,3,5685,1088,4597,1532.333333,272,4.225183824
NM_001195098,ANKRD28,28,27,130949,6410,124539,4612.555556,228.9285714,19.42886115
NM_001144912,ATG7,17,16,285131,4828,280303,17518.9375,284,58.0577879
NM_001998,FBLN2,17,16,89299,4200,85099,5318.6875,247.0588235,20.26166667
NM_006395,ATG7,19,18,285131,5070,280061,15558.94444,266.8421053,55.23885602
NM_015199,ANKRD28,28,27,192311,6366,185945,6886.851852,227.3571429,29.20907948
NM_001165035,FBLN2,18,17,69684,4599,65085,3828.529412,255.5,14.15198956
NM_001004019,FBLN2,18,17,89299,4342,84957,4997.470588,241.2222222,19.56632888
NM_001136031,ATG7,18,17,285131,4988,280143,16479,277.1111111,56.16339214
NM_001195099,ANKRD28,26,25,89316,6099,83217,3328.68,234.5769231,13.64436793
NM_001001331,ATP2B2,23,22,181563,8985,172578,7844.454545,390.6521739,19.20734558
NM_144715,EFHB,13,12,54742,2868,51874,4322.833333,220.6153846,18.08716876
NM_199347,NEK10,25,24,153817,2664,151153,6298.041667,106.56,56.73911411
NM_001177712,RBMS3,14,13,710008,1791,708217,54478.23077,127.9285714,395.4310441
NM_001177711,RBMS3,14,13,729085,8183,720902,55454,584.5,88.09751925
NM_014483,RBMS3,13,12,710008,1751,708257,59021.41667,134.6923077,404.4871502
NM_182523,CMC1,4,3,78141,629,77512,25837.33333,157.25,123.2305246
NM_001003793,RBMS3,15,14,729085,8232,720853,51489.5,548.8,87.56717687
NM_001003792,RBMS3,14,13,729085,8177,720908,55454.46154,584.0714286,88.16289593
NM_002207,ITGA9,28,27,367470,3990,363480,13462.22222,142.5,91.09774436
NM_006514,SCN10A,27,26,96666,5901,90765,3490.961538,218.5555556,15.38129131
NM_001135197,CCDC36,8,7,58606,2704,55902,7986,338,20.67381657
NM_014159,SETD2,21,20,147571,8454,139117,6955.85,402.5714286,16.45576059
NM_178173,CCDC36,10,9,59678,3004,56674,6297.111111,300.4,18.86617843
NM_015576,ERC2,17,16,960057,6149,953908,59619.25,361.7058824,155.1322166
NM_152678,DENND6A,20,19,67637,4678,62959,3313.631579,233.9,13.45852929
NM_018398,CACNA2D3,38,37,951893,3713,948180,25626.48649,97.71052632,255.3676273
NM_001141947,CCDC66,18,17,64666,3154,61512,3618.352941,175.2222222,19.50285352
NM_001012506,CCDC66,18,17,64666,3135,61531,3619.470588,174.1666667,19.62711324
NM_015512,DNAH1,78,77,84180,13188,70992,921.974026,169.0769231,5.383075523
NM_004947,DOCK3,53,52,708959,8808,700151,13464.44231,166.1886792,79.49034968
NM_002012,FHIT,10,9,1502099,1100,1500999,166777.6667,110,1364.544545
NM_001166243,FHIT,10,9,1502099,1089,1501010,166778.8889,108.9,1378.337925
NM_001177387,ATXN7,13,12,105063,6862,98201,8183.416667,527.8461538,14.31084232
NM_000333,ATXN7,13,12,138905,7238,131667,10972.25,556.7692308,18.19107488
NM_002841,PTPRG,30,29,733332,6678,726654,25057.03448,222.6,108.8131177
NM_001128149,ATXN7,9,8,35718,6414,29304,3663,712.6666667,4.568755847
NM_213609,FAM19A1,5,4,541414,2014,539400,134850,402.8,267.8252234
NM_001012505,FOXP1,7,6,386108,899,385209,64201.5,128.4285714,428.4860957
NM_032682,FOXP1,21,20,629277,7114,622163,31108.15,338.7619048,87.45614282
NM_001252216,FAM19A1,5,4,554039,1740,552299,138074.75,348,317.4132184
NM_001244812,FOXP1,16,15,350048,6509,343539,22902.6,406.8125,52.77907513
NM_001244808,FOXP1,21,20,629041,7214,621827,31091.35,343.5238095,86.19725534
NM_001244816,FOXP1,20,19,588845,7018,581827,30622.47368,350.9,82.90495868
NM_001244810,FOXP1,21,20,629277,7162,622115,31105.75,341.047619,86.86330634
NM_020872,CNTN3,22,21,258623,5019,253604,12076.38095,228.1363636,50.5287906
NM_001128929,ROBO2,25,24,551953,8011,543942,22664.25,320.44,67.89938834
NM_000158,GBE1,16,15,272102,3115,268987,17932.46667,194.6875,86.35216693
NM_002941,ROBO1,31,30,1170673,6870,1163803,38793.43333,221.6129032,169.403639
NM_002942,ROBO2,26,25,609822,8714,601108,24044.32,335.1538462,68.98186826
NM_016206,VGLL3,4,3,53136,10400,42736,14245.33333,2600,4.109230769
NM_153184,CADM2,10,9,347949,8970,338979,37664.33333,897,37.790301
NM_001256505,CADM2,10,9,569372,9017,560355,62261.66667,901.7,62.14428302
NM_001256502,CADM2,11,10,569372,9138,560234,56023.4,830.7272727,61.30816371
NM_001167675,CADM2,10,9,1115448,9497,1105951,122883.4444,949.7,116.4526693
NM_001256504,CADM2,11,10,569372,9045,560327,56032.7,822.2727273,61.9488115
NM_001256503,CADM2,10,9,569372,8987,560385,62265,898.7,62.35506843
NM_001167674,CADM2,10,9,1115448,9590,1105858,122873.1111,959,115.3136601
NM_001042459,FILIP1L,5,4,266592,4229,262363,65590.75,845.8,62.03901632
NM_032359,CMSS1,10,9,360800,1240,359560,39951.11111,124,289.9677419
NM_080927,DCBLD2,16,15,105721,6109,99612,6640.8,381.8125,16.30577836
NM_182909,FILIP1L,6,5,281371,3976,277395,55479,662.6666667,69.76735412
NM_015642,ZBTB20,10,9,809182,3545,805637,89515.22222,354.5,227.2600846
NM_001164347,ZBTB20,6,5,286108,3358,282750,56550,559.6666667,84.2019059
NM_001164346,ZBTB20,6,5,286847,3336,283511,56702.2,556,84.98531175
NM_001130064,GAP43,4,3,98185,2108,96077,32025.66667,527,45.57732448
NM_181780,BTLA,5,4,35597,3220,32377,8094.25,644,10.05496894
NM_002045,GAP43,3,2,98185,1711,96474,48237,570.3333333,56.38457043
NM_001164345,ZBTB20,7,6,421179,3698,417481,69580.16667,528.2857143,112.8937263
NM_001164344,ZBTB20,8,7,421179,3745,417434,59633.42857,468.125,111.4643525
NM_001085357,BTLA,4,3,35597,3075,32522,10840.66667,768.75,10.57626016
NM_001164343,ZBTB20,12,11,733316,3785,729531,66321,315.4166667,192.7426684
NM_001031702,SEMA5B,23,22,118621,4816,113805,5172.954545,209.3913043,23.63060631
NM_021082,SLC15A2,22,21,49865,5545,44320,2110.47619,252.0454545,7.992786294
NM_001256348,SEMA5B,22,21,118621,4545,114076,5432.190476,206.5909091,25.09922992
NM_001256347,SEMA5B,23,22,66943,4602,62341,2833.681818,200.0869565,13.54650152
NM_001256346,SEMA5B,23,22,84082,4956,79126,3596.636364,215.4782609,15.96569814
NM_001145998,SLC15A2,21,20,49865,5451,44414,2220.7,259.5714286,8.147862777
NM_016128,COPG1,24,23,28165,3098,25067,1089.869565,129.0833333,8.091349258
NM_003571,BFSP2,7,6,75219,1584,73635,12272.5,226.2857143,46.48674242
NM_021937,EEFSEC,7,6,255178,2223,252955,42159.16667,317.5714286,113.7899235
NM_005862,STAG1,34,33,415248,5200,410048,12425.69697,152.9411765,78.85538462
NM_006219,PIK3CB,22,21,106663,5942,100721,4796.238095,270.0909091,16.95069
NM_001256045,PIK3CB,13,12,54925,4799,50126,4177.166667,369.1538462,10.44509273
NM_000096,CP,19,18,49544,4681,44863,2492.388889,246.3684211,9.584063234
NM_207296,MBNL1,8,7,166377,5234,161143,23020.42857,654.25,30.78773405
NM_207293,MBNL1,9,8,166377,5379,160998,20124.75,597.6666667,29.93084216
NM_001130002,C3orf55,5,4,57890,1541,56349,14087.25,308.2,36.56651525
NM_001130001,C3orf55,4,3,57890,1451,56439,18813,362.75,38.89662302
NM_021038,MBNL1,10,9,197741,6414,191327,21258.55556,641.4,29.82959152
NM_001243729,C3orf55,4,3,35549,1024,34525,11508.33333,256,33.71582031
NM_001038705,GPR149,4,3,92045,2327,89718,29906,581.75,38.55522131
NM_001099777,C3orf55,5,4,35549,1114,34435,8608.75,222.8,30.91113106
NM_207297,MBNL1,8,7,166377,5265,161112,23016,658.125,30.6005698
NM_207295,MBNL1,8,7,166377,5156,161221,23031.57143,644.5,31.26861908
NM_207294,MBNL1,7,6,166377,5119,161258,26876.33333,731.2857143,31.50185583
NM_207292,MBNL1,9,8,197741,6377,191364,23920.5,708.5555556,30.00846793
NM_003471,KCNAB1,14,13,396178,3849,392329,30179.15385,274.9285714,101.9301117
NM_172160,KCNAB1,14,13,418592,3729,414863,31912.53846,266.3571429,111.253151
NM_172159,KCNAB1,14,13,248153,4532,243621,18740.07692,323.7142857,53.75573698
NM_024947,PHC3,15,14,94171,12687,81484,5820.285714,845.8,6.422637345
NM_001161566,TNIK,30,29,397907,5560,392347,13529.2069,185.3333333,70.56600719
NM_001161565,TNIK,31,30,397907,5585,392322,13077.4,180.1612903,70.24565801
NM_001161561,TNIK,32,31,397907,5751,392156,12650.19355,179.71875,68.18918449
NM_001161560,TNIK,32,31,397907,5814,392093,12648.16129,181.6875,67.43945648
NM_001161564,TNIK,31,30,397907,5648,392259,13075.3,182.1935484,69.45095609
NM_001161563,TNIK,32,31,397907,5673,392234,12652.70968,177.28125,69.14049004
NM_001161562,TNIK,31,30,397907,5726,392181,13072.7,184.7096774,68.4912679
NM_001163999,MECOM,15,14,62808,4826,57982,4141.571429,321.7333333,12.01450477
NM_005241,MECOM,16,15,62808,4851,57957,3863.8,303.1875,11.94743352
NM_001205194,MECOM,16,15,580278,5211,575067,38337.8,325.6875,110.3563615
NM_015028,TNIK,33,32,397907,5839,392068,12252.125,176.9393939,67.14642918
NM_022763,FNDC3B,26,25,361076,7040,354036,14161.44,270.7692308,50.28920455
NM_001105078,MECOM,16,15,63115,4907,58208,3880.533333,306.6875,11.86223762
NM_001105077,MECOM,17,16,62808,4917,57891,3618.1875,289.2352941,11.77364246
NM_001164000,MECOM,15,14,64237,5755,58482,4177.285714,383.6666667,10.16194613
NM_004991,MECOM,17,16,580278,5550,574728,35920.5,326.4705882,103.5545946
NM_207015,NAALADL2,14,13,946319,4926,941393,72414.84615,351.8571429,191.1069834
NM_001135095,FNDC3B,26,25,360150,6967,353183,14127.32,267.9615385,50.69369887
NM_018023,YEATS2,31,30,114809,6537,108272,3609.066667,210.8709677,16.56294937
NM_181426,CCDC39,20,19,65489,3874,61615,3242.894737,193.7,15.90474961
NM_181361,KCNMB2,5,4,308133,2686,305447,76361.75,537.2,113.7181683
NM_020409,MRPL47,7,6,16181,1187,14994,2499,169.5714286,12.63184499
NM_177988,MRPL47,6,5,16181,1040,15141,3028.2,173.3333333,14.55865385
NM_021032,FGF12,5,4,269658,6179,263479,65869.75,1235.8,42.64104224
NM_018192,LEPREL1,15,14,164393,3714,160679,11477.07143,247.6,43.2630587
NM_001134418,LEPREL1,15,14,165711,3081,162630,11616.42857,205.4,52.78481013
NM_004113,FGF12,6,5,588208,5414,582794,116558.8,902.3333333,107.6457333
NM_012287,ACAP2,23,22,168354,7193,161161,7325.5,312.7391304,22.40525511
NM_015562,UBXN7,11,10,78978,4743,74235,7423.5,431.1818182,15.6514864
NM_006614,CHL1,28,27,212820,8048,204772,7584.148148,287.4285714,25.44383698
NM_001253387,CHL1,27,26,212820,7999,204821,7877.730769,296.2592593,25.60582573
NM_001253388,CHL1,25,24,89733,7338,82395,3433.125,293.52,11.22853639
NM_001289080,CNTN6,23,22,310952,3845,307107,13959.40909,167.173913,79.87178153
NM_001289081,CNTN6,22,21,310952,3707,307245,14630.71429,168.5,82.88238468
NM_014461,CNTN6,23,22,310952,3854,307098,13959,167.5652174,79.68292683
NM_175607,CNTN4,25,24,959097,5186,953911,39746.29167,207.44,183.9396452
NM_175613,CNTN4,16,15,165748,3944,161804,10786.93333,246.5,41.02535497
NM_001206956,CNTN4,16,15,165748,3941,161807,10787.13333,246.3125,41.05734585
NM_001206955,CNTN4,24,23,819134,5230,813904,35387.13043,217.9166667,155.6221797
NM_001164674,SUMF1,8,7,106139,2094,104045,14863.57143,261.75,49.68720153
NM_001164675,SUMF1,8,7,106139,2109,104030,14861.42857,263.625,49.32669512
NM_182760,SUMF1,9,8,106139,2170,103969,12996.125,241.1111111,47.91198157
NM_002222,ITPR1,58,57,354494,10111,344383,6041.807018,174.3275862,34.06023143
NM_001099952,ITPR1,59,58,354494,10157,344337,5936.844828,172.1525424,33.90144728
NM_001168272,ITPR1,61,60,354494,10258,344236,5737.266667,168.1639344,33.55780854
NM_014850,SRGAP3,22,21,269095,8983,260112,12386.28571,408.3181818,28.95602805
NM_001033117,SRGAP3,22,21,269095,8911,260184,12389.71429,405.0454545,29.1980698
NM_001234,CAV3,3,2,12967,1338,11629,5814.5,446,8.691330344
NM_033337,CAV3,2,1,12967,1433,11534,11534,716.5,8.048848569
NM_001136026,SEC13,10,9,20261,1625,18636,2070.666667,162.5,11.46830769
NM_033084,FANCD2,43,42,73233,5247,67986,1618.714286,122.0232558,12.95711835
NM_198560,LHFPL4,4,3,55443,4884,50559,16853,1221,10.3519656
NM_133480,TADA3,8,7,9885,2837,7048,1006.857143,354.625,2.484314417
NM_183352,SEC13,9,8,20261,1446,18815,2351.875,160.6666667,13.01175657
NM_030673,SEC13,10,9,20261,1481,18780,2086.666667,148.1,12.6806212
NM_001278946,SEC13,5,4,9613,979,8634,2158.5,195.8,8.819203269
NM_032732,IL17RC,18,17,16549,2406,14143,831.9411765,133.6666667,5.878221114
NM_006354,TADA3,9,8,13049,2524,10525,1315.625,280.4444444,4.169968304
NM_022485,MTMR14,17,16,52963,2206,50757,3172.3125,129.7647059,23.00861287
NM_001570,IRAK2,13,12,78866,3482,75384,6282,267.8461538,21.64962665
NM_001136232,SEC13,9,8,20114,1478,18636,2329.5,164.2222222,12.60893099
NM_001278270,TADA3,9,8,13049,1918,11131,1391.375,213.1111111,5.803441084
NM_001018115,FANCD2,44,43,75503,5146,70357,1636.209302,116.9545455,13.67217256
NM_001077526,MTMR14,18,17,52963,2387,50576,2975.058824,132.6111111,21.18810222
NM_001077525,MTMR14,19,18,52963,2544,50419,2801.055556,133.8947368,19.81878931
NM_001203265,IL17RC,17,16,16549,2354,14195,887.1875,138.4705882,6.030161427
NM_001203264,IL17RC,17,16,16549,2360,14189,886.8125,138.8235294,6.012288136
NM_001203263,IL17RC,18,17,16549,2412,14137,831.5882353,134,5.861111111
NM_153461,IL17RC,19,18,16525,2641,13884,771.3333333,139,5.257099583
NM_153460,IL17RC,19,18,16549,2452,14097,783.1666667,129.0526316,5.749184339
NM_001098213,HRH1,2,1,126162,4560,121602,121602,2280,26.66710526
NM_001098211,HRH1,2,1,37272,4330,32942,32942,2165,7.607852194
NM_014229,SLC6A11,14,13,122231,2005,120226,9248.153846,143.2142857,59.96309227
NM_001098212,HRH1,2,1,108727,4280,104447,104447,2140,24.40350467
NM_015869,PPARG,7,6,82856,1827,81029,13504.83333,261,44.35084839
NM_003178,SYN2,12,11,181366,3896,177470,16133.63636,324.6666667,45.55184805
NM_133625,SYN2,14,13,187672,3331,184341,14180.07692,237.9285714,55.34103873
NM_001128219,VGLL4,5,4,87912,3844,84068,21017,768.8,21.86992716
NM_138711,PPARG,8,7,145421,1927,143494,20499.14286,240.875,74.46497146
NM_001284390,VGLL4,7,6,164703,3890,160813,26802.16667,555.7142857,41.34010283
NM_138712,PPARG,8,7,146508,1900,144608,20658.28571,237.5,76.10947368
NM_014667,VGLL4,6,5,164703,3756,160947,32189.4,626,42.85063898
NM_005037,PPARG,7,6,146508,1825,144683,24113.83333,260.7142857,79.27835616
NM_024923,NUP210,40,39,104091,7248,96843,2483.153846,181.2,13.36134106
NM_012298,CAND2,13,12,38144,4254,33890,2824.166667,327.2307692,7.966619652
NM_001134382,IQSEC1,15,14,176077,7403,168676,12048.28571,493.5333333,22.78481697
NM_001162499,CAND2,15,14,38144,4607,33537,2395.5,307.1333333,7.27957456
NM_014869,IQSEC1,14,13,70420,5262,65158,5012.153846,375.8571429,12.3827442
NM_001080423,GRIP2,25,24,52971,8001,44970,1873.75,320.04,5.620547432
NM_144636,CHCHD4,4,3,12796,1608,11188,3729.333333,402,6.957711443
NM_001098502,CHCHD4,3,2,12796,1437,11359,5679.5,479,7.904662491
NM_004625,WNT7A,4,3,61538,1718,59820,19940,429.5,34.81955763
NM_003298,NR2C2,15,14,101546,8345,93201,6657.214286,556.3333333,11.16848412
NM_001184958,C3orf20,17,16,97939,2948,94991,5936.9375,173.4117647,32.22218453
NM_032137,C3orf20,17,16,97939,3345,94594,5912.125,196.7647059,28.27922272
NM_152536,FGD5,20,19,115605,5917,109688,5773.052632,295.85,18.53777252
NM_152396,METTL6,6,5,17667,2505,15162,3032.4,417.5,6.052694611
NM_001018009,SH3BP5,9,8,87040,3209,83831,10478.875,356.5555556,26.12371455
NM_001184957,C3orf20,17,16,97939,2843,95096,5943.5,167.2352941,33.44917341
NM_004844,SH3BP5,9,8,78275,3328,74947,9368.375,369.7777778,22.52013221
NM_001190811,DAZL,11,10,17998,3113,14885,1488.5,283,4.781561195
NM_054110,GALNT15,10,9,55071,4651,50420,5602.222222,465.1,10.84067942
NM_015150,RFTN1,10,9,197872,3012,194860,21651.11111,301.2,64.69455511
NM_001351,DAZL,11,10,18707,3059,15648,1564.8,278.0909091,5.115397189
NM_001134381,TBC1D5,24,23,542860,6543,536317,23318.13043,272.625,81.96805747
NM_001144382,PLCL2,8,7,205648,4158,201492,28784.57143,519.75,48.45887446
NM_015184,PLCL2,6,5,157518,3959,153559,30711.8,659.8333333,38.78732003
NM_014744,TBC1D5,22,21,583747,7876,575871,27422.42857,358,73.11719147
NM_001257177,LOC339862,5,4,306348,2336,304012,76003,467.2,130.1421233
NM_144633,KCNH8,16,15,387120,5079,382041,25469.4,317.4375,75.21972829
NM_003884,KAT2B,18,17,114374,4842,109532,6443.058824,269,22.6212309
NM_024697,ZNF385D,8,7,330328,1820,328508,46929.71429,227.5,180.4989011
NM_182666,UBE2E1,5,4,85749,1799,83950,20987.5,359.8,46.66481379
NM_003341,UBE2E1,6,5,85749,1851,83898,16779.6,308.5,45.32576985
NM_152653,UBE2E2,6,5,387514,1766,385748,77149.6,294.3333333,218.4303511
NM_001202476,UBE2E1,5,4,81199,1555,79644,19911,311,51.21800643
NM_001252634,THRB,12,11,377670,7648,370022,33638.36364,637.3333333,48.38153766
NM_001128176,THRB,11,10,377670,7523,370147,37014.7,683.9090909,49.20204706
NM_000461,THRB,10,9,377670,7411,370259,41139.88889,741.1,49.96073404
NM_001128177,THRB,11,10,377670,7549,370121,37012.1,686.2727273,49.02914293
NM_016152,RARB,8,7,169670,2782,166888,23841.14286,347.75,59.98849748
NM_001145295,NGLY1,11,10,64556,2422,62134,6213.4,220.1818182,25.65400495
NM_001145294,NGLY1,12,11,71097,2541,68556,6232.363636,211.75,26.97992916
NM_001145293,NGLY1,12,11,64556,2547,62009,5637.181818,212.25,24.34589713
NM_001068,TOP2B,36,35,66469,5379,61090,1745.428571,149.4166667,11.35712958
NM_000965,RARB,8,7,169590,3059,166531,23790.14286,382.375,54.43968617
NM_018297,NGLY1,12,11,64556,2601,61955,5632.272727,216.75,23.81968474
NM_052953,LRRC3B,2,1,87967,1693,86274,86274,846.5,50.95924395
NM_001258379,SLC4A7,25,24,111701,7758,103943,4330.958333,310.32,13.39816963
NM_001040432,ZCWPW2,9,8,134647,1668,132979,16622.375,185.3333333,79.7236211
NM_003242,TGFBR2,7,6,87641,4635,83006,13834.33333,662.1428571,17.90852211
NM_207359,GADL1,15,14,168463,3670,164793,11770.92857,244.6666667,44.9027248
NM_001024847,TGFBR2,8,7,87641,4711,82930,11847.14286,588.875,17.60348121
NM_001174060,OSBPL10,11,10,321027,4032,316995,31699.5,366.5454545,78.61979167
NM_017784,OSBPL10,12,11,321027,4225,316802,28800.18182,352.0833333,74.98272189
NM_178868,CMTM8,4,3,131644,1174,130470,43490,293.5,111.132879
NM_178862,STT3B,16,15,103067,2497,100570,6704.666667,156.0625,40.2763316
NM_012157,FBXL2,15,14,109825,3015,106810,7629.285714,201,35.42620232
NM_006371,CRTAP,7,6,33817,6658,27159,4526.5,951.1428571,4.079152899
NM_015442,CNOT10,19,18,88732,2834,85898,4772.111111,149.1578947,30.30980946
NM_001039111,TRIM71,4,3,74263,3142,71121,23707,785.5,22.63558243
NM_001256742,CNOT10,19,18,78336,2783,75553,4197.388889,146.4736842,27.14804168
NM_001256741,CNOT10,18,17,88732,2752,85980,5057.647059,152.8888889,31.24273256
NM_001171713,FBXL2,14,13,109822,2807,107015,8231.923077,200.5,38.12433203
NM_003149,STAC,11,10,167401,2974,164427,16442.7,270.3636364,55.28816409
NM_016300,ARPP21,20,19,152141,3261,148880,7835.789474,163.05,45.65470715
NM_001267619,ARPP21,19,18,114711,3211,111500,6194.444444,169,34.72438493
NM_001267617,ARPP21,19,18,153480,3186,150294,8349.666667,167.6842105,47.173258
NM_002078,GOLGA4,24,23,123690,7910,115780,5033.913043,329.5833333,14.63716814
NM_001172713,GOLGA4,23,22,123690,7891,115799,5263.590909,343.0869565,14.67481941
NM_014831,TRANK1,23,22,118242,10507,107735,4897.045455,456.826087,10.25364043
NM_001160161,SCN5A,27,26,101613,8370,93243,3586.269231,310,11.14014337
NM_007337,DLEC1,36,35,83534,5526,78008,2228.8,153.5,14.11653999
NM_007335,DLEC1,37,36,83534,5651,77883,2163.416667,152.7297297,13.78216245
NM_005808,CTDSPL,7,6,122293,4429,117864,19644,632.7142857,26.61187627
NM_001160160,SCN5A,28,27,101613,8434,93179,3451.074074,301.2142857,11.04801992
NM_000335,SCN5A,28,27,101612,8529,93083,3447.518519,304.6071429,10.91370618
NM_198056,SCN5A,28,27,101612,8532,93080,3447.407407,304.7142857,10.90951711
NM_005108,XYLB,19,18,68218,3702,64516,3584.222222,194.8421053,17.42733657
NM_001099405,SCN5A,27,26,101612,8477,93135,3582.115385,313.962963,10.98678778
NM_001099404,SCN5A,28,27,101612,8532,93080,3447.407407,304.7142857,10.90951711
NM_005109,OXSR1,18,17,89955,4541,85414,5024.352941,252.2777778,18.80951332
NM_001008392,CTDSPL,8,7,122293,4463,117830,16832.85714,557.875,26.40152364
NM_014139,SCN11A,26,25,104794,6526,98268,3930.72,251,15.05792216
NM_033027,CSRNP1,5,4,11762,3193,8569,2142.25,638.6,2.683683057
NM_001171174,CX3CR1,2,1,18243,3154,15089,15089,1577,4.784083703
NM_001171172,CX3CR1,2,1,16947,3218,13729,13729,1609,4.266314481
NM_001171171,CX3CR1,2,1,17781,3258,14523,14523,1629,4.457642726
NM_002295,RPSA,7,6,5830,1153,4677,779.5,164.7142857,4.056374675
NM_001287223,SCN11A,27,26,107884,6358,101526,3904.846154,235.4814815,15.968229
NM_001012321,RPSA,6,5,4923,1101,3822,764.4,183.5,3.471389646
NM_015460,MYRIP,17,16,450662,5038,445624,27851.5,296.3529412,88.45256054
NM_001034996,RPL14,6,5,5035,927,4108,821.6,154.5,4.431499461
NM_001284423,MYRIP,17,16,451408,4849,446559,27909.9375,285.2352941,92.09300887
NM_003973,RPL14,6,5,5082,863,4219,843.8,143.8333333,4.888760139
NM_001284425,MYRIP,16,15,450662,4900,445762,29717.46667,306.25,90.97183673
NM_001284424,MYRIP,16,15,450662,4842,445820,29721.33333,302.625,92.07352334
NM_001284426,MYRIP,15,14,160311,4657,155654,11118.14286,310.4666667,33.4236633
NM_001201584,SEC22C,6,5,34063,1552,32511,6502.2,258.6666667,20.94780928
NM_001042646,TRAK1,16,15,134638,5247,129391,8626.066667,327.9375,24.65999619
NM_152393,KLHL40,6,5,6929,2425,4504,900.8,404.1666667,1.857319588
NM_001296,ACKR2,3,2,57813,2963,54850,27425,987.6666667,18.5116436
NM_001265610,TRAK1,12,11,54956,3272,51684,4698.545455,272.6666667,15.79584352
NM_001265609,TRAK1,13,12,63393,4696,58697,4891.416667,361.2307692,12.49936116
NM_001265608,TRAK1,14,13,121374,4834,116540,8964.615385,345.2857143,24.10839884
NM_032970,SEC22C,7,6,34063,6410,27653,4608.833333,915.7142857,4.314040562
NM_001201572,SEC22C,7,6,53115,1557,51558,8593,222.4285714,33.11368015
NM_014965,TRAK1,13,12,52459,4636,47823,3985.25,356.6153846,10.31557377
NM_004206,SEC22C,7,6,34063,1619,32444,5407.333333,231.2857143,20.03953057
NM_001204832,ANO10,12,11,255744,2548,253196,23017.81818,212.3333333,99.37048666
NM_001204833,ANO10,11,10,255744,2412,253332,25333.2,219.2727273,105.0298507
NM_017719,SNRK,7,6,64632,5222,59410,9901.666667,746,11.3768671
NM_018075,ANO10,13,12,255744,2747,252997,21083.08333,211.3076923,92.09938114
NM_001100594,SNRK,6,5,64632,5159,59473,11894.6,859.8333333,11.5280093
NM_001204834,ANO10,12,11,255744,2176,253568,23051.63636,181.3333333,116.5294118
NM_001204831,ANO10,13,12,255744,2750,252994,21082.83333,211.5384615,91.99781818
NM_032806,POMGNT2,2,1,26856,2558,24298,24298,1279,9.498827209
NM_001135179,ZDHHC3,7,6,60923,12609,48314,8052.333333,1801.285714,3.831707511
NM_003420,ZNF35,4,3,12052,2653,9399,3133,663.25,3.542781757
NM_001282913,TCAIM,11,10,71331,3513,67818,6781.8,319.3636364,19.30486763
NM_173826,TCAIM,11,10,70998,3695,67303,6730.3,335.9090909,18.21461434
NM_016598,ZDHHC3,8,7,60923,12694,48229,6889.857143,1586.75,3.799354026
NM_001282915,TCAIM,11,10,71331,3437,67894,6789.4,312.4545455,19.75385511
NM_020242,KIF15,35,34,91541,4872,86669,2549.088235,139.2,17.78920361
NM_001145030,TOPAZ1,20,19,90214,5354,84860,4466.315789,267.7,15.8498319
NM_001282914,TCAIM,11,10,70998,3619,67379,6737.9,329,18.61812655
NM_020347,LZTFL1,10,9,18842,4073,14769,1641,407.3,3.626074147
NM_024513,FYCO1,18,17,77927,8536,69391,4081.823529,474.2222222,8.129217432
NM_014016,SACM1L,20,19,56148,3727,52421,2759,186.35,14.06519989
NM_015340,LARS2,22,21,160255,4225,156030,7430,192.0454545,36.93017751
NM_001276379,LZTFL1,10,9,92408,4125,88283,9809.222222,412.5,21.40193939
NM_001276378,LZTFL1,12,11,92408,4356,88052,8004.727273,363,20.21395776
NM_001184744,PTH1R,15,14,21552,2006,19546,1396.142857,133.7333333,9.743768694
NM_001195442,LOC100132146,3,2,14110,1829,12281,6140.5,609.6666667,6.714598141
NM_001123041,CCR2,3,2,7180,2675,4505,2252.5,891.6666667,1.68411215
NM_000316,PTH1R,16,15,26055,2144,23911,1594.066667,134,11.15251866
NM_001123396,CCR2,2,1,5635,2337,3298,3298,1168.5,1.411210954
NM_002375,MAP4,19,18,238591,6346,232245,12902.5,334,36.59706902
NM_003074,SMARCC1,28,27,196029,5785,190244,7046.074074,206.6071429,32.88573898
NM_182902,KIF9,21,20,54823,3378,51445,2572.25,160.8571429,15.2294257
NM_030885,MAP4,4,3,116202,3209,112993,37664.33333,802.25,35.21128077
NM_015466,PTPN23,25,24,32442,5288,27154,1131.416667,211.52,5.135022693
NM_022342,KIF9,20,19,54823,3182,51641,2717.947368,159.1,16.22910119
NM_001134878,KIF9,22,21,54823,3625,51198,2438,164.7727273,14.12358621
NM_001134364,MAP4,18,17,238591,6054,232537,13678.64706,336.3333333,38.41047241
NM_001199160,USP19,27,26,12267,4891,7376,283.6923077,181.1481481,1.508076058
NM_001199161,USP19,27,26,12894,4867,8027,308.7307692,180.2592593,1.649270598
NM_130384,ATRIP,13,12,18942,2626,16316,1359.666667,202,6.213252094
NM_032166,ATRIP,12,11,18942,2544,16398,1490.727273,212,6.445754717
NM_001199162,USP19,27,26,12894,4831,8063,310.1153846,178.9259259,1.669012627
NM_006677,USP19,26,25,12267,4587,7680,307.2,176.4230769,1.674296926
NM_000094,COL7A1,118,117,31089,9287,21802,186.3418803,78.70338983,2.347582642
NM_006321,ARIH2,16,15,66692,4078,62614,4174.266667,254.875,15.35409514
NM_001271022,ATRIP,14,13,18942,2417,16525,1271.153846,172.6428571,6.836988002
NM_001271023,ATRIP,13,12,18559,2673,15886,1323.833333,205.6153846,5.943135054
NM_001080525,SPINK8,5,4,21497,445,21052,5263,89,47.30786517
NM_001177644,DAG1,3,2,65488,5668,59820,29910,1889.333333,10.5539873
NM_001177640,DAG1,4,3,65488,5586,59902,19967.33333,1396.5,10.7235947
NM_001177639,DAG1,3,2,65488,5369,60119,30059.5,1789.666667,11.19742969
NM_001177638,DAG1,4,3,65488,5680,59808,19936,1420,10.52957746
NM_001177636,DAG1,5,4,65488,5812,59676,14919,1162.4,10.26772195
NM_001177634,DAG1,6,5,65488,5835,59653,11930.6,972.5,10.22330763
NM_005777,RBM6,21,20,137210,3760,133450,6672.5,179.047619,35.49202128
NM_001242829,IP6K1,6,5,61901,4812,57089,11417.8,802,11.86388196
NM_003458,BSN,12,11,117062,15971,101091,9190.090909,1330.916667,6.329660009
NM_004186,SEMA3F,19,18,33662,3535,30127,1673.722222,186.0526316,8.522489392
NM_001244937,MST1R,19,18,16872,4643,12229,679.3888889,244.3684211,2.63385742
NM_001664,RHOA,5,4,52949,1926,51023,12755.75,385.2,26.49169263
NM_002447,MST1R,20,19,16872,4791,12081,635.8421053,239.55,2.521603006
NM_001165928,DAG1,6,5,65488,5892,59596,11919.2,982,10.11473184
NM_001177643,DAG1,3,2,66917,5579,61338,30669,1859.666667,10.99444345
NM_001177642,DAG1,4,3,65488,5581,59907,19969,1395.25,10.73409783
NM_001177641,DAG1,4,3,65488,5676,59812,19937.33333,1419,10.53770261
NM_001177637,DAG1,4,3,65488,5649,59839,19946.33333,1412.25,10.59284829
NM_001177635,DAG1,4,3,65488,5422,60066,20022,1355.5,11.07819993
NM_001167582,RBM6,17,16,137210,2243,134967,8435.4375,131.9411765,60.17253678
NM_004393,DAG1,3,2,65488,5528,59960,29980,1842.666667,10.84659913
NM_153273,IP6K1,6,5,62247,4474,57773,11554.6,745.6666667,12.9130532
NM_001006115,IP6K1,5,4,62247,4122,58125,14531.25,824.4,14.10116448
NM_001174051,CACNA2D2,39,38,140663,5396,135267,3559.657895,138.3589744,25.06801334
NM_006030,CACNA2D2,38,37,140663,5374,135289,3656.459459,141.4210526,25.17473018
NM_001005505,CACNA2D2,38,37,140663,5380,135283,3656.297297,141.5789474,25.14553903
NM_025222,WDR82,9,8,24223,4301,19922,2490.25,477.8888889,4.631946059
NM_001161581,POC1A,11,10,79459,2278,77181,7718.1,207.0909091,33.881036
NM_001161580,POC1A,10,9,79459,2062,77397,8599.666667,206.2,37.53491756
NM_015106,RAD54L2,22,21,122018,4727,117291,5585.285714,214.8636364,24.81298921
NM_001171904,VPRBP,24,23,100722,5816,94906,4126.347826,242.3333333,16.31808803
NM_015426,POC1A,11,10,79459,2207,77252,7725.2,200.6363636,35.00317173
NM_014703,VPRBP,25,24,100722,5867,94855,3952.291667,234.68,16.1675473
NM_016329,SFMBT1,21,20,142508,4579,137929,6896.45,218.047619,30.12207906
NM_001166436,ITIH1,18,17,12144,2397,9747,573.3529412,133.1666667,4.066332916
NM_212539,PRKCD,18,17,31512,2741,28771,1692.411765,152.2777778,10.49653411
NM_001134231,NT5DC2,14,13,9410,1829,7581,583.1538462,130.6428571,4.144887917
NM_022908,NT5DC2,14,13,10710,2102,8608,662.1538462,150.1428571,4.095147479
NM_001166434,ITIH1,20,19,13577,2782,10795,568.1578947,139.1,3.880301941
NM_006254,PRKCD,19,18,31512,2854,28658,1592.111111,150.2105263,10.04134548
NM_002215,ITIH1,22,21,14484,2945,11539,549.4761905,133.8636364,3.918166384
NM_018403,DCP1A,10,9,64211,6022,58189,6465.444444,602.2,9.662736632
NM_018313,PBRM1,30,29,140500,7604,132896,4582.62069,253.4666667,17.47711731
NM_001166435,ITIH1,18,17,12149,2511,9638,566.9411765,139.5,3.83831143
NM_001128839,CACNA1D,46,45,317418,7637,309781,6884.022222,166.0217391,40.56317926
NM_001128840,CACNA1D,48,47,317418,7711,309707,6589.510638,160.6458333,40.16431072
NM_000720,CACNA1D,49,48,317418,7772,309646,6450.958333,158.6122449,39.84122491
NM_018397,CHDH,9,8,30098,3715,26383,3297.875,412.7777778,7.101749664
NM_012096,APPL1,22,21,45735,6082,39653,1888.238095,276.4545455,6.519730352
NM_178504,DNAH12,59,58,202346,9601,192745,3323.189655,162.7288136,20.07551297
NM_017563,IL17RD,13,12,75395,8733,66662,5555.166667,671.7692308,7.633344784
NM_001128615,ARHGEF3,13,12,351892,3652,348240,29020,280.9230769,95.35596933
NM_001289698,ARHGEF3,11,10,189055,3574,185481,18548.1,324.9090909,51.89731393
NM_007159,SLMAP,21,20,171722,4441,167281,8364.05,211.4761905,37.66741725
NM_001256560,DNASE1L3,7,6,18379,993,17386,2897.666667,141.8571429,17.50855992
NM_017771,PXK,18,17,93239,3021,90218,5306.941176,167.8333333,29.86362132
NM_001457,FLNB,46,45,163857,9513,154344,3429.866667,206.8043478,16.22453485
NM_001164319,FLNB,45,44,163857,9440,154417,3509.477273,209.7777778,16.35773305
NM_001164318,FLNB,46,45,163857,9480,154377,3430.6,206.0869565,16.28449367
NM_001164317,FLNB,47,46,163857,9607,154250,3353.26087,204.4042553,16.05600083
NM_004944,DNASE1L3,8,7,18379,1084,17295,2470.714286,135.5,15.95479705
NM_001282714,FAM107A,5,4,63500,3625,59875,14968.75,725,16.51724138
NM_001289099,PXK,18,17,93239,3126,90113,5300.764706,173.6666667,28.82693538
NM_001289100,PXK,17,16,93239,2954,90285,5642.8125,173.7647059,30.56364252
NM_001289101,PXK,15,14,93239,2732,90507,6464.785714,182.1333333,33.12847731
NM_001289098,PXK,19,18,93239,3055,90184,5010.222222,160.7894737,29.52013093
NM_001289096,PXK,16,15,93239,2920,90319,6021.266667,182.5,30.93116438
NM_001289095,PXK,18,17,93239,3001,90238,5308.117647,166.7222222,30.06931023
NM_198463,C3orf67,16,15,307980,2567,305413,20360.86667,160.4375,118.9766264
NM_183394,CADPS,28,27,477045,5393,471652,17468.59259,192.6071429,87.45633228
NM_183393,CADPS,27,26,477045,5272,471773,18145.11538,195.2592593,89.48653263
NM_003716,CADPS,30,29,477045,5512,471533,16259.75862,183.7333333,85.54662554
NM_025075,THOC7,8,7,30055,1018,29037,4148.142857,127.25,28.52357564
NM_001130003,SYNPR,6,5,338685,2600,336085,67217,433.3333333,129.2634615
NM_144642,SYNPR,5,4,173846,2612,171234,42808.5,522.4,65.55666156
NM_001285404,THOC7,8,7,29918,1149,28769,4109.857143,143.625,25.03829417
NM_001285387,THOC7,7,6,30055,899,29156,4859.333333,128.4285714,32.43159066
NM_198859,PRICKLE2,8,7,131607,8330,123277,17611,1041.25,14.79915966
NM_182920,ADAMTS9,40,39,172036,7352,164684,4222.666667,183.8,22.39989119
NM_001033057,MAGI1,23,22,684605,7085,677520,30796.36364,308.0434783,95.62738179
NM_004742,MAGI1,23,22,679567,6200,673367,30607.59091,269.5652174,108.6075806
NM_015520,MAGI1,25,24,684605,7260,677345,28222.70833,290.4,93.29820937
NM_173471,SLC25A26,11,10,310068,2684,307384,30738.4,244,114.5245902
NM_015541,LRIG1,19,18,121626,4781,116845,6491.388889,251.6315789,24.43944781
NM_001164796,SLC25A26,9,8,158185,2150,156035,19504.375,238.8888889,72.5744186
NM_001177599,SUCLG2,11,10,294156,1531,292625,29262.5,139.1818182,191.1332462
NM_003848,SUCLG2,11,10,279899,2365,277534,27753.4,215,117.3505285
NM_007114,TMF1,17,16,32508,6896,25612,1600.75,405.6470588,3.714037123
NM_182522,FAM19A4,6,5,200848,2300,198548,39709.6,383.3333333,86.32521739
NM_001005527,FAM19A4,6,5,200848,2218,198630,39726,369.6666667,89.55365194
NM_001184967,MITF,10,9,204783,4695,200088,22232,469.5,42.6172524
NM_015123,FRMD4B,23,22,216286,5284,211002,9591,229.7391304,39.9322483
NM_198178,MITF,9,8,31739,4295,27444,3430.5,477.2222222,6.38975553
NM_000248,MITF,9,8,31739,4481,27258,3407.25,497.8888889,6.083017184
NM_006722,MITF,10,9,204528,4690,199838,22204.22222,469,42.60938166
NM_198177,MITF,10,9,102115,4681,97434,10826,468.1,20.81478317
NM_198159,MITF,10,9,228904,4825,224079,24897.66667,482.5,46.44124352
NM_198158,MITF,9,8,31739,4463,27276,3409.5,495.8888889,6.111584136
NM_001244815,FOXP1,16,15,176229,6847,169382,11292.13333,427.9375,24.73813349
NM_001244814,FOXP1,17,16,290453,6907,283546,17721.625,406.2941176,41.05197626
NM_001244813,FOXP1,15,14,110211,6400,103811,7415.071429,426.6666667,16.22046875
NM_001126128,PROK2,4,3,13553,1617,11936,3978.666667,404.25,7.38157081
NM_021935,PROK2,3,2,13553,1553,12000,6000,517.6666667,7.726980039
NM_012234,RYBP,4,3,72032,4453,67579,22526.33333,1113.25,15.17606108
NM_018130,SHQ1,11,10,99172,2859,96313,9631.3,259.9090909,33.68765303
NM_001080393,GXYLT2,7,6,87139,1551,85588,14264.66667,221.5714286,55.18246293
NM_015009,PDZRN3,10,9,242422,4171,238251,26472.33333,417.1,57.12083433
NM_133631,ROBO1,29,28,422223,7523,414700,14810.71429,259.4137931,55.12428552
NM_001145845,ROBO1,29,28,422223,7358,414865,14816.60714,253.7241379,56.3828486
NM_014043,CHMP2B,6,5,28287,2634,25653,5130.6,439,9.739179954
NM_001244644,CHMP2B,5,4,28287,2541,25746,6436.5,508.2,10.1322314
NM_182644,EPHA3,7,6,292823,2691,290132,48355.33333,384.4285714,107.8156819
NM_005233,EPHA3,17,16,374612,5826,368786,23049.125,342.7058824,63.30003433
NM_182896,ARL13B,11,10,75541,3842,71699,7169.9,349.2727273,18.66189485
NM_001174151,ARL13B,9,8,75541,3925,71616,8952,436.1111111,18.24611465
NM_001174150,ARL13B,10,9,75541,3997,71544,7949.333333,399.7,17.89942457
NM_144996,ARL13B,8,7,75541,3674,71867,10266.71429,459.25,19.56096897
NM_001278301,EPHA6,4,3,195548,1285,194263,64754.33333,321.25,151.1774319
NM_001278300,EPHA6,13,12,208986,1736,207250,17270.83333,133.5384615,119.3836406
NM_001080448,EPHA6,18,17,934363,3695,930668,54745.17647,205.2777778,251.8722598
NM_173655,EPHA6,13,12,208986,1660,207326,17277.16667,127.6923077,124.8951807
NM_153605,CRYBG3,22,21,122948,10774,112174,5341.619048,489.7272727,10.41154632
NM_000097,CPOX,7,6,14167,2716,11451,1908.5,388,4.216126657
NM_001850,COL8A1,5,4,158139,3096,155043,38760.75,619.2,50.07848837
NM_020351,COL8A1,4,3,158139,3033,155106,51702,758.25,51.13946588
NM_001199198,TBC1D23,19,18,64437,3905,60532,3362.888889,205.5263158,15.50115237
NM_018309,TBC1D23,18,17,64437,3859,60578,3563.411765,214.3888889,15.69784918
NM_018004,TMEM45A,6,5,84824,1570,83254,16650.8,261.6666667,53.02802548
NM_001085451,LNP1,4,3,55135,2221,52914,17638,555.25,23.82440342
NM_032787,GPR128,16,15,85892,3156,82736,5515.733333,197.25,26.21546261
NM_001167924,CMSS1,10,9,63704,1099,62605,6956.111111,109.9,56.96542311
NM_001282801,SENP7,23,22,189054,4843,184211,8373.227273,210.5652174,38.03654759
NM_001282804,SENP7,5,4,141390,822,140568,35142,164.4,171.0072993
NM_001282803,SENP7,21,20,189054,4596,184458,9222.9,218.8571429,40.13446475
NM_020654,SENP7,24,23,189054,5042,184012,8000.521739,210.0833333,36.49583499
NM_024548,CEP97,11,10,42689,4422,38267,3826.7,402,8.653776572
NM_001077203,SENP7,23,22,189054,4846,184208,8373.090909,210.6956522,38.01238135
NM_001282802,SENP7,23,22,189054,4991,184063,8366.5,217,36.87898217
NM_170662,CBLB,19,18,210780,3995,206785,11488.05556,210.2631579,51.76095119
NM_001243283,ALCAM,3,2,158675,1971,156704,78352,657,79.50481989
NM_001243281,ALCAM,14,13,186459,2959,183500,14115.38462,211.3571429,62.01419398
NM_001243280,ALCAM,15,14,210202,4886,205316,14665.42857,325.7333333,42.0212853
NM_001627,ALCAM,16,15,210202,4926,205276,13685.06667,307.875,41.67194478
NM_020235,BBX,17,16,288395,8952,279443,17465.1875,526.5882353,31.21570599
NM_001276286,BBX,17,16,288395,8033,280362,17522.625,472.5294118,34.90128221
NM_001142568,BBX,18,17,288395,9043,279352,16432.47059,502.3888889,30.8915183
NM_014648,DZIP3,33,32,105358,5575,99783,3118.21875,168.9393939,17.89829596
NM_005459,GUCA1C,4,3,46037,929,45108,15036,232.25,48.55543595
NM_014981,MYH15,42,41,148955,7116,141839,3459.487805,169.4285714,19.93240585
NM_014429,MORC1,28,27,159908,3795,156113,5781.962963,135.5357143,41.13649539
NM_001243288,PVRL3,9,8,122003,2515,119488,14936,279.4444444,47.51013917
NM_001185106,PLCXD2,5,4,171773,2153,169620,42405,430.6,78.78309336
NM_005816,CD96,14,13,110282,4447,105835,8141.153846,317.6428571,23.79919047
NM_183061,SLC9C1,29,28,153324,4152,149172,5327.571429,143.1724138,35.92774566
NM_005944,CD200,6,5,29744,2221,27523,5504.6,370.1666667,12.39216569
NM_153268,PLCXD2,4,3,171773,2067,169706,56568.66667,516.75,82.1025641
NM_145753,PHLDB2,17,16,117339,6015,111324,6957.75,353.8235294,18.50773067
NM_198196,CD96,15,14,110282,4496,105786,7556.142857,299.7333333,23.52891459
NM_001134439,PHLDB2,18,17,116798,5906,110892,6523.058824,328.1111111,18.77615984
NM_001134438,PHLDB2,18,17,117339,6145,111194,6540.823529,341.3888889,18.09503662
NM_001134437,PHLDB2,18,17,244039,5958,238081,14004.76471,331,39.95988587
NM_001004196,CD200,7,6,29744,2297,27447,4574.5,328.1428571,11.949064
NM_015412,C3orf17,9,8,17265,4865,12400,1550,540.5555556,2.548818088
NM_199512,CCDC80,8,7,36759,4123,32636,4662.285714,515.375,7.91559544
NM_199511,CCDC80,8,7,36759,4720,32039,4577,590,6.787923729
NM_018338,WDR52,21,20,78651,3302,75349,3767.45,157.2380952,22.81920048
NM_033254,BOC,20,19,74932,4300,70632,3717.473684,215,16.42604651
NM_001164496,WDR52,35,34,154586,10294,144292,4243.882353,294.1142857,14.01709734
NM_001009899,KIAA2018,7,6,48262,13714,34548,5758,1959.142857,2.519177483
NM_020817,KIAA1407,17,16,92478,3993,88485,5530.3125,234.8823529,22.16003005
NM_001282563,DRD3,8,7,70699,1507,69192,9884.571429,188.375,45.9137359
NM_001172105,GRAMD1C,13,12,49705,3501,46204,3850.333333,269.3076923,13.19737218
NM_017577,GRAMD1C,18,17,108342,3779,104563,6150.764706,209.9444444,27.66948928
NM_001690,ATP6V1A,15,14,65041,4608,60433,4316.642857,307.2,13.11480035
NM_002338,LSAMP,7,6,643177,9485,633692,105615.3333,1355,66.80991038
NM_005191,CD80,7,6,35343,2764,32579,5429.833333,394.8571429,11.78690304
NM_152538,IGSF11,9,8,245421,3571,241850,30231.25,396.7777778,67.72612714
NM_020754,ARHGAP31,12,11,125105,8091,117014,10637.63636,674.25,14.462242
NM_001015887,IGSF11,7,6,134199,3438,130761,21793.5,491.1428571,38.03403141
NM_002093,GSK3B,12,11,272464,7130,265334,24121.27273,594.1666667,37.21374474
NM_001146156,GSK3B,11,10,272464,7090,265374,26537.4,644.5454545,37.42933709
NM_173825,RABL3,8,7,55858,3891,51967,7423.857143,486.375,13.35569262
NM_153002,GPR156,9,8,78816,4202,74614,9326.75,466.8888889,17.75678248
NM_001099678,LRRC58,4,3,24612,7687,16925,5641.666667,1921.75,2.201769221
NM_001168271,GPR156,9,8,78816,4190,74626,9328.25,465.5555556,17.81050119
NM_001023570,IQCB1,15,14,65318,2609,62709,4479.214286,173.9333333,24.03564584
NM_014980,STXBP5L,28,27,516560,9393,507167,18783.96296,335.4642857,53.99414458
NM_199420,POLQ,30,29,114582,8810,105772,3647.310345,293.6666667,12.00590238
NM_001023571,IQCB1,12,11,65318,2207,63111,5737.363636,183.9166667,28.59583145
NM_005335,HCLS1,14,13,29547,2047,27500,2115.384615,146.2142857,13.43429409
NM_017554,PARP14,17,16,50017,7725,42292,2643.25,454.4117647,5.474692557
NM_002264,KPNA1,14,13,93040,6903,86137,6625.923077,493.0714286,12.47819788
NM_032839,DIRC2,9,8,86087,3346,82741,10342.625,371.7777778,24.72833234
NM_138287,DTX3L,5,4,10866,5772,5094,1273.5,1154.4,0.882536383
NM_006810,PDIA5,17,16,95099,1879,93220,5826.25,110.5294118,49.61149548
NM_053028,MYLK,32,31,272008,7508,264500,8532.258065,234.625,35.22908897
NM_001199642,ADCY5,21,20,134048,5144,128904,6445.2,244.952381,25.05909798
NM_012430,SEC22A,7,6,72210,3423,68787,11464.5,489,20.09553024
NM_053027,MYLK,33,32,272008,7716,264292,8259.125,233.8181818,34.25246242
NM_053031,MYLK,3,2,8389,2663,5726,2863,887.6666667,2.150206534
NM_053032,MYLK,3,2,8389,2666,5723,2861.5,888.6666667,2.146661665
NM_053026,MYLK,33,32,272008,7662,264346,8260.8125,232.1818182,34.5009136
NM_053025,MYLK,34,33,272008,7870,264138,8004.181818,231.4705882,33.56264295
NM_183357,ADCY5,21,20,166251,6119,160132,8006.6,291.3809524,26.16963556
NM_007064,KALRN,27,26,136532,5779,130753,5028.961538,214.037037,22.62554075
NM_003947,KALRN,34,33,425142,6542,418600,12684.84848,192.4117647,63.98654846
NM_033049,MUC13,12,11,29308,2888,26420,2401.818182,240.6666667,9.148199446
NM_002213,ITGB5,15,14,124351,3387,120964,8640.285714,225.8,35.71420136
NM_001024660,KALRN,60,59,626480,10867,615613,10434.11864,181.1166667,56.64976534
NM_001195483,SLC12A8,13,12,128765,3462,125303,10441.91667,266.3076923,36.1938186
NM_022776,OSBPL11,13,12,66681,4651,62030,5169.166667,357.7692308,13.33691679
NM_021964,ZNF148,9,8,149687,9552,140135,17516.875,1061.333333,14.67074958
NM_001012337,ROPN1B,6,5,14270,1006,13264,2652.8,167.6666667,13.18489066
NM_024628,SLC12A8,14,13,130131,3524,126607,9739,251.7142857,35.92707151
NM_003794,SNX4,14,13,73572,2544,71028,5463.692308,181.7142857,27.91981132
NM_032343,CHCHD6,8,7,256202,1028,255174,36453.42857,128.5,248.2237354
NM_032242,PLXNA1,31,30,48800,9097,39703,1323.433333,293.4516129,4.364405848
NM_001173513,TXNRD3,15,14,48074,2826,45248,3232,188.4,16.01132343
NM_144639,UROC1,20,19,36610,3285,33325,1753.947368,164.25,10.14459665
NM_052883,TXNRD3,16,15,48074,2935,45139,3009.266667,183.4375,15.37955707
NM_001165974,UROC1,21,20,36610,3466,33144,1657.2,165.047619,9.562608194
NM_001256585,MGLL,7,6,133822,4559,129263,21543.83333,651.2857143,28.35336697
NM_007283,MGLL,8,7,133822,4650,129172,18453.14286,581.25,27.77892473
NM_207335,KBTBD12,5,4,64614,5273,59341,14835.25,1054.6,11.2537455
NM_001003794,MGLL,8,7,134190,4243,129947,18563.85714,530.375,30.62620787
NM_020741,KIAA1257,8,7,23206,1720,21486,3069.428571,215,12.49186047
NM_001204890,ISY1-RAB43,13,12,73663,5081,68582,5715.166667,390.8461538,13.49773667
NM_004637,RAB7A,6,5,88664,2238,86426,17285.2,373,38.61751564
NM_018262,IFT122,29,28,80473,4115,76358,2727.071429,141.8965517,18.55601458
NM_001280545,IFT122,31,30,80473,4445,76028,2534.266667,143.3870968,17.10416198
NM_001128224,TMCC1,6,5,245786,5492,240294,48058.8,915.3333333,43.75345958
NM_001280546,IFT122,28,27,80473,4035,76438,2831.037037,144.1071429,18.94374226
NM_001280541,IFT122,30,29,80473,4272,76201,2627.62069,142.4,17.83731273
NM_001017395,TMCC1,6,5,232769,6091,226678,45335.6,1015.166667,37.21523559
NM_052990,IFT122,27,26,80473,3960,76513,2942.807692,146.6666667,19.32146465
NM_052989,IFT122,30,29,80473,4293,76180,2626.896552,143.1,17.74516655
NM_052985,IFT122,31,30,80473,4447,76026,2534.2,143.4516129,17.09601979
NM_024800,NEK11,18,17,323617,2971,320646,18861.52941,165.0555556,107.9252777
NM_001102608,COL6A6,36,35,116712,8506,108206,3091.6,236.2777778,12.72113802
NM_001199183,ATP2C1,28,27,122652,3583,119069,4409.962963,127.9642857,33.23164946
NM_001199182,ATP2C1,27,26,166188,3622,162566,6252.538462,134.1481481,44.8829376
NM_001199181,ATP2C1,27,26,152679,5037,147642,5678.538462,186.5555556,29.31149494
NM_001199180,ATP2C1,28,27,166188,3710,162478,6017.703704,132.5,43.79460916
NM_001199185,ATP2C1,27,26,122265,3538,118727,4566.423077,131.037037,33.55765969
NM_001199184,ATP2C1,27,26,109143,4910,104233,4008.961538,181.8518519,21.2287169
NM_014382,ATP2C1,27,26,108756,4961,103795,3992.115385,183.7407407,20.92219311
NM_014602,PIK3R4,20,19,67920,5059,62861,3308.473684,252.95,12.42557818
NM_001278298,COL6A5,41,40,139333,9166,130167,3254.175,223.5609756,14.20106917
NM_145910,NEK11,15,14,148289,2111,146178,10441.28571,140.7333333,69.24585505
NM_001146003,NEK11,16,15,323617,2799,320818,21387.86667,174.9375,114.6187924
NM_001199179,ATP2C1,28,27,109213,5049,104164,3857.925926,180.3214286,20.63061992
NM_153264,COL6A5,40,39,139333,8920,130413,3343.923077,223,14.62029148
NM_001001485,ATP2C1,28,27,122698,3720,118978,4406.592593,132.8571429,31.98333333
NM_001001487,ATP2C1,28,27,122123,3492,118631,4393.740741,124.7142857,33.97222222
NM_001001486,ATP2C1,28,27,122123,3522,118601,4392.62963,125.7857143,33.67433277
NM_007208,MRPL3,10,9,40817,1774,39043,4338.111111,177.4,22.00845547
NM_130808,CPNE4,16,15,501884,4202,497682,33178.8,262.625,118.4393146
NM_001289112,CPNE4,16,15,504246,3574,500672,33378.13333,223.375,140.0872971
NM_153429,CPNE4,17,16,506048,3563,502485,31405.3125,209.5882353,141.0286276
NM_015268,DNAJC13,56,55,121325,7603,113722,2067.672727,135.7678571,14.95751677
NM_023943,TMEM108,6,5,359489,3836,355653,71130.6,639.3333333,92.7145464
NM_001282865,TMEM108,4,3,272956,2486,270470,90156.66667,621.5,108.7972647
NM_198329,UBA5,12,11,23656,2865,20791,1890.090909,238.75,7.256893543
NM_001136469,TMEM108,6,5,359489,3832,355657,71131.4,638.6666667,92.81236952
NM_024818,UBA5,12,11,17806,3043,14763,1342.090909,253.5833333,4.851462373
NM_016201,AMOTL2,10,9,19242,5018,14224,1580.444444,501.8,2.834595456
NM_017548,CDV3,5,4,16686,3465,13221,3305.25,693,3.815584416
NM_001282765,CDV3,5,4,15842,3821,12021,3005.25,764.2,3.146035069
NM_005630,SLCO2A1,14,13,97382,4237,93145,7165,302.6428571,21.98371489
NM_001134422,CDV3,5,4,16686,4202,12484,3121,840.4,2.970966207
NM_001278683,AMOTL2,10,9,20074,5001,15073,1674.777778,500.1,3.013997201
NM_001278685,AMOTL2,10,9,19242,5009,14233,1581.444444,500.9,2.841485326
NM_001134423,CDV3,5,4,15842,3663,12179,3044.75,732.6,3.324870325
NM_002958,RYK,15,14,93610,2946,90664,6476,196.4,30.77528853
NM_016577,RAB6B,8,7,71613,5568,66045,9435,696,11.86153017
NM_001282764,CDV3,5,4,15842,2636,13206,3301.5,527.2,5.009863429
NM_001282763,CDV3,5,4,15842,2888,12954,3238.5,577.6,4.485457064
NM_001282762,CDV3,5,4,16686,3361,13325,3331.25,672.2,3.964593871
NM_001005861,RYK,15,14,93610,2955,90655,6475.357143,197,30.678511
NM_178554,KY,11,10,51101,5715,45386,4538.6,519.5454545,7.941557305
NM_004441,EPHB1,16,15,465210,4691,460519,30701.26667,293.1875,98.1707525
NM_001190447,PPP2R3A,13,12,182239,4392,177847,14820.58333,337.8461538,40.49339709
NM_002718,PPP2R3A,14,13,182239,6828,175411,13493.15385,487.7142857,25.68995313
NM_181897,PPP2R3A,13,12,125177,4682,120495,10041.25,360.1538462,25.73579667
NM_144717,IL20RB,7,6,53221,2053,51168,8528,293.2857143,24.92352655
NM_016216,DBR1,8,7,13963,2698,11265,1609.285714,337.25,4.175315048
NM_024491,CEP70,18,17,100046,2782,97264,5721.411765,154.5555556,34.96189792
NM_001288965,CEP70,17,16,100046,2707,97339,6083.6875,159.2352941,35.95825637
NM_178130,NME9,12,11,68451,2145,66306,6027.818182,178.75,30.91188811
NM_001288966,CEP70,16,15,94501,2188,92313,6154.2,136.75,42.19058501
NM_001288967,CEP70,14,13,100046,2308,97738,7518.307692,164.8571429,42.347487
NM_001288964,CEP70,18,17,100046,2764,97282,5722.470588,153.5555556,35.19609262
NM_001200047,NMNAT3,4,3,117864,1804,116060,38686.66667,451,64.33481153
NM_178177,NMNAT3,5,4,117864,1923,115941,28985.25,384.6,60.29173167
NM_020191,MRPS22,8,7,13028,1130,11898,1699.714286,141.25,10.52920354
NM_022131,CLSTN2,17,16,632894,4899,627995,39249.6875,288.1764706,128.1884058
NM_080862,SPSB4,3,2,96712,2412,94300,47150,804,39.09618574
NM_001080412,ZBTB38,8,7,125579,8392,117187,16741,1049,13.96413251
NM_006506,RASA2,24,23,125273,2616,122657,5332.913043,109,46.88723242
NM_001178142,TFDP2,8,7,84239,9165,75074,10724.85714,1145.625,8.191380251
NM_001178140,TFDP2,10,9,55961,9386,46575,5175,938.6,4.962177711
NM_001178138,TFDP2,14,13,205118,9932,195186,15014.30769,709.4285714,19.6522352
NM_003304,TRPC1,12,11,83465,4080,79385,7216.818182,340,19.45710784
NM_001178141,TFDP2,10,9,84239,9319,74920,8324.444444,931.9,8.039489216
NM_001178139,TFDP2,13,12,205118,9893,195225,16268.75,761,19.73365006
NM_001145319,PLS1,16,15,117278,3721,113557,7570.466667,232.5625,30.51787154
NM_006286,TFDP2,11,10,84239,9445,74794,7479.4,858.6363636,7.918898888
NM_001282857,XRN1,41,40,141457,10148,131309,3282.725,247.5121951,12.93939693
NM_001251845,TRPC1,13,12,83465,4183,79282,6606.833333,321.7692308,18.95338274
NM_002670,PLS1,16,15,90241,3737,86504,5766.933333,233.5625,23.14797966
NM_001184,ATR,47,46,129593,8298,121295,2636.847826,176.5531915,14.61737768
NM_019001,XRN1,42,41,141457,10185,131272,3201.756098,242.5,12.88875798
NM_001080415,U2SURP,28,27,59197,7492,51705,1915,267.5714286,6.901361452
NM_173653,SLC9A9,16,15,583311,3643,579668,38644.53333,227.6875,159.1183091
NM_139048,HLTF,26,25,56439,4540,51899,2075.96,174.6153846,11.4314978
NM_003071,HLTF,25,24,56439,5376,51063,2127.625,215.04,9.498325893
NM_183381,RNF13,10,9,149452,2872,146580,16286.66667,287.2,51.03760446
NM_007282,RNF13,11,10,149452,2975,146477,14647.7,270.4545455,49.23596639
NM_002628,PFN2,3,2,6052,1787,4265,2132.5,595.6666667,2.386681589
NM_015472,WWTR1,7,6,140868,5120,135748,22624.66667,731.4285714,26.51328125
NM_053024,PFN2,3,2,6052,2109,3943,1971.5,703,1.869606449
NM_001168280,WWTR1,7,6,140792,4984,135808,22634.66667,712,27.24879615
NM_001168278,WWTR1,8,7,186040,5038,181002,25857.42857,629.75,35.92735212
NM_016275,SELT,6,5,27170,3496,23674,4734.8,582.6666667,6.77173913
NM_005067,SIAH2,2,1,22355,2622,19733,19733,1311,7.525934401
NM_001114397,DHX36,25,24,48831,3594,45237,1884.875,143.76,12.58681135
NM_020865,DHX36,25,24,48831,3636,45195,1883.125,145.44,12.42986799
NM_015595,ARHGEF26,15,14,136469,5196,131273,9376.642857,346.4,25.26424172
NM_001251962,ARHGEF26,15,14,136826,5269,131557,9396.928571,351.2666667,24.96811539
NM_001251963,ARHGEF26,15,14,136469,5131,131338,9381.285714,342.0666667,25.59695966
NM_014996,PLCH1,22,21,224328,6150,218178,10389.42857,279.5454545,35.47609756
NM_001130961,PLCH1,24,23,196436,6497,189939,8258.217391,270.7083333,29.23487764
NM_001130960,PLCH1,23,22,196436,6468,189968,8634.909091,281.2173913,29.37043908
NM_001193283,LEKR1,5,4,98899,1945,96954,24238.5,389,49.84781491
NM_001167912,VEPH1,14,13,243606,4135,239471,18420.84615,295.3571429,57.91318017
NM_002852,PTX3,3,2,6839,1941,4898,2449,647,2.523441525
NM_024621,VEPH1,14,13,239915,4326,235589,18122.23077,309,54.45885344
NM_001167911,VEPH1,13,12,243606,3999,239607,19967.25,307.6153846,59.91672918
NM_001004316,LEKR1,13,12,219824,2585,217239,18103.25,198.8461538,84.03829787
NM_016625,RSRC1,10,9,434785,1737,433048,48116.44444,173.7,249.3080023
NM_001271838,RSRC1,10,9,434785,1749,433036,48115.11111,174.9,247.5906232
NM_001271834,RSRC1,9,8,434785,1548,433237,54154.625,172,279.868863
NM_001042706,IQCJ,4,3,194496,1539,192957,64319,384.75,125.3781676
NM_001042705,IQCJ,5,4,197057,1570,195487,48871.75,314,124.5140127
NM_001197100,IQCJ,4,3,197057,1488,195569,65189.66667,372,131.4307796
NM_001190242,IFT80,19,18,126782,4179,122603,6811.277778,219.9473684,29.33787988
NM_001190241,IFT80,21,20,142548,4547,138001,6900.05,216.5238095,30.34990103
NM_020800,IFT80,20,19,142548,4326,138222,7274.842105,216.3,31.95145631
NM_015938,NMD3,16,15,30698,2744,27954,1863.6,171.5,10.18731778
NM_001040100,SPTSSB,3,2,27293,2309,24984,12492,769.6666667,10.82026851
NM_001080440,OTOL1,4,3,7136,1438,5698,1899.333333,359.5,3.962447844
NM_139245,PPM1L,4,3,314823,3060,311763,103921,765,101.8833333
NM_001041,SI,48,47,99599,6059,93540,1990.212766,126.2291667,15.43819112
NM_000055,BCHE,4,3,64563,2451,62112,20704,612.75,25.34149327
NM_001122752,SERPINI1,9,8,89927,1686,88241,11030.125,187.3333333,52.33748517
NM_024687,ZBBX,21,20,140010,3265,136745,6837.25,155.4761905,41.8820827
NM_001199202,ZBBX,21,20,139996,3213,136783,6839.15,153,42.57173981
NM_001199201,ZBBX,22,21,140010,3383,136627,6506.047619,153.7727273,40.38634348
NM_005025,SERPINI1,9,8,89848,1919,87929,10991.125,213.2222222,45.82021886
NM_178824,WDR49,15,14,174818,2608,172210,12300.71429,173.8666667,66.03144172
NM_002740,PRKCI,18,17,83552,4902,78650,4626.470588,272.3333333,16.04447164
NM_020949,SLC7A14,8,7,126523,10141,116382,16626,1267.625,11.476383
NM_001164436,TMEM212,5,4,15971,1886,14085,3521.25,377.2,7.468186638
NM_002662,PLD1,27,26,210091,6052,204039,7847.653846,224.1481481,33.71430932
NM_001130081,PLD1,26,25,210091,5937,204154,8166.16,228.3461538,34.3867273
NM_001146278,NCEH1,4,3,80575,4066,76509,25503,1016.5,18.81677324
NM_001146276,NCEH1,5,4,80575,4320,76255,19063.75,864,17.65162037
NM_020792,NCEH1,5,4,80575,4296,76279,19069.75,859.2,17.75581937
NM_031955,SPATA16,11,10,251913,2118,249795,24979.5,192.5454545,117.9390935
NM_001190942,TNFSF10,3,2,18001,1808,16193,8096.5,602.6666667,8.95630531
NM_018098,ECT2,24,23,70791,4108,66683,2899.26087,171.1666667,16.23247322
NM_001146277,NCEH1,5,4,80575,4286,76289,19072.25,857.2,17.79958003
NM_001258316,ECT2,25,24,70791,4432,66359,2764.958333,177.28,14.97269856
NM_001258315,ECT2,25,24,70791,4202,66589,2774.541667,168.08,15.84697763
NM_003810,TNFSF10,5,4,18001,1958,16043,4010.75,391.6,8.193564862
NM_014932,NLGN1,7,6,884903,4954,879949,146658.1667,707.7142857,177.6239403
NM_024665,TBL1XR1,16,15,176508,6566,169942,11329.46667,410.375,25.88212001
NM_016331,ZNF639,7,6,11771,3020,8751,1458.5,431.4285714,2.897682119
NM_022470,ZMAT3,6,5,54647,9001,45646,9129.2,1500.166667,5.07121431
NM_152240,ZMAT3,7,6,54647,9120,45527,7587.833333,1302.857143,4.991995614
NM_001278911,KCNMB2,5,4,285731,2557,283174,70793.5,511.4,110.7446226
NM_005832,KCNMB2,6,5,285731,2635,283096,56619.2,439.1666667,107.4368121
NM_006218,PIK3CA,21,20,86188,3730,82458,4122.9,177.6190476,22.10670241
NM_001256754,PEX5L,15,14,179263,8949,170314,12165.28571,596.6,19.03162365
NM_001256752,PEX5L,14,13,242096,9113,232983,17921.76923,650.9285714,25.56600461
NM_001256751,PEX5L,14,13,242096,9146,232950,17919.23077,653.2857143,25.47015089
NM_001256756,PEX5L,14,13,179263,8843,170420,13109.23077,631.6428571,19.27174036
NM_001256753,PEX5L,13,12,242096,9040,233056,19421.33333,695.3846154,25.78053097
NM_001256750,PEX5L,15,14,242096,9213,232883,16634.5,614.2,25.27765115
NM_016559,PEX5L,15,14,242096,9219,232877,16634.07143,614.6,25.26054887
NM_001256755,PEX5L,14,13,179263,8753,170510,13116.15385,625.2142857,19.48017822
NM_003940,USP13,21,20,136258,7954,128304,6415.2,378.7619048,16.13075182
NM_017644,KLHL24,8,7,48895,7336,41559,5937,917,5.665076336
NM_015078,MCF2L2,30,29,250267,5043,245224,8456,168.1,48.62661114
NM_032047,B3GNT5,2,1,20149,4125,16024,16024,2062.5,3.884606061
NM_014616,ATP11B,30,29,128132,7350,120782,4164.896552,245,16.43292517
NM_130446,KLHL6,7,6,68182,6327,61855,10309.16667,903.8571429,9.776355303
NM_014398,LAMP3,6,5,40666,3347,37319,7463.8,557.8333333,11.14998506
NM_001278709,PSMD2,19,18,8475,2647,5828,323.7777778,139.3157895,2.201737816
NM_004068,AP2M1,12,11,9247,1952,7297,663.3636364,162.6666667,3.738217213
NM_002808,PSMD2,21,20,9958,3081,6877,343.85,146.7142857,2.232067511
NM_001278708,PSMD2,19,18,8475,2658,5817,323.1666667,139.8947368,2.188487585
NM_001025205,AP2M1,11,10,9247,1945,7302,730.2,176.8181818,3.754241645
NM_004443,EPHB3,16,15,20611,4236,16375,1091.666667,264.75,3.865675165
NM_021627,SENP2,17,16,44856,3211,41645,2602.8125,188.8823529,12.96947991
NM_006548,IGF2BP2,16,15,181302,3687,177615,11841,230.4375,48.17331164
NM_001966,EHHADH,7,6,63476,3857,59619,9936.5,551,15.45735027
NM_004721,MAP3K13,14,13,126048,9959,116089,8929.923077,711.3571429,11.65669244
NM_001166415,EHHADH,7,6,63476,3980,59496,9916,568.5714286,14.94874372
NM_001025266,C3orf70,2,1,74966,5903,69063,69063,2951.5,11.69964425
NM_001242317,MAP3K13,13,12,206155,9107,197048,16420.66667,700.5384615,21.63698254
NM_001242314,MAP3K13,15,14,206155,9845,196310,14022.14286,656.3333333,19.9400711
NM_001007225,IGF2BP2,15,14,181302,3557,177745,12696.07143,237.1333333,49.97048074
NM_001080745,DGKG,24,23,215035,5709,209326,9101.130435,237.875,36.66596602
NM_001080744,DGKG,24,23,215035,5751,209284,9099.304348,239.625,36.39088854
NM_002916,RFC4,11,10,16610,1402,15208,1520.8,127.4545455,10.84736091
NM_181573,RFC4,11,10,16804,1461,15343,1534.3,132.8181818,10.50171116
NM_001346,DGKG,25,24,215035,5827,209208,8717,233.08,35.9032092
NM_000412,HRG,7,6,12278,2010,10268,1711.333333,287.1428571,5.108457711
NM_003032,ST6GAL1,7,6,56678,4288,52390,8731.666667,612.5714286,12.21781716
NM_173217,ST6GAL1,7,6,148028,3954,144074,24012.33333,564.8571429,36.43753161
NM_173216,ST6GAL1,8,7,148028,4612,143416,20488,576.5,31.0962706
NM_005578,LPP,11,10,677741,18289,659452,65945.2,1662.636364,36.0573022
NM_001167671,LPP,11,10,665269,18232,647037,64703.7,1657.454545,35.48908513
NM_001167672,LPP,10,9,736799,17757,719042,79893.55556,1775.7,40.49343921
NM_198485,TPRG1,6,5,151510,3663,147847,29569.4,610.5,40.36227136
NM_003722,TP63,14,13,265854,4923,260931,20071.61538,351.6428571,53.00243754
NM_001114980,TP63,12,11,107621,4691,102930,9357.272727,390.9166667,21.94201663
NM_001114981,TP63,11,10,107621,4596,103025,10302.5,417.8181818,22.41623151
NM_001114979,TP63,11,10,250070,2881,247189,24718.9,261.9090909,85.79972232
NM_001114978,TP63,13,12,265854,4828,261026,21752.16667,371.3846154,54.06503728
NM_001114982,TP63,9,8,91837,2649,89188,11148.5,294.3333333,33.66855417
NM_001146686,GMNC,5,4,9941,3629,6312,1578,725.8,1.739322127
NM_002182,IL1RAP,12,11,137470,4796,132674,12061.27273,399.6666667,27.66346956
NM_134470,IL1RAP,9,8,116235,2103,114132,14266.5,233.6666667,54.27104137
NM_001167928,IL1RAP,13,12,137470,4961,132509,11042.41667,381.6153846,26.71013908
NM_001167931,IL1RAP,12,11,143148,2923,140225,12747.72727,243.5833333,47.97297297
NM_001167929,IL1RAP,11,10,137470,4708,132762,13276.2,428,28.19923534
NM_001167930,IL1RAP,8,7,116235,2015,114220,16317.14286,251.875,56.68486352
NM_178335,CCDC50,12,11,69587,8961,60626,5511.454545,746.75,6.76553956
NM_174908,CCDC50,11,10,69587,8432,61155,6115.5,766.5454545,7.252727704
NM_178496,MB21D2,2,1,121347,3369,117978,117978,1684.5,35.01869991
NM_130834,OPA1,30,29,104669,6412,98257,3388.172414,213.7333333,15.32392389
NM_130836,OPA1,30,29,104669,6469,98200,3386.206897,215.6333333,15.18008966
NM_130833,OPA1,29,28,104669,6360,98309,3511.035714,219.3103448,15.45738994
NM_130831,OPA1,28,27,104669,6248,98421,3645.222222,223.1428571,15.75240077
NM_130837,OPA1,31,30,104669,6524,98145,3271.5,210.4516129,15.04368486
NM_130835,OPA1,30,29,104669,6415,98254,3388.068966,213.8333333,15.31628995
NM_032279,ATP13A4,30,29,152832,4304,148528,5121.655172,143.4666667,34.50929368
NM_198505,ATP13A5,30,29,103685,3687,99998,3448.206897,122.9,27.12177922
NM_130832,OPA1,29,28,104669,6303,98366,3513.071429,217.3448276,15.60621926
NM_015560,OPA1,29,28,104669,6357,98312,3511.142857,219.2068966,15.46515652
NM_005524,HES1,4,3,2472,1465,1007,335.6666667,366.25,0.687372014
NM_152531,XXYLT1,4,3,202884,2725,200159,66719.66667,681.25,73.45284404
NM_018385,LSG1,14,13,31691,3586,28105,2161.923077,256.1428571,7.837423313
NM_004488,GP5,2,1,4447,3495,952,952,1747.5,0.272389127
NM_152672,SLC51A,9,8,16920,1464,15456,1932,162.6666667,10.55737705
NM_001647,APOD,5,4,15505,1135,14370,3592.5,227,12.66079295
NM_001204388,DLG1,21,20,141573,4774,136799,6839.95,227.3333333,28.65500628
NM_001204387,DLG1,22,21,141573,4811,136762,6512.47619,218.6818182,28.42693827
NM_001204386,DLG1,25,24,256018,4957,251061,10460.875,198.28,50.64777083
NM_005929,MFI2,16,15,28077,3978,24099,1606.6,248.625,6.058069382
NM_152617,RNF168,6,5,34984,5350,29634,5926.8,891.6666667,5.539065421
NM_152699,SENP5,10,9,66859,6317,60542,6726.888889,631.7,9.583979737
NM_002577,PAK2,15,14,92792,6154,86638,6188.428571,410.2666667,14.07832304
NM_001098424,DLG1,26,25,256018,4994,251024,10040.96,192.0769231,50.26511814
NM_004087,DLG1,26,25,256018,5060,250958,10038.32,194.6153846,49.59644269
NM_203315,BDH1,7,6,63542,3337,60205,10034.16667,476.7142857,18.04165418
NM_203314,BDH1,8,7,46206,3554,42652,6093.142857,444.25,12.00112549
NM_032773,LRCH3,19,18,80313,2277,78036,4335.333333,119.8421053,34.27140975
NM_032263,IQCG,12,11,70942,2270,68672,6242.909091,189.1666667,30.25198238
NM_001134435,IQCG,11,10,60852,1994,58858,5885.8,181.2727273,29.51755266
NM_004051,BDH1,7,6,46206,3401,42805,7134.166667,485.8571429,12.58600412
NM_001173482,CRBN,11,10,30086,2599,27487,2748.7,236.2727273,10.57599077
NM_016302,CRBN,11,10,30086,2602,27484,2748.4,236.5454545,10.56264412
NM_182916,TRNT1,8,7,22108,2283,19825,2832.142857,285.375,8.683749452
NM_020873,LRRN1,2,1,48268,3825,44443,44443,1912.5,11.61908497
NM_001276325,SETMAR,2,1,11100,1730,9370,9370,865,5.416184971
NM_006515,SETMAR,3,2,13963,2144,11819,5909.5,714.6666667,5.512593284
NM_001243723,SETMAR,4,3,13963,1728,12235,4078.333333,432,7.080439815
NM_003670,BHLHE40,5,4,5770,3039,2731,682.75,607.8,0.898650872
NM_018184,ARL8B,7,6,58673,2992,55681,9280.166667,427.4285714,18.60995989
NM_001278235,LMCD1,5,4,49470,2262,47208,11802,452.4,20.87002653
NM_001278234,LMCD1,5,4,66320,1506,64814,16203.5,301.2,43.03718459
NM_001278233,LMCD1,5,4,66320,1673,64647,16161.75,334.6,38.64136282
NM_014583,LMCD1,6,5,66320,1763,64557,12911.4,293.8333333,36.61769711
NM_015931,SSUH2,12,11,32680,1815,30865,2805.909091,151.25,17.00550964
NM_001256749,SSUH2,12,11,32680,1669,31011,2819.181818,139.0833333,18.58058718
NM_001256748,SSUH2,12,11,25400,1648,23752,2159.272727,137.3333333,14.41262136
NM_000916,OXTR,4,3,19207,4364,14843,4947.666667,1091,3.401237397
NM_020165,RAD18,13,12,86281,5752,80529,6710.75,442.4615385,14.00017385
NM_015453,THUMPD3,10,9,23760,3990,19770,2196.666667,399,4.954887218
NM_001114092,THUMPD3,10,9,23760,3785,19975,2219.444444,378.5,5.277410832
NM_001080517,SETD5,23,22,80437,6850,73587,3344.863636,297.826087,10.74262774
NM_016829,OGG1,8,7,16727,2213,14514,2073.428571,276.625,6.558517849
NM_016828,OGG1,8,7,16727,2260,14467,2066.714286,282.5,6.401327434
NM_016826,OGG1,5,4,16727,1956,14771,3692.75,391.2,7.551635992
NM_016820,OGG1,7,6,7463,1660,5803,967.1666667,237.1428571,3.495783133
NM_002542,OGG1,7,6,7463,1643,5820,970,234.7142857,3.54230067
NM_016827,OGG1,4,3,16727,1773,14954,4984.666667,443.25,8.43429216
NM_016821,OGG1,7,6,16727,2159,14568,2428,308.4285714,6.747568319
NM_016819,OGG1,6,5,7463,1886,5577,1115.4,314.3333333,2.957051962
NM_004634,BRPF1,14,13,16267,4724,11543,887.9230769,337.4285714,2.443480102
NM_003656,CAMK1,12,11,12641,1504,11137,1012.454545,125.3333333,7.404920213
NM_153635,CPNE9,20,19,26084,2069,24015,1263.947368,103.45,11.60705655
NM_001003694,BRPF1,14,13,16267,4742,11525,886.5384615,338.7142857,2.43040911
NM_032492,JAGN1,2,1,3762,1660,2102,2102,830,1.26626506
NM_001024959,ARPC4,6,5,14612,1611,13001,2600.2,268.5,8.070142768
NM_001024960,ARPC4,6,5,14612,1466,13146,2629.2,244.3333333,8.967257844
NM_001025930,TTLL3,13,12,26398,3675,22723,1893.583333,282.6923077,6.183129252
NM_001198793,ARPC4-TTLL3,12,11,43810,3999,39811,3619.181818,333.25,9.95523881
NM_022094,CIDEC,6,5,12348,1287,11061,2212.2,214.5,8.594405594
NM_001193380,IL17RE,16,15,13574,2791,10783,718.8666667,174.4375,3.863489789
NM_001142547,RPUSD3,8,7,6171,1190,4981,711.5714286,148.75,4.185714286
NM_001199623,CIDEC,6,5,12104,1206,10898,2179.6,201,9.036484245
NM_001199552,CIDEC,6,5,13546,1203,12343,2468.6,200.5,10.26018288
NM_001199551,CIDEC,7,6,13546,1234,12312,2052,176.2857143,9.977309562
NM_005718,ARPC4,6,5,14559,1977,12582,2516.4,329.5,6.364188164
NM_153483,IL17RE,17,16,13790,2738,11052,690.75,161.0588235,4.036523009
NM_153480,IL17RE,16,15,13574,2718,10856,723.7333333,169.875,3.994113319
NM_153481,IL17RE,14,13,13574,2580,10994,845.6923077,184.2857143,4.26124031
NM_001198780,ARPC4,6,5,13990,1465,12525,2505,244.1666667,8.549488055
NM_173659,RPUSD3,9,8,6171,1236,4935,616.875,137.3333333,3.992718447
NM_001008737,AC022007.5,4,3,4679,1901,2778,926,475.25,1.461336139
NM_018447,EMC3,8,7,22888,1088,21800,3114.285714,136,20.03676471
NM_001031717,CRELD1,12,11,11574,2402,9172,833.8181818,200.1666667,3.818484596
NM_001077415,CRELD1,11,10,11574,2207,9367,936.7,200.6363636,4.244222927
NM_015513,CRELD1,10,9,11575,2706,8869,985.4444444,270.6,3.277531412
NM_207351,PRRT3,4,3,6854,3765,3089,1029.666667,941.25,0.820451527
NM_001164839,FANCD2OS,2,1,4098,867,3231,3231,433.5,3.726643599
NM_198156,VHL,2,1,12037,4439,7598,7598,2219.5,1.711646767
NM_000551,VHL,3,2,12037,4563,7474,3737,1521,1.637957484
NM_173472,FANCD2OS,3,2,26913,1017,25896,12948,339,25.46312684
NM_018462,BRK1,3,2,11543,1179,10364,5182,393,8.790500424
NM_001134946,GHRL,3,2,7199,363,6836,3418,121,18.83195592
NM_001134945,GHRL,4,3,7199,478,6721,2240.333333,119.5,14.06066946
NM_001134944,GHRL,4,3,7199,481,6718,2239.333333,120.25,13.96673597
NM_016362,GHRL,5,4,4987,533,4454,1113.5,106.6,8.356472795
NM_001134941,GHRL,5,4,4987,530,4457,1114.25,106,8.409433962
NM_014760,TATDN2,8,7,32731,4915,27816,3973.714286,614.375,5.659409969
NM_003042,SLC6A1,16,15,46517,4510,42007,2800.466667,281.875,9.314190687
NM_000861,HRH1,3,2,10556,4410,6146,3073,1470,1.393650794
NM_001128221,VGLL4,4,3,12859,3432,9427,3142.333333,858,2.746794872
NM_001128220,VGLL4,4,3,26326,3218,23108,7702.666667,804.5,7.180857676
NM_001284391,VGLL4,5,4,48516,3561,44955,11238.75,712.2,12.62426285
NM_138807,TAMM41,7,6,56479,1304,55175,9195.833333,186.2857143,42.31211656
NM_001284401,TAMM41,8,7,56479,1368,55111,7873,171,40.28581871
NM_003256,TIMP4,5,4,6285,1638,4647,1161.75,327.6,2.836996337
NM_025265,TSEN2,12,11,48812,2397,46415,4219.545455,199.75,19.36378807
NM_001145395,TSEN2,9,8,46504,2706,43798,5474.75,300.6666667,16.18551367
NM_001145394,TSEN2,13,12,48891,1937,46954,3912.833333,149,24.24057821
NM_001145393,TSEN2,11,10,48891,2034,46857,4685.7,184.9090909,23.03687316
NM_001145392,TSEN2,12,11,48812,2145,46667,4242.454545,178.75,21.75617716
NM_002880,RAF1,17,16,80602,3292,77310,4831.875,193.6470588,23.48420413
NM_014160,MKRN2,8,7,26699,2854,23845,3406.428571,356.75,8.354940434
NM_001271707,MKRN2,7,6,26699,2724,23975,3995.833333,389.1428571,8.801395007
NM_018306,TMEM40,12,11,25781,2085,23696,2154.181818,173.75,11.36498801
NM_001284408,TMEM40,10,9,25781,1855,23926,2658.444444,185.5,12.89811321
NM_001284407,TMEM40,11,10,25781,1994,23787,2378.7,181.2727273,11.92928786
NM_001284406,TMEM40,12,11,35929,2173,33756,3068.727273,181.0833333,15.5342844
NM_000994,RPL32,4,3,6639,1655,4984,1661.333333,413.75,3.011480363
NM_001007074,RPL32,3,2,5507,1773,3734,1867,591,2.106034969
NM_001007073,RPL32,4,3,6639,1754,4885,1628.333333,438.5,2.785062714
NM_024827,HDAC11,10,9,26211,2928,23283,2587,292.8,7.951844262
NM_001136041,HDAC11,10,9,26082,2827,23255,2583.888889,282.7,8.226034666
NM_004628,XPC,16,15,33526,3736,29790,1986,233.5,7.973768737
NM_024334,TMEM43,12,11,18742,3354,15388,1398.909091,279.5,4.587954681
NM_014463,LSM3,4,3,19643,699,18944,6314.666667,174.75,27.10157368
NM_001145769,XPC,16,15,33526,3625,29901,1993.4,226.5625,8.248551724
NM_001134368,SLC6A6,5,4,45619,1306,44313,11078.25,261.2,33.93032159
NM_001134367,SLC6A6,15,14,86783,6549,80234,5731,436.6,12.25133608
NM_003043,SLC6A6,15,14,86783,6553,80230,5730.714286,436.8666667,12.24324737
NM_016474,CCDC174,11,10,20915,2971,17944,1794.4,270.0909091,6.039717267
NM_022497,MRPS25,4,3,16799,4570,12229,4076.333333,1142.5,2.675929978
NM_022340,ZFYVE20,14,13,29077,6692,22385,1721.923077,478,3.345038852
NM_014296,CAPN7,21,20,46692,4389,42303,2115.15,209,9.638414217
NM_005677,COLQ,17,16,71620,3022,68598,4287.375,177.7647059,22.69953673
NM_033083,EAF1,6,5,15058,4494,10564,2112.8,749,2.350689809
NM_080539,COLQ,16,15,71620,2919,68701,4580.066667,182.4375,23.53579993
NM_080538,COLQ,17,16,48741,3151,45590,2849.375,185.3529412,14.46842272
NM_012260,HACL1,17,16,41150,2304,38846,2427.875,135.5294118,16.86024306
NM_001281724,BTD,6,5,44078,2265,41813,8362.6,377.5,18.46048565
NM_001281726,BTD,3,2,40509,763,39746,19873,254.3333333,52.09174312
NM_001281725,BTD,4,3,43854,2267,41587,13862.33333,566.75,18.34450816
NM_001281723,BTD,4,3,44471,2344,42127,14042.33333,586,17.97226962
NM_001284415,HACL1,15,14,41150,2122,39028,2787.714286,141.4666667,18.39208294
NM_001284416,HACL1,14,13,41150,2055,39095,3007.307692,146.7857143,19.0243309
NM_000060,BTD,4,3,44078,2075,42003,14001,518.75,20.24240964
NM_001284413,HACL1,16,15,41150,2222,38928,2595.2,138.875,17.51935194
NM_001047434,DPH3,2,1,7930,3992,3938,3938,1996,0.986472946
NM_138381,OXNAD1,9,8,40929,3977,36952,4619,441.8888889,9.291425698
NM_206831,DPH3,3,2,7930,4068,3862,1931,1356,0.949360865
NM_001195470,SATB1,12,11,77698,5664,72034,6548.545455,472,12.71786723
NM_002971,SATB1,11,10,77698,5567,72131,7213.1,506.0909091,12.95688881
NM_001131010,SATB1,11,10,91134,4065,87069,8706.9,369.5454545,21.41918819
NM_001252657,PP2D1,3,2,26931,2133,24798,12399,711,11.62587904
NM_004162,RAB5A,6,5,38097,2541,35556,7111.2,423.5,13.99291617
NM_001199253,SGOL1,8,7,17790,3388,14402,2057.428571,423.5,4.250885478
NM_001199257,SGOL1,7,6,25641,1459,24182,4030.333333,208.4285714,16.574366
NM_001199256,SGOL1,8,7,25641,1691,23950,3421.428571,211.375,14.16321703
NM_001199254,SGOL1,9,8,25641,1743,23898,2987.25,193.6666667,13.71084337
NM_001199252,SGOL1,9,8,25641,2499,23142,2892.75,277.6666667,9.260504202
NM_001199255,SGOL1,7,6,17790,3336,14454,2409,476.5714286,4.332733813
NM_001199251,SGOL1,8,7,17790,4144,13646,1949.428571,518,3.292953668
NM_001012411,SGOL1,8,7,17764,3251,14513,2073.285714,406.375,4.464164872
NM_001012409,SGOL1,8,7,17764,4007,13757,1965.285714,500.875,3.433241827
NM_001012413,SGOL1,7,6,17764,3199,14565,2427.5,457,4.552985308
NM_138484,SGOL1,8,7,25615,1554,24061,3437.285714,194.25,15.48326898
NM_001012412,SGOL1,9,8,25615,1606,24009,3001.125,178.4444444,14.94956413
NM_001012410,SGOL1,9,8,25615,2362,23253,2906.625,262.4444444,9.844623201
NM_002948,RPL15,4,3,4054,2354,1700,566.6666667,588.5,0.722175021
NM_001253383,RPL15,4,3,3731,2097,1634,544.6666667,524.25,0.779208393
NM_001253379,RPL15,4,3,4054,2367,1687,562.3333333,591.75,0.712716519
NM_001253384,RPL15,5,4,6894,2844,4050,1012.5,568.8,1.424050633
NM_001253382,RPL15,4,3,3696,2118,1578,526,529.5,0.745042493
NM_001253380,RPL15,3,2,3153,2128,1025,512.5,709.3333333,0.481672932
NM_020345,NKIRAS1,5,4,24967,2000,22967,5741.75,400,11.4835
NM_001145425,NR1D2,8,7,34499,5064,29435,4205,633,5.812598736
NM_005126,NR1D2,8,7,35360,5266,30094,4299.142857,658.25,5.714774022
NM_001145391,OXSM,4,3,4464,1282,3182,1060.666667,320.5,2.482059282
NM_017897,OXSM,3,2,4464,1530,2934,1467,510,1.917647059
NM_003615,SLC4A7,25,24,84035,7784,76251,3177.125,311.36,9.795863309
NM_001258380,SLC4A7,24,23,84035,7411,76624,3331.478261,308.7916667,10.33922548
NM_001278183,EOMES,6,5,6768,2650,4118,823.6,441.6666667,1.553962264
NM_001278182,EOMES,6,5,6768,3666,3102,620.4,611,0.846153846
NM_005442,EOMES,6,5,6768,3609,3159,631.8,601.5,0.875311721
NM_001134432,AZI2,7,6,17440,1452,15988,2664.666667,207.4285714,11.01101928
NM_001134433,AZI2,7,6,17440,1448,15992,2665.333333,206.8571429,11.0441989
NM_022461,AZI2,8,7,26776,3408,23368,3338.285714,426,6.856807512
NM_001271650,AZI2,9,8,26776,3473,23303,2912.875,385.8888889,6.709761014
NM_001137674,ZNF860,2,1,9964,3208,6756,6756,1604,2.105985037
NM_015141,GPD1L,8,7,62206,4070,58136,8305.142857,508.75,14.28402948
NM_138410,CMTM7,5,4,63172,1356,61816,15454,271.2,45.58702065
NM_181472,CMTM7,4,3,63172,1256,61916,20638.66667,314,49.29617834
NM_016141,DYNC1LI1,13,12,44905,2517,42388,3532.333333,193.6153846,16.84068335
NM_017801,CMTM6,4,3,21601,3370,18231,6077,842.5,5.409792285
NM_005508,CCR4,2,1,3339,1659,1680,1680,829.5,1.012658228
NM_001135602,GLB1,13,12,100596,2208,98388,8199,169.8461538,44.55978261
NM_001079811,GLB1,16,15,100216,2516,97700,6513.333333,157.25,38.83147854
NM_001136238,TMPPE,2,1,6387,3458,2929,2929,1729,0.8470214
NM_000404,GLB1,16,15,100596,2604,97992,6532.8,162.75,37.63133641
NM_001039770,TMPPE,2,1,6387,3973,2414,2414,1986.5,0.607601309
NM_015551,SUSD5,5,4,69172,5010,64162,16040.5,1002,12.80678643
NM_001128161,UBP1,17,16,52070,3783,48287,3017.9375,222.5294118,12.7642083
NM_014517,UBP1,16,15,52043,4163,47880,3192,260.1875,11.50132116
NM_001128160,UBP1,15,14,52043,4054,47989,3427.785714,270.2666667,11.8374445
NM_013374,PDCD6IP,18,17,71138,5965,65173,3833.705882,331.3888889,10.92590109
NM_001256192,PDCD6IP,6,5,28695,1565,27130,5426,260.8333333,17.33546326
NM_001162429,PDCD6IP,18,17,71138,5980,65158,3832.823529,332.2222222,10.89598662
NM_001025069,ARPP21,6,5,6265,2424,3841,768.2,404,1.584570957
NM_001025068,ARPP21,6,5,6265,2415,3850,770,402.5,1.594202899
NM_198399,ARPP21,5,4,4952,2405,2547,636.75,481,1.059043659
NM_001267618,ARPP21,5,4,6268,2511,3757,939.25,502.2,1.496216647
NM_001267616,ARPP21,6,5,46715,3571,43144,8628.8,595.1666667,12.08176981
NM_033403,DCLK3,5,4,27441,5349,22092,5523,1069.8,4.130117779
NM_001167618,MLH1,19,18,57071,2476,54595,3033.055556,130.3157895,22.0496769
NM_000249,MLH1,19,18,57498,2681,54817,3045.388889,141.1052632,20.4464752
NM_014805,EPM2AIP1,1,0,7440,7440,NA,NA,7440,NA
NM_001258273,MLH1,18,17,57498,2589,54909,3229.941176,143.8333333,21.20857474
NM_001258271,MLH1,17,16,57498,2472,55026,3439.125,145.4117647,22.25970874
NM_001258274,MLH1,20,19,57071,2627,54444,2865.473684,131.35,20.72478112
NM_001167619,MLH1,18,17,57071,2388,54683,3216.647059,132.6666667,22.89907873
NM_001167617,MLH1,19,18,57071,2476,54595,3033.055556,130.3157895,22.0496769
NM_001134369,LRRFIP2,15,14,123736,2938,120798,8628.428571,195.8666667,41.11572498
NM_006309,LRRFIP2,28,27,121981,3541,118440,4386.666667,126.4642857,33.44817848
NM_017724,LRRFIP2,14,13,123736,2865,120871,9297.769231,204.6428571,42.18883072
NM_001282691,LRRFIP2,19,18,122591,2931,119660,6647.777778,154.2631579,40.82565677
NM_178342,C3orf35,5,4,18899,1777,17122,4280.5,355.4,9.635340461
NM_178339,C3orf35,6,5,36022,1550,34472,6894.4,258.3333333,22.24
NM_015873,VILL,19,18,13600,2806,10794,599.6666667,147.6842105,3.846756949
NM_001130964,PLCD1,15,14,17293,2980,14313,1022.357143,198.6666667,4.803020134
NM_006225,PLCD1,15,14,22169,2687,19482,1391.571429,179.1333333,7.250465203
NM_002468,MYD88,5,4,4545,2854,1691,422.75,570.8,0.592501752
NM_001172569,MYD88,4,3,4545,2672,1873,624.3333333,668,0.700973054
NM_001172568,MYD88,4,3,4545,2718,1827,609,679.5,0.67218543
NM_001172567,MYD88,5,4,4545,2878,1667,416.75,575.6,0.579221682
NM_001172566,MYD88,3,2,4545,2536,2009,1004.5,845.3333333,0.792192429
NM_001607,ACAA1,12,11,14534,1831,12703,1154.818182,152.5833333,6.93773894
NM_001130410,ACAA1,10,9,14534,1550,12984,1442.666667,155,8.376774194
NM_004803,SLC22A14,10,9,12416,1987,10429,1158.777778,198.7,5.248616004
NM_004256,SLC22A13,10,9,12510,2570,9940,1104.444444,257,3.86770428
NM_001106,ACVR2B,11,10,38845,11384,27461,2746.1,1034.909091,2.412245257
NM_001145464,EXOG,5,4,30035,3001,27034,6758.5,600.2,9.008330556
NM_005107,EXOG,6,5,30035,3152,26883,5376.6,525.3333333,8.528870558
NM_001278789,GORASP1,7,6,11303,3041,8262,1377,434.4285714,2.716869451
NM_001278790,GORASP1,6,5,11303,2860,8443,1688.6,476.6666667,2.952097902
NM_031899,GORASP1,9,8,11766,3791,7975,996.875,421.2222222,2.103666579
NM_145755,TTC21A,29,28,31244,4284,26960,962.8571429,147.7241379,6.29318394
NM_020839,WDR48,19,18,44376,3710,40666,2259.222222,195.2631579,10.96118598
NM_001105513,TTC21A,28,27,31244,4139,27105,1003.888889,147.8214286,6.548683257
NM_194293,XIRP1,2,1,9372,6453,2919,2919,3226.5,0.452347745
NM_001337,CX3CR1,2,1,16544,3110,13434,13434,1555,4.319614148
NM_001198621,XIRP1,3,2,9381,6036,3345,1672.5,2012,0.55417495
NM_017875,SLC25A38,7,6,14006,2131,11875,1979.166667,304.4285714,5.572501173
NM_005201,CCR8,2,1,3976,1489,2487,2487,744.5,1.670248489
NM_001278323,MOBP,2,1,962,704,258,258,352,0.366477273
NM_001278322,MOBP,5,4,48432,3502,44930,11232.5,700.4,12.82981154
NM_182935,MOBP,4,3,48432,3087,45345,15115,771.75,14.68901846
NM_005875,EIF1B,4,3,2744,1016,1728,576,254,1.700787402
NM_001248,ENTPD3,11,10,41439,2804,38635,3863.5,254.9090909,13.77853067
NM_001098414,ZNF621,5,4,14918,8252,6666,1666.5,1650.4,0.807804169
NM_001256168,ZNF620,3,2,12112,2528,9584,4792,842.6666667,3.791139241
NM_001256167,ZNF620,3,2,12184,2538,9646,4823,846,3.800630418
NM_001145083,ZNF619,4,3,11438,2196,9242,3080.666667,549,4.20856102
NM_001145082,ZNF619,6,5,13126,4160,8966,1793.2,693.3333333,2.155288462
NM_001145093,ZNF619,5,4,13126,4039,9087,2271.75,807.8,2.24981431
NM_175888,ZNF620,5,4,12184,2781,9403,2350.75,556.2,3.381157857
NM_001287245,ZNF621,6,5,14918,2410,12508,2501.6,401.6666667,5.190041494
NM_198484,ZNF621,5,4,14918,8488,6430,1607.5,1697.6,0.757540057
NM_001098210,CTNNB1,16,15,40999,3272,37727,2515.133333,204.5,11.53025672
NM_001098209,CTNNB1,16,15,40999,3431,37568,2504.533333,214.4375,10.94957738
NM_001904,CTNNB1,15,14,40999,3735,37264,2661.714286,249,9.976974565
NM_000729,CCK,5,4,8346,1494,6852,1713,298.8,4.586345382
NM_001174138,CCK,3,2,6123,750,5373,2686.5,250,7.164
NM_144634,LYZL4,5,4,13492,877,12615,3153.75,175.4,14.38426454
NM_001251882,VIPR1,14,13,48276,3181,45095,3468.846154,227.2142857,14.17635964
NM_001251885,VIPR1,13,12,34963,2757,32206,2683.833333,212.0769231,11.6815379
NM_001251883,VIPR1,10,9,34963,2437,32526,3614,243.7,13.34673779
NM_001251884,VIPR1,12,11,34963,2693,32270,2933.636364,224.4166667,11.98291868
NM_004624,VIPR1,13,12,34963,2803,32160,2680,215.6153846,11.47342133
NM_016305,SS18L2,3,2,4194,818,3376,1688,272.6666667,4.127139364
NM_145166,ZBTB47,6,5,13898,5513,8385,1677,918.8333333,1.520950481
NM_005385,NKTR,17,16,48088,7319,40769,2548.0625,430.5294118,5.570296489
NM_014056,HIGD1A,4,3,21629,2771,18858,6286,692.75,6.805485384
NM_020707,HHATL,12,11,10166,1877,8289,753.5454545,156.4166667,4.416089505
NM_001099668,HIGD1A,4,3,21536,2942,18594,6198,735.5,6.320190347
NM_001099669,HIGD1A,4,3,21629,2795,18834,6278,698.75,6.738461538
NM_144719,CCDC13,16,15,64873,2846,62027,4135.133333,177.875,21.79444835
NM_207404,ZNF662,5,4,13425,5617,7808,1952,1123.4,1.390065871
NM_001205272,KRBOX1,5,4,6451,696,5755,1438.75,139.2,8.268678161
NM_001134656,ZNF662,4,3,13169,5528,7641,2547,1382,1.38223589
NM_004391,CYP8B1,1,0,3951,3951,NA,NA,3951,NA
NM_001129908,FAM198A,5,4,78450,3438,75012,18753,687.6,21.81849913
NM_016006,ABHD5,7,6,31844,5360,26484,4414,765.7142857,4.941044776
NM_001029840,TCAIM,4,3,21685,2000,19685,6561.666667,500,9.8425
NM_001029839,TCAIM,4,3,21352,2182,19170,6390,545.5,8.785517874
NM_181489,ZNF445,8,7,37902,10257,27645,3949.285714,1282.125,2.695232524
NM_001287349,ZNF852,5,4,11672,1975,9697,2424.25,395,4.909873418
NM_006991,ZNF197,6,5,20243,4342,15901,3180.2,723.6666667,3.662137264
NM_001024855,ZNF197,6,5,23454,2971,20483,4096.6,495.1666667,6.89431168
NM_001288592,ZKSCAN7,6,5,28291,1935,26356,5271.2,322.5,13.62067183
NM_173658,ZNF660,3,2,11103,2208,8895,4447.5,736,4.028532609
NM_001288590,ZKSCAN7,6,5,16985,3479,13506,2701.2,579.8333333,3.882150043
NM_018651,ZKSCAN7,6,5,16985,3516,13469,2693.8,586,3.830773606
NM_001288591,ZKSCAN7,6,5,28291,1735,26556,5311.2,289.1666667,15.30605187
NM_025169,ZKSCAN7,6,5,28291,1772,26519,5303.8,295.3333333,14.96557562
NM_020696,KIAA1143,3,2,12939,5144,7795,3897.5,1714.666667,1.515357698
NM_033210,ZNF502,4,3,11190,3277,7913,2637.666667,819.25,2.414708575
NM_145044,ZNF501,3,2,7479,3092,4387,2193.5,1030.666667,1.418822768
NM_001134442,ZNF502,3,2,11190,3174,8016,4008,1058,2.525519849
NM_001134441,ZNF502,3,2,11190,3178,8012,4006,1059.333333,2.521082442
NM_001134440,ZNF502,4,3,11190,3273,7917,2639,818.25,2.41888176
NM_001258280,ZNF501,3,2,7479,3385,4094,2047,1128.333333,1.209453471
NM_001282880,ZNF502,5,4,11190,3397,7793,1948.25,679.4,2.294083014
NM_144638,TMEM42,3,2,3748,974,2774,1387,324.6666667,2.848049281
NM_003241,TGM4,14,13,39992,3013,36979,2844.538462,215.2142857,12.27314968
NM_015004,EXOSC7,8,7,35223,1044,34179,4882.714286,130.5,32.73850575
NM_003278,CLEC3B,3,2,9806,855,8951,4475.5,285,10.46900585
NM_178181,CDCP1,4,3,36208,1420,34788,11596,355,24.49859155
NM_022842,CDCP1,9,8,64150,6019,58131,7266.375,668.7777778,9.657916597
NM_015444,TMEM158,1,0,1860,1860,NA,NA,1860,NA
NM_014240,LIMD1,8,7,86434,6292,80142,11448.85714,786.5,12.73712651
NM_022405,SLC6A20,10,9,41096,5331,35765,3973.888889,533.1,6.708872632
NM_020208,SLC6A20,11,10,41096,5443,35653,3565.3,494.8181818,6.550248025
NM_031200,CCR9,3,2,16673,2570,14103,7051.5,856.6666667,5.487548638
NM_006564,CXCR6,2,1,4874,1955,2919,2919,977.5,1.493094629
NM_006641,CCR9,2,1,16673,2520,14153,14153,1260,5.616269841
NM_001256369,CCR9,4,3,16673,2657,14016,4672,664.25,5.275122318
NM_001024644,XCR1,2,1,6690,1253,5437,5437,626.5,4.339185954
NM_005283,XCR1,3,2,6690,1376,5314,2657,458.6666667,3.861918605
NM_001295,CCR1,2,1,6634,2678,3956,3956,1339,1.477221807
NM_001837,CCR3,3,2,24327,1799,22528,11264,599.6666667,12.52251251
NM_178329,CCR3,2,1,24327,1719,22608,22608,859.5,13.15183246
NM_001164680,CCR3,3,2,24327,1780,22547,11273.5,593.3333333,12.66685393
NM_178328,CCR3,3,2,24327,1789,22538,11269,596.3333333,12.5980995
NM_001100168,CCR5,3,2,6066,3429,2637,1318.5,1143,0.769028871
NM_001199149,LTF,17,16,27667,2525,25142,1571.375,148.5294118,9.957227723
NM_001130910,CCRL2,2,1,1967,1595,372,372,797.5,0.23322884
NM_002343,LTF,17,16,29138,2615,26523,1657.6875,153.8235294,10.14263862
NM_000579,CCR5,3,2,6066,3664,2402,1201,1221.333333,0.655567686
NM_003965,CCRL2,2,1,2295,1731,564,564,865.5,0.325823224
NM_024512,LRRC2,9,8,51164,5144,46020,5752.5,571.5555556,8.946345257
NM_031440,RTP3,2,1,2956,819,2137,2137,409.5,2.609279609
NM_001174136,TDGF1,6,5,7909,1779,6130,1226,296.5,3.445756043
NM_003212,TDGF1,6,5,4878,2169,2709,541.8,361.5,1.248962656
NM_001190707,ALS2CL,26,25,24663,5070,19593,783.72,195,3.864497041
NM_199183,PRSS45,4,3,2666,950,1716,572,237.5,1.806315789
NM_147196,TMIE,4,3,9592,1865,7727,2575.666667,466.25,4.143163539
NM_147129,ALS2CL,26,25,24711,4964,19747,789.88,190.9230769,3.978041902
NM_013270,PRSS50,6,5,5769,1353,4416,883.2,225.5,3.263858093
NM_001205271,PRSS46,4,3,16850,988,15862,5287.333333,247,16.05465587
NM_182775,ALS2CL,11,10,8416,3335,5081,508.1,303.1818182,1.523538231
NM_000258,MYL3,7,6,5618,936,4682,780.3333333,133.7142857,5.002136752
NM_182702,PRSS42,5,4,3693,887,2806,701.5,177.4,3.163472379
NM_001277074,CCDC12,7,6,55039,870,54169,9028.166667,124.2857143,62.26321839
NM_015175,NBEAL2,54,53,30023,8882,21141,398.8867925,164.4814815,2.380207161
NM_144716,CCDC12,8,7,60282,1026,59256,8465.142857,128.25,57.75438596
NM_025010,KLHL18,10,9,63978,4736,59242,6582.444444,473.6,12.50886824
NM_001031703,ELP6,7,6,18071,1356,16715,2785.833333,193.7142857,12.32669617
NM_012235,SCAP,23,22,62263,4278,57985,2635.681818,186,13.55423095
NM_001206944,CSPG5,4,3,16633,2086,14547,4849,521.5,6.973633749
NM_001206942,CSPG5,5,4,18004,2241,15763,3940.75,448.2,7.033913432
NM_001206943,CSPG5,5,4,16633,2244,14389,3597.25,448.8,6.412210339
NM_006574,CSPG5,5,4,16633,2163,14470,3617.5,432.6,6.689782709
NM_001206945,CSPG5,5,4,18004,2322,15682,3920.5,464.4,6.753660637
NM_138615,DHX30,22,21,47289,4109,43180,2056.190476,186.7727273,10.50863957
NM_014966,DHX30,23,22,47289,4139,43150,1961.363636,179.9565217,10.42522348
NM_201567,CDC25A,14,13,31135,3600,27535,2118.076923,257.1428571,7.648611111
NM_001789,CDC25A,15,14,31135,3721,27414,1958.142857,248.0666667,7.367374362
NM_005793,NME6,6,5,7261,1175,6086,1217.2,195.8333333,5.179574468
NM_016089,ZNF589,4,3,29885,3368,26517,8839,842,7.873218527
NM_004345,CAMP,4,3,2146,749,1397,465.6666667,187.25,1.865153538
NM_024661,CCDC51,4,3,7951,1510,6441,2147,377.5,4.265562914
NM_001159929,FBXW12,10,9,22483,1483,21000,2333.333333,148.3,14.1604855
NM_001159927,FBXW12,10,9,22483,1474,21009,2334.333333,147.4,14.25305292
NM_207102,FBXW12,11,10,22483,1658,20825,2082.5,150.7272727,12.56031363
NM_001256967,CCDC51,4,3,7951,1492,6459,2153,373,4.329088472
NM_001256966,CCDC51,4,3,7951,1497,6454,2151.333333,374.25,4.311289245
NM_001256965,CCDC51,4,3,7951,1602,6349,2116.333333,400.5,3.963171036
NM_001256964,CCDC51,4,3,7951,1618,6333,2111,404.5,3.914091471
NM_001256968,CCDC51,4,3,7951,1389,6562,2187.333333,347.25,4.724262059
NM_001256969,CCDC51,4,3,7951,1384,6567,2189,346,4.744942197
NM_015933,TMA7,4,3,3853,467,3386,1128.666667,116.75,7.250535332
NM_001130082,PLXNB1,38,37,26201,7181,19020,514.0540541,188.9736842,2.648656176
NM_002673,PLXNB1,38,37,25613,7348,18265,493.6486486,193.3684211,2.485710397
NM_001272065,SHISA5,6,5,32487,2172,30315,6063,362,13.95718232
NM_001272083,SHISA5,3,2,5547,2219,3328,1664,739.6666667,1.499774673
NM_001272082,SHISA5,4,3,5547,2046,3501,1167,511.5,1.711143695
NM_033199,UCN2,2,1,2052,1487,565,565,743.5,0.37995965
NM_001272067,SHISA5,6,5,33052,2354,30698,6139.6,392.3333333,13.04078165
NM_001272066,SHISA5,6,5,33064,2159,30905,6181,359.8333333,14.31449745
NM_007248,TREX1,2,1,2127,1630,497,497,815,0.304907975
NM_016381,TREX1,1,0,2127,2127,NA,NA,2127,NA
NM_033629,TREX1,2,1,2127,1808,319,319,904,0.176438053
NM_016479,SHISA5,6,5,32487,2193,30294,6058.8,365.5,13.81395349
NM_004567,PFKFB4,14,13,39112,3504,35608,2739.076923,250.2857143,10.16210046
NM_001272068,SHISA5,7,6,32288,2392,29896,4982.666667,341.7142857,12.49832776
NM_016453,NCKIPSD,13,12,12096,3013,9083,756.9166667,231.7692308,3.014603385
NM_001281732,SLC26A6,20,19,9772,2555,7217,379.8421053,127.75,2.824657534
NM_001190317,IP6K2,3,2,23829,2232,21597,10798.5,744,9.676075269
NM_001190316,IP6K2,3,2,23829,2309,21520,10760,769.6666667,9.320051971
NM_134263,SLC26A6,21,20,9772,2661,7111,355.55,126.7142857,2.672303645
NM_134426,SLC26A6,20,19,9772,2606,7166,377.1578947,130.3,2.749808135
NM_003365,UQCRC1,13,12,10668,1630,9038,753.1666667,125.3846154,5.544785276
NM_184231,NCKIPSD,13,12,12096,2992,9104,758.6666667,230.1538462,3.042780749
NM_001146179,IP6K2,4,3,23829,1312,22517,7505.666667,328,17.16234756
NM_001281733,SLC26A6,19,18,9772,2338,7434,413,123.0526316,3.179640719
NM_001146178,IP6K2,4,3,23829,1315,22514,7504.666667,328.75,17.12091255
NM_016291,IP6K2,6,5,29277,1809,27468,5493.6,301.5,15.1840796
NM_001407,CELSR3,35,34,26454,11997,14457,425.2058824,342.7714286,1.205051263
NM_001005911,IP6K2,3,2,23829,1244,22585,11292.5,414.6666667,18.15514469
NM_001005910,IP6K2,3,2,23829,1247,22582,11291,415.6666667,18.10906175
NM_001005909,IP6K2,6,5,29277,1806,27471,5494.2,301,15.21096346
NM_001040454,SLC26A6,20,19,8125,2751,5374,282.8421053,137.55,1.953471465
NM_022911,SLC26A6,21,20,9772,2664,7108,355.4,126.8571429,2.668168168
NM_001008269,TMEM89,2,1,916,482,434,434,241,0.900414938
NM_004157,PRKAR2A,11,10,97179,2392,94787,9478.7,217.4545455,39.62667224
NM_001123040,ARIH2OS,1,0,1599,1599,NA,NA,1599,NA
NM_000387,SLC25A20,9,8,42072,1901,40171,5021.375,211.2222222,21.13150973
NM_001276405,DALRD3,12,11,3122,1762,1360,123.6363636,146.8333333,0.77185017
NM_001272073,QARS,24,23,9199,2812,6387,277.6956522,117.1666667,2.271337127
NM_198880,QRICH1,10,9,64364,3265,61099,6788.777778,326.5,18.71332312
NM_001009996,DALRD3,12,11,3122,1788,1334,121.2727273,149,0.746085011
NM_199069,NDUFAF3,5,4,1854,1385,469,117.25,277,0.338628159
NM_017730,QRICH1,11,10,64364,3326,61038,6103.8,302.3636364,18.3517739
NM_018114,DALRD3,12,11,5585,1805,3780,343.6363636,150.4166667,2.094182825
NM_018031,WDR6,6,5,8751,4265,4486,897.2,710.8333333,1.051817116
NM_199074,NDUFAF3,5,4,3020,900,2120,530,180,2.355555556
NM_199073,NDUFAF3,5,4,2310,1019,1291,322.75,203.8,1.266928361
NM_199070,NDUFAF3,5,4,1854,948,906,226.5,189.6,0.955696203
NM_000884,IMPDH2,14,13,5115,1705,3410,262.3076923,121.7857143,2
NM_005051,QARS,24,23,9199,2845,6354,276.2608696,118.5416667,2.233391916
NM_177939,P4HTM,9,8,17242,2108,15134,1891.75,234.2222222,7.179316888
NM_177938,P4HTM,9,8,17242,2291,14951,1868.875,254.5555556,6.525971192
NM_022903,CCDC71,2,1,3819,1814,2005,2005,907,1.105292172
NM_002292,LAMB2,32,31,12054,5840,6214,200.4516129,182.5,1.064041096
NM_001080528,C3orf84,4,3,14224,706,13518,4506,176.5,19.14730878
NM_173546,KLHDC8B,6,5,4903,1991,2912,582.4,331.8333333,1.462581617
NM_199443,USP4,21,20,62961,4000,58961,2948.05,190.4761905,14.74025
NM_198562,C3orf62,3,2,8480,3593,4887,2443.5,1197.666667,1.360144726
NM_003363,USP4,22,21,62961,4142,58819,2800.904762,188.2727273,14.20062772
NM_201397,GPX1,1,0,1184,1184,NA,NA,1184,NA
NM_000581,GPX1,2,1,1184,906,278,278,453,0.306843267
NM_001251877,USP4,7,6,28320,1610,26710,4451.666667,230,16.59006211
NM_000481,AMT,9,8,5902,2211,3691,461.375,245.6666667,1.669380371
NM_022171,TCTA,3,2,4272,2150,2122,1061,716.6666667,0.986976744
NM_032316,NICN1,6,5,6993,3233,3760,752,538.8333333,1.163006496
NM_001164712,AMT,10,9,5902,1965,3937,437.4444444,196.5,2.003562341
NM_001164711,AMT,8,7,5902,2042,3860,551.4285714,255.25,1.890303624
NM_001164710,AMT,8,7,5902,2078,3824,546.2857143,259.75,1.840230991
NM_198722,AMIGO3,1,0,2973,2973,NA,NA,2973,NA
NM_020998,MST1,18,17,4818,2349,2469,145.2352941,130.5,1.051085568
NM_022064,RNF123,39,38,32014,4334,27680,728.4210526,111.1282051,6.386709737
NM_013334,GMPPB,8,7,2500,1696,804,114.8571429,212,0.474056604
NM_001640,APEH,22,21,9501,2780,6721,320.047619,126.3636364,2.417625899
NM_021971,GMPPB,9,8,2500,1616,884,110.5,179.5555556,0.547029703
NM_203370,FAM212A,2,1,1778,1042,736,736,521,0.706333973
NM_005879,TRAIP,15,14,27966,2039,25927,1851.928571,135.9333333,12.71554684
NM_003335,UBA7,24,23,8755,3337,5418,235.5652174,139.0416667,1.623614025
NM_024046,CAMKV,11,10,11949,3039,8910,891,276.2727273,2.931885489
NM_001007540,CDHR4,19,18,9089,2493,6596,366.4444444,131.2105263,2.645808263
NM_032355,MON1A,6,5,21145,2236,18909,3781.8,372.6666667,8.456618962
NM_001142501,MON1A,5,4,21145,1749,19396,4849,349.8,11.08976558
NM_005778,RBM5,25,24,30058,3156,26902,1120.916667,126.24,8.524081115
NM_006841,SLC38A3,16,15,15716,2469,13247,883.1333333,154.3125,5.365330093
NM_001282619,GNAI2,10,9,32668,2601,30067,3340.777778,260.1,11.5597847
NM_144499,GNAT1,9,8,6088,3608,2480,310,400.8888889,0.687361419
NM_001166425,GNAI2,9,8,12462,2152,10310,1288.75,239.1111111,4.790892193
NM_000172,GNAT1,9,8,6088,2474,3614,451.75,274.8888889,1.460792239
NM_006764,IFRD2,12,11,4865,2121,2744,249.4545455,176.75,1.293729373
NM_002070,GNAI2,9,8,23199,2267,20932,2616.5,251.8888889,9.233348037
NM_001282620,GNAI2,9,8,32668,2476,30192,3774,275.1111111,12.19386107
NM_001282618,GNAI2,8,7,23199,2223,20976,2996.571429,277.875,9.435897436
NM_001282617,GNAI2,9,8,28580,2193,26387,3298.375,243.6666667,12.03237574
NM_001005914,SEMA3B,18,17,9534,2941,6593,387.8235294,163.3888889,2.241754505
NM_004636,SEMA3B,18,17,9534,2944,6590,387.6470588,163.5555556,2.238451087
NM_153215,LSMEM2,4,3,9029,1438,7591,2530.333333,359.5,5.278859527
NM_015896,ZMYND10,12,11,4621,1785,2836,257.8181818,148.75,1.588795518
NM_007024,TMEM115,2,1,4761,2097,2664,2664,1048.5,1.270386266
NM_007182,RASSF1,6,5,11152,1955,9197,1839.4,325.8333333,4.704347826
NM_007275,TUSC2,3,2,3329,1685,1644,822,561.6666667,0.975667656
NM_007022,CYB561D2,4,3,3201,1204,1997,665.6666667,301,1.658637874
NM_006545,NPRL2,11,10,3569,1675,1894,189.4,152.2727273,1.130746269
NM_001200016,NAT6,2,1,3021,1482,1539,1539,741,1.038461538
NM_001200018,NAT6,2,1,2489,1197,1292,1292,598.5,1.079365079
NM_012191,NAT6,2,1,3021,1337,1684,1684,668.5,1.259536275
NM_003773,HYAL2,4,3,5062,2009,3053,1017.666667,502.25,1.519661523
NM_033158,HYAL2,5,4,5062,2418,2644,661,483.6,1.093465674
NM_033159,HYAL1,4,3,3714,2066,1648,549.3333333,516.5,0.79767667
NM_001206957,RASSF1,5,4,11152,1847,9305,2326.25,369.4,5.037899296
NM_170714,RASSF1,6,5,11152,1967,9185,1837,327.8333333,4.669547534
NM_170713,RASSF1,5,4,7680,1758,5922,1480.5,351.6,3.368600683
NM_170712,RASSF1,6,5,8449,1665,6784,1356.8,277.5,4.074474474
NM_153285,HYAL1,4,3,3714,1291,2423,807.6666667,322.75,1.876839659
NM_153283,HYAL1,4,3,3714,1709,2005,668.3333333,427.25,1.173200702
NM_153282,HYAL1,3,2,3714,1975,1739,869.5,658.3333333,0.880506329
NM_153281,HYAL1,6,5,12494,2335,10159,2031.8,389.1666667,4.350749465
NM_016210,C3orf18,6,5,9769,2708,7061,1412.2,451.3333333,2.60745938
NM_016173,HEMK1,11,10,15514,5872,9642,964.2,533.8181818,1.642029973
NM_145071,CISH,3,2,5379,2114,3265,1632.5,704.6666667,1.544465468
NM_013324,CISH,4,3,5379,2272,3107,1035.666667,568,1.367517606
NM_001243926,MAPKAPK3,13,12,37437,3055,34382,2865.166667,235,11.25433715
NM_001243925,MAPKAPK3,11,10,32168,2574,29594,2959.4,234,11.4972805
NM_001171743,C3orf18,5,4,9769,2397,7372,1843,479.4,3.075511055
NM_001171741,C3orf18,5,4,13004,2413,10591,2647.75,482.6,4.389142147
NM_001171740,C3orf18,5,4,9769,2618,7151,1787.75,523.6,2.731474408
NM_004635,MAPKAPK3,11,10,32168,2559,29609,2960.9,232.6363636,11.57053537
NM_006010,MANF,4,3,4138,943,3195,1065,235.75,3.388123012
NM_013286,RBM15B,1,0,6639,6639,NA,NA,6639,NA
NM_015926,TEX264,5,4,33150,1402,31748,7937,280.4,22.64479315
NM_001278195,TEX264,6,5,33150,1495,31655,6331,249.1666667,21.17391304
NM_001130063,GRM2,4,3,11546,1935,9611,3203.666667,483.75,4.966925065
NM_001243726,TEX264,5,4,33051,1346,31705,7926.25,269.2,23.55497771
NM_001243725,TEX264,5,4,33051,1562,31489,7872.25,312.4,20.15941101
NM_001243727,TEX264,4,3,33150,1179,31971,10657,294.75,27.11704835
NM_001129884,TEX264,6,5,33150,1455,31695,6339,242.5,21.78350515
NM_000839,GRM2,6,5,11546,3361,8185,1637,560.1666667,2.435287117
NM_203424,IQCF2,3,2,1797,590,1207,603.5,196.6666667,2.045762712
NM_001207023,IQCF3,7,6,3977,1275,2702,450.3333333,182.1428571,2.119215686
NM_001085479,IQCF3,7,6,3977,1308,2669,444.8333333,186.8571429,2.040519878
NM_001143833,IQCF6,2,1,628,448,180,180,224,0.401785714
NM_001146314,ABHD14B,4,3,6122,2247,3875,1291.666667,561.75,1.724521584
NM_005485,PARP3,11,10,6524,2371,4153,415.3,215.5454545,1.751581611
NM_001198896,ACY1,13,12,5920,1475,4445,370.4166667,113.4615385,3.013559322
NM_001198895,ACY1,15,14,5920,1688,4232,302.2857143,112.5333333,2.507109005
NM_015407,ABHD14A,5,4,6176,1113,5063,1265.75,222.6,4.548966757
NM_020418,PCBP4,13,12,9982,1959,8023,668.5833333,150.6923077,4.095456866
NM_032750,ABHD14B,4,3,6122,2441,3681,1227,610.25,1.507988529
NM_000666,ACY1,15,14,5920,1693,4227,301.9285714,112.8666667,2.496751329
NM_001198897,ACY1,13,12,5920,1496,4424,368.6666667,115.0769231,2.957219251
NM_033008,PCBP4,13,12,10014,2037,7977,664.75,156.6923077,3.916053019
NM_033010,PCBP4,13,12,5440,1979,3461,288.4166667,152.2307692,1.748863062
NM_001174100,PCBP4,14,13,10014,2186,7828,602.1538462,156.1428571,3.580969808
NM_001198898,ACY1,14,13,5920,1587,4333,333.3076923,113.3571429,2.730308759
NM_000992,RPL29,4,3,2316,699,1617,539,174.75,2.313304721
NM_001254753,ABHD14B,3,2,6122,2007,4115,2057.5,669,2.050323866
NM_080865,GPR62,1,0,2192,2192,NA,NA,2192,NA
NM_001145059,IQCF5,2,1,1865,514,1351,1351,257,2.628404669
NM_004704,RRP9,15,14,8517,1597,6920,494.2857143,106.4666667,4.333124609
NM_001003931,PARP3,11,10,6524,2366,4158,415.8,215.0909091,1.75739645
NM_152397,IQCF1,4,3,8496,734,7762,2587.333333,183.5,10.57493188
NM_001947,DUSP7,3,2,7526,3236,4290,2145,1078.666667,1.325710754
NM_199166,ALAS1,11,10,16246,2286,13960,1396,207.8181818,6.106736658
NM_007284,TWF2,9,8,10559,1634,8925,1115.625,181.5555556,5.462056304
NM_144641,PPM1M,10,9,4808,2207,2601,289,220.7,1.178522882
NM_000688,ALAS1,12,11,16246,2464,13782,1252.909091,205.3333333,5.593344156
NM_017442,TLR9,2,1,5085,3872,1213,1213,1936,0.313274793
NM_001122870,PPM1M,9,8,4431,1840,2591,323.875,204.4444444,1.408152174
NM_145262,GLYCTK,5,4,7438,3803,3635,908.75,760.6,0.955824349
NM_001144951,GLYCTK,4,3,5187,1375,3812,1270.666667,343.75,2.772363636
NM_020163,SEMA3G,16,15,11777,4716,7061,470.7333333,294.75,1.497243427
NM_001276294,NISCH,14,13,26404,2708,23696,1822.769231,193.4285714,8.750369276
NM_001276293,NISCH,13,12,26404,3290,23114,1926.166667,253.0769231,7.025531915
NM_007184,NISCH,21,20,37566,5260,32306,1615.3,250.4761905,6.141825095
NM_001278221,PHF7,9,8,10832,1431,9401,1175.125,159,6.569531796
NM_015136,STAB1,69,68,29157,7995,21162,311.2058824,115.8695652,2.646904315
NM_016483,PHF7,11,10,13082,2237,10845,1084.5,203.3636364,4.848010729
NM_004656,BAP1,17,16,9103,3718,5385,336.5625,218.7058824,1.448359333
NM_003280,TNNC1,6,5,2952,702,2250,450,117,3.205128205
NM_001124767,SMIM4,2,1,3967,451,3516,3516,225.5,7.796008869
NM_014041,SPCS1,4,3,2342,1088,1254,418,272,1.152573529
NM_001278280,GLT8D1,11,10,11601,2386,9215,921.5,216.9090909,3.862112322
NM_206825,GNL3,15,14,8576,2154,6422,458.7142857,143.6,2.981429898
NM_206826,GNL3,15,14,8576,2007,6569,469.2142857,133.8,3.273044345
NM_001010983,GLT8D1,11,10,11601,2390,9211,921.1,217.2727273,3.853974895
NM_152932,GLT8D1,10,9,9216,1718,7498,833.1111111,171.8,4.364377183
NM_003157,NEK4,16,15,60171,3742,56429,3761.933333,233.875,15.07990379
NM_018446,GLT8D1,10,9,11601,2160,9441,1049,216,4.370833333
NM_001278281,GLT8D1,11,10,11601,2134,9467,946.7,194,4.436269916
NM_014366,GNL3,15,14,8576,2057,6519,465.6428571,137.1333333,3.169178415
NM_001193533,NEK4,15,14,60171,3474,56697,4049.785714,231.6,16.32037997
NM_002218,ITIH4,24,23,17713,3307,14406,626.3478261,137.7916667,4.356214091
NM_002217,ITIH3,22,21,14243,3059,11184,532.5714286,139.0454545,3.656096764
NM_198563,TMEM110,9,8,60827,4745,56082,7010.25,527.2222222,11.81917808
NM_205853,MUSTN1,3,2,2106,732,1374,687,244,1.87704918
NM_001198974,TMEM110-MUSTN1,10,9,64468,1469,62999,6999.888889,146.9,42.88563649
NM_001166449,ITIH4,22,21,17713,3215,14498,690.3809524,146.1363636,4.509486781
NM_052859,RFT1,13,12,41971,5111,36860,3071.666667,393.1538462,7.211895911
NM_001135055,TKT,15,14,31409,2967,28442,2031.571429,197.8,9.58611392
NM_001064,TKT,14,13,30479,2177,28302,2177.076923,155.5,13.00045935
NM_001258028,TKT,15,14,30479,2202,28277,2019.785714,146.8,12.84150772
NM_021237,SELK,5,4,6765,823,5942,1485.5,164.6,7.219927096
NM_018725,IL17RB,11,10,19252,2051,17201,1720.1,186.4545455,8.386640663
NM_022899,ACTR8,13,12,15137,3641,11496,958,280.0769231,3.157374348
NM_020678,LRTM1,3,2,9693,1280,8413,4206.5,426.6666667,6.57265625
NM_001256105,WNT5A,5,4,15685,5587,10098,2524.5,1117.4,1.807410059
NM_003392,WNT5A,5,4,21929,6182,15747,3936.75,1236.4,2.547233905
NM_015224,FAM208A,17,16,43916,7264,36652,2290.75,427.2941176,5.045704846
NM_001112736,FAM208A,24,23,62977,8320,54657,2376.391304,346.6666667,6.569350962
NM_019555,ARHGEF3,10,9,74551,3612,70939,7882.111111,361.2,19.63981174
NM_001128616,ARHGEF3,10,9,48301,4065,44236,4915.111111,406.5,10.88216482
NM_181727,SPATA12,2,1,14993,2415,12578,12578,1207.5,5.208281573
NM_003865,HESX1,4,3,2338,1177,1161,387,294.25,0.986406117
NM_001142733,ASB14,11,10,24333,3186,21147,2114.7,289.6363636,6.63747646
NM_130387,ASB14,4,3,10603,2203,8400,2800,550.75,3.812982297
NM_198564,DNAH12,12,11,46342,2063,44279,4025.363636,171.9166667,21.46340281
NM_001660,ARF4,6,5,26127,1746,24381,4876.2,291,13.96391753
NM_177966,PDE12,3,2,5789,3996,1793,896.5,1332,0.448698699
NM_020676,ABHD6,9,8,57204,2402,54802,6850.25,266.8888889,22.81515404
NM_007042,RPP14,6,5,13950,3272,10678,2135.6,545.3333333,3.263447433
NM_001098783,RPP14,6,5,13950,3506,10444,2088.8,584.3333333,2.978893326
NM_000925,PDHB,10,9,6224,1537,4687,520.7777778,153.7,3.049446975
NM_001173468,PDHB,11,10,6224,1484,4740,474,134.9090909,3.194070081
NM_007177,FAM107A,5,4,13654,3475,10179,2544.75,695,2.929208633
NM_003500,ACOX2,15,14,32068,2324,29744,2124.571429,154.9333333,12.79862306
NM_001128214,KCTD6,3,2,10266,1562,8704,4352,520.6666667,5.57234315
NM_153331,KCTD6,2,1,3997,1835,2162,2162,917.5,1.178201635
NM_001076778,FAM107A,4,3,13654,3376,10278,3426,844,3.04443128
NM_001282713,FAM107A,4,3,23003,3176,19827,6609,794,6.242758186
NM_138805,FAM3D,10,9,32893,1318,31575,3508.333333,131.8,23.95675266
NM_020685,C3orf14,5,4,13926,772,13154,3288.5,154.4,17.0388601
NM_018008,FEZF2,5,4,3845,2091,1754,438.5,418.2,0.838833094
NM_001080537,SNTN,4,3,12549,1588,10961,3653.666667,397,6.902392947
NM_001271780,PSMD6,8,7,13463,1358,12105,1729.285714,169.75,8.913843888
NM_001271779,PSMD6,9,8,13059,1644,11415,1426.875,182.6666667,6.943430657
NM_014814,PSMD6,8,7,13059,1484,11575,1653.571429,185.5,7.799865229
NM_001271781,PSMD6,8,7,12925,1233,11692,1670.285714,154.125,9.482562855
NM_032505,KBTBD8,4,3,12907,4686,8221,2740.333333,1171.5,1.754374733
NM_001278689,EOGT,18,17,38684,4684,34000,2000,260.2222222,7.258753202
NM_173654,EOGT,15,14,38684,4429,34255,2446.785714,295.2666667,7.734251524
NM_006407,ARL6IP5,3,2,21151,2131,19020,9510,710.3333333,8.925387142
NM_198271,LMOD3,3,2,15709,4102,11607,5803.5,1367.333333,2.829595319
NM_198195,UBA3,17,16,25645,2094,23551,1471.9375,123.1764706,11.24689589
NM_003968,UBA3,18,17,25645,2137,23508,1382.823529,118.7222222,11.00046795
NM_001184968,MITF,3,2,2467,1101,1366,683,367,1.240690282
NM_001134649,EIF4E3,8,7,75096,6217,68879,9839.857143,777.125,11.07913785
NM_018971,GPR27,1,0,1129,1129,NA,NA,1129,NA
NM_001134651,EIF4E3,7,6,46088,6083,40005,6667.5,869,6.576524741
NM_001134650,EIF4E3,8,7,49831,6093,43738,6248.285714,761.625,7.178401444
NM_173359,EIF4E3,8,7,75486,6178,69308,9901.142857,772.25,11.21851732
NM_001282886,EIF4E3,8,7,74337,6210,68127,9732.428571,776.25,10.9705314
NM_018029,EBLN2,1,0,1663,1663,NA,NA,1663,NA
NM_174907,PPP4R2,9,8,68894,1471,67423,8427.875,163.4444444,45.83480625
NM_001124759,FRG2C,4,3,2883,2073,810,270,518.25,0.390738061
NM_001128223,ZNF717,5,4,48228,3073,45155,11288.75,614.6,14.69410999
NM_001122757,POU1F1,6,5,16956,1346,15610,3122,224.3333333,11.59732541
NM_000306,POU1F1,6,5,16956,1268,15688,3137.6,211.3333333,12.37223975
NM_000866,HTR1F,2,1,11195,3180,8015,8015,1590,2.520440252
NM_003663,CGGBP1,3,2,7048,4440,2608,1304,1480,0.587387387
NM_018293,ZNF654,2,1,5554,4959,595,595,2479.5,0.119983868
NM_001195308,CGGBP1,4,3,97918,4524,93394,31131.33333,1131,20.64412025
NM_173824,C3orf38,3,2,8224,2633,5591,2795.5,877.6666667,2.123433346
NM_001008390,CGGBP1,4,3,7048,4543,2505,835,1135.75,0.551397755
NM_000313,PROS1,15,14,101055,3595,97460,6961.428571,239.6666667,27.10987483
NM_001195643,DHFRL1,2,1,5303,4042,1261,1261,2021,0.31197427
NM_022072,NSUN3,6,5,63777,1441,62336,12467.2,240.1666667,43.25884802
NM_176815,DHFRL1,2,1,5067,3929,1138,1138,1964.5,0.28964113
NM_001001850,STX19,2,1,14241,1158,13083,13083,579,11.29792746
NM_001278293,ARL6,8,7,34016,1539,32477,4639.571429,192.375,21.10266407
NM_032146,ARL6,9,8,34016,1639,32377,4047.125,182.1111111,19.75411836
NM_177976,ARL6,9,8,34016,1599,32417,4052.125,177.6666667,20.27329581
NM_001042533,MINA,10,9,30636,5352,25284,2809.333333,535.2,4.724215247
NM_001261829,MINA,10,9,30636,4882,25754,2861.555556,488.2,5.275297009
NM_032778,MINA,10,9,30636,5349,25287,2809.666667,534.9,4.727425687
NM_153182,MINA,10,9,30636,4885,25751,2861.222222,488.5,5.271443193
NM_001105580,GABRR3,10,9,48623,1531,47092,5232.444444,153.1,30.75898106
NM_001005515,OR5H15,1,0,943,943,NA,NA,943,NA
NM_054106,OR5AC2,1,0,931,931,NA,NA,931,NA
NM_001005338,OR5H1,1,0,943,943,NA,NA,943,NA
NM_001005514,OR5H14,1,0,934,934,NA,NA,934,NA
NM_001005479,OR5H6,1,0,979,979,NA,NA,979,NA
NM_001005482,OR5H2,1,0,946,946,NA,NA,946,NA
NM_001005517,OR5K4,1,0,967,967,NA,NA,967,NA
NM_001005516,OR5K3,1,0,967,967,NA,NA,967,NA
NM_001040181,CLDND1,5,4,7595,2189,5406,1351.5,437.8,2.469620831
NM_019895,CLDND1,6,5,7595,2241,5354,1070.8,373.5,2.389112004
NM_001040199,CLDND1,5,4,7595,2496,5099,1274.75,499.2,2.04286859
NM_001040200,CLDND1,4,3,7595,1878,5717,1905.666667,469.5,3.044195953
NM_001040183,CLDND1,5,4,7595,2184,5411,1352.75,436.8,2.477564103
NM_001040182,CLDND1,6,5,7595,2234,5361,1072.2,372.3333333,2.399731423
NM_005290,GPR15,1,0,1253,1253,NA,NA,1253,NA
NM_001004737,OR5K2,1,0,952,952,NA,NA,952,NA
NM_001004736,OR5K1,1,0,953,953,NA,NA,953,NA
NM_006100,ST3GAL6,11,10,63143,3582,59561,5956.1,325.6363636,16.62786153
NM_001271147,ST3GAL6,10,9,63611,3372,60239,6693.222222,337.2,17.86447212
NM_001271146,ST3GAL6,10,9,63611,3398,60213,6690.333333,339.8,17.72012949
NM_001271145,ST3GAL6,10,9,63143,3409,59734,6637.111111,340.9,17.5224406
NM_001271142,ST3GAL6,11,10,63611,3469,60142,6014.2,315.3636364,17.33698472
NM_001271148,ST3GAL6,7,6,63611,3153,60458,10076.33333,450.4285714,19.1747542
NM_001282793,FILIP1L,4,3,43061,2525,40536,13512,631.25,16.05386139
NM_001282794,FILIP1L,3,2,43061,3029,40032,20016,1009.666667,13.21624298
NM_014890,FILIP1L,2,1,28282,3282,25000,25000,1641,7.61730652
NM_020202,NIT2,10,9,20918,1281,19637,2181.888889,128.1,15.32943013
NM_014820,TOMM70A,12,11,37941,4393,33548,3049.818182,366.0833333,7.636694742
NM_001195478,TFG,8,7,39427,1737,37690,5384.285714,217.125,21.69833045
NM_006070,TFG,8,7,39638,2081,37557,5365.285714,260.125,18.04757328
NM_001195479,TFG,8,7,39638,2069,37569,5367,258.625,18.15804737
NM_001007565,TFG,8,7,39679,1832,37847,5406.714286,229,20.65884279
NM_016247,IMPG2,19,18,98031,8371,89660,4981.111111,440.5789474,10.71078724
NM_017819,TRMT10C,2,1,4612,1847,2765,2765,923.5,1.497022198
NM_020357,PCNP,5,4,20241,2244,17997,4499.25,448.8,8.020053476
NM_014415,ZBTB11,11,10,27707,5130,22577,2257.7,466.3636364,4.400974659
NM_000986,RPL24,6,5,5631,568,5063,1012.6,94.66666667,8.913732394
NM_001005474,NFKBIZ,13,12,33037,3806,29231,2435.916667,292.7692308,7.680241724
NM_031419,NFKBIZ,12,11,11513,3938,7575,688.6363636,328.1666667,1.923565262
NM_145037,NXPE3,8,7,49048,8602,40446,5778,1075.25,4.701929784
NM_001134456,NXPE3,8,7,48791,8921,39870,5695.714286,1115.125,4.469229907
NM_175056,ZPLD1,11,10,44828,3630,41198,4119.8,330,11.34931129
NM_032600,CCDC54,1,0,1295,1295,NA,NA,1295,NA
NM_198793,CD47,9,8,47996,5297,42699,5337.375,588.5555556,8.060977912
NM_001777,CD47,11,10,47996,5357,42639,4263.9,487,7.959492253
NM_018010,IFT57,11,10,61760,3214,58546,5854.6,292.1818182,18.2159303
NM_001282557,HHLA2,10,9,66501,2415,64086,7120.666667,241.5,26.53664596
NM_007072,HHLA2,10,9,75801,2675,73126,8125.111111,267.5,27.33682243
NM_001282559,HHLA2,11,10,81796,2301,79495,7949.5,209.1818182,34.5480226
NM_001282556,HHLA2,10,9,81796,2484,79312,8812.444444,248.4,31.92914654
NM_001282558,HHLA2,10,9,81796,2511,79285,8809.444444,251.1,31.57506969
NM_020890,KIAA1524,21,20,39775,4286,35489,1774.45,204.0952381,8.280214652
NM_032579,RETNLB,3,2,1646,576,1070,535,192,1.857638889
NM_016388,TRAT1,6,5,32085,1701,30384,6076.8,283.5,17.86243386
NM_138815,DPPA2,9,8,22731,1392,21339,2667.375,154.6666667,15.32974138
NM_015480,PVRL3,6,5,65803,5260,60543,12108.6,876.6666667,11.51007605
NM_001243286,PVRL3,6,5,65803,5234,60569,12113.8,872.3333333,11.5722201
NM_024508,ZBED2,2,1,2437,2205,232,232,1102.5,0.10521542
NM_013259,TAGLN3,5,4,15151,1494,13657,3414.25,298.8,9.141231593
NM_001042575,TMPRSS7,16,15,41653,2525,39128,2608.533333,157.8125,15.49623762
NM_018394,ABHD10,5,4,14494,2759,11735,2933.75,551.8,4.253352664
NM_001008273,TAGLN3,4,3,14730,1204,13526,4508.666667,301,11.23421927
NM_001008272,TAGLN3,5,4,15151,1320,13831,3457.75,264,10.4780303
NM_001272069,ABHD10,6,5,14494,2812,11682,2336.4,468.6666667,4.154338549
NM_024616,C3orf52,6,5,31864,2284,29580,5916,380.6666667,12.95096322
NM_001190260,GCSAM,5,4,12466,3296,9170,2292.5,659.2,2.782160194
NM_001190259,GCSAM,6,5,12466,3348,9118,1823.6,558,2.723416965
NM_001171747,C3orf52,4,3,31893,2058,29835,9945,514.5,14.49708455
NM_152785,GCSAM,6,5,12466,3342,9124,1824.8,557,2.730101735
NM_001278712,ATG3,11,10,29458,3071,26387,2638.7,279.1818182,8.592315207
NM_022488,ATG3,12,11,29458,1584,27874,2534,132,17.59722222
NM_017945,SLC35A5,7,6,22429,3266,19163,3193.833333,466.5714286,5.867421923
NM_001008784,CD200R1L,6,5,30243,1302,28941,5788.2,217,22.2281106
NM_001199215,CD200R1L,7,6,30243,1372,28871,4811.833333,196,21.04300292
NM_138940,CD200R1,3,2,46174,959,45215,22607.5,319.6666667,47.14807091
NM_138939,CD200R1,4,3,46174,1029,45145,15048.33333,257.25,43.87269193
NM_014170,GTPBP8,6,5,10423,1363,9060,1812,227.1666667,6.647101981
NM_138806,CD200R1,8,7,52407,2280,50127,7161,285,21.98552632
NM_138485,GTPBP8,5,4,10423,1263,9160,2290,252.6,7.252573238
NM_170780,CD200R1,7,6,52407,2210,50197,8366.166667,315.7142857,22.71357466
NM_144718,SPICE1,18,17,72471,5466,67005,3941.470588,303.6666667,12.25850714
NM_017699,SIDT1,25,24,97206,5027,92179,3840.791667,201.08,18.33678138
NM_025146,NAA50,5,4,29815,6139,23676,5919,1227.8,3.856654178
NM_173570,ZDHHC23,6,5,15081,3782,11299,2259.8,630.3333333,2.987572713
NM_033663,DRD3,8,7,50344,1549,48795,6970.714286,193.625,31.50096837
NM_024638,QTRTD1,10,9,31688,4034,27654,3072.666667,403.4,6.85523054
NM_000796,DRD3,7,6,50344,1647,48697,8116.166667,235.2857143,29.56709168
NM_001256837,QTRTD1,8,7,31688,3668,28020,4002.857143,458.5,7.639040349
NM_001256836,QTRTD1,6,5,31688,3568,28120,5624,594.6666667,7.881165919
NM_001256835,QTRTD1,9,8,31688,3925,27763,3470.375,436.1111111,7.073375796
NM_007136,ZNF80,1,0,2947,2947,NA,NA,2947,NA
NM_173799,TIGIT,4,3,16304,2972,13332,4444,743,4.485868102
NM_001164342,ZBTB20,5,4,45544,3316,42228,10557,663.2,12.73462002
NM_152539,C3orf30,3,2,5307,1817,3490,1745,605.6666667,1.920748487
NM_212543,B4GALT4,9,8,29165,2353,26812,3351.5,261.4444444,11.39481513
NM_006952,UPK1B,8,7,31577,2066,29511,4215.857143,258.25,14.28412391
NM_003778,B4GALT4,8,7,29165,2269,26896,3842.285714,283.625,11.85368004
NM_152305,POGLUT1,11,10,25771,3543,22228,2222.8,322.0909091,6.273779283
NM_016589,TIMMDC1,7,6,25759,1600,24159,4026.5,228.5714286,15.099375
NM_018266,TMEM39A,9,8,34724,4918,29806,3725.75,546.4444444,6.060593737
NM_001206960,PLA1A,11,10,31965,1743,30222,3022.2,158.4545455,17.33907057
NM_005694,COX17,3,2,7873,426,7447,3723.5,142,17.48122066
NM_001125,ADPRH,5,4,10271,3444,6827,1706.75,688.8,1.982288037
NM_015900,PLA1A,11,10,31965,1791,30174,3017.4,162.8181818,16.84757119
NM_022135,POPDC2,4,3,18498,1648,16850,5616.666667,412,10.22451456
NM_001206961,PLA1A,10,9,31965,1588,30377,3375.222222,158.8,19.1290932
NM_022002,NR1I2,9,8,35777,2752,33025,4128.125,305.7777778,12.00036337
NM_033013,NR1I2,9,8,38003,4315,33688,4211,479.4444444,7.807184241
NM_033364,MAATS1,18,17,64082,4451,59631,3507.705882,247.2777778,13.39721411
NM_003889,NR1I2,9,8,38003,4426,33577,4197.125,491.7777778,7.586308179
NM_007085,FSTL1,11,10,56859,3851,53008,5300.8,350.0909091,13.76473643
NM_001168331,NDUFB4,2,1,6132,1562,4570,4570,781,2.925736236
NM_004547,NDUFB4,3,2,6132,613,5519,2759.5,204.3333333,9.003262643
NM_000187,HGD,14,13,54405,2024,52381,4029.307692,144.5714286,25.87994071
NM_005513,GTF2E1,5,4,40360,3038,37322,9330.5,607.6,12.28505596
NM_016298,FBXO40,4,3,36971,5726,31245,10415,1431.5,5.456688788
NM_001012659,ARGFX,5,4,22693,5070,17623,4405.75,1014,3.475936884
NM_001256486,GOLGB1,22,21,86570,11251,75319,3586.619048,511.4090909,6.694427162
NM_001256487,GOLGB1,22,21,86570,11264,75306,3586,512,6.685546875
NM_004487,GOLGB1,22,21,86570,11221,75349,3588.047619,510.0454545,6.714998663
NM_001256488,GOLGB1,21,20,86570,11140,75430,3771.5,530.4761905,6.771095153
NM_018456,EAF2,6,5,51341,1026,50315,10063,171,49.03996101
NM_001199800,ILDR1,6,5,34959,2627,32332,6466.4,437.8333333,12.30757518
NM_001199799,ILDR1,8,7,34959,2896,32063,4580.428571,362,11.0714779
NM_175924,ILDR1,7,6,34959,2763,32196,5366,394.7142857,11.65255157
NM_006889,CD86,7,6,43294,2787,40507,6751.166667,398.1428571,14.53426624
NM_001206924,CD86,6,5,65781,2395,63386,12677.2,399.1666667,26.46597077
NM_001206925,CD86,6,5,65781,2681,63100,12620,446.8333333,23.53599403
NM_176892,CD86,6,5,43294,2642,40652,8130.4,440.3333333,15.38682816
NM_175862,CD86,7,6,65781,2732,63049,10508.16667,390.2857143,23.07796486
NM_001178065,CASR,7,6,102165,5018,97147,16191.16667,716.8571429,19.35970506
NM_000388,CASR,7,6,102816,4922,97894,16315.66667,703.1428571,19.88906948
NM_001017928,CCDC58,5,4,23640,723,22917,5729.25,144.6,31.69709544
NM_005213,CSTA,3,2,16806,830,15976,7988,276.6666667,19.24819277
NM_014367,FAM162A,5,4,25940,843,25097,6274.25,168.6,29.77105575
NM_019069,WDR5B,1,0,4184,4184,NA,NA,4184,NA
NM_001146106,PARP9,10,9,32576,6811,25765,2862.777778,681.1,3.78285127
NM_001146105,PARP9,11,10,36389,3067,33322,3332.2,278.8181818,10.86468862
NM_001146104,PARP9,11,10,36436,3248,33188,3318.8,295.2727273,10.2179803
NM_001146103,PARP9,11,10,36765,3249,33516,3351.6,295.3636364,10.31578947
NM_001146102,PARP9,11,10,36389,3172,33217,3321.7,288.3636364,10.47194199
NM_031458,PARP9,11,10,36765,3354,33411,3341.1,304.9090909,9.961538462
NM_001113523,PARP15,12,11,59089,2704,56385,5125.909091,225.3333333,20.85244083
NM_152615,PARP15,8,7,21013,1964,19049,2721.285714,245.5,9.699083503
NM_024610,HSPBAP1,8,7,53824,1962,51862,7408.857143,245.25,26.4332314
NM_198402,PTPLB,7,6,90563,1194,89369,14894.83333,170.5714286,74.84840871
NM_017578,ROPN1,7,6,22322,1110,21212,3535.333333,158.5714286,19.10990991
NM_022757,CCDC14,12,11,47983,4194,43789,3980.818182,349.5,10.44086791
NM_000373,UMPS,6,5,18908,6743,12165,2433,1123.833333,1.804093134
NM_020733,HEG1,17,16,90250,9173,81077,5067.3125,539.5882353,8.838656928
NM_001195223,ALG1L,7,6,7771,928,6843,1140.5,132.5714286,7.373922414
NM_001015050,ALG1L,6,5,7771,816,6955,1391,136,8.523284314
NM_001164475,SLC41A3,10,9,95193,1980,93213,10357,198,47.07727273
NM_001008487,SLC41A3,10,9,50420,2278,48142,5349.111111,227.8,21.1334504
NM_017836,SLC41A3,11,10,77936,2360,75576,7557.6,214.5454545,32.02372881
NM_001008486,SLC41A3,11,10,77936,1703,76233,7623.3,154.8181818,44.76394598
NM_001008485,SLC41A3,12,11,77936,1812,76124,6920.363636,151,42.01103753
NM_014079,KLF15,3,2,14760,2528,12232,6116,842.6666667,4.838607595
NM_025112,ZXDC,10,9,38320,3415,34905,3878.333333,341.5,10.22108346
NM_182628,CCDC37,17,16,41618,2103,39515,2469.6875,123.7058824,18.78982406
NM_001040653,ZXDC,6,5,17020,4821,12199,2439.8,803.5,2.530387886
NM_001039783,TXNRD3NB,4,3,36778,1138,35640,11880,284.5,31.31810193
NM_152889,CHST13,3,2,19005,1787,17218,8609,595.6666667,9.635142697
NM_152533,C3orf22,4,3,9241,951,8290,2763.333333,237.75,8.717139853
NM_001007534,C3orf56,2,1,5055,1741,3314,3314,870.5,1.903503733
NM_015720,PODXL2,8,7,43653,2217,41436,5919.428571,277.125,18.69012179
NM_032548,ABTB1,12,11,7990,1999,5991,544.6363636,166.5833333,2.996998499
NM_001142646,TPRA1,9,8,17697,1791,15906,1988.25,199,8.881072027
NM_001136053,TPRA1,11,10,17697,1957,15740,1574,177.9090909,8.042922841
NM_004526,MCM2,16,15,24080,3503,20577,1371.8,218.9375,5.874107908
NM_172027,ABTB1,12,11,7990,1988,6002,545.6363636,165.6666667,3.019114688
NM_013336,SEC61A1,12,11,19316,3648,15668,1424.363636,304,4.29495614
NM_003707,RUVBL1,11,10,42873,1779,41094,4109.4,161.7272727,23.0994941
NM_153330,DNAJB8,3,2,4818,2478,2340,1170,826,0.944309927
NM_001145661,GATA2,7,6,9110,3482,5628,938,497.4285714,1.616312464
NM_007354,C3orf27,3,2,4088,2700,1388,694,900,0.514074074
NM_032638,GATA2,6,5,13767,3380,10387,2077.4,563.3333333,3.073076923
NM_001145662,GATA2,6,5,8501,3260,5241,1048.2,543.3333333,1.607668712
NM_002950,RPN1,10,9,30908,2351,28557,3173,235.1,12.14674607
NM_014049,ACAD9,18,17,33626,2593,31033,1825.470588,144.0555556,11.96799074
NM_024768,EFCC1,8,7,39115,2699,36416,5202.285714,337.375,13.49240459
NM_000174,GP9,3,2,1610,861,749,374.5,287,0.869918699
NM_001204883,RAB43,4,3,34583,4219,30364,10121.33333,1054.75,7.196966106
NM_198490,RAB43,3,2,34237,4484,29753,14876.5,1494.666667,6.635370205
NM_001204887,RAB43,4,3,34237,4579,29658,9886,1144.75,6.476960035
NM_001204888,RAB43,3,2,34237,4470,29767,14883.5,1490,6.659284116
NM_001204886,RAB43,4,3,34237,4234,30003,10001,1058.5,7.086206897
NM_001204885,RAB43,4,3,34355,4197,30158,10052.66667,1049.25,7.185608768
NM_001204884,RAB43,4,3,34447,4207,30240,10080,1051.75,7.188019967
NM_001127195,CNBP,5,4,16154,3365,12789,3197.25,673,3.800594354
NM_001127194,CNBP,5,4,16154,3368,12786,3196.5,673.6,3.79631829
NM_001127193,CNBP,5,4,16154,3386,12768,3192,677.2,3.770821028
NM_001127196,CNBP,5,4,16154,3362,12792,3198,672.4,3.804878049
NM_001199469,ISY1,12,11,33816,3856,29960,2723.636364,321.3333333,7.769709544
NM_003418,CNBP,5,4,16154,3383,12771,3192.75,676.6,3.775051729
NM_020701,ISY1,11,10,33816,3789,30027,3002.7,344.4545455,7.924782264
NM_001127192,CNBP,5,4,16154,3389,12765,3191.25,677.8,3.766597816
NM_006026,H1FX,1,0,1508,1508,NA,NA,1508,NA
NM_020187,HMCES,7,6,26453,1627,24826,4137.666667,232.4285714,15.25875845
NM_001006109,HMCES,7,6,26320,1800,24520,4086.666667,257.1428571,13.62222222
NM_001276273,MBD4,7,6,9237,1699,7538,1256.333333,242.7142857,4.436727487
NM_001276272,MBD4,8,7,9237,2601,6636,948,325.125,2.551326413
NM_001276270,MBD4,8,7,9237,2636,6601,943,329.5,2.504172989
NM_001276271,MBD4,7,6,8005,2345,5660,943.3333333,335,2.413646055
NM_207307,EFCAB12,9,8,27332,2163,25169,3146.125,240.3333333,11.63615349
NM_003925,MBD4,8,7,9237,2654,6583,940.4285714,331.75,2.480406933
NM_015103,PLXND1,36,35,51528,7013,44515,1271.857143,194.8055556,6.347497505
NM_153833,H1FOO,5,4,8149,1072,7077,1769.25,214.4,6.601679104
NM_000539,RHO,5,4,6707,2773,3934,983.5,554.6,1.41868013
NM_007117,TRH,3,2,3547,1893,1654,827,631,0.873745378
NM_001136152,ALG1L2,8,7,16561,977,15584,2226.285714,122.125,15.95087001
NM_001288950,ASTE1,7,6,12983,2575,10408,1734.666667,367.8571429,4.041941748
NM_014065,ASTE1,6,5,12983,2724,10259,2051.8,454,3.766152717
NM_001171906,NUDT16,2,1,1034,932,102,102,466,0.10944206
NM_001171905,NUDT16,4,3,7161,5947,1214,404.6666667,1486.75,0.204136539
NM_152395,NUDT16,3,2,7067,6120,947,473.5,2040,0.154738562
NM_001134194,ACPP,11,10,50937,1838,49099,4909.9,167.0909091,26.7132753
NM_001099,ACPP,10,9,41481,3229,38252,4250.222222,322.9,11.84639207
NM_016557,ACKR4,2,1,5406,2342,3064,3064,1171,1.308283518
NM_032169,ACAD11,20,19,101995,3576,98419,5179.947368,178.8,27.52209172
NM_178445,ACKR4,1,0,2506,2506,NA,NA,2506,NA
NM_153240,NPHP3,27,26,41852,5425,36427,1401.038462,200.9259259,6.714654378
NM_007027,TOPBP1,28,27,61290,5374,55916,2070.962963,191.9285714,10.40491254
NM_021203,SRPRB,8,7,37461,2835,34626,4946.571429,354.375,12.21375661
NM_001063,TF,17,16,32875,2808,30067,1879.1875,165.1764706,10.70762108
NM_025041,C3orf36,1,0,1668,1668,NA,NA,1668,NA
NM_015391,ANAPC13,3,2,8319,1211,7108,3554,403.6666667,5.869529315
NM_001242374,ANAPC13,3,2,8321,1845,6476,3238,615,3.5100271
NM_001242375,ANAPC13,3,2,8287,1430,6857,3428.5,476.6666667,4.795104895
NM_018133,MSL2,2,1,46930,4698,42232,42232,2349,8.989357173
NM_001145417,MSL2,2,1,45552,3897,41655,41655,1948.5,10.68899153
NM_001178014,PCCB,16,15,79848,1892,77956,5197.066667,118.25,41.20295983
NM_000532,PCCB,15,14,79848,1831,78017,5572.642857,122.0666667,42.60895685
NM_025246,SLC35G2,2,1,36875,2062,34813,34813,1031,16.88312318
NM_001097600,SLC35G2,2,1,36875,1648,35227,35227,824,21.3756068
NM_001097599,SLC35G2,2,1,36875,1797,35078,35078,898.5,19.52031163
NM_001190796,NCK1,3,2,18653,1704,16949,8474.5,568,9.946596244
NM_006153,NCK1,4,3,86920,1941,84979,28326.33333,485.25,43.7810407
NM_004189,SOX14,1,0,2040,2040,NA,NA,2040,NA
NM_016369,CLDN18,5,4,23490,3364,20126,5031.5,672.8,5.982758621
NM_001002026,CLDN18,5,4,34838,3355,31483,7870.75,671,9.38390462
NM_001170538,DZIP1L,14,13,44499,2121,42378,3259.846154,151.5,19.98019802
NM_173543,DZIP1L,16,15,53626,3514,50112,3340.8,219.625,14.2606716
NM_016161,A4GNT,3,2,8671,1774,6897,3448.5,591.3333333,3.887824126
NM_213654,ARMC8,13,12,59641,3288,56353,4696.083333,252.9230769,17.13899027
NM_001267042,ARMC8,21,20,111140,4643,106497,5324.85,221.0952381,22.93710963
NM_001267041,ARMC8,21,20,111140,4751,106389,5319.45,226.2380952,22.3929699
NM_001282342,ARMC8,20,19,111140,4673,106467,5603.526316,233.65,22.78343676
NM_014154,ARMC8,13,12,59641,3234,56407,4700.583333,248.7692308,17.44186766
NM_015396,ARMC8,23,22,111140,4922,106218,4828.090909,214,21.58025193
NM_012219,MRAS,6,5,57889,4595,53294,10658.8,765.8333333,11.59825898
NM_001252090,MRAS,6,5,56409,4169,52240,10448,694.8333333,12.53058287
NM_001252093,MRAS,5,4,56871,3807,53064,13266,761.4,13.93853428
NM_001252092,MRAS,5,4,56687,3888,52799,13199.75,777.6,13.57998971
NM_001252091,MRAS,5,4,57889,4383,53506,13376.5,876.6,12.20762035
NM_001085049,MRAS,6,5,56871,4019,52852,10570.4,669.8333333,13.15053496
NM_031913,ESYT3,23,22,43843,4470,39373,1789.681818,194.3478261,8.808277405
NM_001033031,FAIM,6,5,24673,1158,23515,4703,193,20.30656304
NM_001033030,FAIM,6,5,24673,1532,23141,4628.2,255.3333333,15.10509138
NM_001033032,FAIM,5,4,24673,1097,23576,5894,219.4,21.49134002
NM_018147,FAIM,5,4,24296,929,23367,5841.75,185.8,25.15285253
NM_023067,FOXL2,1,0,2918,2918,NA,NA,2918,NA
NM_001040061,C3orf72,3,2,6756,4078,2678,1339,1359.333333,0.656694458
NM_001134659,PRR23A,1,0,2308,2308,NA,NA,2308,NA
NM_001134657,PRR23C,1,0,2792,2792,NA,NA,2792,NA
NM_001013650,PRR23B,1,0,1897,1897,NA,NA,1897,NA
NM_004766,COPB2,22,21,32091,3145,28946,1378.380952,142.9545455,9.20381558
NM_004164,RBP2,4,3,23628,692,22936,7645.333333,173,33.14450867
NM_001130993,RBP1,3,2,14046,670,13376,6688,223.3333333,19.9641791
NM_002899,RBP1,4,3,22397,902,21495,7165,225.5,23.83037694
NM_001130992,RBP1,3,2,13426,1490,11936,5968,496.6666667,8.010738255
NM_152616,TRIM42,5,4,23128,2559,20569,5142.25,511.8,8.037905432
NM_018155,SLC25A36,7,6,38125,4665,33460,5576.666667,666.4285714,7.172561629
NM_001104647,SLC25A36,7,6,38125,4668,33457,5576.166667,666.8571429,7.16730934
NM_001037172,ACPL2,6,5,63080,3287,59793,11958.6,547.8333333,18.19075145
NM_152282,ACPL2,8,7,63080,3463,59617,8516.714286,432.875,17.21542016
NM_001282728,ACPL2,7,6,63080,3386,59694,9949,483.7142857,17.62965151
NM_001201370,RNF7,2,1,8596,1955,6641,6641,977.5,3.396930946
NM_014245,RNF7,3,2,8596,2004,6592,3296,668,3.289421158
NM_183237,RNF7,3,2,8596,1997,6599,3299.5,665.6666667,3.304456685
NM_139209,GRK7,4,3,38851,1750,37101,12367,437.5,21.20057143
NM_001679,ATP1B3,7,6,49914,1860,48054,8009,265.7142857,25.83548387
NM_001039547,GK5,16,15,68082,9853,58229,3881.933333,615.8125,5.909773673
NM_001282859,XRN1,12,11,30222,2138,28084,2553.090909,178.1666667,13.13564079
NM_001172312,PLS1,16,15,56768,3882,52886,3525.733333,242.625,13.62339001
NM_198504,PAQR9,1,0,2106,2106,NA,NA,2106,NA
NM_004267,CHST2,2,1,4240,4139,101,101,2069.5,0.024402029
NM_001134470,C3orf58,3,2,19045,3404,15641,7820.5,1134.666667,4.594888367
NM_173552,C3orf58,3,2,20572,4358,16214,8107,1452.666667,3.720513997
NM_182943,PLOD2,20,19,92056,4079,87977,4630.368421,203.95,21.56827654
NM_000935,PLOD2,19,18,92056,4015,88041,4891.166667,211.3157895,21.92801993
NM_001177304,PLSCR4,6,5,58844,3013,55831,11166.2,502.1666667,18.53003651
NM_001128306,PLSCR4,7,6,58844,3042,55802,9300.333333,434.5714286,18.34385273
NM_001128304,PLSCR4,11,10,58844,3442,55402,5540.2,312.9090909,16.09587449
NM_001128305,PLSCR4,9,8,58529,3402,55127,6890.875,378,16.20429159
NM_020353,PLSCR4,9,8,58844,3314,55530,6941.25,368.2222222,16.75618588
NM_001199979,PLSCR2,8,7,62705,1223,61482,8783.142857,152.875,50.27146361
NM_001199978,PLSCR2,10,9,36015,1608,34407,3823,160.8,21.39738806
NM_021105,PLSCR1,9,8,29663,2219,27444,3430.5,246.5555556,12.36773321
NM_001085420,PLSCR5,8,7,20380,1977,18403,2629,247.125,9.308548306
NM_032153,ZIC4,5,4,20763,4283,16480,4120,856.6,3.847770254
NM_001243256,ZIC4,4,3,20763,3664,17099,5699.666667,916,4.666757642
NM_001168379,ZIC4,5,4,19474,3984,15490,3872.5,796.8,3.888052209
NM_001168378,ZIC4,5,4,18238,4157,14081,3520.25,831.4,3.387298533
NM_003412,ZIC1,3,2,7327,5234,2093,1046.5,1744.666667,0.399885365
NM_032049,AGTR1,3,2,12825,2233,10592,5296,744.3333333,4.743394536
NM_009585,AGTR1,2,1,45134,2274,42860,42860,1137,18.84784521
NM_031850,AGTR1,4,3,45134,2418,42716,14238.66667,604.5,17.66583954
NM_000685,AGTR1,3,2,45134,2359,42775,21387.5,786.3333333,18.13268334
NM_004835,AGTR1,3,2,45134,2333,42801,21400.5,777.6666667,18.34590656
NM_001871,CPB1,11,10,32386,1471,30915,3091.5,133.7272727,21.01631543
NM_001870,CPA3,11,10,31831,1695,30136,3013.6,154.0909091,17.77935103
NM_001184720,GYG1,7,6,36263,1978,34285,5714.166667,282.5714286,17.33316481
NM_001184721,GYG1,6,5,36263,1757,34506,6901.2,292.8333333,19.63915766
NM_004130,GYG1,8,7,36263,2030,34233,4890.428571,253.75,16.8635468
NM_032383,HPS3,17,16,43936,4468,39468,2466.75,262.8235294,8.833482543
NM_014220,TM4SF1,5,4,8765,1696,7069,1767.25,339.2,4.168042453
NM_138786,TM4SF18,6,5,15265,3858,11407,2281.4,643,2.956713323
NM_001184723,TM4SF18,5,4,14976,3681,11295,2823.75,736.2,3.068459658
NM_004617,TM4SF4,5,4,28815,1612,27203,6800.75,322.4,16.87531017
NM_016094,COMMD2,5,4,14031,3711,10320,2580,742.2,2.780921584
NM_001144960,ANKUB1,6,5,31722,2479,29243,5848.6,413.1666667,11.79628883
NM_014779,TSC22D2,4,3,50829,3889,46940,15646.66667,972.25,12.06994086
NM_032025,EIF2A,14,13,39231,3893,35338,2718.307692,278.0714286,9.077318264
NM_014445,SERP1,3,2,4650,3175,1475,737.5,1058.333333,0.464566929
NM_152394,FAM194A,14,13,44069,2067,42002,3230.923077,147.6428571,20.32027092
NM_174878,CLRN1,3,2,46434,2362,44072,22036,787.3333333,18.65876376
NM_052995,CLRN1,4,3,18075,1448,16627,5542.333333,362,11.48273481
NM_001256819,CLRN1,4,3,46434,2535,43899,14633,633.75,17.31715976
NM_001195794,CLRN1,4,3,46434,2402,44032,14677.33333,600.5,18.33139051
NM_013308,GPR171,3,2,5371,1798,3573,1786.5,599.3333333,1.987208009
NM_001081455,P2RY14,3,2,37095,2681,34414,17207,893.6666667,12.83625513
NM_022788,P2RY12,3,2,47971,2306,45665,22832.5,768.6666667,19.80268864
NM_023915,GPR87,3,2,22762,1522,21240,10620,507.3333333,13.95532194
NM_176894,P2RY13,2,1,3243,2771,472,472,1385.5,0.170335619
NM_176876,P2RY12,2,1,4014,2279,1735,1735,1139.5,0.761298815
NM_001178145,IGSF10,2,1,4802,2826,1976,1976,1413,0.699221515
NM_001178146,IGSF10,2,1,4802,2673,2129,2129,1336.5,0.796483352
NM_178822,IGSF10,6,5,22721,8577,14144,2828.8,1429.5,1.649061443
NM_207365,AADACL2,5,4,23854,1505,22349,5587.25,301,14.84983389
NM_033050,SUCNR1,3,2,8447,1653,6794,3397,551,4.110102843
NM_001086,AADAC,5,4,14417,1611,12806,3201.5,322.2,7.949099938
NM_001123228,TMEM14E,1,0,1294,1294,NA,NA,1294,NA
NM_002563,P2RY1,1,0,3109,3109,NA,NA,3109,NA
NM_002886,RAP2B,1,0,8414,8414,NA,NA,8414,NA
NM_001101337,C3orf79,3,2,18204,583,17621,8810.5,194.3333333,30.22469983
NM_007289,MME,23,22,103441,5733,97708,4441.272727,249.2608696,17.0430839
NM_007288,MME,23,22,103567,5688,97879,4449.045455,247.3043478,17.20798172
NM_007287,MME,23,22,103815,5642,98173,4462.409091,245.3043478,17.40038993
NM_000902,MME,23,22,104084,5666,98418,4473.545455,246.3478261,17.36992587
NM_001190992,SLC33A1,7,6,27949,2455,25494,4249,350.7142857,10.38452138
NM_004733,SLC33A1,6,5,27949,3816,24133,4826.6,636,6.324161426
NM_173657,C3orf33,6,5,43656,1937,41719,8343.8,322.8333333,21.53794528
NM_003875,GMPS,16,15,67197,2472,64725,4315,154.5,26.18325243
NM_007107,SSR3,5,4,15046,3721,11325,2831.25,744.2,3.043536684
NM_001184718,TIPARP,6,5,30106,3689,26417,5283.4,614.8333333,7.161019246
NM_015508,TIPARP,6,5,32354,4039,28315,5663,673.1666667,7.010398614
NM_001184717,TIPARP,6,5,31844,4124,27720,5544,687.3333333,6.721629486
NM_020307,CCNL1,11,10,12898,2635,10263,1026.3,239.5454545,3.89487666
NM_001167916,VEPH1,4,3,44007,1406,42601,14200.33333,351.5,30.29943101
NM_001167917,VEPH1,4,3,35887,996,34891,11630.33333,249,35.0311245
NM_001167915,VEPH1,5,4,44007,1669,42338,10584.5,333.8,25.3672858
NM_001163678,SHOX2,5,4,10154,3120,7034,1758.5,624,2.254487179
NM_006884,SHOX2,5,4,10154,3156,6998,1749.5,631.2,2.217363752
NM_003030,SHOX2,6,5,10154,3229,6925,1385,538.1666667,2.144626819
NM_001195432,MLF1,9,8,35298,2530,32768,4096,281.1111111,12.95177866
NM_001195434,MLF1,9,8,35298,2373,32925,4115.625,263.6666667,13.87484197
NM_001195433,MLF1,7,6,35298,2197,33101,5516.833333,313.8571429,15.06645426
NM_022443,MLF1,7,6,35298,2209,33089,5514.833333,315.5714286,14.9791761
NM_001130157,MLF1,8,7,35298,2327,32971,4710.142857,290.875,14.16888698
NM_001130156,MLF1,7,6,35298,2253,33045,5507.5,321.8571429,14.66711052
NM_206963,RARRES1,6,5,35380,1532,33848,6769.6,255.3333333,22.09399478
NM_024996,GFM1,18,17,48045,3485,44560,2621.176471,193.6111111,12.78622669
NM_002888,RARRES1,4,3,27837,887,26950,8983.333333,221.75,30.38331454
NM_020169,LXN,6,5,6281,1122,5159,1031.8,187,4.598039216
NM_001289406,MFSD1,15,14,27795,2264,25531,1823.642857,150.9333333,11.27694346
NM_001289407,MFSD1,16,15,27795,2347,25448,1696.533333,146.6875,10.84277801
NM_022736,MFSD1,16,15,27795,2378,25417,1694.466667,148.625,10.68839361
NM_001167903,MFSD1,15,14,27795,2260,25535,1823.928571,150.6666667,11.29867257
NM_001197109,SCHIP1,7,6,57507,1658,55849,9308.166667,236.8571429,33.68455971
NM_000882,IL12A,7,6,7185,1450,5735,955.8333333,207.1428571,3.955172414
NM_001168214,C3orf80,1,0,2579,2579,NA,NA,2579,NA
NM_005496,SMC4,23,22,34396,5302,29094,1322.454545,230.5217391,5.487363259
NM_173084,TRIM59,3,2,14337,3879,10458,5229,1293,2.696055684
NM_001288753,SMC4,24,23,35659,5419,30240,1314.782609,225.7916667,5.580365381
NM_001002800,SMC4,24,23,35659,5494,30165,1311.521739,228.9166667,5.490535129
NM_002268,KPNA4,17,16,70595,8998,61597,3849.8125,529.2941176,6.845632363
NM_025047,ARL14,1,0,1289,1289,NA,NA,1289,NA
NM_001038628,B3GALNT1,8,7,21491,3649,17842,2548.857143,456.125,4.889558783
NM_033169,B3GALNT1,5,4,21014,3296,17718,4429.5,659.2,5.375606796
NM_033168,B3GALNT1,4,3,21491,3227,18264,6088,806.75,5.659745894
NM_033167,B3GALNT1,6,5,21491,3443,18048,3609.6,573.8333333,5.241940168
NM_003781,B3GALNT1,5,4,21491,3323,18168,4542,664.6,5.467348781
NM_014926,SLITRK3,2,1,9963,4224,5739,5739,2112,1.358664773
NM_006217,SERPINI2,9,8,32345,1687,30658,3832.25,187.4444444,18.17308832
NM_001012303,SERPINI2,10,9,32345,1779,30566,3396.222222,177.9,17.18156268
NM_145859,PDCD10,9,8,50958,1296,49662,6207.75,144,38.31944444
NM_007217,PDCD10,9,8,50901,1447,49454,6181.75,160.7777778,34.17691776
NM_145860,PDCD10,8,7,50937,1201,49736,7105.142857,150.125,41.41215654
NM_024727,LRRC31,9,8,30696,2537,28159,3519.875,281.8888889,11.09932992
NM_001277128,LRRC31,8,7,30696,2368,28328,4046.857143,296,11.96283784
NM_001185119,MYNN,6,5,15453,4821,10632,2126.4,803.5,2.205351587
NM_001080460,LRRIQ4,5,4,15852,1829,14023,3505.75,365.8,7.667031165
NM_032487,ACTRT3,2,1,2974,2005,969,969,1002.5,0.483291771
NM_001185118,MYNN,9,8,16653,5376,11277,1409.625,597.3333333,2.09765625
NM_153353,LRRC34,10,9,19360,1754,17606,1956.222222,175.4,10.03762828
NM_018657,MYNN,8,7,16653,5308,11345,1620.714286,663.5,2.137339864
NM_001277127,LRRC31,9,8,30696,2555,28141,3517.625,283.8888889,11.01409002
NM_001172780,LRRC34,9,8,17147,1884,15263,1907.875,209.3333333,8.101380042
NM_001172779,LRRC34,11,10,19360,1851,17509,1750.9,168.2727273,9.459211237
NM_003262,SEC62,8,7,31583,6549,25034,3576.285714,818.625,3.822568331
NM_182610,SAMD7,9,8,27468,2271,25197,3149.625,252.3333333,11.09511229
NM_014373,GPR160,4,3,47450,2017,45433,15144.33333,504.25,22.52503718
NM_001145097,SKIL,6,5,37228,7064,30164,6032.8,1177.333333,4.270101925
NM_005414,SKIL,7,6,39166,7206,31960,5326.666667,1029.428571,4.435192895
NM_001248008,SKIL,6,5,37228,7202,30026,6005.2,1200.333333,4.169119689
NM_001145098,SKIL,8,7,39166,6716,32450,4635.714286,839.5,4.831745086
NM_001185056,CLDN11,3,2,13453,2434,11019,5509.5,811.3333333,4.527115859
NM_005602,CLDN11,3,2,15828,2764,13064,6532,921.3333333,4.726483357
NM_020390,EIF5A2,5,4,20224,5542,14682,3670.5,1108.4,2.649224107
NM_001099645,RPL22L1,4,3,5382,1966,3416,1138.666667,491.5,1.737538149
NM_001278658,SLC2A2,10,9,30633,3186,27447,3049.666667,318.6,8.614877589
NM_001278659,SLC2A2,10,9,30633,3324,27309,3034.333333,332.4,8.215703971
NM_000340,SLC2A2,11,10,30633,3450,27183,2718.3,313.6363636,7.879130435
NM_004122,GHSR,1,0,915,915,NA,NA,915,NA
NM_198407,GHSR,2,1,5167,3016,2151,2151,1508,0.713196286
NM_001190943,TNFSF10,2,1,6122,1336,4786,4786,668,3.582335329
NM_001163677,KCNMB3,4,3,27303,1113,26190,8730,278.25,23.5309973
NM_171828,KCNMB3,4,3,24286,1316,22970,7656.666667,329,17.45440729
NM_014407,KCNMB3,4,3,8851,1494,7357,2452.333333,373.5,4.924364123
NM_171829,KCNMB3,4,3,17127,1858,15269,5089.666667,464.5,8.217976319
NM_171830,KCNMB3,3,2,9093,1836,7257,3628.5,612,3.952614379
NM_021629,GNB4,10,9,55497,6438,49059,5451,643.8,7.620223672
NM_033540,MFN1,18,17,45530,3531,41999,2470.529412,196.1666667,11.8943642
NM_004301,ACTL6A,14,13,25487,1872,23615,1816.538462,133.7142857,12.61485043
NM_177989,ACTL6A,14,13,25487,1728,23759,1827.615385,123.4285714,13.7494213
NM_178042,ACTL6A,14,13,25487,1920,23567,1812.846154,137.1428571,12.27447917
NM_001199958,NDUFB5,5,4,19715,957,18758,4689.5,191.4,19.60083595
NM_002492,NDUFB5,6,5,19715,1065,18650,3730,177.5,17.51173709
NM_001199957,NDUFB5,4,3,19715,907,18808,6269.333333,226.75,20.73649394
NM_001042601,TTC14,10,9,9002,4797,4205,467.2222222,479.7,0.876589535
NM_133462,TTC14,12,11,9002,3045,5957,541.5454545,253.75,1.956321839
NM_001288582,TTC14,13,12,16219,2887,13332,1111,222.0769231,4.617942501
NM_145261,DNAJC19,6,5,6066,1459,4607,921.4,243.1666667,3.157642221
NM_001190233,DNAJC19,6,5,5810,1471,4339,867.8,245.1666667,2.949694086
NM_005087,FXR1,17,16,70307,8582,61725,3857.8125,504.8235294,7.192379399
NM_001013439,FXR1,18,17,70307,8927,61380,3610.588235,495.9444444,6.875770136
NM_001013438,FXR1,16,15,70307,8489,61818,4121.2,530.5625,7.282129815
NM_003106,SOX2,1,0,2513,2513,NA,NA,2513,NA
NM_020640,DCUN1D1,7,6,37769,3159,34610,5768.333333,451.2857143,10.95599873
NM_020166,MCCC1,19,18,84361,2554,81807,4544.833333,134.4210526,32.03093187
NM_024871,MAP6D1,3,2,9731,2141,7590,3795,713.6666667,3.545072396
NM_018622,PARL,10,9,55522,1422,54100,6011.111111,142.2,38.04500703
NM_001037639,PARL,9,8,55522,1271,54251,6781.375,141.2222222,42.68371361
NM_001023587,ABCC5,7,6,34188,1980,32208,5368,282.8571429,16.26666667
NM_005688,ABCC5,30,29,98005,5873,92132,3176.965517,195.7666667,15.68738294
NM_001145143,HTR3D,8,7,7629,1617,6012,858.8571429,202.125,3.717996289
NM_001163646,HTR3D,8,7,6540,1767,4773,681.8571429,220.875,2.701188455
NM_182537,HTR3D,6,5,7827,1465,6362,1272.4,244.1666667,4.342662116
NM_198313,HTR3E,8,7,9933,2102,7831,1118.714286,262.75,3.725499524
NM_003907,EIF2B5,16,15,10291,2914,7377,491.8,182.125,2.531571723
NM_001256614,HTR3E,7,6,6818,1952,4866,811,278.8571429,2.492827869
NM_001256613,HTR3E,9,8,9933,2148,7785,973.125,238.6666667,3.624301676
NM_198314,HTR3E,7,6,6818,1874,4944,824,267.7142857,2.638207044
NM_130770,HTR3C,9,8,7628,1708,5920,740,189.7777778,3.466042155
NM_004423,DVL3,15,14,18032,5077,12955,925.3571429,338.4666667,2.551703762
NM_182589,HTR3E,8,7,6818,1920,4898,699.7142857,240,2.551041667
NM_032331,ECE2,3,2,9104,993,8111,4055.5,331,8.168177241
NM_018358,ABCF3,21,20,7934,2593,5341,267.05,123.4761905,2.059776321
NM_138345,VWA5B2,19,18,11802,4039,7763,431.2777778,212.5789474,1.922010399
NM_001037324,ECE2,18,17,17022,3165,13857,815.1176471,175.8333333,4.378199052
NM_014693,ECE2,19,18,43376,3502,39874,2215.222222,184.3157895,11.38606511
NM_033259,CAMK2N2,2,1,2250,1362,888,888,681,0.651982379
NM_001100121,ECE2,19,18,17022,3253,13769,764.9444444,171.2105263,4.232708269
NM_001100120,ECE2,19,18,17022,3391,13631,757.2777778,178.4736842,4.019758183
NM_005787,ALG3,9,8,6644,1542,5102,637.75,171.3333333,3.308690013
NM_001006941,ALG3,9,8,7198,1615,5583,697.875,179.4444444,3.456965944
NM_001177598,THPO,6,5,6161,1794,4367,873.4,299,2.434225195
NM_001177597,THPO,6,5,6161,1799,4362,872.4,299.8333333,2.424680378
NM_001278699,POLR2H,5,4,5614,1278,4336,1084,255.6,3.392801252
NM_001278698,POLR2H,5,4,5614,1333,4281,1070.25,266.6,3.211552888
NM_001278700,POLR2H,5,4,6883,1119,5764,1441,223.8,5.151027703
NM_001278715,POLR2H,4,3,5614,1193,4421,1473.666667,298.25,3.705783738
NM_001278714,POLR2H,4,3,5614,1184,4430,1476.666667,296,3.741554054
NM_001171089,CLCN2,23,22,15468,3226,12242,556.4545455,140.2608696,3.794792312
NM_001194947,EIF4G1,33,32,20865,5518,15347,479.59375,167.2121212,2.781261327
NM_001194946,EIF4G1,34,33,20865,5576,15289,463.3030303,164,2.741929699
NM_001171093,FAM131A,6,5,10348,2437,7911,1582.2,406.1666667,3.24620435
NM_001171088,CLCN2,23,22,15468,3181,12287,558.5,138.3043478,3.862621817
NM_001171087,CLCN2,24,23,15468,3263,12205,530.6521739,135.9583333,3.740422924
NM_006232,POLR2H,5,4,5614,1269,4345,1086.25,253.8,3.423955871
NM_144635,FAM131A,6,5,8789,2555,6234,1246.8,425.8333333,2.439921722
NM_004366,CLCN2,24,23,15468,3314,12154,528.4347826,138.0833333,3.667471334
NM_198244,EIF4G1,30,29,20865,5313,15552,536.2758621,177.1,2.927159797
NM_198241,EIF4G1,33,32,20865,5554,15311,478.46875,168.3030303,2.756751891
NM_198242,EIF4G1,29,28,20865,5135,15730,561.7857143,177.0689655,3.063291139
NM_000460,THPO,6,5,6161,1811,4350,870,301.8333333,2.401987852
NM_004953,EIF4G1,26,25,15047,5059,9988,399.52,194.5769231,1.974303222
NM_003741,CHRD,23,22,9758,3544,6214,282.4545455,154.0869565,1.753386005
NM_182917,EIF4G1,32,31,20196,5701,14495,467.5806452,178.15625,2.542536397
NM_022149,MAGEF1,1,0,1683,1683,NA,NA,1683,NA
NM_080652,TMEM41A,5,4,9458,2832,6626,1656.5,566.4,2.339689266
NM_139248,LIPH,10,9,44801,2484,42317,4701.888889,248.4,17.03582931
NM_001243879,TRA2B,8,7,23568,4162,19406,2772.285714,520.25,4.662662182
NM_004593,TRA2B,9,8,23568,4297,19271,2408.875,477.4444444,4.484756807
NM_004454,ETV5,13,12,62797,4115,58682,4890.166667,316.5384615,14.26051033
NM_016306,DNAJB11,10,9,15124,1699,13425,1491.666667,169.9,7.901706886
NM_014375,FETUB,7,6,12650,1634,11016,1836,233.4285714,6.741738066
NM_001134415,TBCCD1,8,7,24478,3072,21406,3058,384,6.968098958
NM_017541,CRYGS,3,2,5937,845,5092,2546,281.6666667,6.026035503
NM_001622,AHSG,7,6,8259,1580,6679,1113.166667,225.7142857,4.22721519
NM_018138,TBCCD1,8,7,21289,2723,18566,2652.285714,340.375,6.818215204
NM_001286749,TBCCD1,7,6,24478,2692,21786,3631,384.5714286,8.092867756
NM_001166451,KNG1,10,9,27103,2045,25058,2784.222222,204.5,12.25330073
NM_000893,KNG1,11,10,27103,2154,24949,2494.9,195.8181818,11.58263695
NM_001967,EIF4A2,11,10,6326,1901,4425,442.5,172.8181818,2.327722251
NM_001102416,KNG1,10,9,25582,2737,22845,2538.333333,273.7,8.346729996
NM_004797,ADIPOQ,3,2,15791,4581,11210,5605,1527,2.44706396
NM_001177800,ADIPOQ,4,3,15791,4633,11158,3719.333333,1158.25,2.408374703
NM_052969,RPL39L,3,2,18524,706,17818,8909,235.3333333,25.23796034
NM_001031849,MASP1,9,8,45670,2521,43149,5393.625,280.1111111,17.11582705
NM_001879,MASP1,16,15,75939,6492,69447,4629.8,405.75,10.69731978
NM_139125,MASP1,11,10,57942,4190,53752,5375.2,380.9090909,12.82863962
NM_153708,RTP1,2,1,3981,2219,1762,1762,1109.5,0.794051374
NM_022147,RTP4,2,1,3203,1013,2190,2190,506.5,2.16189536
NM_001048,SST,2,1,1509,634,875,875,317,1.380126183
NM_001004312,RTP2,2,1,4300,1348,2952,2952,674,2.189910979
NM_001130845,BCL6,10,9,15122,3669,11453,1272.555556,366.9,3.121559008
NM_001706,BCL6,10,9,24350,3577,20773,2308.111111,357.7,5.807380486
NM_001134738,BCL6,8,7,13532,3091,10441,1491.571429,386.375,3.377871239
NM_021101,CLDN1,4,3,16747,3456,13291,4430.333333,864,3.845775463
NM_207316,TMEM207,5,4,21223,1453,19770,4942.5,290.6,13.60633173
NM_006580,CLDN16,5,4,24273,3278,20995,5248.75,655.6,6.404820012
NM_198184,OSTN,3,2,37590,405,37185,18592.5,135,91.81481481
NM_198152,UTS2B,9,8,63383,2417,60966,7620.75,268.5555556,25.2238312
NM_001083308,PYDC2,1,0,295,295,NA,NA,295,NA
NM_020386,HRASLS,4,3,29729,1067,28662,9554,266.75,26.86223055
NM_130830,LRRC15,2,1,14498,5885,8613,8613,2942.5,1.463551402
NM_001135057,LRRC15,3,2,14498,5943,8555,4277.5,1981,1.439508666
NM_001080513,CPN2,2,1,11565,3030,8535,8535,1515,2.816831683
NM_024524,ATP13A3,32,31,65567,7360,58207,1877.645161,230,7.908559783
NM_001166306,TMEM44,10,9,45750,2355,43395,4821.666667,235.5,18.42675159
NM_001011655,TMEM44,10,9,45750,2359,43391,4821.222222,235.9,18.39381094
NM_138399,TMEM44,11,10,45750,2390,43360,4336,217.2727273,18.14225941
NM_001166305,TMEM44,11,10,45750,2501,43249,4324.9,227.3636364,17.29268293
NM_153690,FAM43A,1,0,3146,3146,NA,NA,3146,NA
NM_006241,PPP1R2,6,5,29005,3473,25532,5106.4,578.8333333,7.351569248
NM_001282506,MUC20,4,3,12673,2595,10078,3359.333333,648.75,3.883622351
NM_138297,MUC4,23,22,65208,3966,61242,2783.727273,172.4347826,15.44175492
NM_018406,MUC4,25,24,65208,16829,48379,2015.791667,673.16,2.874740032
NM_004532,MUC4,24,23,65208,4120,61088,2656,171.6666667,14.82718447
NM_001010938,TNK2,15,14,32198,4237,27961,1997.214286,282.4666667,6.599244749
NM_005781,TNK2,15,14,45646,4491,41155,2939.642857,299.4,9.163883322
NM_003234,TFRC,19,18,32808,5243,27565,1531.388889,275.9473684,5.257486172
NM_001128148,TFRC,19,18,32879,5102,27777,1543.166667,268.5263158,5.444335555
NM_001039617,ZDHHC19,8,7,13979,1345,12634,1804.857143,168.125,9.39330855
NM_001204898,TM4SF19,4,3,14876,985,13891,4630.333333,246.25,14.10253807
NM_001204897,TM4SF19,5,4,14876,1060,13816,3454,212,13.03396226
NM_138461,TM4SF19,5,4,14876,1064,13812,3453,212.8,12.98120301
NM_005017,PCYT1A,10,9,49333,1593,47740,5304.444444,159.3,29.96861268
NM_152773,TCTEX1D2,5,4,27077,684,26393,6598.25,136.8,38.58625731
NM_182627,WDR53,4,3,14356,1575,12781,4260.333333,393.75,8.114920635
NM_001105573,FBXO45,3,2,20207,5736,14471,7235.5,1912,2.522838215
NM_001077657,C3orf43,3,2,8489,1813,6676,3338,604.3333333,3.682294539
NM_198565,NRROS,3,2,22220,2467,19753,9876.5,822.3333333,8.006890961
NM_032898,CEP19,3,2,5977,2163,3814,1907,721,1.763291724
NM_017861,PIGX,6,5,23633,3045,20588,4117.6,507.5,6.761247947
NM_001166304,PIGX,7,6,23633,3100,20533,3422.166667,442.8571429,6.623548387
NM_001042540,NCBP2,4,3,7193,2015,5178,1726,503.75,2.569727047
NM_007362,NCBP2,4,3,7193,2174,5019,1673,543.5,2.308647654
NM_025163,PIGZ,3,2,22530,2742,19788,9894,914,7.216630197
NM_033316,MFI2,7,6,10864,1681,9183,1530.5,240.1428571,5.46281975
NM_032288,FYTTD1,9,8,34695,3722,30973,3871.625,413.5555556,8.32160129
NM_001011537,FYTTD1,10,9,34895,3664,31231,3470.111111,366.4,8.523744541
NM_001145642,KIAA0226,21,20,78256,6924,71332,3566.6,329.7142857,10.30213749
NM_014687,KIAA0226,20,19,65516,6752,58764,3092.842105,337.6,8.703199052
NM_033029,LMLN,16,15,83522,7059,76463,5097.533333,441.1875,10.83198753
NM_000996,RPL35A,5,4,5671,488,5183,1295.75,97.6,10.62090164
NM_001136049,LMLN,17,16,83522,7171,76351,4771.9375,421.8235294,10.64719007
NM_001145248,FAM157A,7,6,28493,1282,27211,4535.166667,183.1428571,21.22542902
NM_003501,ACOX3,18,17,74445,2892,71553,4209,160.6666667,24.74170124
NM_018126,TMEM33,7,6,25689,7724,17965,2994.166667,1103.428571,2.325867426
NM_001290,LDB2,8,7,397261,2547,394714,56387.71429,318.375,154.9721241
NM_001101667,ACOX3,17,16,74445,2823,71622,4476.375,166.0588235,25.37088204
NM_001130834,LDB2,9,8,397261,2691,394570,49321.25,299,146.6257897
NM_194282,LIN54,13,12,86232,6144,80088,6674,472.6153846,13.03515625
NM_001145065,CCSER1,11,10,1474688,6216,1468472,146847.2,565.0909091,236.2406692
NM_001130714,LEF1,10,9,121413,3487,117926,13102.88889,348.7,33.81875538
NM_001130713,LEF1,11,10,121413,3529,117884,11788.4,320.8181818,33.40436384
NM_016269,LEF1,12,11,121413,3614,117799,10709,301.1666667,32.59518539
NM_001115008,LIN54,13,12,86232,5481,80751,6729.25,421.6153846,14.73289546
NM_001115007,LIN54,13,12,88339,5280,83059,6921.583333,406.1538462,15.73087121
NM_001166119,LEF1,11,10,119254,2653,116601,11660.1,241.1818182,43.95062194
NM_001288997,LIN54,13,12,86232,5218,81014,6751.166667,401.3846154,15.52587198
NM_001288996,LIN54,11,10,86232,5875,80357,8035.7,534.0909091,13.67778723
NM_001204354,SPOCK3,10,9,501207,2943,498264,55362.66667,294.3,169.304791
NM_001204358,SPOCK3,8,7,480506,1502,479004,68429.14286,187.75,318.9107856
NM_001204356,SPOCK3,10,9,501207,2869,498338,55370.88889,286.9,173.6974556
NM_001204352,SPOCK3,12,11,501207,3072,498135,45285,256,162.1533203
NM_016950,SPOCK3,12,11,501207,3000,498207,45291.54545,250,166.069
NM_001251967,SPOCK3,8,7,501207,2702,498505,71215,337.75,184.4948187
NM_001040159,SPOCK3,11,10,501207,2990,498217,49821.7,271.8181818,166.6277592
NM_001204355,SPOCK3,9,8,501207,2827,498380,62297.5,314.1111111,176.29289
NM_000585,IL15,8,7,97393,2010,95383,13626.14286,251.25,47.45422886
NM_001204353,SPOCK3,10,9,501043,2806,498237,55359.66667,280.6,177.5612972
NM_172175,IL15,10,9,97393,2333,95060,10562.22222,233.3,40.74582083
NM_002111,HTT,67,66,169281,13542,155739,2359.681818,202.119403,11.50044307
NM_020777,SORCS2,27,26,550192,6080,544112,20927.38462,225.1851852,89.49210526
NM_001145853,WFS1,8,7,33417,3644,29773,4253.285714,455.5,8.170417124
NM_006005,WFS1,8,7,33417,3648,29769,4252.714286,456,8.160361842
NM_018401,STK32B,12,11,449200,3236,445964,40542.18182,269.6666667,137.8133498
NM_181808,POLN,24,23,157315,2923,154392,6712.695652,121.7916667,52.81970578
NM_177998,OTOP1,6,5,38093,1875,36218,7243.6,312.5,19.31626667
NM_004334,BST1,9,8,29225,1489,27736,3467,165.4444444,18.62726662
NM_022346,NCAPG,21,20,34053,4773,29280,1464,227.2857143,6.1345066
NM_147183,KCNIP4,8,7,575292,2164,573128,81875.42857,270.5,264.8465804
NM_147182,KCNIP4,9,8,1220137,2358,1217779,152222.375,262,516.4457167
NM_001035003,KCNIP4,8,7,969081,2410,966671,138095.8571,301.25,401.1082988
NM_001035004,KCNIP4,8,7,816042,2331,813711,116244.4286,291.375,349.0823681
NM_001166050,APBB2,18,17,404593,8990,395603,23270.76471,499.4444444,44.00478309
NM_004307,APBB2,18,17,404593,8993,395600,23270.58824,499.6111111,43.98976982
NM_001100399,PDS5A,33,32,155095,7209,147886,4621.4375,218.4545455,20.51407962
NM_173075,APBB2,17,16,404593,8923,395670,24729.375,524.8823529,44.34270985
NM_003215,TEC,18,17,134016,3638,130378,7669.294118,202.1111111,35.83782298
NM_000812,GABRB1,9,8,395154,2220,392934,49116.75,246.6666667,176.9972973
NM_001080476,GRXCR1,4,3,137394,996,136398,45466,249,136.9457831
NM_001134223,USP46,9,8,65634,8050,57584,7198,894.4444444,7.153291925
NM_000222,KIT,21,20,82788,5197,77591,3879.55,247.4761905,14.92995959
NM_022832,USP46,9,8,68377,7974,60403,7550.375,886,7.57499373
NM_001093772,KIT,21,20,82788,5185,77603,3880.15,246.9047619,14.96682739
NM_001286767,USP46,9,8,68377,7938,60439,7554.875,882,7.61388259
NM_001286768,USP46,10,9,68377,8142,60235,6692.777778,814.2,7.398059445
NM_015236,LPHN3,23,22,575331,6148,569183,25871.95455,267.3043478,92.58018868
NM_001145006,MUC7,4,3,52507,2545,49962,16654,636.25,19.63143418
NM_201431,RASSF6,11,10,49083,5937,43146,4314.6,539.7272727,7.267306721
NM_133370,YTHDC1,16,15,39721,6211,33510,2234,388.1875,5.395266463
NM_001270391,RASSF6,10,9,49022,5924,43098,4788.666667,592.4,7.275151924
NM_177532,RASSF6,11,10,49022,6027,42995,4299.5,547.9090909,7.133731541
NM_014243,ADAMTS3,22,21,287832,5844,281988,13428,265.6363636,48.25256674
NM_001031732,YTHDC1,17,16,39721,6266,33455,2090.9375,368.5882353,5.339131823
NM_001098484,SLC4A4,26,25,384803,7719,377084,15083.36,296.8846154,48.85140562
NM_001134742,SLC4A4,25,24,384803,7621,377182,15715.91667,304.84,49.49245506
NM_001270392,RASSF6,10,9,49083,5804,43279,4808.777778,580.4,7.456753963
NM_003759,SLC4A4,23,22,233036,7663,225373,10244.22727,333.173913,29.41054417
NM_001206997,C4orf22,7,6,628038,953,627085,104514.1667,136.1428571,658.0115425
NM_020859,SHROOM3,11,10,348154,11030,337124,33712.4,1002.727273,30.56427924
NM_144571,CNOT6L,12,11,106005,8806,97199,8836.272727,733.8333333,11.03781513
NM_152770,C4orf22,6,5,628038,901,627137,125427.4,150.1666667,696.045505
NM_003948,CDKL2,12,11,54019,4727,49292,4481.090909,393.9166667,10.42775545
NM_001286790,CNOT6L,12,11,106005,8877,97128,8829.818182,739.75,10.9415343
NM_138982,MAPK10,14,13,345101,4200,340901,26223.15385,300,81.16690476
NM_138980,MAPK10,14,13,345101,4227,340874,26221.07692,301.9285714,80.64206293
NM_002753,MAPK10,14,13,438009,3741,434268,33405.23077,267.2142857,116.0834002
NM_198281,GPRIN3,2,1,63734,6354,57380,57380,3177,9.030531948
NM_207491,CCSER1,8,7,546974,3934,543040,77577.14286,491.75,138.0376207
NM_001257386,ABCG2,16,15,141060,4292,136768,9117.866667,268.25,31.86579683
NM_001011516,PDLIM5,10,9,136364,1973,134391,14932.33333,197.3,68.11505322
NM_001011513,PDLIM5,13,12,216372,5818,210554,17546.16667,447.5384615,36.19009969
NM_001256426,PDLIM5,17,16,216372,6236,210136,13133.5,366.8235294,33.69724182
NM_001256428,PDLIM5,12,11,216372,5992,210380,19125.45455,499.3333333,35.11014686
NM_001256427,PDLIM5,15,14,216372,3849,212523,15180.21429,256.6,55.21512081
NM_006457,PDLIM5,13,12,216372,6145,210227,17518.91667,472.6923077,34.21106591
NM_001256425,PDLIM5,12,11,216372,5725,210647,19149.72727,477.0833333,36.79423581
NM_003728,UNC5C,16,15,386707,9894,376813,25120.86667,618.375,38.08500101
NM_174952,STPG2,11,10,584368,1665,582703,58270.3,151.3636364,349.9717718
NM_001510,GRID2,16,15,1470158,5355,1464803,97653.53333,334.6875,273.5393091
NM_001286838,GRID2,15,14,1470158,5069,1465089,104649.2143,337.9333333,289.0291971
NM_001011515,PDLIM5,9,8,136364,2032,134332,16791.5,225.7777778,66.10826772
NM_001127507,BANK1,16,15,284207,3062,281145,18743,191.375,91.81743958
NM_001008388,CISD2,3,2,23830,5894,17936,8968,1964.666667,3.043094673
NM_017935,BANK1,17,16,284207,3462,280745,17546.5625,203.6470588,81.09329867
NM_001100874,SLC9B1,12,11,134693,1767,132926,12084.18182,147.25,75.22693831
NM_001083907,BANK1,17,16,260988,3231,257757,16109.8125,190.0588235,79.77623027
NM_032518,COL25A1,34,33,478762,2701,476061,14426.09091,79.44117647,176.2536098
NM_025144,ALPK1,16,15,145267,5428,139839,9322.6,339.25,25.76252763
NM_001102406,ALPK1,16,15,145267,5376,139891,9326.066667,336,26.02139137
NM_001127493,ANK2,47,46,565659,8129,557530,12120.21739,172.9574468,68.58531185
NM_020977,ANK2,45,44,334113,8033,326080,7410.909091,178.5111111,40.59255571
NM_001253884,ALPK1,15,14,145267,5220,140047,10003.35714,348,26.8289272
NM_001148,ANK2,46,45,334113,14289,319824,7107.2,310.6304348,22.38253202
NM_001256074,COL25A1,32,31,478487,2526,475961,15353.58065,78.9375,188.4247823
NM_198721,COL25A1,37,36,491924,5739,486185,13505.13889,155.1081081,84.71597839
NM_018699,PRDM5,16,15,228086,2496,225590,15039.33333,156,90.38060897
NM_152399,TMEM155,6,5,6257,2322,3935,787,387,1.694659776
NM_001099783,C4orf33,6,5,16563,1595,14968,2993.6,265.8333333,9.384326019
NM_173487,C4orf33,6,5,19016,1867,17149,3429.8,311.1666667,9.185324049
NM_015130,TBC1D9,21,20,135537,5507,130030,6501.5,262.2380952,23.61176684
NM_024605,ARHGAP10,23,22,340476,3079,337397,15336.22727,133.8695652,109.5800585
NM_031956,TTC29,13,12,238857,1799,237058,19754.83333,138.3846154,131.7720956
NM_001101669,INPP4B,26,25,818424,4050,814374,32574.96,155.7692308,201.08
NM_003866,INPP4B,27,26,818424,4150,814274,31318.23077,153.7037037,196.2106024
NM_178835,ZNF827,15,14,177721,4198,173523,12394.5,279.8666667,41.33468318
NM_001128923,SH3D19,20,19,106229,5212,101017,5316.684211,260.6,19.38161934
NM_001128924,SH3D19,13,12,55273,4208,51065,4255.416667,323.6923077,12.13521863
NM_001130067,TRIM2,12,11,186206,6804,179402,16309.27273,567,26.36713698
NM_017639,DCHS2,25,24,156924,8937,147987,6166.125,357.48,16.55891239
NM_001243349,SH3D19,20,19,107751,5133,102618,5400.947368,256.65,19.99181765
NM_015271,TRIM2,12,11,134878,6769,128109,11646.27273,564.0833333,18.92583838
NM_001009555,SH3D19,21,20,106229,5294,100935,5046.75,252.0952381,19.06592369
NM_001128428,FSTL5,15,14,780144,4820,775324,55380.28571,321.3333333,160.8556017
NM_001166373,Mar-01,8,7,858959,5510,853449,121921.2857,688.75,154.8909256
NM_020116,FSTL5,16,15,780144,4851,775293,51686.2,303.1875,159.821274
NM_001128427,FSTL5,16,15,780144,4848,775296,51686.4,303,159.9207921
NM_021647,MFAP3L,3,2,39683,6192,33491,16745.5,2064,5.40875323
NM_001034845,GALNTL6,13,12,1226985,2862,1224123,102010.25,220.1538462,427.7159329
NM_001009554,MFAP3L,2,1,17189,5829,11360,11360,2914.5,1.948876308
NM_001080477,TENM3,27,26,479042,10837,468205,18007.88462,401.3703704,43.20430008
NM_018248,NEIL3,10,9,53103,2412,50691,5632.333333,241.2,21.01616915
NM_001145672,SORBS2,21,20,225452,4377,221075,11053.75,208.4285714,50.50833905
NM_021069,SORBS2,21,20,371274,6365,364909,18245.45,303.0952381,57.33055774
NM_152683,PRIMPOL,14,13,45347,2309,43038,3310.615385,164.9285714,18.63923777
NM_001270771,SORBS2,24,23,371274,6588,364686,15855.91304,274.5,55.356102
NM_001145673,SORBS2,23,22,190470,5265,185205,8418.409091,228.9130435,35.17663818
NM_001145670,SORBS2,21,20,226814,4950,221864,11093.2,235.7142857,44.8210101
NM_001145671,SORBS2,23,22,225662,4741,220921,10041.86364,206.1304348,46.59797511
NM_003603,SORBS2,23,22,226814,4980,221834,10083.36364,216.5217391,44.54497992
NM_006651,CPLX1,4,3,41202,2144,39058,13019.33333,536,18.21735075
NM_001286833,GAK,25,24,83114,4265,78849,3285.375,170.6,18.48745604
NM_000283,PDE6B,22,21,45320,3425,41895,1995,155.6818182,12.23211679
NM_001145291,PDE6B,22,21,45320,3422,41898,1995.142857,155.5454545,12.24371712
NM_001145292,PDE6B,20,19,17717,2802,14915,785,140.1,5.322983583
NM_005255,GAK,28,27,83111,4559,78552,2909.333333,162.8214286,17.23009432
NM_001127178,PIGG,13,12,40723,3653,37070,3089.166667,281,10.14782371
NM_001289051,PIGG,13,12,40723,3462,37261,3105.083333,266.3076923,10.76285384
NM_001289052,PIGG,11,10,40723,3252,37471,3747.1,295.6363636,11.52244772
NM_017733,PIGG,13,12,40723,3629,37094,3091.166667,279.1538462,10.22154864
NM_001039127,ZNF718,5,4,104758,3669,101091,25272.75,733.8,27.55273917
NM_001289931,ZNF718,5,4,101083,3598,97487,24371.75,719.6,27.09477487
NM_001289930,ZNF718,2,1,33593,4075,29518,29518,2037.5,7.243680982
NM_005882,MAEA,8,7,50255,2074,48181,6883,259.25,23.23095468
NM_001199021,SPON2,8,7,42031,2168,39863,5694.714286,271,18.38699262
NM_133330,WHSC1,24,23,89423,7910,81513,3544.043478,329.5833333,10.30505689
NM_001042424,WHSC1,22,21,110813,7594,103219,4915.190476,345.1818182,13.59217804
NM_006527,SLBP,8,7,19505,1733,17772,2538.857143,216.625,10.25504905
NM_012318,LETM1,14,13,44770,5476,39294,3022.615385,391.1428571,7.175675676
NM_133331,WHSC1,23,22,89423,7729,81694,3713.363636,336.0434783,10.56980204
NM_133335,WHSC1,22,21,89427,7557,81870,3898.571429,343.5,10.83366415
NM_001017405,MAEA,9,8,50255,2198,48057,6007.125,244.2222222,21.86396724
NM_001161527,TNIP2,6,5,14367,1694,12673,2534.6,282.3333333,7.481109799
NM_001185009,RNF4,9,8,46408,3492,42916,5364.5,388,12.28980527
NM_020972,ZFYVE28,13,12,149048,4125,144923,12076.91667,317.3076923,35.13284848
NM_182982,GRK4,16,15,77133,2330,74803,4986.866667,145.625,32.10429185
NM_005307,GRK4,14,13,77133,2094,75039,5772.230769,149.5714286,35.83524355
NM_001172660,ZFYVE28,7,6,36300,1625,34675,5779.166667,232.1428571,21.33846154
NM_001172657,ZFYVE28,7,6,88392,1824,86568,14428,260.5714286,47.46052632
NM_001172659,ZFYVE28,13,12,95282,4158,91124,7593.666667,319.8461538,21.91534392
NM_001172658,ZFYVE28,5,4,90066,1359,88707,22176.75,271.8,65.27373068
NM_001172656,ZFYVE28,12,11,149048,4034,145014,13183.09091,336.1666667,35.94794249
NM_024309,TNIP2,6,5,14718,1980,12738,2547.6,330,6.433333333
NM_014189,ADD1,15,14,86220,4062,82158,5868.428571,270.8,20.22599705
NM_014190,ADD1,16,15,86220,4004,82216,5481.066667,250.25,20.53346653
NM_002938,RNF4,8,7,46793,2969,43824,6260.571429,371.125,14.76052543
NM_001185010,RNF4,7,6,46793,2808,43985,7330.833333,401.1428571,15.66417379
NM_001119,ADD1,15,14,86220,3969,82251,5875.071429,264.6,20.72335601
NM_176801,ADD1,16,15,86220,4097,82123,5474.866667,256.0625,20.04466683
NM_001286645,ADD1,18,17,85927,4774,81153,4773.705882,265.2222222,16.99895266
NM_001004057,GRK4,15,14,77133,2191,74942,5353,146.0666667,34.20447284
NM_001004056,GRK4,15,14,77133,2233,74900,5350,148.8666667,33.54231975
NM_198229,RGS12,18,17,125768,5495,120273,7074.882353,305.2777778,21.88771611
NM_198227,RGS12,16,15,69918,2916,67002,4466.8,182.25,22.97736626
NM_002926,RGS12,17,16,118032,6257,111775,6985.9375,368.0588235,17.86399233
NM_016930,STX18,11,10,123081,2168,120913,12091.3,197.0909091,55.77167897
NM_147127,EVC2,22,21,146150,4432,141718,6748.47619,201.4545455,31.97608303
NM_001099433,JAKMIP1,21,20,174394,3032,171362,8568.1,144.3809524,56.51781003
NM_144720,JAKMIP1,13,12,146838,2600,144238,12019.83333,200,55.47615385
NM_001166136,EVC2,22,21,147131,4870,142261,6774.333333,221.3636364,29.21170431
NM_153717,EVC,21,20,103109,6451,96658,4832.9,307.1904762,14.98341342
NM_020773,TBC1D14,14,13,123352,5023,118329,9102.230769,358.7857143,23.5574358
NM_001206996,PPP2R2C,10,9,100542,4310,96232,10692.44444,431,22.32761021
NM_001206995,PPP2R2C,10,9,235102,4260,230842,25649.11111,426,54.18826291
NM_001206994,PPP2R2C,10,9,243024,4156,238868,26540.88889,415.6,57.47545717
NM_001100590,KIAA0232,9,8,101442,7782,93660,11707.5,864.6666667,12.03546646
NM_014743,KIAA0232,10,9,101442,7867,93575,10397.22222,786.7,11.89462311
NM_001113361,TBC1D14,14,13,123676,4901,118775,9136.538462,350.0714286,24.23485003
NM_001130088,ABLIM2,14,13,151813,2591,149222,11478.61538,185.0714286,57.59243535
NM_198595,AFAP1,17,16,181215,7535,173680,10855,443.2352941,23.04976775
NM_032432,ABLIM2,16,15,193524,3405,190119,12674.6,212.8125,55.83524229
NM_001286688,ABLIM2,15,14,106708,3038,103670,7405,202.5333333,34.12442396
NM_001130087,ABLIM2,17,16,193524,3436,190088,11880.5,202.1176471,55.32246799
NM_001130086,ABLIM2,18,17,193524,3521,190003,11176.64706,195.6111111,53.96279466
NM_001130085,ABLIM2,18,17,193524,3560,189964,11174.35294,197.7777778,53.36067416
NM_001130084,ABLIM2,20,19,193524,3679,189845,9991.842105,183.95,51.60233759
NM_001130083,ABLIM2,21,20,193524,3782,189742,9487.1,180.0952381,50.16975145
NM_001134647,AFAP1,18,17,181215,7788,173427,10201.58824,432.6666667,22.26848998
NM_020041,SLC2A9,12,11,195268,1869,193399,17581.72727,155.75,103.4772606
NM_017491,WDR1,15,14,42612,3158,39454,2818.142857,210.5333333,12.49335022
NM_005112,WDR1,12,11,42612,2735,39877,3625.181818,227.9166667,14.58025594
NM_001001290,SLC2A9,13,12,214026,1881,212145,17678.75,144.6923077,112.7830941
NM_052964,CLNK,19,18,194550,1696,192854,10714.11111,89.26315789,113.7110849
NM_005114,HS3ST1,2,1,30551,1967,28584,28584,983.5,14.53177428
NM_001080522,CC2D2A,38,37,131693,5278,126415,3416.621622,138.8947368,23.95130731
NM_006017,PROM1,27,26,107894,4004,103890,3995.769231,148.2962963,25.94655345
NM_001145850,PROM1,25,24,107894,3909,103985,4332.708333,156.36,26.60143259
NM_001145849,PROM1,26,25,107894,3934,103960,4158.4,151.3076923,26.42602949
NM_001145848,PROM1,27,26,115776,4000,111776,4299.076923,148.1481481,27.944
NM_001145847,PROM1,27,26,115747,4284,111463,4287.038462,158.6666667,26.01844071
NM_001145852,PROM1,24,23,107894,3881,104013,4522.304348,161.7083333,26.80056686
NM_001145851,PROM1,25,24,107894,3906,103988,4332.833333,156.24,26.62263185
NM_015688,FAM184B,18,17,149428,3860,145568,8562.823529,214.4444444,37.7119171
NM_153686,LCORL,7,6,178646,3578,175068,29178,511.1428571,48.92901062
NM_001166139,LCORL,7,6,141267,5050,136217,22702.83333,721.4285714,26.97366337
NM_025221,KCNIP4,8,7,154096,2167,151929,21704.14286,270.875,70.11029072
NM_001130727,PACRGL,5,4,27946,1784,26162,6540.5,356.8,14.66479821
NM_001258346,PACRGL,7,6,27946,1854,26092,4348.666667,264.8571429,14.07335491
NM_001258345,PACRGL,9,8,27946,2163,25783,3222.875,240.3333333,11.92001849
NM_147181,KCNIP4,7,6,122054,2064,119990,19998.33333,294.8571429,58.13468992
NM_145048,PACRGL,8,7,27946,2081,25865,3695,260.125,12.42912062
NM_001289135,SLIT2,36,35,366999,6418,360581,10302.31429,178.2777778,56.18276722
NM_001289136,SLIT2,36,35,366999,6406,360593,10302.65714,177.9444444,56.28988448
NM_004787,SLIT2,37,36,366999,6431,360568,10015.77778,173.8108108,56.06717462
NM_001277225,GBA3,5,4,105485,2068,103417,25854.25,413.6,50.0082205
NM_145290,GPR125,19,18,128682,4586,124096,6894.222222,241.3684211,27.05974706
NM_020973,GBA3,5,4,126660,2166,124494,31123.5,433.2,57.47645429
NM_001128432,GBA3,3,2,126660,1243,125417,62708.5,414.3333333,100.8986323
NM_013261,PPARGC1A,13,12,98058,6331,91727,7643.916667,487,14.48854841
NM_173463,CCDC149,13,12,174089,4075,170014,14167.83333,313.4615385,41.72122699
NM_001130726,CCDC149,12,11,106863,3973,102890,9353.636364,331.0833333,25.89730682
NM_015187,SEL1L3,24,23,115563,4573,110990,4825.652174,190.5416667,24.27071944
NM_015874,RBPJ,11,10,114325,5820,108505,10850.5,529.0909091,18.64347079
NM_203284,RBPJ,12,11,114325,6004,108321,9847.363636,500.3333333,18.04147235
NM_020860,STIM2,12,11,164692,5166,159526,14502.36364,430.5,30.87998451
NM_001169118,STIM2,13,12,164692,5191,159501,13291.75,399.3076923,30.72644962
NM_001169117,STIM2,13,12,164692,5235,159457,13288.08333,402.6923077,30.45978988
NM_018317,TBC1D19,21,20,171374,2221,169153,8457.65,105.7619048,76.16073841
NM_203283,RBPJ,11,10,115422,5757,109665,10966.5,523.3636364,19.04898385
NM_005349,RBPJ,12,11,115422,5874,109548,9958.909091,489.5,18.64964249
NM_032457,PCDH7,3,2,426388,8707,417681,208840.5,2902.333333,47.97071322
NM_001173523,PCDH7,3,2,426388,8731,417657,208828.5,2910.333333,47.83610125
NM_001136536,DTHD1,9,8,63172,3219,59953,7494.125,357.6666667,18.62472818
NM_015230,ARAP2,33,32,178361,7395,170966,5342.6875,224.0909091,23.11913455
NM_001170700,DTHD1,9,8,60765,3374,57391,7173.875,374.8888889,17.00978068
NM_001085399,RELL1,7,6,95579,1334,94245,15707.5,190.5714286,70.64842579
NM_001085400,RELL1,7,6,75745,3625,72120,12020,517.8571429,19.89517241
NM_001104629,C4orf19,4,3,139582,3642,135940,45313.33333,910.5,37.32564525
NM_001144990,KIAA1239,7,6,204399,7484,196915,32819.16667,1069.142857,26.31146446
NM_001253912,TBC1D1,21,20,248093,5699,242394,12119.7,271.3809524,42.53272504
NM_015173,TBC1D1,20,19,248093,5725,242368,12756.21053,286.25,42.33502183
NM_016531,KLF3,6,5,37341,5621,31720,6344,936.8333333,5.643123999
NM_025132,WDR19,37,36,103408,4557,98851,2745.861111,123.1621622,21.69212201
NM_001204747,RFC1,25,24,78934,4924,74010,3083.75,196.96,15.03046304
NM_001171654,KLHL5,11,10,81404,7191,74213,7421.3,653.7272727,10.32026144
NM_138389,FAM114A1,15,14,78013,4153,73860,5275.714286,276.8666667,17.78473393
NM_002913,RFC1,25,24,78934,4921,74013,3083.875,196.84,15.04023572
NM_001007075,KLHL5,12,11,81404,7669,73735,6703.181818,639.0833333,9.614682488
NM_001111113,UBE2K,5,4,84748,5095,79653,19913.25,1019,15.63356232
NM_001111112,UBE2K,6,5,84748,5120,79628,15925.6,853.3333333,15.55234375
NM_005339,UBE2K,7,6,84748,5250,79498,13249.66667,750,15.14247619
NM_174921,SMIM14,5,4,87937,1663,86274,21568.5,332.6,51.87853277
NM_175737,KLB,5,4,44682,6084,38598,9649.5,1216.8,6.34418146
NM_001278361,RHOH,4,3,47859,2234,45625,15208.33333,558.5,20.42300806
NM_001278367,RHOH,3,2,51799,1868,49931,24965.5,622.6666667,26.72965739
NM_001278365,RHOH,4,3,51799,2069,49730,16576.66667,517.25,24.03576607
NM_001278363,RHOH,3,2,47859,2117,45742,22871,705.6666667,21.60699103
NM_024677,NSUN7,12,11,60090,3710,56380,5125.454545,309.1666667,15.1967655
NM_018177,N4BP2,18,17,101350,9684,91666,5392.117647,538,9.465716646
NM_001278369,RHOH,3,2,51117,1875,49242,24621,625,26.2624
NM_001278368,RHOH,3,2,53755,2039,51716,25858,679.6666667,25.36341344
NM_001278366,RHOH,4,3,51799,2049,49750,16583.33333,512.25,24.28013665
NM_001278364,RHOH,5,4,51799,2232,49567,12391.75,446.4,22.20743728
NM_001278362,RHOH,4,3,47859,2160,45699,15233,540,21.15694444
NM_001278360,RHOH,4,3,47859,2258,45601,15200.33333,564.5,20.19530558
NM_001278359,RHOH,4,3,47859,2272,45587,15195.66667,568,20.0647007
NM_019027,RBM47,5,4,92720,4490,88230,22057.5,898,19.65033408
NM_001098634,RBM47,7,6,206613,5148,201465,33577.5,735.4285714,39.13461538
NM_001100400,PDS5A,16,15,79987,2744,77243,5149.533333,171.5,28.14978134
NM_004310,RHOH,3,2,47859,2105,45754,22877,701.6666667,21.73586698
NM_001289124,LIMCH1,26,25,340439,6196,334243,13369.72,238.3076923,53.94496449
NM_001112717,LIMCH1,26,25,339261,6115,333146,13325.84,235.1923077,54.48013083
NM_001112718,LIMCH1,26,25,339261,6112,333149,13325.96,235.0769231,54.50736257
NM_001289122,LIMCH1,26,25,339261,6151,333110,13324.4,236.5769231,54.15542188
NM_014988,LIMCH1,27,26,339261,6194,333067,12810.26923,229.4074074,53.7725218
NM_001112719,LIMCH1,21,20,87274,5892,81382,4069.1,280.5714286,13.81228785
NM_001112720,LIMCH1,20,19,87274,5855,81419,4285.210526,292.75,13.9058924
NM_006345,SLC30A9,18,17,97030,3279,93751,5514.764706,182.1666667,28.59133882
NM_006095,ATP8A1,37,36,248732,8305,240427,6678.527778,224.4594595,28.94966887
NM_001105529,ATP8A1,36,35,248732,8259,240473,6870.657143,229.4166667,29.11647899
NM_198353,KCTD8,2,1,274906,2595,272311,272311,1297.5,104.9368015
NM_021927,GUF1,17,16,22266,4233,18033,1127.0625,249,4.26009922
NM_001204267,GABRA4,8,7,74607,10858,63749,9107,1357.25,5.871154909
NM_130902,COX7B2,3,2,174407,546,173861,86930.5,182,318.4267399
NM_000809,GABRA4,9,8,75509,11982,63527,7940.875,1331.333333,5.301869471
NM_000807,GABRA2,10,9,140477,2425,138052,15339.11111,242.5,56.92865979
NM_001114175,GABRA2,9,8,139817,2782,137035,17129.375,309.1111111,49.25772825
NM_001204266,GABRA4,9,8,74607,11012,63595,7949.375,1223.555556,5.775063567
NM_001286827,GABRA2,10,9,140477,2537,137940,15326.66667,253.7,54.37130469
NM_001142564,CNGA1,10,9,45558,2875,42683,4742.555556,287.5,14.84626087
NM_006587,CORIN,22,21,244110,5031,239079,11384.71429,228.6818182,47.52116875
NM_001278586,CORIN,14,13,195273,2439,192834,14833.38462,174.2142857,79.06273063
NM_001278585,CORIN,20,19,244110,4717,239393,12599.63158,235.85,50.751113
NM_000087,CNGA1,11,10,76969,2794,74175,7417.5,254,26.54795991
NM_020453,ATP10D,23,22,108095,6573,101522,4614.636364,285.7826087,15.44530656
NM_003328,TXK,15,14,67865,2929,64936,4638.285714,195.2666667,22.1700239
NM_001014446,OCIAD2,7,6,21450,809,20641,3440.166667,115.5714286,25.51421508
NM_025087,CWH43,16,15,75832,2486,73346,4889.733333,155.375,29.50362027
NM_015030,FRYL,64,63,282938,11770,271168,4304.253968,183.90625,23.03891249
NM_001286773,OCIAD2,6,5,21450,713,20737,4147.4,118.8333333,29.08415147
NM_020846,SLAIN2,8,7,84604,6019,78585,11226.42857,752.375,13.05615551
NM_152398,OCIAD2,6,5,21450,690,20760,4152,115,30.08695652
NM_001286791,CWH43,16,15,75438,2405,73033,4868.866667,150.3125,30.36715177
NM_001286774,OCIAD2,6,5,21450,711,20739,4147.8,118.5,29.16877637
NM_145263,SPATA18,13,12,45867,4313,41554,3462.833333,331.7692308,9.634593091
NM_030917,FIP1L1,18,17,82285,2476,79809,4694.647059,137.5555556,32.23303716
NM_001126328,LNX1,11,10,131318,3120,128198,12819.8,283.6363636,41.08910256
NM_032622,LNX1,10,9,98001,2850,95151,10572.33333,285,33.38631579
NM_001134937,FIP1L1,18,17,82285,2458,79827,4695.705882,136.5555556,32.47640358
NM_152540,SCFD2,9,8,493093,3183,489910,61238.75,353.6666667,153.914546
NM_001134938,FIP1L1,15,14,82285,2251,80034,5716.714286,150.0666667,35.5548645
NM_012110,CHIC2,6,5,54859,1156,53703,10740.6,192.6666667,46.45588235
NM_024592,SRD5A3,5,4,26880,4086,22794,5698.5,817.2,5.57856094
NM_001267843,CLOCK,24,23,118033,11005,107028,4653.391304,458.5416667,9.725397547
NM_006681,NMU,10,9,41069,826,40243,4471.444444,82.6,48.72033898
NM_002253,KDR,30,29,47338,6085,41253,1422.517241,202.8333333,6.779457683
NM_004898,CLOCK,23,22,119010,10495,108515,4932.5,456.3043478,10.33968556
NM_025009,CEP135,26,25,84557,5761,78796,3151.84,221.5769231,13.67748655
NM_001024924,EXOC1,19,18,51430,3601,47829,2657.166667,189.5263158,13.28214385
NM_032495,HOPX,4,3,33720,1547,32173,10724.33333,386.75,20.7970265
NM_002703,PPAT,11,10,42275,3713,38562,3856.2,337.5454545,10.38567196
NM_178237,EXOC1,18,17,51430,3399,48031,2825.352941,188.8333333,14.13092086
NM_001256475,THEGL,9,8,72716,1475,71241,8905.125,163.8888889,48.29898305
NM_020722,KIAA1211,11,10,160531,7024,153507,15350.7,638.5454545,21.85464123
NM_018261,EXOC1,19,18,51430,3445,47985,2665.833333,181.3157895,13.92888244
NM_001145460,HOPX,5,4,33720,1678,32042,8010.5,335.6,19.09535161
NM_139212,HOPX,3,2,33720,1421,32299,16149.5,473.6666667,22.72976777
NM_001553,IGFBP7,5,4,79316,1134,78182,19545.5,226.8,68.94356261
NM_001253835,IGFBP7,4,3,78149,1055,77094,25698,263.75,73.07488152
NM_001010874,TECRL,12,11,131003,2826,128177,11652.45455,235.5,45.35633404
NM_001281767,EPHA5,17,16,339938,5195,334743,20921.4375,305.5882353,64.43561116
NM_001281766,EPHA5,17,16,350934,8372,342562,21410.125,492.4705882,40.91758242
NM_001281765,EPHA5,18,17,350934,8439,342495,20146.76471,468.8333333,40.58478493
NM_182472,EPHA5,17,16,350934,8369,342565,21410.3125,492.2941176,40.93260844
NM_004439,EPHA5,18,17,350934,8436,342498,20146.94118,468.6666667,40.59957326
NM_207407,TMPRSS11F,10,9,76673,2087,74586,8287.333333,208.7,35.73838045
NM_018227,UBA6,33,32,85412,6480,78932,2466.625,196.3636364,12.1808642
NM_001114387,TMPRSS11A,10,9,53215,2429,50786,5642.888889,242.9,20.90819267
NM_182606,TMPRSS11A,10,9,53215,2438,50777,5641.888889,243.8,20.82731747
NM_014058,TMPRSS11E,10,9,50157,2146,48011,5334.555556,214.6,22.3723206
NM_006798,UGT2A1,7,6,64834,2662,62172,10362,380.2857143,23.3553719
NM_001252275,UGT2A1,7,6,64834,2662,62172,10362,380.2857143,23.3553719
NM_001252274,UGT2A1,7,6,64834,3160,61674,10279,451.4285714,19.51708861
NM_002092,GRSF1,10,9,24130,6641,17489,1943.222222,664.1,2.633488932
NM_173468,MOB1B,6,5,85836,6971,78865,15773,1161.833333,11.31329795
NM_001244767,MOB1B,4,3,74405,2067,72338,24112.66667,516.75,34.99661345
NM_001244766,MOB1B,7,6,85836,7084,78752,13125.33333,1012,11.11688312
NM_001098477,GRSF1,10,9,23723,6477,17246,1916.222222,647.7,2.662652463
NM_000583,GC,13,12,42670,1984,40686,3390.5,152.6153846,20.50705645
NM_053036,NPFFR2,4,3,109071,1945,107126,35708.66667,486.25,55.07763496
NM_001144756,NPFFR2,5,4,109071,2057,107014,26753.5,411.4,52.02430724
NM_001204306,GC,14,13,63828,1856,61972,4767.076923,132.5714286,33.39008621
NM_001204307,GC,14,13,62349,1793,60556,4658.153846,128.0714286,33.77356386
NM_004885,NPFFR2,4,3,116399,2060,114339,38113,515,55.50436893
NM_198889,ANKRD17,33,32,184002,8655,175347,5479.59375,262.2727273,20.25961872
NM_032217,ANKRD17,34,33,184002,9409,174593,5290.69697,276.7352941,18.55595706
NM_173827,COX18,6,5,15058,4529,10529,2105.8,754.8333333,2.324795761
NM_001134,AFP,15,14,19568,2054,17514,1251,136.9333333,8.52677702
NM_001286771,ANKRD17,34,33,148331,9040,139291,4220.939394,265.8823529,15.40829646
NM_001432,EREG,5,4,23619,4633,18986,4746.5,926.6,4.097992661
NM_001144978,MTHFD2L,8,7,144987,2367,142620,20374.28571,295.875,60.25348542
NM_001278538,RCHY1,9,8,35395,4396,30999,3874.875,488.4444444,7.051637853
NM_001278537,RCHY1,7,6,35395,4291,31104,5184,613,7.248659986
NM_001278536,RCHY1,8,7,35395,4319,31076,4439.428571,539.875,7.19518407
NM_001009922,RCHY1,8,7,35395,4412,30983,4426.142857,551.5,7.022438803
NM_015393,PARM1,4,3,117042,5058,111984,37328,1264.5,22.13997628
NM_001278539,RCHY1,9,8,35395,4478,30917,3864.625,497.5555556,6.904198303
NM_015436,RCHY1,9,8,35395,4440,30955,3869.375,493.3333333,6.971846847
NM_003715,USO1,22,21,85539,3853,81686,3889.809524,175.1363636,21.20062289
NM_001242936,FAM47E,8,7,69745,1635,68110,9730,204.375,41.65749235
NM_001130017,ART3,10,9,101624,1547,100077,11119.66667,154.7,64.69101487
NM_001136570,FAM47E,8,7,32085,1562,30523,4360.428571,195.25,19.54097311
NM_006239,PPEF2,17,16,42657,3430,39227,2451.6875,201.7647059,11.43644315
NM_001242939,FAM47E-STBD1,7,6,59432,3067,56365,9394.166667,438.1428571,18.37789371
NM_006835,CCNI,7,6,27950,1880,26070,4345,268.5714286,13.86702128
NM_006419,CXCL13,5,4,100083,1208,98875,24718.75,241.6,81.85016556
NM_025074,FRAS1,74,73,486701,15698,471003,6452.09589,212.1351351,30.00401325
NM_001166133,FRAS1,42,41,389065,7259,381806,9312.341463,172.8333333,52.59760298
NM_198892,BMP2K,16,15,135811,3822,131989,8799.266667,238.875,34.53401361
NM_058172,ANTXR2,17,16,171708,8059,163649,10228.0625,474.0588235,20.30636555
NM_001286781,ANTXR2,17,16,171708,7759,163949,10246.8125,456.4117647,21.13017141
NM_001286780,ANTXR2,17,16,171857,7222,164635,10289.6875,424.8235294,22.79631681
NM_001282482,PRKG2,14,13,66789,3698,63091,4853.153846,264.1428571,17.0608437
NM_001282481,PRKG2,14,13,66789,3785,63004,4846.461538,270.3571429,16.64570674
NM_001282480,PRKG2,15,14,66789,3912,62877,4491.214286,260.8,16.07285276
NM_001282483,PRKG2,14,13,66789,3762,63027,4848.230769,268.7142857,16.75358852
NM_001282485,PRKG2,19,18,127749,4754,122995,6833.055556,250.2105263,25.87189735
NM_006259,PRKG2,19,18,127749,4841,122908,6828.222222,254.7894737,25.38896922
NM_024906,SCD5,4,3,138972,2084,136888,45629.33333,521,65.68522073
NM_016211,SEC31A,25,24,72600,4160,68440,2851.666667,166.4,16.45192308
NM_021204,ENOPH1,6,5,30520,2020,28500,5700,336.6666667,14.10891089
NM_001077207,SEC31A,27,26,72600,4279,68321,2627.730769,158.4814815,15.96658098
NM_001077206,SEC31A,26,25,72600,3936,68664,2746.56,151.3846154,17.44512195
NM_014933,SEC31A,27,26,72607,4283,68324,2627.846154,158.6296296,15.95236983
NM_001077208,SEC31A,27,26,72600,4234,68366,2629.461538,156.8148148,16.146906
NM_001191049,SEC31A,26,25,72523,4073,68450,2738,156.6538462,16.80579425
NM_001037582,SCD5,5,4,169322,3108,166214,41553.5,621.6,53.47940798
NM_016619,PLAC8,5,4,24702,1398,23304,5826,279.6,16.6695279
NM_001130716,PLAC8,5,4,19803,1437,18366,4591.5,287.4,12.78079332
NM_001130715,PLAC8,4,3,20606,1007,19599,6533,251.75,19.46276068
NM_014991,WDFY3,68,67,296853,14385,282468,4215.940299,211.5441176,19.6362878
NM_001042669,ARHGAP24,8,7,223974,4203,219771,31395.85714,525.375,52.28907923
NM_001025616,ARHGAP24,10,9,527541,4654,522887,58098.55556,465.4,112.3521702
NM_031305,ARHGAP24,7,6,72399,4581,67818,11303,654.4285714,14.80419122
NM_001287805,ARHGAP24,8,7,174779,4018,170761,24394.42857,502.25,42.49900448
NM_080685,PTPN13,48,47,220862,8625,212237,4515.680851,179.6875,24.60718841
NM_080684,PTPN13,45,44,220862,8034,212828,4837,178.5333333,26.49091362
NM_080683,PTPN13,48,47,220862,8610,212252,4516,179.375,24.65180023
NM_006264,PTPN13,47,46,220862,8552,212310,4615.434783,181.9574468,24.82577175
NM_005935,AFF1,20,19,134040,9398,124642,6560.105263,469.9,13.26260907
NM_001166693,AFF1,21,20,206054,9306,196748,9837.4,443.1428571,21.14205889
NM_000297,PKD2,15,14,70134,5094,65040,4645.714286,339.6,12.76796231
NM_001265580,FAM13A,16,15,97409,4962,92447,6163.133333,310.125,18.63099557
NM_001265579,FAM13A,17,16,97409,4963,92446,5777.875,291.9411765,18.6270401
NM_001265578,FAM13A,17,16,97409,5005,92404,5775.25,294.4117647,18.46233766
NM_014883,FAM13A,24,23,331243,5906,325337,14145.08696,246.0833333,55.0858449
NM_014606,HERC3,26,25,116121,5000,111121,4444.84,192.3076923,22.2242
NM_016323,HERC5,23,22,49053,3541,45512,2068.727273,153.9565217,12.85286642
NM_001271602,HERC3,25,24,116121,4744,111377,4640.708333,189.76,23.47744519
NM_001015045,FAM13A,18,17,97409,5048,92361,5433,280.4444444,18.29655309
NM_001146055,SNCA,6,5,114199,3028,111171,22234.2,504.6666667,36.71433289
NM_001146054,SNCA,6,5,112879,3217,109662,21932.4,536.1666667,34.08828101
NM_007308,SNCA,5,4,112879,3132,109747,27436.75,626.4,35.04054917
NM_000345,SNCA,6,5,113102,3221,109881,21976.2,536.8333333,34.11393977
NM_007351,MMRN1,8,7,59730,4977,54753,7821.857143,622.125,11.00120555
NM_001128430,SMARCAD1,24,23,83686,5046,78640,3419.130435,210.25,15.58462148
NM_001128429,SMARCAD1,24,23,83449,5144,78305,3404.565217,214.3333333,15.22258942
NM_020159,SMARCAD1,24,23,83449,5138,78311,3404.826087,214.0833333,15.24153367
NM_001256794,BMPR1B,11,10,66961,5451,61510,6151,495.5454545,11.28416804
NM_001203,BMPR1B,13,12,400475,5573,394902,32908.5,428.6923077,70.85986004
NM_001256793,BMPR1B,11,10,106773,5408,101365,10136.5,491.6363636,18.74352811
NM_001256792,BMPR1B,11,10,162220,5467,156753,15675.3,497,28.67258094
NM_001100430,RAP1GDS1,13,12,182487,3498,178989,14915.75,269.0769231,51.16895369
NM_001100429,RAP1GDS1,14,13,182487,3625,178862,13758.61538,258.9285714,49.34124138
NM_001100428,RAP1GDS1,14,13,182487,3628,178859,13758.38462,259.1428571,49.29961411
NM_001100427,RAP1GDS1,15,14,182487,3773,178714,12765.28571,251.5333333,47.36655182
NM_001100426,RAP1GDS1,15,14,182487,3776,178711,12765.07143,251.7333333,47.328125
NM_021159,RAP1GDS1,15,14,182487,3773,178714,12765.28571,251.5333333,47.36655182
NM_005723,TSPAN5,8,7,188296,3405,184891,26413,425.625,54.29985316
NM_001102470,ADH6,9,8,16610,2812,13798,1724.75,312.4444444,4.906827881
NM_000671,ADH5,9,8,17811,2660,15151,1893.875,295.5555556,5.695864662
NM_000672,ADH6,8,7,14526,1408,13118,1874,176,9.316761364
NM_000669,ADH1C,9,8,16270,1482,14788,1848.5,164.6666667,9.978407557
NM_000253,MTTP,19,18,59916,4109,55807,3100.388889,216.2631579,13.58165004
NM_001159694,EMCN,11,10,122754,4009,118745,11874.5,364.4545455,29.61960589
NM_016242,EMCN,12,11,122754,4049,118705,10791.36364,337.4166667,29.31711534
NM_001130692,PPP3CA,12,11,324043,4532,319511,29046.45455,377.6666667,70.50110327
NM_000944,PPP3CA,14,13,324043,4690,319353,24565.61538,335,68.09232409
NM_001130691,PPP3CA,13,12,324043,4659,319384,26615.33333,358.3846154,68.5520498
NM_005908,MANBA,17,16,129510,3328,126182,7886.375,195.7647059,37.91526442
NM_001813,CENPE,49,48,92605,8661,83944,1748.833333,176.755102,9.692183351
NM_001286734,CENPE,47,46,92605,8296,84309,1832.804348,176.5106383,10.16260849
NM_001059,TACR3,5,4,130350,1758,128592,32148,351.6,73.14675768
NM_139173,SLC9B1,12,11,118813,1891,116922,10629.27273,157.5833333,61.83077737
NM_006903,PPA2,11,10,104995,1597,103398,10339.8,145.1818182,64.74514715
NM_001184693,NPNT,12,11,76233,4607,71626,6511.454545,383.9166667,15.54721077
NM_001184691,NPNT,13,12,76233,4695,71538,5961.5,361.1538462,15.2370607
NM_001127208,TET2,11,10,133120,9791,123329,12332.9,890.0909091,12.59615974
NM_001031720,GSTCD,12,11,136914,4134,132780,12070.90909,344.5,32.11901306
NM_001242729,ARHGEF38,14,13,128295,5470,122825,9448.076923,390.7142857,22.45429616
NM_024751,GSTCD,12,11,138943,4055,134888,12262.54545,337.9166667,33.26461159
NM_001184692,NPNT,11,10,76233,4516,71717,7171.7,410.5454545,15.88064659
NM_001184690,NPNT,13,12,76233,4656,71577,5964.75,358.1538462,15.37306701
NM_001033047,NPNT,12,11,76233,4604,71629,6511.727273,383.6666667,15.55799305
NM_176869,PPA2,12,11,104995,1685,103310,9391.818182,140.4166667,61.3115727
NM_176866,PPA2,8,7,104995,1375,103620,14802.85714,171.875,75.36
NM_176867,PPA2,6,5,104995,1181,103814,20762.8,196.8333333,87.90347163
NM_033115,TBCK,24,23,270192,3376,266816,11600.69565,140.6666667,79.03317536
NM_001163436,TBCK,26,25,270630,3388,267242,10689.68,130.3076923,78.87898465
NM_001163435,TBCK,26,25,270192,3567,266625,10665,137.1923077,74.74768713
NM_014421,DKK2,4,3,114496,3641,110855,36951.66667,910.25,30.44630596
NM_001163437,TBCK,26,25,270192,3450,266742,10669.68,132.6923077,77.31652174
NM_001184705,HADH,9,8,45463,2042,43421,5427.625,226.8888889,21.2639569
NM_005327,HADH,8,7,45463,1990,43473,6210.428571,248.75,21.84572864
NM_001136258,SGMS2,7,6,90485,6155,84330,14055,879.2857143,13.70105605
NM_021227,OSTC,4,3,17239,1082,16157,5385.666667,270.5,14.93253235
NM_001267818,OSTC,5,4,17239,1157,16082,4020.5,231.4,13.89974071
NM_001267817,OSTC,3,2,17239,883,16356,8178,294.3333333,18.52321631
NM_001963,EGF,24,23,100080,5607,94473,4107.521739,233.625,16.84911717
NM_001130721,ELOVL6,5,4,149544,3194,146350,36587.5,638.8,45.82028804
NM_024090,ELOVL6,4,3,149593,3396,146197,48732.33333,849,43.04976443
NM_001042734,SEC24B,23,22,106646,4564,102082,4640.090909,198.4347826,22.36678352
NM_006323,SEC24B,24,23,106646,4670,101976,4433.73913,194.5833333,21.83640257
NM_006583,RRH,7,6,16713,1563,15150,2525,223.2857143,9.692898273
NM_017918,CCDC109B,8,7,127519,1282,126237,18033.85714,160.25,98.46879875
NM_001178131,EGF,23,22,100080,5480,94600,4300,238.2608696,17.26277372
NM_001178130,EGF,23,22,100080,5483,94597,4299.863636,238.3913043,17.25278132
NM_001977,ENPEP,20,19,87266,5015,82251,4329,250.75,16.40099701
NM_001204399,PITX2,4,3,24701,1736,22965,7655,434,13.22868664
NM_001204398,PITX2,5,4,24701,1875,22826,5706.5,375,12.17386667
NM_001204397,PITX2,7,6,24701,3485,21216,3536,497.8571429,6.087804878
NM_000325,PITX2,3,2,5676,2317,3359,1679.5,772.3333333,1.449719465
NM_153427,PITX2,5,4,24701,3111,21590,5397.5,622.2,6.93989071
NM_153426,PITX2,6,5,24701,3250,21451,4290.2,541.6666667,6.600307692
NM_018392,C4orf21,28,27,97664,6768,90896,3366.518519,241.7142857,13.43026005
NM_172129,CAMK2D,18,17,304741,2490,302251,17779.47059,138.3333333,121.3859438
NM_001221,CAMK2D,19,18,310897,5891,305006,16944.77778,310.0526316,51.77491088
NM_172128,CAMK2D,18,17,310897,5794,305103,17947.23529,321.8888889,52.65843977
NM_172115,CAMK2D,17,16,304741,2456,302285,18892.8125,144.4705882,123.0802117
NM_172114,CAMK2D,18,17,304741,2499,302242,17778.94118,138.8333333,120.9451781
NM_172127,CAMK2D,18,17,310897,5838,305059,17944.64706,324.3333333,52.25402535
NM_022569,NDST4,14,13,286107,3357,282750,21750,239.7857143,84.22698838
NM_004784,NDST3,14,13,224291,5961,218330,16794.61538,425.7857143,36.62640497
NM_016599,MYOZ2,6,5,52007,2603,49404,9880.8,433.8333333,18.97963888
NM_133477,SYNPO2,5,4,172408,7300,165108,41277,1460,22.61753425
NM_001128934,SYNPO2,5,4,149681,4862,144819,36204.75,972.4,29.78589058
NM_001083,PDE5A,21,20,134433,7010,127423,6371.15,333.8095238,18.17731812
NM_033430,PDE5A,21,20,132894,6841,126053,6302.65,325.7619048,18.42610729
NM_014822,SEC24D,23,22,113350,4086,109264,4966.545455,177.6521739,26.74106706
NM_019050,USP53,18,17,82893,6613,76280,4487.058824,367.3888889,11.53485559
NM_001128933,SYNPO2,4,3,149681,9945,139736,46578.66667,2486.25,14.05087984
NM_001286755,SYNPO2,3,2,172408,4303,168105,84052.5,1434.333333,39.06693005
NM_001286754,SYNPO2,5,4,210561,7252,203309,50827.25,1450.4,28.03488693
NM_033437,PDE5A,21,20,133691,6793,126898,6344.9,323.4761905,18.68070072
NM_198179,QRFPR,6,5,52386,2353,50033,10006.6,392.1666667,21.26349341
NM_001159285,ADAD1,12,11,50354,1917,48437,4403.363636,159.75,25.26708399
NM_001130698,TRPC3,12,11,72728,3560,69168,6288,296.6666667,19.42921348
NM_001159295,ADAD1,12,11,50354,2014,48340,4394.545455,167.8333333,24.0019861
NM_015312,KIAA1109,84,83,192158,15659,176499,2126.493976,186.4166667,11.27140941
NM_139243,ADAD1,13,12,50828,2029,48799,4066.583333,156.0769231,24.05076392
NM_003305,TRPC3,11,10,54087,3341,50746,5074.6,303.7272727,15.18886561
NM_145207,SPATA5,16,15,396381,8156,388225,25881.66667,509.75,47.59992643
NM_024582,FAT4,17,16,176522,16127,160395,10024.6875,948.6470588,9.945743164
NM_014278,HSPA4L,19,18,51075,3289,47786,2654.777778,173.1052632,14.52903618
NM_015693,INTU,16,15,83849,3291,80558,5370.533333,205.6875,24.47827408
NM_152778,MFSD8,13,12,48181,4558,43623,3635.25,350.6153846,9.57064502
NM_199320,JADE1,11,10,65603,5783,59820,5982,525.7272727,10.34411205
NM_024900,JADE1,9,8,55011,4200,50811,6351.375,466.6666667,12.09785714
NM_001287437,JADE1,11,10,65603,5747,59856,5985.6,522.4545455,10.41517313
NM_001287443,JADE1,11,10,63382,5659,57723,5772.3,514.4545455,10.20021205
NM_144643,SCLT1,21,20,209614,3074,206540,10327,146.3809524,67.18932986
NM_018078,LARP1B,20,19,149879,4068,145811,7674.263158,203.4,35.843412
NM_001287442,JADE1,11,10,63956,5655,58301,5830.1,514.0909091,10.30963749
NM_001287441,JADE1,9,8,53364,4079,49285,6160.625,453.2222222,12.08261829
NM_001287440,JADE1,11,10,65307,5698,59609,5960.9,518,10.46138996
NM_001287439,JADE1,11,10,65307,5901,59406,5940.6,536.4545455,10.06710727
NM_032961,PCDH10,5,4,42264,5371,36893,9223.25,1074.2,6.868925712
NM_031296,RAB33B,2,1,22110,3870,18240,18240,1935,4.713178295
NM_006874,ELF2,7,6,26699,3099,23600,3933.333333,442.7142857,7.615359793
NM_001276459,ELF2,6,5,26699,2975,23724,4744.8,495.8333333,7.974453782
NM_001276458,ELF2,7,6,26699,3063,23636,3939.333333,437.5714286,7.716617695
NM_201999,ELF2,9,8,81761,3251,78510,9813.75,361.2222222,24.14949246
NM_057175,NAA15,20,19,89261,5574,83687,4404.578947,278.7,15.01381414
NM_001276457,ELF2,6,5,26699,3011,23688,4737.6,501.8333333,7.86715377
NM_001153484,SCOC,4,3,9048,1963,7085,2361.666667,490.75,3.609271523
NM_001153690,SCOC,3,2,39097,1918,37179,18589.5,639.3333333,19.38425443
NM_001153663,SCOC,4,3,9048,1960,7088,2362.666667,490,3.616326531
NM_001153635,SCOC,5,4,39115,1868,37247,9311.75,373.6,19.93950749
NM_001153585,SCOC,4,3,39097,2003,37094,12364.66667,500.75,18.51922117
NM_001153552,SCOC,3,2,9048,1878,7170,3585,626,3.817891374
NM_001153446,SCOC,5,4,39115,1871,37244,9311,374.2,19.90593266
NM_001204367,MGST2,5,4,74979,1183,73796,18449,236.6,62.38038884
NM_001204366,MGST2,6,5,74979,1284,73695,14739,214,57.39485981
NM_032547,SCOC,5,4,125272,1969,123303,30825.75,393.8,62.62214322
NM_018717,MAML3,6,5,437689,7094,430595,86119,1182.333333,60.69847759
NM_020724,RNF150,7,6,267893,4668,263225,43870.83333,666.8571429,56.38924593
NM_003601,SMARCA5,24,23,44028,7950,36078,1568.608696,331.25,4.538113208
NM_002039,GAB1,10,9,137737,7830,129907,14434.11111,783,16.59093231
NM_001168235,FREM3,8,7,123269,6631,116638,16662.57143,828.875,17.58980546
NM_207123,GAB1,11,10,137737,7921,129816,12981.6,720.0909091,16.38883979
NM_022475,HHIP,13,12,92735,3568,89167,7430.583333,274.4615385,24.99075112
NM_005900,SMAD1,7,6,77376,3060,74316,12386,437.1428571,24.28627451
NM_001256712,ANAPC10,4,3,103646,1340,102306,34102,335,76.34776119
NM_001256711,ANAPC10,7,6,103646,1586,102060,17010,226.5714286,64.35056747
NM_001256710,ANAPC10,6,5,103646,1512,102134,20426.8,252,67.5489418
NM_001256709,ANAPC10,7,6,103646,1616,102030,17005,230.8571429,63.13737624
NM_001256708,ANAPC10,5,4,103968,1679,102289,25572.25,335.8,60.92257296
NM_001256707,ANAPC10,6,5,103646,1547,102099,20419.8,257.8333333,65.99806076
NM_001256706,ANAPC10,5,4,103646,1473,102173,25543.25,294.6,69.36388323
NM_014885,ANAPC10,5,4,103646,1462,102184,25546,292.4,69.89329685
NM_001003688,SMAD1,7,6,76370,2884,73486,12247.66667,412,25.48058252
NM_001029998,SLC10A7,12,11,267988,3795,264193,24017.54545,316.25,69.61607378
NM_000901,NR3C2,9,8,363759,5907,357852,44731.5,656.3333333,60.58100559
NM_001166104,NR3C2,8,7,363759,5555,358204,51172,694.375,64.48316832
NM_001199282,LRBA,57,56,750610,9961,740649,13225.875,174.754386,74.35488405
NM_001040260,DCLK2,16,15,179184,4280,174904,11660.26667,267.5,40.86542056
NM_006726,LRBA,58,57,750840,9957,740883,12997.94737,171.6724138,74.4082555
NM_001040261,DCLK2,17,16,179184,4332,174852,10928.25,254.8235294,40.36288089
NM_001109977,FAM160A1,14,13,254388,4590,249798,19215.23077,327.8571429,54.42222222
NM_001257069,FBXW7,4,3,124083,975,123108,41036,243.75,126.2646154
NM_033393,FHDC1,11,10,36715,6491,30224,3022.4,590.0909091,4.656293329
NM_033632,FBXW7,12,11,213777,3921,209856,19077.81818,326.75,53.52104055
NM_014447,ARFIP1,8,7,131976,2890,129086,18440.85714,361.25,44.66643599
NM_001287432,ARFIP1,10,9,131976,3240,128736,14304,324,39.73333333
NM_001287431,ARFIP1,9,8,131976,2987,128989,16123.625,331.8888889,43.18346167
NM_001025593,ARFIP1,8,7,131976,3025,128951,18421.57143,378.125,42.62842975
NM_001025595,ARFIP1,9,8,131976,3122,128854,16106.75,346.8888889,41.27290199
NM_001287433,ARFIP1,9,8,131976,3008,128968,16121,334.2222222,42.875
NM_001131007,KIAA0922,35,34,170366,5054,165312,4862.117647,144.4,32.70914127
NM_032117,MND1,8,7,70448,953,69495,9927.857143,119.125,72.92235047
NM_001253861,MND1,7,6,70448,837,69611,11601.83333,119.5714286,83.16726404
NM_015196,KIAA0922,35,34,170366,5051,165315,4862.205882,144.3142857,32.72916254
NM_173662,RNF175,9,8,50077,1578,48499,6062.375,175.3333333,30.73447402
NM_001277171,RBM46,6,5,47543,3690,43853,8770.6,615,11.88428184
NM_144979,RBM46,5,4,47543,2529,45014,11253.5,505.8,17.79913009
NM_001277173,RBM46,5,4,47310,3632,43678,10919.5,726.4,12.02588106
NM_001142552,DCHS2,8,7,169073,5072,164001,23428.71429,634,32.33458202
NM_017419,ASIC5,10,9,36546,1702,34844,3871.555556,170.2,20.47238543
NM_001130684,GUCY1A3,9,8,69401,9295,60106,7513.25,1032.777778,6.466487359
NM_001130683,GUCY1A3,10,9,70067,9324,60743,6749.222222,932.4,6.514693265
NM_001130682,GUCY1A3,10,9,70354,9356,60998,6777.555556,935.6,6.519666524
NM_001130685,GUCY1A3,10,9,70067,9145,60922,6769.111111,914.5,6.661782395
NM_001256449,GUCY1A3,10,9,70101,9287,60814,6757.111111,928.7,6.548293313
NM_000856,GUCY1A3,11,10,70354,9451,60903,6090.3,859.1818182,6.444079992
NM_001130687,GUCY1A3,9,8,55861,2699,53162,6645.25,299.8888889,19.69692479
NM_001166061,GLRB,9,8,95967,2774,93193,11649.125,308.2222222,33.59516943
NM_016205,PDGFC,6,5,209785,3014,206771,41354.2,502.3333333,68.60351692
NM_001083620,GRIA2,16,15,145408,5281,140127,9341.8,330.0625,26.53417913
NM_001166060,GLRB,10,9,95689,3051,92638,10293.11111,305.1,30.36315962
NM_000826,GRIA2,16,15,145492,5770,139722,9314.8,360.625,24.2152513
NM_000824,GLRB,10,9,95967,3068,92899,10322.11111,306.8,30.27998696
NM_001083619,GRIA2,16,15,145492,5770,139722,9314.8,360.625,24.2152513
NM_020840,FNIP2,17,16,137774,5803,131971,8248.1875,341.3529412,22.74185766
NM_021634,RXFP1,18,17,131657,3869,127788,7516.941176,214.9444444,33.02868958
NM_152543,C4orf45,5,4,141651,822,140829,35207.25,164.4,171.3248175
NM_001253733,RXFP1,18,17,131657,3881,127776,7516.235294,215.6111111,32.92347333
NM_001253732,RXFP1,19,18,131657,3954,127703,7094.611111,208.1052632,32.29716743
NM_001253730,RXFP1,17,16,131657,3790,127867,7991.6875,222.9411765,33.73799472
NM_001253729,RXFP1,16,15,131657,3723,127934,8528.933333,232.6875,34.363148
NM_001253728,RXFP1,17,16,131657,3769,127888,7993,221.7058824,33.93154683
NM_001253727,RXFP1,18,17,131657,3950,127707,7512.176471,219.4444444,32.33088608
NM_017923,Mar-01,4,3,89328,5393,83935,27978.33333,1348.25,15.56369368
NM_001161521,KLHL2,15,14,113139,3029,110110,7865,201.9333333,36.35193133
NM_001161522,KLHL2,14,13,113139,2921,110218,8478.307692,208.6428571,37.73296816
NM_007246,KLHL2,15,14,115540,3152,112388,8027.714286,210.1333333,35.65609137
NM_001873,CPE,9,8,119387,2437,116950,14618.75,270.7777778,47.98933114
NM_001204760,TLL1,10,9,157703,2322,155381,17264.55556,232.2,66.916882
NM_012464,TLL1,21,20,231201,7291,223910,11195.5,347.1904762,30.71046496
NM_016081,PALLD,21,20,431393,5830,425563,21278.15,277.6190476,72.99536878
NM_007193,ANXA10,12,11,95207,1459,93748,8522.545455,121.5833333,64.25496916
NM_001012967,DDX60L,38,37,123754,6792,116962,3161.135135,178.7368421,17.22055359
NM_017631,DDX60,38,37,102518,6111,96407,2605.594595,160.8157895,15.77597775
NM_001166109,PALLD,19,18,296842,4947,291895,16216.38889,260.3684211,59.00444714
NM_001166108,PALLD,22,21,431393,5882,425511,20262.42857,267.3636364,72.34121047
NM_020870,SH3RF1,12,11,176844,5277,171567,15597,439.75,32.51222285
NM_012224,NEK1,34,33,219359,5707,213652,6474.30303,167.8529412,37.43683196
NM_001199399,NEK1,33,32,219359,5421,213938,6685.5625,164.2727273,39.46467441
NM_001199398,NEK1,35,34,219359,5582,213777,6287.558824,159.4857143,38.2975636
NM_001199397,NEK1,36,35,219359,5715,213644,6104.114286,158.75,37.38302712
NM_001199400,NEK1,33,32,219359,5574,213785,6680.78125,168.9090909,38.35396484
NM_017867,C4orf27,8,7,28476,1224,27252,3893.142857,153,22.26470588
NM_017423,GALNT7,12,11,155216,4319,150897,13717.90909,359.9166667,34.9379486
NM_001278126,ADAM29,6,5,59824,3385,56439,11287.8,564.1666667,16.6732644
NM_001130705,ADAM29,3,2,59824,3141,56683,28341.5,1047,18.04616364
NM_001130704,ADAM29,4,3,59824,3223,56601,18867,805.75,17.56158858
NM_001130703,ADAM29,4,3,59824,3248,56576,18858.66667,812,17.41871921
NM_001145314,CEP44,11,10,49478,3301,46177,4617.7,300.0909091,13.98879128
NM_014269,ADAM29,5,4,59824,3330,56494,14123.5,666,16.96516517
NM_001042543,GLRA3,9,8,187306,3638,183668,22958.5,404.2222222,50.48598131
NM_001278127,ADAM29,2,1,59824,2951,56873,56873,1475.5,19.27245002
NM_001278125,ADAM29,6,5,59824,3392,56432,11286.4,565.3333333,16.63679245
NM_006529,GLRA3,10,9,187306,3684,183622,20402.44444,368.4,49.84310532
NM_170710,WDR17,31,30,116996,7552,109444,3648.133333,243.6129032,14.49205508
NM_005277,GPM6A,8,7,369756,3218,366538,52362.57143,402.25,113.9024239
NM_181265,WDR17,29,28,116996,7382,109614,3914.785714,254.5517241,14.84882146
NM_201592,GPM6A,7,6,369756,3158,366598,61099.66667,451.1428571,116.0854972
NM_201591,GPM6A,7,6,180179,3699,176480,29413.33333,528.4285714,47.71019194
NM_001261448,GPM6A,7,6,154741,3116,151625,25270.83333,445.1428571,48.66014121
NM_001261447,GPM6A,5,4,369756,2806,366950,91737.5,561.2,130.7733428
NM_024949,WWC2,23,22,221468,8831,212637,9665.318182,383.9565217,24.07847356
NM_002199,IRF2,9,8,86852,2295,84557,10569.625,255,36.84400871
NM_153343,ENPP6,8,7,129257,3944,125313,17901.85714,493,31.77307302
NM_001995,ACSL1,21,20,70521,3879,66642,3332.1,184.7142857,17.18020108
NM_001286711,ACSL1,20,19,70521,3776,66745,3512.894737,188.8,17.67611229
NM_020827,KIAA1430,5,4,44365,4884,39481,9870.25,976.8,8.083742834
NM_031953,SNX25,19,18,153838,3232,150606,8367,170.1052632,46.59839109
NM_001286712,ACSL1,22,21,53008,4126,48882,2327.714286,187.5454545,11.84730974
NM_001145411,CCDC110,6,5,26577,2791,23786,4757.2,465.1666667,8.522393407
NM_001286708,ACSL1,21,20,56666,3780,52886,2644.3,180,13.99100529
NM_001145675,SORBS2,15,14,71527,4008,67519,4822.785714,267.2,16.84605788
NM_001145674,SORBS2,15,14,71527,5544,65983,4713.071429,369.6,11.90169553
NM_152775,CCDC110,7,6,26577,2903,23674,3945.666667,414.7142857,8.155012056
NM_000892,KLKB1,15,14,30955,2262,28693,2049.5,150.8,12.68479222
NM_005245,FAT1,27,26,136052,14791,121261,4663.884615,547.8148148,8.198296261
NM_001286052,ZNF595,5,4,34922,2815,32111,8027.75,563,11.4071048
NM_001286054,ZNF595,7,6,34922,3014,31912,5318.666667,430.5714286,10.58792303
NM_182524,ZNF595,6,5,34922,2912,32014,6402.8,485.3333333,10.99381868
NM_001286053,ZNF595,4,3,34922,2687,32239,10746.33333,671.75,11.99813919
NM_003441,ZNF141,4,3,36097,1646,34451,11483.66667,411.5,20.93013366
NM_001137608,ZNF732,3,2,25482,2182,23300,11650,727.3333333,10.67827681
NM_133474,ZNF721,3,2,59189,4695,54494,27247,1565,11.60681576
NM_001289053,PIGG,8,7,23645,3218,20427,2918.142857,402.25,6.34773151
NM_001289055,PIGG,9,8,23645,2685,20960,2620,298.3333333,7.806331471
NM_001289057,PIGG,7,6,23645,2677,20968,3494.666667,382.4285714,7.832648487
NM_007100,ATP5I,4,3,1904,369,1535,511.6666667,92.25,4.159891599
NM_032219,MFSD7,10,9,7357,1876,5481,609,187.6,2.921641791
NM_006315,PCGF3,11,10,64856,5676,59180,5918,516,10.42635659
NM_002477,MYL5,7,6,4108,668,3440,573.3333333,95.42857143,5.149700599
NM_213613,SLC26A1,4,3,5785,3668,2117,705.6666667,917,0.577153762
NM_022042,SLC26A1,3,2,5785,3452,2333,1166.5,1150.666667,0.675840093
NM_021923,FGFRL1,6,5,14436,3094,11342,2268.4,515.6666667,3.665804783
NM_000203,IDUA,14,13,17562,2228,15334,1179.538462,159.1428571,6.882405745
NM_032326,TMEM175,11,10,26183,1783,24400,2440,162.0909091,13.6848009
NM_001347,DGKQ,23,22,14678,4666,10012,455.0909091,202.8695652,2.145735105
NM_134425,SLC26A1,3,2,14369,1178,13191,6595.5,392.6666667,11.19779287
NM_001004356,FGFRL1,7,6,15078,3222,11856,1976,460.2857143,3.679702048
NM_001004358,FGFRL1,7,6,14928,3105,11823,1970.5,443.5714286,3.807729469
NM_001128325,SPON2,7,6,6280,1813,4467,744.5,259,2.463872035
NM_194439,RNF212,10,9,42088,2347,39741,4415.666667,234.7,16.93268002
NM_012445,SPON2,6,5,5938,1870,4068,813.6,311.6666667,2.17540107
NM_001131034,RNF212,10,9,42088,2400,39688,4409.777778,240,16.53666667
NM_001193318,RNF212,4,3,20258,1057,19201,6400.333333,264.25,18.16556291
NM_001012614,CTBP1,10,9,37682,2493,35189,3909.888889,249.3,14.11512234
NM_001328,CTBP1,9,8,37682,2297,35385,4423.125,255.2222222,15.40487593
NM_020894,UVSSA,14,13,40735,4679,36056,2773.538462,334.2142857,7.705920068
NM_175918,CRIPAK,1,0,4444,4444,NA,NA,4444,NA
NM_001013622,FAM53A,5,4,44112,2812,41300,10325,562.4,14.68705548
NM_001174070,FAM53A,5,4,44382,2807,41575,10393.75,561.4,14.81118632
NM_001127266,TMEM129,4,3,5407,2841,2566,855.3333333,710.25,0.903203098
NM_138385,TMEM129,3,2,5407,2680,2727,1363.5,893.3333333,1.017537313
NM_022965,FGFR3,16,15,15562,3967,11595,773,247.9375,2.922863625
NM_000142,FGFR3,18,17,15562,4305,11257,662.1764706,239.1666667,2.614866434
NM_001163213,FGFR3,18,17,15562,4311,11251,661.8235294,239.5,2.609835305
NM_006342,TACC3,16,15,23690,2853,20837,1389.133333,178.3125,7.303540133
NM_007331,WHSC1,11,10,49795,5183,44612,4461.2,471.1818182,8.607370249
NM_133334,WHSC1,9,8,48194,8399,39795,4974.375,933.2222222,4.738064055
NM_005663,NELFA,11,10,26523,2479,24044,2404.4,225.3636364,9.699072207
NM_001168243,C4orf48,4,3,1979,437,1542,514,109.25,3.528604119
NM_178557,NAT8L,3,2,9579,5874,3705,1852.5,1958,0.630745659
NM_001141936,C4orf48,4,3,1922,487,1435,478.3333333,121.75,2.94661191
NM_006454,MXD4,6,5,14581,3779,10802,2160.4,629.8333333,2.858428156
NM_024511,HAUS3,5,4,13766,5605,8161,2040.25,1121,1.456021409
NM_001193282,RP11-503N18.1,16,15,43991,2131,41860,2790.666667,133.1875,19.64335992
NM_003704,FAM193A,19,18,107145,4752,102393,5688.5,250.1052632,21.54734848
NM_001256668,FAM193A,20,19,107145,4846,102299,5384.157895,242.3,21.10998762
NM_001256667,FAM193A,20,19,107145,4819,102326,5385.578947,240.95,21.23386595
NM_001256666,FAM193A,20,19,107145,4876,102269,5382.578947,243.8,20.97395406
NM_003023,SH3BP2,13,12,22284,9222,13062,1088.5,709.3846154,1.416395576
NM_001122681,SH3BP2,13,12,48075,9081,38994,3249.5,698.5384615,4.294020482
NM_001145856,SH3BP2,13,12,22913,9171,13742,1145.166667,705.4615385,1.498418929
NM_001145855,SH3BP2,13,12,28879,9224,19655,1637.916667,709.5384615,2.130854293
NM_001146069,MFSD10,13,12,4300,1770,2530,210.8333333,136.1538462,1.429378531
NM_001120,MFSD10,12,11,3678,1971,1707,155.1818182,164.25,0.866057839
NM_003703,NOP14,19,18,25456,2936,22520,1251.111111,154.5263158,7.670299728
NM_001042690,MSANTD1,3,2,7577,1673,5904,2952,557.6666667,3.528989839
NM_001256896,DOK7,4,3,9940,2268,7672,2557.333333,567,3.382716049
NM_001164673,DOK7,7,6,31178,2562,28616,4769.333333,366,11.16939891
NM_002337,LRPAP1,8,7,28902,10544,18358,2622.571429,1318,1.741084977
NM_001528,HGFAC,14,13,7489,2052,5437,418.2307692,146.5714286,2.649610136
NM_173660,DOK7,7,6,31178,2573,28605,4767.5,367.5714286,11.11737272
NM_000683,ADRA2C,1,0,1959,1959,NA,NA,1959,NA
NM_032927,TMEM128,5,4,12667,1737,10930,2732.5,347.4,6.292458261
NM_001145725,LYAR,10,9,22321,1480,20841,2315.666667,148,14.08175676
NM_145291,ZBTB49,8,7,31591,2951,28640,4091.428571,368.875,9.705184683
NM_017816,LYAR,10,9,22469,1578,20891,2321.222222,157.8,13.23891001
NM_001040101,NSG1,5,4,32804,2600,30204,7551,520,11.61692308
NM_001287763,NSG1,6,5,32804,2656,30148,6029.6,442.6666667,11.35090361
NM_014392,NSG1,5,4,32097,2423,29674,7418.5,484.6,12.24680149
NM_001287764,NSG1,5,4,32804,2546,30258,7564.5,509.2,11.88452474
NM_002448,MSX1,2,1,4270,1939,2331,2331,969.5,1.202166065
NM_018659,CYTL1,4,3,4885,1004,3881,1293.666667,251,3.865537849
NM_005750,C4orf6,3,2,2646,875,1771,885.5,291.6666667,2.024
NM_001313,CRMP1,14,13,67854,3079,64775,4982.692308,219.9285714,21.03767457
NM_001014809,CRMP1,14,13,72321,3185,69136,5318.153846,227.5,21.70675039
NM_001288662,CRMP1,14,13,67051,3115,63936,4918.153846,222.5,20.52520064
NM_001288661,CRMP1,14,13,69464,3292,66172,5090.153846,235.1428571,20.10085055
NM_181876,PPP2R2C,9,8,61294,4101,57193,7149.125,455.6666667,13.9461107
NM_001272053,MRFAP1,3,2,2654,2066,588,294,688.6666667,0.284607938
NM_001272054,MRFAP1,3,2,2654,2113,541,270.5,704.3333333,0.256034075
NM_033296,MRFAP1,2,1,2654,2184,470,470,1092,0.215201465
NM_015274,MAN2B2,19,18,47288,4261,43027,2390.388889,224.2631579,10.09786435
NM_203462,MRFAP1L1,2,1,2179,1593,586,586,796.5,0.367859385
NM_005980,S100P,2,1,3333,512,2821,2821,256,5.509765625
NM_018366,BLOC1S4,1,0,1547,1547,NA,NA,1547,NA
NM_025196,GRPEL1,4,3,8022,1508,6514,2171.333333,377,4.319628647
NM_153376,CCDC96,1,0,2154,2154,NA,NA,2154,NA
NM_001113363,TBC1D14,12,11,45958,4165,41793,3799.363636,347.0833333,10.03433373
NM_152293,TADA2B,2,1,14523,4312,10211,10211,2156,2.368042672
NM_001286805,TBC1D14,12,11,45612,4034,41578,3779.818182,336.1666667,10.30689142
NM_001085382,PSAPL1,1,0,4681,4681,NA,NA,4681,NA
NM_018986,SH3TC1,18,17,41772,4278,37494,2205.529412,237.6666667,8.764375877
NM_053044,HTRA3,9,8,37351,2553,34798,4349.75,283.6666667,13.63023893
NM_152544,TRMT44,11,10,35752,2857,32895,3289.5,259.7272727,11.51382569
NM_080819,GPR78,3,2,9535,4248,5287,2643.5,1416,1.244585687
NM_001014448,CPZ,11,10,27103,2551,24552,2455.2,231.9090909,9.624460996
NM_001014447,CPZ,11,10,27103,2288,24815,2481.5,208,10.84571678
NM_003652,CPZ,10,9,27103,2254,24849,2761,225.4,11.02440106
NM_018942,HMX1,2,1,4772,1898,2874,2874,949,1.514225501
NM_001040071,LOC650293,1,0,652,652,NA,NA,652,NA
NM_001256894,USP17L15,2,1,1951,1682,269,269,841,0.159928656
NM_001256863,USP17L22,1,0,1594,1594,NA,NA,1594,NA
NM_001256863,USP17L22,1,0,1594,1594,NA,NA,1594,NA
NM_001256859,USP17L18,1,0,1594,1594,NA,NA,1594,NA
NM_001256859,USP17L18,1,0,1594,1594,NA,NA,1594,NA
NM_001256854,USP17L11,1,0,1594,1594,NA,NA,1594,NA
NM_001256854,USP17L11,1,0,1594,1594,NA,NA,1594,NA
NM_001256854,USP17L11,1,0,1594,1594,NA,NA,1594,NA
NM_001256853,USP17L12,1,0,1594,1594,NA,NA,1594,NA
NM_001256853,USP17L12,1,0,1594,1594,NA,NA,1594,NA
NM_001256852,USP17L10,1,0,1594,1594,NA,NA,1594,NA
NM_001256862,USP17L21,1,0,1594,1594,NA,NA,1594,NA
NM_001256862,USP17L21,1,0,1594,1594,NA,NA,1594,NA
NM_001256860,USP17L19,1,0,1594,1594,NA,NA,1594,NA
NM_001256861,USP17L20,1,0,1594,1594,NA,NA,1594,NA
NM_001256861,USP17L20,1,0,1594,1594,NA,NA,1594,NA
NM_001256861,USP17L20,1,0,1594,1594,NA,NA,1594,NA
NM_001256857,USP17L17,1,0,1594,1594,NA,NA,1594,NA
NM_001256855,USP17L13,1,0,1594,1594,NA,NA,1594,NA
NM_001242327,USP17L24,1,0,1594,1594,NA,NA,1594,NA
NM_001242327,USP17L24,1,0,1594,1594,NA,NA,1594,NA
NM_001242327,USP17L24,1,0,1594,1594,NA,NA,1594,NA
NM_001242327,USP17L24,1,0,1594,1594,NA,NA,1594,NA
NM_001242327,USP17L24,1,0,1594,1594,NA,NA,1594,NA
NM_001242327,USP17L24,1,0,1594,1594,NA,NA,1594,NA
NM_001242327,USP17L24,1,0,1594,1594,NA,NA,1594,NA
NM_001242327,USP17L24,1,0,1594,1594,NA,NA,1594,NA
NM_001256867,USP17L30,1,0,1594,1594,NA,NA,1594,NA
NM_001256867,USP17L30,1,0,1594,1594,NA,NA,1594,NA
NM_001256867,USP17L30,1,0,1594,1594,NA,NA,1594,NA
NM_001256867,USP17L30,1,0,1594,1594,NA,NA,1594,NA
NM_001256867,USP17L30,1,0,1594,1594,NA,NA,1594,NA
NM_001256867,USP17L30,1,0,1594,1594,NA,NA,1594,NA
NM_001242332,USP17L29,1,0,1594,1594,NA,NA,1594,NA
NM_001242332,USP17L29,1,0,1594,1594,NA,NA,1594,NA
NM_001242332,USP17L29,1,0,1594,1594,NA,NA,1594,NA
NM_001242332,USP17L29,1,0,1594,1594,NA,NA,1594,NA
NM_001242332,USP17L29,1,0,1594,1594,NA,NA,1594,NA
NM_001242332,USP17L29,1,0,1594,1594,NA,NA,1594,NA
NM_001242332,USP17L29,1,0,1594,1594,NA,NA,1594,NA
NM_001242332,USP17L29,1,0,1594,1594,NA,NA,1594,NA
NM_001242331,USP17L28,1,0,1594,1594,NA,NA,1594,NA
NM_001242331,USP17L28,1,0,1594,1594,NA,NA,1594,NA
NM_001242331,USP17L28,1,0,1594,1594,NA,NA,1594,NA
NM_001242331,USP17L28,1,0,1594,1594,NA,NA,1594,NA
NM_001242331,USP17L28,1,0,1594,1594,NA,NA,1594,NA
NM_001242331,USP17L28,1,0,1594,1594,NA,NA,1594,NA
NM_001242331,USP17L28,1,0,1594,1594,NA,NA,1594,NA
NM_001242331,USP17L28,1,0,1594,1594,NA,NA,1594,NA
NM_001242330,USP17L27,1,0,1594,1594,NA,NA,1594,NA
NM_001242330,USP17L27,1,0,1594,1594,NA,NA,1594,NA
NM_001242330,USP17L27,1,0,1594,1594,NA,NA,1594,NA
NM_001242330,USP17L27,1,0,1594,1594,NA,NA,1594,NA
NM_001242330,USP17L27,1,0,1594,1594,NA,NA,1594,NA
NM_001242330,USP17L27,1,0,1594,1594,NA,NA,1594,NA
NM_001242330,USP17L27,1,0,1594,1594,NA,NA,1594,NA
NM_001242330,USP17L27,1,0,1594,1594,NA,NA,1594,NA
NM_001242329,USP17L5,1,0,1594,1594,NA,NA,1594,NA
NM_001242329,USP17L5,1,0,1594,1594,NA,NA,1594,NA
NM_001242329,USP17L5,1,0,1594,1594,NA,NA,1594,NA
NM_001242329,USP17L5,1,0,1594,1594,NA,NA,1594,NA
NM_001242329,USP17L5,1,0,1594,1594,NA,NA,1594,NA
NM_001242329,USP17L5,1,0,1594,1594,NA,NA,1594,NA
NM_001242329,USP17L5,1,0,1594,1594,NA,NA,1594,NA
NM_001242329,USP17L5,1,0,1594,1594,NA,NA,1594,NA
NM_001242328,USP17L26,1,0,1594,1594,NA,NA,1594,NA
NM_001242328,USP17L26,1,0,1594,1594,NA,NA,1594,NA
NM_001242328,USP17L26,1,0,1594,1594,NA,NA,1594,NA
NM_001242328,USP17L26,1,0,1594,1594,NA,NA,1594,NA
NM_001242328,USP17L26,1,0,1594,1594,NA,NA,1594,NA
NM_001242328,USP17L26,1,0,1594,1594,NA,NA,1594,NA
NM_001242328,USP17L26,1,0,1594,1594,NA,NA,1594,NA
NM_001242328,USP17L26,1,0,1594,1594,NA,NA,1594,NA
NM_001242326,USP17L25,1,0,1594,1594,NA,NA,1594,NA
NM_001242326,USP17L25,1,0,1594,1594,NA,NA,1594,NA
NM_001242326,USP17L25,1,0,1594,1594,NA,NA,1594,NA
NM_001242326,USP17L25,1,0,1594,1594,NA,NA,1594,NA
NM_001242326,USP17L25,1,0,1594,1594,NA,NA,1594,NA
NM_001242326,USP17L25,1,0,1594,1594,NA,NA,1594,NA
NM_001242326,USP17L25,1,0,1594,1594,NA,NA,1594,NA
NM_001242326,USP17L25,1,0,1594,1594,NA,NA,1594,NA
NM_001256867,USP17L30,1,0,1594,1594,NA,NA,1594,NA
NM_001256867,USP17L30,1,0,1594,1594,NA,NA,1594,NA
NM_001040448,DEFB131,2,1,5982,215,5767,5767,107.5,26.82325581
NM_000798,DRD5,1,0,2377,2377,NA,NA,2377,NA
NM_053042,ZNF518B,3,2,17530,6939,10591,5295.5,2313,1.52630062
NM_001159601,RAB28,8,7,116644,1797,114847,16406.71429,224.625,63.91040623
NM_001017979,RAB28,7,6,116644,1723,114921,19153.5,246.1428571,66.69820081
NM_004249,RAB28,8,7,116644,1819,114825,16403.57143,227.375,63.1253436
NM_148894,BOD1L1,26,25,58964,10568,48396,1935.84,406.4615385,4.579485238
NM_001189,NKX3-2,2,1,3662,2243,1419,1419,1121.5,0.632634864
NM_182646,CPEB2,10,9,67481,6774,60707,6745.222222,677.4,8.961765574
NM_001177384,CPEB2,10,9,67481,6783,60698,6744.222222,678.3,8.94854784
NM_001177383,CPEB2,11,10,67481,6799,60682,6068.2,618.0909091,8.925136049
NM_001177382,CPEB2,12,11,67481,6890,60591,5508.272727,574.1666667,8.794049347
NM_001177381,CPEB2,11,10,67481,6808,60673,6067.3,618.9090909,8.912015276
NM_182485,CPEB2,11,10,67481,6865,60616,6061.6,624.0909091,8.82971595
NM_031911,C1QTNF7,3,2,18164,4351,13813,6906.5,1450.333333,3.174672489
NM_001135171,C1QTNF7,3,2,71618,4468,67150,33575,1489.333333,15.02909579
NM_001135170,C1QTNF7,3,2,106233,4521,101712,50856,1507,22.4976775
NM_001164720,CC2D2A,5,4,12400,1530,10870,2717.5,306,7.104575163
NM_020785,CC2D2A,7,6,12400,1672,10728,1788,238.8571429,6.416267943
NM_001145191,FAM200B,2,1,8720,4387,4333,4333,2193.5,0.987690905
NM_012161,FBXL5,11,10,51030,3551,47479,4747.9,322.8181818,13.37059983
NM_001193535,FBXL5,11,10,51030,3500,47530,4753,318.1818182,13.58
NM_001193534,FBXL5,11,10,51030,3548,47482,4748.2,322.5454545,13.38275085
NM_001775,CD38,8,7,70777,1499,69278,9896.857143,187.375,46.2161441
NM_031950,FGFBP2,2,1,2998,1173,1825,1825,586.5,1.555839727
NM_005130,FGFBP1,3,2,3172,1361,1811,905.5,453.6666667,1.330639236
NM_153365,TAPT1,14,13,66035,4602,61433,4725.615385,328.7142857,13.349196
NM_000320,QDPR,7,6,25843,1660,24183,4030.5,237.1428571,14.56807229
NM_001079827,CLRN2,3,2,11941,826,11115,5557.5,275.3333333,13.45641646
NM_025205,MED28,4,3,9889,1285,8604,2868,321.25,6.695719844
NM_015907,LAP3,13,12,30665,2113,28552,2379.333333,162.5384615,13.51254141
NM_017741,DCAF16,3,2,10105,4551,5554,2777,1517,1.220391123
NM_001358,DHX15,14,13,57098,3029,54069,4159.153846,216.3571429,17.85044569
NM_003102,SOD3,2,1,5384,1531,3853,3853,765.5,2.516655781
NM_018176,LGI2,8,7,31945,6347,25598,3656.857143,793.375,4.033086498
NM_016955,SEPSECS,11,10,40579,5656,34923,3492.3,514.1818182,6.17450495
NM_018323,PI4K2B,10,9,45180,3611,41569,4618.777778,361.1,11.51176959
NM_024936,ZCCHC4,13,12,57611,2810,54801,4566.75,216.1538462,19.50213523
NM_013367,ANAPC4,29,28,41274,2701,38573,1377.607143,93.13793103,14.28100703
NM_001286756,ANAPC4,29,28,41274,2704,38570,1377.5,93.24137931,14.26405325
NM_001177999,SLC34A2,13,12,22284,4184,18100,1508.333333,321.8461538,4.326003824
NM_001177998,SLC34A2,13,12,22935,4161,18774,1564.5,320.0769231,4.511896179
NM_006424,SLC34A2,13,12,22935,4164,18771,1564.25,320.3076923,4.507925072
NM_001145432,SMIM20,3,2,15689,1017,14672,7336,339,14.42674533
NM_000730,CCKAR,5,4,9026,1687,7339,1834.75,337.4,4.350326023
NM_032456,PCDH7,1,0,4929,4929,NA,NA,4929,NA
NM_002589,PCDH7,2,1,10803,4648,6155,6155,2324,1.324225473
NM_018302,C4orf19,3,2,9279,3636,5643,2821.5,1212,1.551980198
NM_018290,PGM2,14,13,36279,3252,33027,2540.538462,232.2857143,10.15590406
NM_006607,PTTG2,1,0,577,577,NA,NA,577,NA
NM_001253915,TBC1D1,4,3,19223,2544,16679,5559.666667,636,6.556210692
NM_001253914,TBC1D1,6,5,27275,2996,24279,4855.8,499.3333333,8.103805073
NM_001253913,TBC1D1,6,5,28996,3350,25646,5129.2,558.3333333,7.655522388
NM_001195106,TLR10,3,2,10753,3804,6949,3474.5,1268,1.826761304
NM_001017388,TLR10,2,1,10753,3486,7267,7267,1743,2.084624211
NM_001195108,TLR10,3,2,10753,3707,7046,3523,1235.666667,1.900728352
NM_001195107,TLR10,3,2,10753,3676,7077,3538.5,1225.333333,1.925190424
NM_030956,TLR10,4,3,10753,3994,6759,2253,998.5,1.692288433
NM_003263,TLR1,4,3,8538,2855,5683,1894.333333,713.75,1.990542907
NM_006068,TLR6,2,1,33111,5889,27222,27222,2944.5,4.622516556
NM_024943,TMEM156,7,6,65602,1866,63736,10622.66667,266.5714286,34.15648446
NM_199039,KLHL5,10,9,64003,7545,56458,6273.111111,754.5,7.482836315
NM_015990,KLHL5,11,10,64003,7729,56274,5627.4,702.6363636,7.280890154
NM_006859,LIAS,11,10,18629,1760,16869,1686.9,160,9.584659091
NM_001278590,LIAS,10,9,18629,1630,16999,1888.777778,163,10.42883436
NM_001278592,LIAS,3,2,4792,605,4187,2093.5,201.6666667,6.920661157
NM_001184701,UGDH,11,10,28844,3037,25807,2580.7,276.0909091,8.497530458
NM_003359,UGDH,12,11,28844,3207,25637,2330.636364,267.25,7.99407546
NM_001024921,RPL9,7,6,4464,845,3619,603.1666667,120.7142857,4.282840237
NM_194451,LIAS,10,9,18629,1647,16982,1886.888889,164.7,10.31086825
NM_000661,RPL9,8,7,4825,757,4068,581.1428571,94.625,5.373844122
NM_001278591,LIAS,4,3,4792,700,4092,1364,175,5.845714286
NM_001184700,UGDH,11,10,28845,3006,25839,2583.9,273.2727273,8.595808383
NM_017581,CHRNA9,5,4,19890,2281,17609,4402.25,456.2,7.719859711
NM_001166054,APBB2,7,6,47167,6990,40177,6696.166667,998.5714286,5.747782546
NM_001166053,APBB2,7,6,47167,6995,40172,6695.333333,999.2857143,5.742959257
NM_001166052,APBB2,7,6,47130,6994,40136,6689.333333,999.1428571,5.738633114
NM_001166051,APBB2,7,6,47130,7000,40130,6688.333333,1000,5.732857143
NM_004181,UCHL1,9,8,11550,1133,10417,1302.125,125.8888889,9.194174757
NM_003924,PHOX2B,3,2,4890,3033,1857,928.5,1011,0.612265084
NM_001029955,DCAF4L1,1,0,4773,4773,NA,NA,4773,NA
NM_001159547,BEND4,6,5,42027,8785,33242,6648.4,1464.166667,3.783949915
NM_207406,BEND4,6,5,42027,8856,33171,6634.2,1476,3.745596206
NM_001080505,SHISA3,2,1,4650,1973,2677,2677,986.5,1.35681703
NM_182592,YIPF7,6,5,29306,943,28363,5672.6,157.1666667,30.07741251
NM_138335,GNPDA2,7,6,24841,2320,22521,3753.5,331.4285714,9.707327586
NM_001270881,GNPDA2,6,5,24841,2160,22681,4536.2,360,10.50046296
NM_001270880,GNPDA2,6,5,24841,2217,22624,4524.8,369.5,10.20478124
NM_173536,GABRG1,9,8,88297,6777,81520,10190,753,12.02892135
NM_017845,COMMD8,5,4,12867,1416,11451,2862.75,283.2,8.086864407
NM_001278624,NFXL1,23,22,67326,3884,63442,2883.727273,168.8695652,16.33419156
NM_152995,NFXL1,23,22,67413,3786,63627,2892.136364,164.6086957,16.80586371
NM_001278623,NFXL1,23,22,67436,3746,63690,2895,162.8695652,17.00213561
NM_207330,NIPAL1,6,5,20291,2196,18095,3619,366,8.239981785
NM_175619,ZAR1,4,3,4139,1464,2675,891.6666667,366,1.827185792
NM_152679,SLC10A4,3,2,6183,2121,4062,2031,707,1.915134371
NM_001079841,OCIAD1,8,7,30776,1905,28871,4124.428571,238.125,15.15538058
NM_017830,OCIAD1,9,8,30776,2014,28762,3595.25,223.7777778,14.28103277
NM_001079842,OCIAD1,8,7,30592,1923,28669,4095.571429,240.375,14.90847634
NM_001079839,OCIAD1,9,8,30592,2077,28515,3564.375,230.7777778,13.72893597
NM_001079840,OCIAD1,8,7,30776,1860,28916,4130.857143,232.5,15.54623656
NM_001168254,OCIAD1,9,8,30513,2033,28480,3560,225.8888889,14.00885391
NM_001287755,DCUN1D4,11,10,73260,4282,68978,6897.8,389.2727273,16.10882765
NM_001040402,DCUN1D4,11,10,73839,4386,69453,6945.3,398.7272727,15.83515732
NM_001287757,DCUN1D4,12,11,73839,4550,69289,6299,379.1666667,15.22835165
NM_015115,DCUN1D4,10,9,73839,4280,69559,7728.777778,428,16.2521028
NM_001024611,LRRC66,4,3,23922,3333,20589,6863,833.25,6.177317732
NM_000232,SGCB,6,5,17626,4285,13341,2668.2,714.1666667,3.113418903
NM_023940,RASL11B,4,3,4509,1961,2548,849.3333333,490.25,1.299337073
NM_024534,ERVMER34-1,4,3,8125,2989,5136,1712,747.25,1.718300435
NM_001242690,ERVMER34-1,3,2,8125,2868,5257,2628.5,956,1.832984658
NM_133267,GSX2,2,1,1876,1214,662,662,607,0.545304778
NM_006206,PDGFRA,23,22,69150,6597,62553,2843.318182,286.826087,9.48203729
NM_018475,TMEM165,6,5,30264,1981,28283,5656.6,330.1666667,14.27713276
NM_152401,PDCL2,6,5,35689,867,34822,6964.4,144.5,40.16378316
NM_181806,AASDH,15,14,49225,3618,45607,3257.642857,241.2,12.6055832
NM_001286672,AASDH,11,10,38550,2991,35559,3555.9,271.9090909,11.888666
NM_001286671,AASDH,12,11,49225,3196,46029,4184.454545,266.3333333,14.40206508
NM_001286669,AASDH,14,13,49225,3496,45729,3517.615385,249.7142857,13.08037757
NM_001286670,AASDH,12,11,49225,3018,46207,4200.636364,251.5,15.31047051
NM_001286668,AASDH,14,13,49225,3345,45880,3529.230769,238.9285714,13.71599402
NM_006947,SRP72,19,18,36087,3895,32192,1788.444444,205,8.264955071
NM_006452,PAICS,10,9,25621,3349,22272,2474.666667,334.9,6.650343386
NM_001267722,SRP72,17,16,36087,3710,32377,2023.5625,218.2352941,8.726954178
NM_001079525,PAICS,10,9,25267,3349,21918,2435.333333,334.9,6.544640191
NM_001079524,PAICS,9,8,25267,3327,21940,2742.5,369.6666667,6.594529606
NM_206919,ARL9,4,3,18685,840,17845,5948.333333,210,21.24404762
NM_001145459,HOPX,3,2,8536,1192,7344,3672,397.3333333,6.161073826
NM_139211,HOPX,3,2,8536,1148,7388,3694,382.6666667,6.43554007
NM_021114,SPINK2,4,3,12011,745,11266,3755.333333,186.25,15.12214765
NM_001271722,SPINK2,2,1,11884,612,11272,11272,306,18.41830065
NM_001271721,SPINK2,3,2,11884,682,11202,5601,227.3333333,16.42521994
NM_001271720,SPINK2,4,3,11884,723,11161,3720.333333,180.75,15.43706777
NM_001271719,SPINK2,3,2,11884,727,11157,5578.5,242.3333333,15.34662999
NM_001271718,SPINK2,4,3,11884,768,11116,3705.333333,192,14.47395833
NM_001193508,REST,4,3,26933,7126,19807,6602.333333,1781.5,2.779539714
NM_005612,REST,4,3,27970,7337,20633,6877.666667,1834.25,2.812184817
NM_032313,NOA1,7,6,14312,2279,12033,2005.5,325.5714286,5.279947345
NM_000938,POLR2B,25,24,52227,3773,48454,2018.916667,150.92,12.84230056
NM_001812,CENPC,19,18,73269,3368,69901,3883.388889,177.2631579,20.75445368
NM_012108,STAP1,9,8,48172,1520,46652,5831.5,168.8888889,30.69210526
NM_000406,GNRHR,3,2,18707,5840,12867,6433.5,1946.666667,2.203253425
NM_001012763,GNRHR,3,2,18707,5712,12995,6497.5,1904,2.275035014
NM_004262,TMPRSS11D,10,9,63124,2793,60331,6703.444444,279.3,21.60078768
NM_182502,TMPRSS11B,10,9,19043,2655,16388,1820.888889,265.5,6.172504708
NM_001077,UGT2B17,6,5,31344,2082,29262,5852.4,347,14.05475504
NM_001076,UGT2B15,6,5,24181,2264,21917,4383.4,377.3333333,9.68065371
NM_001075,UGT2B10,6,5,16030,2762,13268,2653.6,460.3333333,4.803765387
NM_001144767,UGT2B10,6,5,16030,2510,13520,2704,418.3333333,5.386454183
NM_024743,UGT2A3,6,5,23334,2975,20359,4071.8,495.8333333,6.843361345
NM_001144767,UGT2B10,8,7,15820,1616,14206,2029.428571,202,8.790841584
NM_001075,UGT2B10,8,7,15820,1868,13954,1993.428571,233.5,7.470021413
NM_001074,UGT2B7,6,5,16514,1893,14621,2924.2,315.5,7.723718965
NM_001073,UGT2B11,6,5,14400,1712,12688,2537.6,285.3333333,7.411214953
NM_053039,UGT2B28,6,5,14553,1839,12714,2542.8,306.5,6.913539967
NM_001207004,UGT2B28,4,3,14553,1529,13024,4341.333333,382.25,8.517985612
NM_021139,UGT2B4,6,5,15745,2109,13636,2727.2,351.5,6.465623518
NM_001105677,UGT2A2,6,5,51227,2574,48653,9730.6,429,18.9017094
NM_014465,SULT1B1,8,7,33746,1317,32429,4632.714286,164.625,24.62338648
NM_005420,SULT1E1,8,7,18942,1788,17154,2450.571429,223.5,9.593959732
NM_001891,CSN2,7,6,5754,1074,4680,780,153.4285714,4.357541899
NM_001890,CSN1S1,16,15,15491,997,14494,966.2666667,62.3125,14.53761284
NM_001009181,STATH,5,4,6527,575,5952,1488,115,10.35130435
NM_001025104,CSN1S1,15,14,15491,969,14522,1037.285714,64.6,14.98658411
NM_000200,HTN3,6,5,8127,584,7543,1508.6,97.33333333,12.91609589
NM_003154,STATH,6,5,6527,606,5921,1184.2,101,9.770627063
NM_002159,HTN1,6,5,8402,543,7859,1571.8,90.5,14.4732965
NM_214711,C4orf40,5,4,12424,4802,7622,1905.5,960.4,1.58725531
NM_005212,CSN3,5,4,8814,813,8001,2000.25,162.6,9.841328413
NM_152997,FDCSP,5,4,9182,570,8612,2153,114,15.10877193
NM_017855,ODAM,11,10,8051,1299,6752,675.2,118.0909091,5.197844496
NM_021225,PROL1,3,2,12317,1046,11271,5635.5,348.6666667,10.77533461
NM_012390,SMR3A,3,2,6332,601,5731,2865.5,200.3333333,9.53577371
NM_006685,SMR3B,3,2,7168,788,6380,3190,262.6666667,8.096446701
NM_033122,CABS1,2,1,2164,1546,618,618,773,0.399741268
NM_001145007,MUC7,4,3,11041,2484,8557,2852.333333,621,3.444847021
NM_001286731,AMTN,9,8,14173,1012,13161,1645.125,112.4444444,13.00494071
NM_152291,MUC7,3,2,10882,2446,8436,4218,815.3333333,3.448896157
NM_212557,AMTN,9,8,14173,1015,13158,1644.75,112.7777778,12.9635468
NM_031889,ENAM,9,8,18077,5683,12394,1549.25,631.4444444,2.180890375
NM_016519,AMBN,13,12,15031,2015,13016,1084.666667,155,6.45955335
NM_020368,UTP3,1,0,2074,2074,NA,NA,2074,NA
NM_144646,IGJ,4,3,11092,1413,9679,3226.333333,353.25,6.849964614
NM_001037442,RUFY3,18,17,86642,4436,82206,4835.647059,246.4444444,18.53155996
NM_001130709,RUFY3,12,11,84962,1834,83128,7557.090909,152.8333333,45.32606325
NM_014961,RUFY3,13,12,71580,4278,67302,5608.5,329.0769231,15.73211781
NM_000788,DCK,7,6,37366,2612,34754,5792.333333,373.1428571,13.30551302
NM_000477,ALB,15,14,17159,2262,14897,1064.071429,150.8,6.58576481
NM_001133,AFM,15,14,22258,2012,20246,1446.142857,134.1333333,10.06262425
NM_000584,IL8,4,3,3212,1709,1503,501,427.25,0.879461673
NM_002993,CXCL6,4,3,2206,1663,543,181,415.75,0.32651834
NM_002620,PF4V1,3,2,1187,744,443,221.5,248,0.595430108
NM_001511,CXCL1,4,3,1912,1173,739,246.3333333,293.25,0.630008525
NM_002090,CXCL3,4,3,2180,1157,1023,341,289.25,0.884183232
NM_002089,CXCL2,4,3,2245,1207,1038,346,301.75,0.85998343
NM_002994,CXCL5,4,3,3089,2492,597,199,623,0.239566613
NM_002704,PPBP,3,2,1753,1310,443,221.5,436.6666667,0.338167939
NM_002619,PF4,3,2,1301,859,442,221,286.3333333,0.514551804
NM_001270993,EPGN,4,3,8335,2519,5816,1938.666667,629.75,2.308852719
NM_001270992,EPGN,4,3,8335,2546,5789,1929.666667,636.5,2.273762765
NM_001270991,EPGN,5,4,8335,2547,5788,1447,509.4,2.272477424
NM_001270990,EPGN,5,4,8335,2574,5761,1440.25,514.8,2.238150738
NM_001270989,EPGN,5,4,8335,2700,5635,1408.75,540,2.087037037
NM_001657,AREG,6,5,9875,1244,8631,1726.2,207.3333333,6.938102894
NM_001657,AREG,6,5,9858,1244,8614,1722.8,207.3333333,6.924437299
NM_001729,BTC,6,5,48436,1329,47107,9421.4,221.5,35.44544771
NM_001257072,C4orf26,3,2,9847,1750,8097,4048.5,583.3333333,4.626857143
NM_001206981,C4orf26,3,2,9847,1929,7918,3959,643,4.10471747
NM_144721,THAP6,5,4,15584,3583,12001,3000.25,716.6,3.349427854
NM_178497,C4orf26,2,1,9847,1884,7963,7963,942,4.226645435
NM_203505,G3BP2,12,11,30716,4422,26294,2390.363636,368.5,5.9461782
NM_203504,G3BP2,11,10,30716,4322,26394,2639.4,392.9090909,6.106894956
NM_012297,G3BP2,12,11,30392,4287,26105,2373.181818,357.25,6.089339865
NM_001042402,NAAA,9,8,30360,1741,28619,3577.375,193.4444444,16.43825388
NM_002416,CXCL9,4,3,6020,2549,3471,1157,637.25,1.361710475
NM_014435,NAAA,11,10,27359,1874,25485,2548.5,170.3636364,13.59925293
NM_018115,SDAD1,22,21,41058,3051,38007,1809.857143,138.6818182,12.45722714
NM_001288984,SDAD1,22,21,41058,3126,37932,1806.285714,142.0909091,12.13435701
NM_001288983,SDAD1,21,20,41058,2939,38119,1905.95,139.952381,12.97005784
NM_001130016,ART3,12,11,38109,1599,36510,3319.090909,133.25,22.83302064
NM_017426,NUP54,12,11,33858,2384,31474,2861.272727,198.6666667,13.20218121
NM_005409,CXCL11,4,3,2512,1605,907,302.3333333,401.25,0.565109034
NM_001565,CXCL10,4,3,2422,1220,1202,400.6666667,305,0.985245902
NM_001278603,NUP54,11,10,33858,2239,31619,3161.9,203.5454545,14.12192943
NM_001179,ART3,11,10,38109,1565,36544,3654.4,142.2727273,23.35079872
NM_005506,SCARB2,12,11,55162,4779,50383,4580.272727,398.25,10.54258213
NM_001204255,SCARB2,9,8,55162,4347,50815,6351.875,483,11.68967104
NM_001042784,CCDC158,24,23,94268,3650,90618,3939.913043,152.0833333,24.82684932
NM_003943,STBD1,2,1,5106,2953,2153,2153,1476.5,0.729089062
NM_001029870,SOWAHB,1,0,2922,2922,NA,NA,2922,NA
NM_018243,Sep-11,10,9,88875,5565,83310,9256.666667,556.5,14.9703504
NM_004354,CCNG2,8,7,12858,5482,7376,1053.714286,685.25,1.345494345
NM_020236,MRPL1,9,8,90141,1368,88773,11096.625,152,64.89254386
NM_005139,ANXA3,13,12,58865,1631,57234,4769.5,125.4615385,35.091355
NM_017593,BMP2K,14,13,103064,2680,100384,7721.846154,191.4285714,37.45671642
NM_001040202,PAQR3,6,5,21490,3745,17745,3549,624.1666667,4.738317757
NM_032693,NAA11,2,1,8901,1518,7383,7383,759,4.863636364
NM_033214,GK2,1,0,1867,1867,NA,NA,1867,NA
NM_001145794,ANTXR2,16,15,95817,2320,93497,6233.133333,145,40.30043103
NM_001099403,PRDM8,4,3,6827,3133,3694,1231.333333,783.25,1.179061602
NM_020226,PRDM8,10,9,19060,4107,14953,1661.444444,410.7,3.640857073
NM_033143,FGF5,2,1,24431,5287,19144,19144,2643.5,3.620957064
NM_004464,FGF5,3,2,24431,5392,19039,9519.5,1797.333333,3.53097181
NM_001201,BMP3,3,2,26568,5737,20831,10415.5,1912.333333,3.630991808
NM_152545,RASGEF1B,14,13,44844,2283,42561,3273.923077,163.0714286,18.64257556
NM_002138,HNRNPD,8,7,20684,2118,18566,2652.285714,264.75,8.765816808
NM_031372,HNRNPDL,8,7,7663,4148,3515,502.1428571,518.5,0.847396336
NM_031370,HNRNPD,9,8,20684,2266,18418,2302.25,251.7777778,8.127978817
NM_031369,HNRNPD,8,7,20684,2208,18476,2639.428571,276,8.367753623
NM_001207000,HNRNPDL,7,6,7663,3976,3687,614.5,568,0.927313883
NM_001003810,HNRNPD,7,6,20684,2060,18624,3104,294.2857143,9.040776699
NM_001080506,TMEM150C,8,7,77524,1896,75628,10804,237,39.88818565
NM_024672,THAP9,5,4,19449,4043,15406,3851.5,808.6,3.81053673
NM_016129,COPS4,10,9,40734,1758,38976,4330.666667,175.8,22.17064846
NM_001258006,COPS4,9,8,40734,1672,39062,4882.75,185.7777778,23.36244019
NM_015697,COQ2,7,6,21092,1648,19444,3240.666667,235.4285714,11.79854369
NM_006665,HPSE,13,12,42694,4665,38029,3169.083333,358.8461538,8.151982851
NM_001199830,HPSE,11,10,42354,4383,37971,3797.1,398.4545455,8.663244353
NM_001098540,HPSE,12,11,42422,4626,37796,3436,385.5,8.170341548
NM_001166498,HPSE,11,10,42694,4441,38253,3825.3,403.7272727,8.61360054
NM_133636,HELQ,18,17,48528,3610,44918,2642.235294,200.5555556,12.44265928
NM_139076,FAM175A,9,8,24198,2832,21366,2670.75,314.6666667,7.544491525
NM_016067,MRPS18C,6,5,5813,1127,4686,937.2,187.8333333,4.157941437
NM_001256422,AGPAT9,13,12,69962,2648,67314,5609.5,203.6923077,25.42069486
NM_032717,AGPAT9,12,11,69559,2730,66829,6075.363636,227.5,24.47948718
NM_001256421,AGPAT9,13,12,69769,2644,67125,5593.75,203.3846154,25.3876702
NM_006168,NKX6-1,3,2,4953,1119,3834,1917,373,3.426273458
NM_001263,CDS1,13,12,68438,4551,63887,5323.916667,350.0769231,14.03801362
NM_138981,MAPK10,9,8,92532,3520,89012,11126.5,391.1111111,25.2875
NM_144645,C4orf36,5,4,16219,913,15306,3826.5,182.6,16.7645126
NM_197965,SLC10A6,6,5,25797,1508,24289,4857.8,251.3333333,16.10676393
NM_020803,KLHL8,10,9,59462,4586,54876,6097.333333,458.6,11.96598343
NM_016245,HSD17B11,7,6,54766,1880,52886,8814.333333,268.5714286,28.13085106
NM_001136230,HSD17B13,6,5,19119,2295,16824,3364.8,382.5,7.330718954
NM_178135,HSD17B13,7,6,19119,2404,16715,2785.833333,343.4285714,6.952995008
NM_001128310,SPARCL1,12,11,56169,3018,53151,4831.909091,251.5,17.61133201
NM_198038,NUDT9,8,7,36859,2466,34393,4913.285714,308.25,13.94687753
NM_024047,NUDT9,8,7,36880,2824,34056,4865.142857,353,12.05949008
NM_001248011,NUDT9,7,6,36880,2727,34153,5692.166667,389.5714286,12.52401907
NM_004684,SPARCL1,11,10,56169,2915,53254,5325.4,265,18.26895369
NM_014208,DSPP,5,4,8346,4336,4010,1002.5,867.2,0.924815498
NM_001079911,DMP1,5,4,14060,2643,11417,2854.25,528.6,4.319712448
NM_004407,DMP1,6,5,14060,2692,11368,2273.6,448.6666667,4.222882615
NM_004967,IBSP,7,6,12901,1598,11303,1883.833333,228.2857143,7.073216521
NM_001184697,MEPE,6,5,13849,2211,11638,2327.6,368.5,5.263681592
NM_001184696,MEPE,5,4,13849,2139,11710,2927.5,427.8,5.474520804
NM_001184695,MEPE,5,4,13849,2117,11732,2933,423.4,5.54180444
NM_001184694,MEPE,4,3,25407,2025,23382,7794,506.25,11.54666667
NM_020203,MEPE,4,3,13849,2010,11839,3946.333333,502.5,5.890049751
NM_001040060,SPP1,6,5,7763,1550,6213,1242.6,258.3333333,4.008387097
NM_000582,SPP1,6,5,7763,1589,6174,1234.8,264.8333333,3.885462555
NM_001251830,SPP1,8,7,7763,1822,5941,848.7142857,227.75,3.260702525
NM_001251829,SPP1,5,4,7763,1507,6256,1564,301.4,4.151293962
NM_001040058,SPP1,7,6,7763,1632,6131,1021.833333,233.1428571,3.756740196
NM_004827,ABCG2,16,15,68597,4447,64150,4276.666667,277.9375,14.42545536
NM_152542,PPM1K,7,6,27224,6597,20627,3437.833333,942.4285714,3.126724269
NM_001165136,HERC6,22,21,64360,3803,60557,2883.666667,172.8636364,15.92348146
NM_017912,HERC6,23,22,64360,3912,60448,2747.636364,170.0869565,15.45194274
NM_001042616,PIGY,2,1,2825,1358,1467,1467,679,1.080265096
NM_032906,PYURF,2,1,2825,1358,1467,1467,679,1.080265096
NM_153757,NAP1L5,1,0,1959,1959,NA,NA,1959,NA
NM_145715,TIGD2,1,0,2086,2086,NA,NA,2086,NA
NM_005172,ATOH1,1,0,1066,1066,NA,NA,1066,NA
NM_014485,HPGDS,6,5,44322,1621,42701,8540.2,270.1666667,26.34238125
NM_001254949,SMARCAD1,16,15,38000,3952,34048,2269.866667,247,8.615384615
NM_001256429,PDLIM5,3,2,5334,1226,4108,2054,408.6666667,3.350734095
NM_005390,PDHA2,1,0,1388,1388,NA,NA,1388,NA
NM_001968,EIF4E,7,6,52181,4756,47425,7904.166667,679.4285714,9.971614802
NM_001130679,EIF4E,8,7,52181,4850,47331,6761.571429,606.25,9.758969072
NM_001130678,EIF4E,7,6,50638,3413,47225,7870.833333,487.5714286,13.83680047
NM_015143,METAP1,11,10,67174,2781,64393,6439.3,252.8181818,23.15462064
NM_000670,ADH4,9,8,20618,1988,18630,2328.75,220.8888889,9.371227364
NM_000668,ADH1B,9,8,15057,2701,12356,1544.5,300.1111111,4.574601999
NM_000667,ADH1A,9,8,14664,1509,13155,1644.375,167.6666667,8.717693837
NM_001286650,ADH1B,10,9,15057,2824,12233,1359.222222,282.4,4.331798867
NM_000673,ADH7,9,8,23251,2298,20953,2619.125,255.3333333,9.117928634
NM_001166504,ADH7,9,8,22875,2111,20764,2595.5,234.5555556,9.836096637
NM_032149,C4orf17,9,8,31301,1645,29656,3707,182.7777778,18.02796353
NM_152292,TRMT10A,8,7,16963,3722,13241,1891.571429,465.25,3.55749597
NM_001134665,TRMT10A,8,7,17327,3552,13775,1967.857143,444,3.878096847
NM_001134666,TRMT10A,8,7,17327,3541,13786,1969.428571,442.625,3.893250494
NM_014395,DAPP1,9,8,53367,2946,50421,6302.625,327.3333333,17.11507128
NM_001278311,DNAJB14,4,3,23044,714,22330,7443.333333,178.5,31.2745098
NM_001243736,LAMTOR3,7,6,16210,4266,11944,1990.666667,609.4285714,2.799812471
NM_002106,H2AFZ,5,4,2270,952,1318,329.5,190.4,1.384453782
NM_021970,LAMTOR3,7,6,16210,4287,11923,1987.166667,612.4285714,2.781198974
NM_001278310,DNAJB14,7,6,50478,5908,44570,7428.333333,844,7.544008125
NM_001031723,DNAJB14,8,7,50478,6081,44397,6342.428571,760.125,7.300937346
NM_145244,DDIT4L,3,2,4630,2637,1993,996.5,879,0.755783087
NM_001135146,SLC39A8,9,8,83836,3179,80657,10082.125,353.2222222,25.37181504
NM_001135148,SLC39A8,8,7,62650,2615,60035,8576.428571,326.875,22.95793499
NM_001135147,SLC39A8,11,10,94214,4091,90123,9012.3,371.9090909,22.02957712
NM_022154,SLC39A8,8,7,83529,3300,80229,11461.28571,412.5,24.31181818
NM_001165412,NFKB1,24,23,115975,4106,111869,4863.869565,171.0833333,27.24525085
NM_003998,NFKB1,24,23,115975,4109,111866,4863.73913,171.2083333,27.22462886
NM_003340,UBE2D3,8,7,33567,3969,29598,4228.285714,496.125,7.457294029
NM_181891,UBE2D3,8,7,33567,4134,29433,4204.714286,516.75,7.119738752
NM_181890,UBE2D3,8,7,74512,3791,70721,10103,473.875,18.6549723
NM_181888,UBE2D3,8,7,33567,3826,29741,4248.714286,478.25,7.773392577
NM_181887,UBE2D3,8,7,33172,3947,29225,4175,493.375,7.40435774
NM_181886,UBE2D3,8,7,33567,4177,29390,4198.571429,522.125,7.036150347
NM_181893,UBE2D3,7,6,74512,3638,70874,11812.33333,519.7142857,19.48158329
NM_181892,UBE2D3,8,7,32802,4209,28593,4084.714286,526.125,6.793300071
NM_181889,UBE2D3,8,7,33799,3849,29950,4278.571429,481.125,7.781241881
NM_178833,SLC9B2,12,11,51520,3373,48147,4377,281.0833333,14.27423658
NM_020139,BDH2,10,9,22244,2930,19314,2146,293,6.591808874
NM_025212,CXXC4,3,2,26597,5581,21016,10508,1860.333333,3.765633399
NM_017628,TET2,3,2,96898,9236,87662,43831,3078.666667,9.491338242
NM_017700,ARHGEF38,4,3,79062,1441,77621,25873.66667,360.25,53.86606523
NM_020395,INTS12,8,7,26098,1760,24338,3476.857143,220,13.82840909
NM_001142471,INTS12,7,6,26098,1597,24501,4083.5,228.1428571,15.34189105
NM_001195138,GIMD1,2,1,9254,656,8598,8598,328,13.10670732
NM_001142416,AIMP1,7,6,32719,2591,30128,5021.333333,370.1428571,11.62794288
NM_001142415,AIMP1,7,6,33616,2530,31086,5181,361.4285714,12.28695652
NM_004757,AIMP1,7,6,33530,3152,30378,5063,450.2857143,9.637690355
NM_005443,PAPSS1,12,11,106599,2554,104045,9458.636364,212.8333333,40.73805795
NM_152621,SGMS2,6,5,21786,6238,15548,3109.6,1039.666667,2.492465534
NM_183075,CYP2U1,5,4,21898,4757,17141,4285.25,951.4,3.603321421
NM_001136257,SGMS2,6,5,21786,5962,15824,3164.8,993.6666667,2.654142905
NM_033625,RPL34,6,5,9892,993,8899,1779.8,165.5,8.961732125
NM_000995,RPL34,6,5,9919,908,9011,1802.2,151.3333333,9.924008811
NM_001146590,ETNPPL,13,12,21035,2114,18921,1576.75,162.6153846,8.950331126
NM_031279,ETNPPL,13,12,21035,2132,18903,1575.25,164,8.866322702
NM_001146627,ETNPPL,12,11,21035,2034,19001,1727.363636,169.5,9.341691249
NM_032992,CASP6,4,3,14846,1398,13448,4482.666667,349.5,9.619456366
NM_001226,CASP6,7,6,14846,1668,13178,2196.333333,238.2857143,7.900479616
NM_000204,CFI,13,12,61489,2174,59315,4942.916667,167.2307692,27.28380865
NM_030821,PLA2G12A,4,3,20099,5239,14860,4953.333333,1309.75,2.836419164
NM_018983,GAR1,7,6,9229,1274,7955,1325.833333,182,6.24411303
NM_032993,GAR1,7,6,9229,1015,8214,1369,145,8.092610837
NM_198506,LRIT3,4,3,24133,3588,20545,6848.333333,897,5.726031215
NM_152400,C4orf32,2,1,43686,2728,40958,40958,1364,15.01392962
NM_018569,AP1AR,10,9,38318,2918,35400,3933.333333,291.8,12.13159698
NM_052864,TIFA,2,1,10279,3075,7204,7204,1537.5,2.342764228
NM_001128426,AP1AR,9,8,38318,2818,35500,4437.5,313.1111111,12.59758694
NM_024019,NEUROG2,2,1,2658,2289,369,369,1144.5,0.161205767
NM_016648,LARP7,13,12,20630,2305,18325,1527.083333,177.3076923,7.95010846
NM_015454,LARP7,13,12,20138,2177,17961,1496.75,167.4615385,8.250344511
NM_001267039,LARP7,15,14,20630,2515,18115,1293.928571,167.6666667,7.2027833
NM_024590,ARSJ,2,1,79440,4680,74760,74760,2340,15.97435897
NM_003360,UGT8,5,4,54681,2903,51778,12944.5,580.6,17.83603169
NM_001128174,UGT8,6,5,78593,2912,75681,15136.2,485.3333333,25.9893544
NM_152402,TRAM1L1,1,0,2028,2028,NA,NA,2028,NA
NM_003619,PRSS12,13,12,72731,4586,68145,5678.75,352.7692308,14.85935456
NM_020961,METTL14,11,10,25505,2118,23387,2338.7,192.5454545,11.04202077
NM_000134,FABP2,4,3,4913,2253,2660,886.6666667,563.25,1.180648025
NM_001170330,C4orf3,3,2,8028,2963,5065,2532.5,987.6666667,1.709416132
NM_001001701,C4orf3,2,1,4396,2841,1555,1555,1420.5,0.547342485
NM_002358,MAD2L1,5,4,7436,1441,5995,1498.75,288.2,4.160305344
NM_024574,NDNF,4,3,36893,2875,34018,11339.33333,718.75,11.83234783
NM_024873,TNIP3,11,10,32933,2426,30507,3050.7,220.5454545,12.57502061
NM_001128843,TNIP3,13,12,85220,2422,82798,6899.833333,186.3076923,34.18579686
NM_001244764,TNIP3,13,12,96059,2462,93597,7799.75,189.3846154,38.01665313
NM_001154,ANXA5,13,12,28997,1612,27385,2282.083333,124,16.9882134
NM_018190,BBS7,18,17,42772,2635,40137,2361,146.3888889,15.23225806
NM_001034194,EXOSC9,13,12,15706,1657,14049,1170.75,127.4615385,8.478575739
NM_001237,CCNA2,8,7,7491,2806,4685,669.2857143,350.75,1.669636493
NM_005033,EXOSC9,12,11,15706,1605,14101,1281.909091,133.75,8.785669782
NM_176824,BBS7,19,18,46170,3882,42288,2349.333333,204.3157895,10.89335394
NM_000586,IL2,4,3,5026,802,4224,1408,200.5,5.266832918
NM_001207006,IL21,4,3,8431,711,7720,2573.333333,177.75,10.85794655
NM_021803,IL21,5,4,8431,622,7809,1952.25,124.4,12.55466238
NM_001178007,BBS12,3,2,12243,3435,8808,4404,1145,2.56419214
NM_152618,BBS12,2,1,12243,3246,8997,8997,1623,2.771719039
NM_007083,NUDT6,5,4,29964,1174,28790,7197.5,234.8,24.5229983
NM_198041,NUDT6,5,4,30362,1106,29256,7314,221.2,26.45207957
NM_002006,FGF2,3,2,71529,6777,64752,32376,2259,9.554670208
NM_005841,SPRY1,2,1,4272,2531,1741,1741,1265.5,0.687870407
NM_001258039,SPRY1,2,1,5376,2354,3022,3022,1177,1.283772302
NM_001258038,SPRY1,3,2,6967,2611,4356,2178,870.3333333,1.668326312
NM_199327,SPRY1,2,1,6967,2364,4603,4603,1182,1.947123519
NM_001167882,ANKRD50,4,3,48682,7523,41159,13719.66667,1880.75,5.471088661
NM_020337,ANKRD50,5,4,48685,8802,39883,9970.75,1760.4,4.531129289
NM_031291,SLC25A31,6,5,43894,1818,42076,8415.2,303,23.14411441
NM_001190799,PLK4,15,14,18363,3787,14576,1041.142857,252.4666667,3.848956958
NM_014264,PLK4,16,15,18363,3884,14479,965.2666667,242.75,3.727857878
NM_001190801,PLK4,16,15,17980,3707,14273,951.5333333,231.6875,3.850283248
NM_001039717,C4orf29,11,10,65996,2198,63798,6379.8,199.8181818,29.02547771
NM_001278604,LARP1B,10,9,47640,2233,45407,5045.222222,223.3,20.33452754
NM_032239,LARP1B,9,8,47640,2801,44839,5604.875,311.2222222,16.00821135
NM_178043,LARP1B,11,10,61089,1913,59176,5917.6,173.9090909,30.93361213
NM_006320,PGRMC2,3,2,19594,3793,15801,7900.5,1264.333333,4.165831795
NM_020815,PCDH10,1,0,3936,3936,NA,NA,3936,NA
NM_001114734,PABPC4L,2,1,5416,4945,471,471,2472.5,0.095247725
NM_019035,PCDH18,4,3,13557,5908,7649,2549.666667,1477,1.294685173
NM_014331,SLC7A11,12,11,78257,9660,68597,6236.090909,805,7.101138716
NM_012118,CCRN4L,3,2,30182,1987,28195,14097.5,662.3333333,14.18973327
NM_001184991,NDUFC1,5,4,11295,1203,10092,2523,240.6,8.389027431
NM_001184989,NDUFC1,6,5,12636,790,11846,2369.2,131.6666667,14.99493671
NM_001184990,NDUFC1,5,4,12636,726,11910,2977.5,145.2,16.40495868
NM_032623,MGARP,4,3,14177,1343,12834,4278,335.75,9.556217424
NM_002494,NDUFC1,5,4,11319,865,10454,2613.5,173,12.08554913
NM_001184988,NDUFC1,6,5,12636,767,11869,2373.8,127.8333333,15.47457627
NM_001184987,NDUFC1,5,4,12636,730,11906,2976.5,146,16.30958904
NM_001184986,NDUFC1,6,5,11295,1263,10032,2006.4,210.5,7.942992874
NM_030648,SETD7,8,7,50387,7020,43367,6195.285714,877.5,6.177635328
NM_002413,MGST2,5,4,38486,805,37681,9420.25,161,46.80869565
NM_001204368,MGST2,4,3,38486,733,37753,12584.33333,183.25,51.5047749
NM_001277353,LOC152586,11,10,55004,1352,53652,5365.2,122.9090909,39.68343195
NM_001130675,CLGN,16,15,39210,2838,36372,2424.8,177.375,12.81606765
NM_004362,CLGN,15,14,39210,2753,36457,2604.071429,183.5333333,13.24264439
NM_153702,ELMOD2,9,8,29614,4418,25196,3149.5,490.8888889,5.703033047
NM_021833,UCP1,6,5,8911,1006,7905,1581,167.6666667,7.857852883
NM_014487,ZNF330,10,9,13803,1900,11903,1322.555556,190,6.264736842
NM_032557,USP38,10,9,37073,5205,31868,3540.888889,520.5,6.122574448
NM_002102,GYPE,4,3,30250,501,29749,9916.333333,125.25,59.37924152
NM_198682,GYPE,4,3,34699,1693,33006,11002,423.25,19.49556999
NM_002100,GYPB,5,4,23241,532,22709,5677.25,106.4,42.68609023
NM_002099,GYPA,7,6,31450,2667,28783,4797.166667,381,10.79227597
NM_002940,ABCE1,18,17,31522,4212,27310,1606.470588,234,6.483855651
NM_001102653,OTUD4,21,20,46032,7089,38943,1947.15,337.5714286,5.493440542
NM_001040876,ABCE1,18,17,31522,4209,27313,1606.647059,233.8333333,6.489189831
NM_017493,OTUD4,6,5,15609,842,14767,2953.4,140.3333333,17.53800475
NM_001080531,C4orf51,6,5,52594,851,51743,10348.6,141.8333333,60.80258519
NM_172250,MMAA,7,6,40649,5950,34699,5783.166667,850,5.831764706
NM_007080,LSM6,4,3,14380,791,13589,4529.666667,197.75,17.1795196
NM_032128,SLC10A7,5,4,80305,1809,78496,19624,361.8,43.39192924
NM_004575,POU4F2,2,1,3580,3143,437,437,1571.5,0.139039135
NM_001957,EDNRA,8,7,64039,4158,59881,8554.428571,519.75,14.4013949
NM_001166055,EDNRA,6,5,64039,3829,60210,12042,638.1666667,15.72473231
NM_001256283,EDNRA,7,6,64039,3667,60372,10062,523.8571429,16.46359422
NM_138364,PRMT9,12,11,45748,2841,42907,3900.636364,236.75,15.10278071
NM_018241,TMEM184C,10,9,18135,2983,15152,1683.555556,298.3,5.079450218
NM_006439,MAB21L2,1,0,2770,2770,NA,NA,2770,NA
NM_001006,RPS3A,6,5,5081,940,4141,828.2,156.6666667,4.405319149
NM_001267699,RPS3A,3,2,4634,1584,3050,1525,528,1.925505051
NM_183375,PRSS48,5,4,14282,992,13290,3322.5,198.4,13.39717742
NM_004564,PET112,13,12,90368,2245,88123,7343.583333,172.6923077,39.25300668
NM_018315,FBXW7,11,10,31702,3746,27956,2795.6,340.5454545,7.462893753
NM_001013415,FBXW7,11,10,61256,3581,57675,5767.5,325.5454545,16.10583636
NM_152680,TMEM154,7,6,54053,3223,50830,8471.666667,460.4285714,15.77102079
NM_145720,TIGD4,2,1,10412,2474,7938,7938,1237,3.208569119
NM_003264,TLR2,3,2,21803,3405,18398,9199,1135,5.403230543
NM_003013,SFRP2,3,2,8488,1993,6495,3247.5,664.3333333,3.258906172
NM_001142553,DCHS2,2,1,5337,2555,2782,2782,1277.5,1.088845401
NM_000508,FGA,6,5,7619,3661,3958,791.6,610.1666667,1.081125376
NM_005141,FGB,8,7,9785,3636,6149,878.4285714,454.5,1.691144114
NM_002669,PLRG1,15,14,15438,3373,12065,861.7857143,224.8666667,3.57693448
NM_021871,FGA,5,4,5470,2215,3255,813.75,443,1.469525959
NM_021870,FGG,9,8,8176,1770,6406,800.75,196.6666667,3.61920904
NM_001201564,PLRG1,15,14,15438,3346,12092,863.7142857,223.0666667,3.613867304
NM_000509,FGG,10,9,8618,1671,6947,771.8888889,167.1,4.157390784
NM_001184741,FGB,8,7,9785,3459,6326,903.7142857,432.375,1.828852269
NM_004744,LRAT,3,2,9109,4891,4218,2109,1630.333333,0.862400327
NM_000910,NPY2R,2,1,8449,3628,4821,4821,1814,1.328831312
NM_001039580,MAP9,14,13,34312,7345,26967,2074.384615,524.6428571,3.671477195
NM_000857,GUCY1B3,14,13,48659,3263,45396,3492,233.0714286,13.9123506
NM_005651,TDO2,12,11,16715,1715,15000,1363.636364,142.9166667,8.746355685
NM_001334,CTSO,8,7,29780,2941,26839,3834.142857,367.625,9.125807548
NM_001031700,FAM198B,6,5,48472,4824,43648,8729.6,804,9.048092869
NM_016613,FAM198B,5,4,47988,4844,43144,10786,968.8,8.906688687
NM_001128424,FAM198B,5,4,48472,4799,43673,10918.25,959.8,9.100437591
NM_018342,TMEM144,13,12,45040,3331,41709,3475.75,256.2307692,12.52146503
NM_001281738,ETFDH,11,10,26607,1963,24644,2464.4,178.4545455,12.55425369
NM_004453,ETFDH,13,12,36614,2409,34205,2850.416667,185.3076923,14.19883769
NM_001281737,ETFDH,12,11,36614,2267,34347,3122.454545,188.9166667,15.15086017
NM_005038,PPID,10,9,14275,1844,12431,1381.222222,184.4,6.74132321
NM_001008393,C4orf46,2,1,5377,3531,1846,1846,1765.5,0.522798074
NM_014247,RAPGEF2,24,23,92305,6844,85461,3715.695652,285.1666667,12.48699591
NM_001128931,NAF1,8,7,40215,1643,38572,5510.285714,205.375,23.47656726
NM_138386,NAF1,8,7,38252,1913,36339,5191.285714,239.125,18.99581809
NM_006174,NPY5R,4,3,7997,1847,6150,2050,461.75,3.329723877
NM_000909,NPY1R,3,2,8832,2961,5871,2935.5,987,1.982776089
NM_032136,TKTL2,1,0,2802,2802,NA,NA,2802,NA
NM_018352,TMA16,7,6,26020,1925,24095,4015.833333,275,12.51688312
NM_012403,ANP32C,1,0,706,706,NA,NA,706,NA
NM_001012414,TRIM61,5,4,23222,1585,21637,5409.25,317,13.6511041
NM_153027,FAM218A,1,0,2175,2175,NA,NA,2175,NA
NM_001258025,TRIM60,4,3,9747,2020,7727,2575.666667,505,3.825247525
NM_001100389,TMEM192,6,5,36796,4501,32295,6459,750.1666667,7.175072206
NM_152620,TRIM60,3,2,9747,1845,7902,3951,615,4.282926829
NM_006745,MSMO1,6,5,15498,2234,13264,2652.8,372.3333333,5.93733214
NM_001017369,MSMO1,5,4,15498,1947,13551,3387.75,389.4,6.959938367
NM_001166110,PALLD,12,11,96454,4439,92015,8365,369.9166667,20.72876774
NM_032783,CBR4,5,4,22728,3506,19222,4805.5,701.2,5.482601255
NM_001243372,CLCN3,12,11,102668,6137,96531,8775.545455,511.4166667,15.72934659
NM_001829,CLCN3,13,12,102668,6219,96449,8037.416667,478.3846154,15.50876347
NM_001243374,CLCN3,12,11,63127,5886,57241,5203.727273,490.5,9.724940537
NM_173872,CLCN3,14,13,102668,6296,96372,7413.230769,449.7142857,15.3068615
NM_016228,AADAT,13,12,29812,2339,27473,2289.416667,179.9230769,11.74561779
NM_182662,AADAT,14,13,30001,2122,27879,2144.538462,151.5714286,13.13807729
NM_001286683,AADAT,14,13,30167,2207,27960,2150.769231,157.6428571,12.66878115
NM_001286682,AADAT,14,13,30001,2134,27867,2143.615385,152.4285714,13.05857545
NM_002129,HMGB2,5,4,3070,1532,1538,384.5,306.4,1.003916449
NM_007281,SCRG1,3,2,11320,906,10414,5207,302,11.49448124
NM_001130689,HMGB2,4,3,2395,1458,937,312.3333333,364.5,0.64266118
NM_001130688,HMGB2,5,4,2984,1472,1512,378,294.4,1.027173913
NM_003864,SAP30,4,3,6592,1113,5479,1826.333333,278.25,4.922731357
NM_021973,HAND2,2,1,3728,2370,1358,1358,1185,0.572995781
NM_001040157,CEP44,12,11,36656,4547,32109,2919,378.9166667,7.061579063
NM_012180,FBXO8,6,5,47594,2569,45025,9005,428.1666667,17.52627482
NM_000860,HPGD,7,6,32723,3034,29689,4948.166667,433.4285714,9.785431773
NM_001256305,HPGD,5,4,32723,2791,29932,7483,558.2,10.72447152
NM_001256301,HPGD,7,6,32718,2764,29954,4992.333333,394.8571429,10.83719247
NM_001145816,HPGD,6,5,32723,2869,29854,5970.8,478.1666667,10.40571628
NM_001256307,HPGD,6,5,32723,2926,29797,5959.4,487.6666667,10.183527
NM_001256306,HPGD,5,4,32723,2828,29895,7473.75,565.6,10.57107496
NM_080874,ASB5,7,6,55549,3036,52513,8752.166667,433.7142857,17.29677207
NM_144644,SPATA4,6,5,11099,1239,9860,1972,206.5,7.95803067
NM_021928,SPCS3,5,4,12308,4601,7707,1926.75,920.2,1.675070637
NM_005429,VEGFC,7,6,109212,2092,107120,17853.33333,298.8571429,51.20458891
NM_000027,AGA,9,8,11730,2111,9619,1202.375,234.5555556,4.556608243
NM_001171988,AGA,9,8,11730,2081,9649,1206.125,231.2222222,4.636713119
NM_001012732,DCTD,6,5,27388,2048,25340,5068,341.3333333,12.37304688
NM_001921,DCTD,6,5,27388,2025,25363,5072.6,337.5,12.52493827
NM_001185149,CLDN24,1,0,664,664,NA,NA,664,NA
NM_001111319,CLDN22,1,0,2709,2709,NA,NA,2709,NA
NM_017632,CDKN2AIP,3,2,3262,2377,885,442.5,792.3333333,0.372318048
NM_001564,ING2,2,1,6031,1118,4913,4913,559,4.394454383
NM_199053,TRAPPC11,31,30,54329,4466,49863,1662.1,144.0645161,11.16502463
NM_152682,RWDD4,7,6,19544,2600,16944,2824,371.4285714,6.516923077
NM_021942,TRAPPC11,30,29,54329,4584,49745,1715.344828,152.8,10.85187609
NM_020225,STOX2,4,3,112368,4658,107710,35903.33333,1164.5,23.12365822
NM_032991,CASP3,7,6,21781,2513,19268,3211.333333,359,7.667329885
NM_004346,CASP3,8,7,21781,2681,19100,2728.571429,335.125,7.124207385
NM_024629,CENPU,13,12,40069,2563,37506,3125.5,197.1538462,14.63363246
NM_001286710,ACSL1,21,20,50195,3942,46253,2312.65,187.7142857,11.73338407
NM_001029887,HELT,4,3,1845,988,857,285.6666667,247,0.867408907
NM_001151,SLC25A4,4,3,7123,4424,2699,899.6666667,1106,0.610081374
NM_018409,LRP2BP,8,7,15122,5166,9956,1422.285714,645.75,1.927216415
NM_018359,UFSP2,12,11,26447,2391,24056,2186.909091,199.25,10.06106232
NM_001114357,C4orf47,7,6,20278,981,19297,3216.166667,140.1428571,19.67074414
NM_181726,ANKRD37,5,4,3552,939,2613,653.25,187.8,2.782747604
NM_001114107,PDLIM3,7,6,34899,2715,32184,5364,387.8571429,11.85414365
NM_001257962,PDLIM3,7,6,34899,2595,32304,5384,370.7142857,12.44855491
NM_001257963,PDLIM3,5,4,34899,2356,32543,8135.75,471.2,13.81281834
NM_014476,PDLIM3,8,7,34899,2860,32039,4577,357.5,11.20244755
NM_003265,TLR3,5,4,15945,3046,12899,3224.75,609.2,4.234734077
NM_015398,FAM149A,14,13,27824,2718,25106,1931.230769,194.1428571,9.236938926
NM_207352,CYP4V2,11,10,21945,4715,17230,1723,428.6363636,3.654294804
NM_001006655,FAM149A,13,12,23492,2418,21074,1756.166667,186,8.715467328
NM_000128,F11,15,14,23719,3293,20426,1459,219.5333333,6.20285454
NM_005958,MTNR1A,2,1,21730,1107,20623,20623,553.5,18.62962963
NM_174900,ZFP42,4,3,9276,2650,6626,2208.666667,662.5,2.500377358
NM_173553,TRIML2,7,6,13983,1307,12676,2112.666667,186.7142857,9.698546289
NM_178556,TRIML1,6,5,8053,1651,6402,1280.4,275.1666667,3.877649909
NM_001199232,LOC100288255,4,3,2891,2087,804,268,521.75,0.385241974
NM_001286820,FRG2,4,3,2891,2090,801,267,522.5,0.383253589
NM_001005217,FRG2,4,3,2891,2087,804,268,521.75,0.385241974
NM_004477,FRG1,9,8,22387,1052,21335,2666.875,116.8888889,20.28041825
NM_012147,DUX2,1,0,1381,1381,NA,NA,1381,NA
NM_012147,DUX2,1,0,1381,1381,NA,NA,1381,NA
NM_012147,DUX2,1,0,1381,1381,NA,NA,1381,NA
NM_012147,DUX2,1,0,1381,1381,NA,NA,1381,NA
NM_012147,DUX2,1,0,1381,1381,NA,NA,1381,NA
NM_012147,DUX2,1,0,1381,1381,NA,NA,1381,NA
NM_033178,DUX4,1,0,1381,1381,NA,NA,1381,NA
NM_033178,DUX4,1,0,1381,1381,NA,NA,1381,NA
NM_033178,DUX4,1,0,1381,1381,NA,NA,1381,NA
NM_001127389,DUX4L5,1,0,1381,1381,NA,NA,1381,NA
NM_001127389,DUX4L5,1,0,1381,1381,NA,NA,1381,NA
NM_001127389,DUX4L5,1,0,1381,1381,NA,NA,1381,NA
NM_001127389,DUX4L5,1,0,1381,1381,NA,NA,1381,NA
NM_001127389,DUX4L5,1,0,1381,1381,NA,NA,1381,NA
NM_001127389,DUX4L5,1,0,1381,1381,NA,NA,1381,NA
NM_001127388,DUX4L6,1,0,1381,1381,NA,NA,1381,NA
NM_001127388,DUX4L6,1,0,1381,1381,NA,NA,1381,NA
NM_001127388,DUX4L6,1,0,1381,1381,NA,NA,1381,NA
NM_001127388,DUX4L6,1,0,1381,1381,NA,NA,1381,NA
NM_001127388,DUX4L6,1,0,1381,1381,NA,NA,1381,NA
NM_001127388,DUX4L6,1,0,1381,1381,NA,NA,1381,NA
NM_001127386,DUX4L2,1,0,1381,1381,NA,NA,1381,NA
NM_001127386,DUX4L2,1,0,1381,1381,NA,NA,1381,NA
NM_001127386,DUX4L2,1,0,1381,1381,NA,NA,1381,NA
NM_001127386,DUX4L2,1,0,1381,1381,NA,NA,1381,NA
NM_001127386,DUX4L2,1,0,1381,1381,NA,NA,1381,NA
NM_001127386,DUX4L2,1,0,1381,1381,NA,NA,1381,NA
NM_033178,DUX4,1,0,1381,1381,NA,NA,1381,NA
NM_033178,DUX4,1,0,1381,1381,NA,NA,1381,NA
NM_033178,DUX4,1,0,1381,1381,NA,NA,1381,NA
NM_001177376,DUX4L4,1,0,1375,1375,NA,NA,1375,NA
NM_001177376,DUX4L4,1,0,1381,1381,NA,NA,1381,NA
NM_001164467,DUX4L3,1,0,1381,1381,NA,NA,1381,NA
NM_001164467,DUX4L3,1,0,1381,1381,NA,NA,1381,NA
NM_001164467,DUX4L3,1,0,1381,1381,NA,NA,1381,NA
NM_001164467,DUX4L3,1,0,1381,1381,NA,NA,1381,NA
NM_001164467,DUX4L3,1,0,1381,1381,NA,NA,1381,NA
NM_001164467,DUX4L3,1,0,1381,1381,NA,NA,1381,NA
NM_024715,TXNDC15,5,4,27865,3694,24171,6042.75,738.8,6.543313481
NM_030955,ADAMTS12,24,23,364839,4978,359861,15646.13043,207.4166667,72.29027722
NM_006203,PDE4D,15,14,617460,7785,609675,43548.21429,519,78.31406551
NM_012334,MYO10,41,40,274371,11471,262900,6572.5,279.7804878,22.91866446
NM_001165899,PDE4D,17,16,1519061,8135,1510926,94432.875,478.5294118,185.7315304
NM_001104631,PDE4D,15,14,924757,8242,916515,65465.35714,549.4666667,111.2005581
NM_001197218,PDE4D,15,14,799574,7981,791593,56542.35714,532.0666667,99.18468864
NM_001146321,GRAMD3,15,14,70986,2992,67994,4856.714286,199.4666667,22.72526738
NM_001146320,GRAMD3,13,12,70986,2835,68151,5679.25,218.0769231,24.03915344
NM_002372,MAN2A1,22,21,180261,7136,173125,8244.047619,324.3636364,24.26079036
NM_001146322,GRAMD3,14,13,29068,2610,26458,2035.230769,186.4285714,10.13716475
NM_001146319,GRAMD3,14,13,134067,2799,131268,10097.53846,199.9285714,46.89817792
NM_023927,GRAMD3,14,13,70986,2948,68038,5233.692308,210.5714286,23.07937585
NM_014979,SV2C,13,12,242113,2375,239738,19978.16667,182.6923077,100.9423158
NM_001161662,WWC1,23,22,180245,6759,173486,7885.727273,293.8695652,25.66740642
NM_001135608,ARHGAP26,23,22,458282,8899,449383,20426.5,386.9130435,50.49814586
NM_015071,ARHGAP26,23,22,458282,9064,449218,20419,394.0869565,49.56067961
NM_015238,WWC1,23,22,180245,6744,173501,7886.409091,293.2173913,25.72672005
NM_001161661,WWC1,23,22,180245,6762,173483,7885.590909,294,25.65557527
NM_000679,ADRA1B,2,1,56279,2256,54023,54023,1128,23.94636525
NM_139056,ADAMTS16,23,22,179971,4997,174974,7953.363636,217.2608696,35.01580949
NM_138348,FAM105B,7,6,35061,7903,27158,4526.333333,1129,3.436416551
NM_012304,FBXL7,4,3,439602,4571,435031,145010.3333,1142.75,95.17195362
NM_001278317,FBXL7,4,3,438360,4339,434021,144673.6667,1084.75,100.0278866
NM_003966,SEMA5A,23,22,511097,11831,499266,22693.90909,514.3913043,42.19981405
NM_001288717,CTNND2,21,20,932203,4935,927268,46363.4,235,187.8962513
NM_001288715,CTNND2,21,20,617077,5308,611769,30588.45,252.7619048,115.2541447
NM_001288716,CTNND2,19,18,617077,4568,612509,34028.27778,240.4210526,134.0869089
NM_001332,CTNND2,22,21,932203,5501,926702,44128.66667,250.0454545,168.4606435
NM_001167667,CDH18,13,12,515200,2991,512209,42684.08333,230.0769231,171.2500836
NM_004934,CDH18,13,12,515200,3100,512100,42675,238.4615385,165.1935484
NM_004061,CDH12,15,14,1102760,4360,1098400,78457.14286,290.6666667,251.9266055
NM_013235,DROSHA,35,34,131682,5456,126226,3712.529412,155.8857143,23.13526393
NM_001100412,DROSHA,35,34,131682,5421,126261,3713.558824,154.8857143,23.2910902
NM_024867,SPEF2,37,36,196726,5675,191051,5306.972222,153.3783784,33.66537445
NM_018034,WDR70,18,17,373364,2140,371224,21836.70588,118.8888889,173.4691589
NM_144722,SPEF2,10,9,53689,2992,50697,5633,299.2,16.94418449
NM_019087,ARL15,5,4,425791,2491,423300,105825,498.2,169.9317543
NM_001134779,IPO11,30,29,209707,4479,205228,7076.827586,149.3,45.82004912
NM_198828,MAST4,6,5,390177,1104,389073,77814.6,184,352.4211957
NM_020928,ZSWIM6,14,13,213901,5517,208384,16029.53846,394.0714286,37.77125249
NM_001164664,MAST4,29,28,573249,10753,562496,20089.14286,370.7931034,52.31061099
NM_016338,IPO11,30,29,215845,4419,211426,7290.551724,147.3,47.84476126
NM_019072,SGTB,11,10,56188,5464,50724,5072.4,496.7272727,9.283308931
NM_001164443,ANKRD31,25,24,168583,6061,162522,6771.75,242.44,26.81438706
NM_138782,FCHO2,26,25,134543,5007,129536,5181.44,192.5769231,25.87098063
NM_001146032,FCHO2,25,24,134543,4907,129636,5401.5,196.28,26.41858569
NM_001164098,VCAN,14,13,110631,7168,103463,7958.692308,512,14.43401228
NM_001164097,VCAN,14,13,110631,9469,101162,7781.692308,676.3571429,10.68349351
NM_003719,PDE8B,22,21,217376,4426,212950,10140.47619,201.1818182,48.1134207
NM_001029852,PDE8B,21,20,217376,4260,213116,10655.8,202.8571429,50.02723005
NM_001029851,PDE8B,19,18,217376,4132,213244,11846.88889,217.4736842,51.60793804
NM_001029854,PDE8B,21,20,217376,4284,213092,10654.6,204,49.74136321
NM_001256732,SSBP2,17,16,333895,4482,329413,20588.3125,263.6470588,73.49687639
NM_012446,SSBP2,17,16,333895,4458,329437,20589.8125,262.2352941,73.89793629
NM_001256733,SSBP2,16,15,333895,4397,329498,21966.53333,274.8125,74.9370025
NM_001256736,SSBP2,15,14,333895,4267,329628,23544.85714,284.4666667,77.2505273
NM_001256735,SSBP2,16,15,333895,4367,329528,21968.53333,272.9375,75.45866728
NM_001256734,SSBP2,16,15,333895,4391,329504,21966.93333,274.4375,75.0407652
NM_001126336,VCAN,13,12,110631,4206,106425,8868.75,323.5384615,25.30313837
NM_001029853,PDE8B,21,20,217376,4365,213011,10650.55,207.8571429,48.7997709
NM_004385,VCAN,15,14,110631,12431,98200,7014.285714,828.7333333,7.899605824
NM_032119,GPR98,90,89,605418,19423,585995,6584.213483,215.8111111,30.17015909
NM_001193350,MEF2C,11,10,165227,6447,158780,15878,586.0909091,24.62850938
NM_001193349,MEF2C,9,8,105688,5693,99995,12499.375,632.5555556,17.56455296
NM_001193348,MEF2C,8,7,105688,5764,99924,14274.85714,720.5,17.33587786
NM_001193347,MEF2C,12,11,185866,6256,179610,16328.18182,521.3333333,28.71003836
NM_002397,MEF2C,11,10,165227,6450,158777,15877.7,586.3636364,24.61658915
NM_001131005,MEF2C,11,10,185866,6195,179671,17967.1,563.1818182,29.00258273
NM_024717,MCTP1,23,22,577992,3935,574057,26093.5,171.0869565,145.8848793
NM_032042,FAM172A,11,10,493975,4731,489244,48924.4,430.0909091,103.4123864
NM_001163418,FAM172A,9,8,493975,4413,489562,61195.25,490.3333333,110.9363245
NM_001163417,FAM172A,10,9,493975,4606,489369,54374.33333,460.6,106.2459835
NM_153234,LIX1,6,5,50948,3973,46975,9395,662.1666667,11.82355902
NM_001002796,MCTP1,23,22,375258,3631,371627,16892.13636,157.8695652,102.3483889
NM_001962,EFNA5,5,4,294008,5340,288668,72167,1068,54.0576779
NM_173488,SLCO6A1,14,13,127236,2703,124533,9579.461538,193.0714286,46.07214206
NM_001289004,SLCO6A1,13,12,127236,2516,124720,10393.33333,193.5384615,49.57074722
NM_001289002,SLCO6A1,14,13,127236,2651,124585,9583.461538,189.3571429,46.99547341
NM_001204196,SRP19,4,3,7206,1407,5799,1933,351.75,4.121535181
NM_001204194,SRP19,4,3,7206,1411,5795,1931.666667,352.75,4.1070163
NM_001204193,SRP19,5,4,7206,1516,5690,1422.5,303.2,3.753298153
NM_003135,SRP19,5,4,7206,1484,5722,1430.5,296.8,3.855795148
NM_001204199,SRP19,5,4,31893,1972,29921,7480.25,394.4,15.17292089
NM_001142475,NREP,4,3,247630,2153,245477,81825.66667,538.25,114.0162564
NM_001142474,NREP,4,3,247630,2123,245507,81835.66667,530.75,115.641545
NM_173800,AQPEP,20,19,65150,4641,60509,3184.684211,232.05,13.03792286
NM_001166226,CEP120,20,19,78709,4650,74059,3897.842105,232.5,15.92666667
NM_005509,DMXL1,43,42,177740,11216,166524,3964.857143,260.8372093,14.84700428
NM_153223,CEP120,21,20,78709,4732,73977,3698.85,225.3333333,15.63334742
NM_133372,FNIP1,18,17,155351,6632,148719,8748.176471,368.4444444,22.42445718
NM_133638,ADAMTS19,23,22,278275,5112,273163,12416.5,222.2608696,53.43564163
NM_001008738,FNIP1,17,16,155351,6547,148804,9300.25,385.1176471,22.72857797
NM_001286808,PRRC1,10,9,37481,2790,34691,3854.555556,279,12.43405018
NM_130809,PRRC1,9,8,37481,4707,32774,4096.75,523,6.96282133
NM_022464,SIL1,10,9,251657,1910,249747,27749.66667,191,130.7575916
NM_001101800,FAM13B,22,21,95162,5492,89670,4270,249.6363636,16.32738529
NM_001101801,FAM13B,22,21,95162,5366,89796,4276,243.9090909,16.7342527
NM_016603,FAM13B,23,22,95162,5577,89585,4072.045455,242.4782609,16.06329568
NM_012159,FBXL21,8,7,11363,1802,9561,1365.857143,225.25,5.305771365
NM_001037633,SIL1,11,10,251657,1999,249658,24965.8,181.7272727,124.8914457
NM_004598,SPOCK1,11,10,524033,4838,519195,51919.5,439.8181818,107.3160397
NM_001892,CSNK1A1,10,9,55660,2571,53089,5898.777778,257.1,20.64916375
NM_001271741,CSNK1A1,10,9,55660,2535,53125,5902.777778,253.5,20.9566075
NM_199453,HTR4,7,6,186031,1447,184584,30764,206.7142857,127.5632343
NM_001025105,CSNK1A1,11,10,55660,2656,53004,5300.4,241.4545455,19.9563253
NM_001197294,DPYSL3,14,13,119250,5494,113756,8750.461538,392.4285714,20.70549691
NM_001387,DPYSL3,14,13,62891,5064,57827,4448.230769,361.7142857,11.41923381
NM_001271742,CSNK1A1,10,9,54439,2094,52345,5816.111111,209.4,24.99761223
NM_020768,KCTD16,4,3,306509,5187,301322,100440.6667,1296.75,58.09176788
NM_001040169,HTR4,6,5,186031,1370,184661,36932.2,228.3333333,134.7890511
NM_024007,EBF1,16,15,403867,5290,398577,26571.8,330.625,75.34536862
NM_015315,LARP1,19,18,104707,6614,98093,5449.611111,348.1052632,14.83111581
NM_000827,GRIA1,16,15,323347,5746,317601,21173.4,359.125,55.27340759
NM_001258023,GRIA1,16,15,322574,5335,317239,21149.26667,333.4375,59.46373008
NM_001258022,GRIA1,16,15,321699,5438,316261,21084.06667,339.875,58.1575947
NM_001258021,GRIA1,16,15,321699,5438,316261,21084.06667,339.875,58.1575947
NM_001258020,GRIA1,17,16,323347,5804,317543,19846.4375,341.4117647,54.71106134
NM_001258019,GRIA1,15,14,323347,5505,317842,22703,367,57.73696639
NM_001114183,GRIA1,16,15,323347,5746,317601,21173.4,359.125,55.27340759
NM_001122679,TENM2,29,28,979321,9674,969647,34630.25,333.5862069,100.2322721
NM_001131055,HRH2,3,2,28207,2557,25650,12825,852.3333333,10.03128666
NM_001034838,KCNIP1,8,7,383148,1903,381245,54463.57143,237.875,200.3389385
NM_198868,TBC1D9B,22,21,45787,5187,40600,1933.333333,235.7727273,7.827260459
NM_001159709,BTNL8,8,7,51831,1810,50021,7145.857143,226.25,27.6359116
NM_024850,BTNL8,8,7,51831,2237,49594,7084.857143,279.625,22.16987036
NM_015043,TBC1D9B,21,20,45787,5135,40652,2032.6,244.5238095,7.916650438
NM_001159710,BTNL8,7,6,41344,1609,39735,6622.5,229.8571429,24.69546302
NM_001159708,BTNL8,7,6,51831,2215,49616,8269.333333,316.4285714,22.4
NM_001159707,BTNL8,7,6,51831,1758,50073,8345.5,251.1428571,28.48293515
NM_001040462,BTNL8,8,7,51831,2107,49724,7103.428571,263.375,23.59943047
NM_020731,AHRR,12,11,134116,5672,128444,11676.72727,472.6666667,22.64527504
NM_004174,SLC9A3,17,16,51217,2794,48423,3026.4375,164.3529412,17.33106657
NM_004237,TRIP13,13,12,25197,2403,22794,1899.5,184.8461538,9.485642946
NM_001242412,AHRR,11,10,134116,5617,128499,12849.9,510.6363636,22.87680256
NM_001284351,SLC9A3,17,16,51217,2767,48450,3028.125,162.7647059,17.50993856
NM_001044,SLC6A3,15,14,52640,3949,48691,3477.928571,263.2666667,12.32995695
NM_178569,C5orf38,4,3,3251,894,2357,785.6666667,223.5,2.636465324
NM_020546,ADCY2,25,24,433853,6578,427275,17803.125,263.12,64.95515354
NM_024091,FASTKD3,7,6,9880,2444,7436,1239.333333,349.1428571,3.042553191
NM_001270661,Mar-06,23,22,86751,9405,77346,3515.727273,408.9130435,8.223923445
NM_001270660,Mar-06,25,24,86751,9578,77173,3215.541667,383.12,8.057318856
NM_005885,Mar-06,26,25,86751,9723,77028,3081.12,373.9615385,7.92224622
NM_001164440,ANKRD33B,4,3,93495,9337,84158,28052.66667,2334.25,9.013387598
NM_004394,DAP,4,3,82047,2346,79701,26567,586.5,33.97314578
NM_007118,TRIO,57,56,365631,10284,355347,6345.482143,180.4210526,34.5533839
NM_001369,DNAH5,79,78,254154,15652,238502,3057.717949,198.1265823,15.23779709
NM_054027,ANKH,12,11,166980,8219,158761,14432.81818,684.9166667,19.31634019
NM_001102562,Mar-11,4,3,112425,1532,110893,36964.33333,383,72.38446475
NM_001034850,FAM134B,9,8,144022,3293,140729,17591.125,365.8888889,42.73580322
NM_006727,CDH10,12,11,157878,3448,154430,14039.09091,287.3333333,44.78828306
NM_016279,CDH9,12,11,157982,3087,154895,14081.36364,257.25,50.17654681
NM_004932,CDH6,12,11,135493,8583,126910,11537.27273,715.25,14.78620529
NM_178140,PDZD2,24,23,312009,11666,300343,13058.3913,486.0833333,25.74515687
NM_016107,ZFR,20,19,90390,4735,85655,4508.157895,236.75,18.08975713
NM_001040446,MTMR12,16,15,86005,5203,80802,5386.8,325.1875,15.5298866
NM_000908,NPR3,8,7,80394,7455,72939,10419.85714,931.875,9.783903421
NM_001204375,NPR3,8,7,80394,7458,72936,10419.42857,932.25,9.779565567
NM_001204376,NPR3,8,7,81089,6388,74701,10671.57143,798.5,11.69395742
NM_001012509,SLC45A2,6,5,38810,2762,36048,7209.6,460.3333333,13.05141202
NM_016180,SLC45A2,7,6,40061,1724,38337,6389.5,246.2857143,22.23723898
NM_015577,RAI14,18,17,176286,5004,171282,10075.41176,278,34.22901679
NM_001145520,RAI14,18,17,176123,5062,171061,10062.41176,281.2222222,33.79316476
NM_001145525,RAI14,20,19,148107,5358,142749,7513.105263,267.9,26.64221725
NM_000949,PRLR,10,9,175023,11827,163196,18132.88889,1182.7,13.79859643
NM_001145521,RAI14,19,18,148107,5176,142931,7940.611111,272.4210526,27.61418083
NM_001145523,RAI14,17,16,145055,4935,140120,8757.5,290.2941176,28.39311044
NM_001145522,RAI14,17,16,176286,4916,171370,10710.625,289.1764706,34.85964199
NM_144725,TTC23L,11,10,60297,1367,58930,5893,124.2727273,43.10899781
NM_032637,SKP2,10,9,31999,1492,30507,3389.666667,149.2,20.44705094
NM_001168316,UGT3A2,6,5,31906,2289,29617,5923.4,381.5,12.93883792
NM_001042625,CAPSL,5,4,34341,976,33365,8341.25,195.2,34.18545082
NM_005983,SKP2,10,9,31999,3514,28485,3165,351.4,8.106146841
NM_001243120,SKP2,8,7,31999,3265,28734,4104.857143,408.125,8.800612557
NM_144647,CAPSL,5,4,34485,1008,33477,8369.25,201.6,33.21130952
NM_174914,UGT3A2,7,6,31906,2392,29514,4919,341.7142857,12.33862876
NM_133433,NIPBL,47,46,189062,9888,179174,3895.086957,210.3829787,18.1203479
NM_015384,NIPBL,46,45,189062,10435,178627,3969.488889,226.8478261,17.11806421
NM_004298,NUP155,35,34,79495,4782,74713,2197.441176,136.6285714,15.62379757
NM_023073,C5orf42,52,51,143202,11251,131951,2587.27451,216.3653846,11.72793529
NM_001278312,NUP155,34,33,79495,4434,75061,2274.575758,130.4117647,16.92850699
NM_153485,NUP155,35,34,79495,4627,74868,2202,132.2,16.18067863
NM_002310,LIFR,20,19,120444,10110,110334,5807.052632,505.5,10.91335312
NM_001127671,LIFR,20,19,81685,10278,71407,3758.263158,513.9,6.947557891
NM_001205301,EGFLAM,23,22,207073,4917,202156,9188.909091,213.7826087,41.11368721
NM_182798,EGFLAM,17,16,61950,4189,57761,3610.0625,246.4117647,13.78873239
NM_152403,EGFLAM,22,21,207073,4892,202181,9627.666667,222.3636364,41.32890433
NM_003999,OSMR,18,17,89644,5557,84087,4946.294118,308.7222222,15.13172575
NM_199335,FYB,18,17,114328,4724,109604,6447.294118,262.4444444,23.20152413
NM_152756,RICTOR,38,37,136489,9579,126910,3430,252.0789474,13.24877336
NM_001285439,RICTOR,39,38,136489,9652,126837,3337.815789,247.4871795,13.14100705
NM_001465,FYB,19,18,114328,4863,109465,6081.388889,255.9473684,22.50976763
NM_001243093,FYB,19,18,165407,4816,160591,8921.722222,253.4736842,33.34530731
NM_001737,C9,11,10,80279,2703,77576,7757.6,245.7272727,28.699963
NM_001285440,RICTOR,38,37,136489,9463,127026,3433.135135,249.0263158,13.42343866
NM_006251,PRKAA1,9,8,38818,5094,33724,4215.5,566,6.620337652
NM_206907,PRKAA1,10,9,38818,5140,33678,3742,514,6.552140078
NM_001115131,C6,18,17,119294,3767,115527,6795.705882,209.2777778,30.66817096
NM_001005473,PLCXD3,3,2,203684,7742,195942,97971,2580.666667,25.30896409
NM_000065,C6,18,17,71449,3740,67709,3982.882353,207.7777778,18.1040107
NM_000436,OXCT1,17,16,140626,3575,137051,8565.6875,210.2941176,38.33594406
NM_173489,MROH2B,42,41,73324,5322,68002,1658.585366,126.7142857,12.77752725
NM_000163,GHR,10,9,298105,4573,293532,32614.66667,457.3,64.18806035
NM_001242462,GHR,8,7,156016,4320,151696,21670.85714,540,35.11481481
NM_001242406,GHR,9,8,156419,4794,151625,18953.125,532.6666667,31.62807676
NM_001242460,GHR,8,7,156016,4324,151692,21670.28571,540.5,35.08140611
NM_001242404,GHR,10,9,172324,4534,167790,18643.33333,453.4,37.00705779
NM_001242403,GHR,10,9,173667,4709,168958,18773.11111,470.9,35.87980463
NM_001242402,GHR,10,9,173837,4501,169336,18815.11111,450.1,37.62186181
NM_001242401,GHR,11,10,296888,4533,292355,29235.5,412.0909091,64.4948158
NM_001242405,GHR,10,9,171800,4429,167371,18596.77778,442.9,37.78979454
NM_001242399,GHR,10,9,297428,4539,292889,32543.22222,453.9,64.52720864
NM_001242400,GHR,11,10,297428,4825,292603,29260.3,438.6363636,60.64310881
NM_003432,ZNF131,8,7,54183,2410,51773,7396.142857,301.25,21.48257261
NM_182977,NNT,22,21,102441,4666,97775,4655.952381,212.0909091,20.95477925
NM_148672,CCL28,3,2,30890,819,30071,15035.5,273,36.71672772
NM_012343,NNT,22,21,102879,4700,98179,4675.190476,213.6363636,20.88914894
NM_153361,NIM1K,4,3,88784,2474,86310,28770,618.5,34.88682296
NM_021072,HCN1,8,7,441170,9677,431493,61641.85714,1209.625,44.58954221
NM_024615,PARP8,26,25,179586,7203,172383,6895.32,277.0384615,23.93211162
NM_001178056,PARP8,25,24,179586,7076,172510,7187.916667,283.04,24.37959299
NM_001178055,PARP8,27,26,180625,7228,173397,6669.115385,267.7037037,23.98962369
NM_181501,ITGA1,29,28,165351,4825,160526,5733.071429,166.3793103,33.26963731
NM_002203,ITGA2,30,29,105455,7899,97556,3364,263.3,12.3504241
NM_002495,NDUFS4,5,4,122708,681,122027,30506.75,136.2,179.1879589
NM_001242639,IL31RA,16,15,64017,2855,61162,4077.466667,178.4375,21.42276708
NM_001242638,IL31RA,18,17,71477,3042,68435,4025.588235,169,22.49671269
NM_015360,SKIV2L2,27,26,117835,4231,113604,4369.384615,156.7037037,26.85038998
NM_024669,ANKRD55,12,11,133681,2512,131169,11924.45455,209.3333333,52.2169586
NM_001166533,DDX4,21,20,78762,2472,76290,3814.5,117.7142857,30.86165049
NM_001242637,IL31RA,16,15,71477,2676,68801,4586.733333,167.25,25.71038864
NM_001242636,IL31RA,15,14,64017,2710,61307,4379.071429,180.6666667,22.62250923
NM_001142549,DDX4,21,20,79131,2799,76332,3816.6,133.2857143,27.27116827
NM_139017,IL31RA,15,14,65960,2719,63241,4517.214286,181.2666667,23.25891872
NM_003711,PPAP2A,6,5,110238,1674,108564,21712.8,279,64.85304659
NM_176895,PPAP2A,6,5,110238,1677,108561,21712.2,279.5,64.7352415
NM_024415,DDX4,22,21,79131,2902,76229,3629.952381,131.9090909,26.26774638
NM_022913,GPBP1,12,11,90733,4635,86098,7827.090909,386.25,18.57562028
NM_152622,MIER3,13,12,32527,5214,27313,2276.083333,401.0769231,5.238396624
NM_001203246,GPBP1,11,10,90733,4514,86219,8621.9,410.3636364,19.10035445
NM_001127235,GPBP1,12,11,89233,4347,84886,7716.909091,362.25,19.52749022
NM_001287053,LOC101928448,6,5,94840,944,93896,18779.2,157.3333333,99.46610169
NM_138453,RAB3C,5,4,268469,1014,267455,66863.75,202.8,263.7623274
NM_001197222,PDE4D,10,9,70475,7798,62677,6964.111111,779.8,8.037573737
NM_001197221,PDE4D,11,10,70475,7713,62762,6276.2,701.1818182,8.13717101
NM_001197220,PDE4D,15,14,307081,8397,298684,21334.57143,559.8,35.57032273
NM_001197219,PDE4D,15,14,387863,7759,380104,27150.28571,517.2666667,48.98878721
NM_018369,DEPDC1B,11,10,103256,2515,100741,10074.1,228.6363636,40.05606362
NM_001145208,DEPDC1B,10,9,103256,2328,100928,11214.22222,232.8,43.35395189
NM_174889,NDUFAF2,4,3,207910,723,207187,69062.33333,180.75,286.5656985
NM_001243952,KIF2A,21,20,81024,4271,76753,3837.65,203.3809524,17.97073285
NM_173667,C5orf64,4,3,68728,2974,65754,21918,743.5,22.10961668
NM_001243953,KIF2A,20,19,81024,4010,77014,4053.368421,200.5,19.20548628
NM_001098511,KIF2A,21,20,81024,4182,76842,3842.1,199.1428571,18.37446198
NM_004520,KIF2A,20,19,81024,4067,76957,4050.368421,203.35,18.92230145
NM_001029875,RGS7BP,6,5,106349,4500,101849,20369.8,750,22.63311111
NM_001113561,RNF180,8,7,207027,4952,202075,28867.85714,619,40.80674475
NM_001278926,PPWD1,12,11,24306,2209,22097,2008.818182,184.0833333,10.00316885
NM_001278929,PPWD1,10,9,24306,2067,22239,2471,206.7,10.75907112
NM_015342,PPWD1,11,10,24315,2180,22135,2213.5,198.1818182,10.15366972
NM_197941,ADAMTS6,25,24,333143,7293,325850,13577.08333,291.72,44.67982997
NM_005869,CWC27,14,13,249837,2094,247743,19057.15385,149.5714286,118.3108883
NM_001278927,PPWD1,11,10,24306,1998,22308,2230.8,181.6363636,11.16516517
NM_001253697,ERBB2IP,26,25,154471,7068,147403,5896.12,271.8461538,20.85498019
NM_018695,ERBB2IP,25,24,154471,6944,147527,6146.958333,277.76,21.2452477
NM_001253699,ERBB2IP,26,25,154471,7089,147382,5895.28,272.6538462,20.7902384
NM_001253698,ERBB2IP,24,23,154471,6868,147603,6417.521739,286.1666667,21.49140944
NM_001253701,ERBB2IP,25,24,154471,6932,147539,6147.458333,277.28,21.28375649
NM_001006600,ERBB2IP,24,23,154471,6736,147735,6423.26087,280.6666667,21.93215558
NM_015183,MAST4,28,27,340821,9945,330876,12254.66667,355.1785714,33.27058824
NM_001278622,RAD17,18,17,44743,3077,41666,2450.941176,170.9444444,13.54111147
NM_001205254,OCLN,9,8,65343,6217,59126,7390.75,690.7777778,9.510374779
NM_133340,RAD17,16,15,43768,2666,41102,2740.133333,166.625,15.41710428
NM_133338,RAD17,19,18,44991,3079,41912,2328.444444,162.0526316,13.61221176
NM_133342,RAD17,18,17,45072,3055,42017,2471.588235,169.7222222,13.75351882
NM_133341,RAD17,16,15,43768,2592,41176,2745.066667,162,15.88580247
NM_002873,RAD17,17,16,44098,3181,40917,2557.3125,187.1176471,12.86293618
NM_002538,OCLN,9,8,65814,6447,59367,7420.875,716.3333333,9.208469055
NM_001205255,OCLN,7,6,53929,5398,48531,8088.5,771.1428571,8.990552056
NM_001799,CDK7,12,11,42637,1529,41108,3737.090909,127.4166667,26.88554611
NM_133344,RAD17,17,16,44991,2836,42155,2634.6875,166.8235294,14.86424542
NM_133343,RAD17,18,17,45508,3022,42486,2499.176471,167.8888889,14.05890139
NM_133339,RAD17,16,15,43349,2633,40716,2714.4,164.5625,15.46372959
NM_022902,SLC30A5,16,15,37125,4076,33049,2203.266667,254.75,8.108194308
NM_021967,SERF1A,3,2,17870,1916,15954,7977,638.6666667,8.326722338
NM_022978,SERF1B,3,2,17858,1904,15954,7977,634.6666667,8.379201681
NM_022132,MCCC2,17,16,71417,3690,67727,4232.9375,217.0588235,18.35420054
NM_018429,BDP1,39,38,112209,11114,101095,2660.394737,284.974359,9.096184992
NM_005909,MAP1B,7,6,102281,11986,90295,15049.16667,1712.285714,7.533372268
NM_015084,MRPS27,11,10,100850,2792,98058,9805.8,253.8181818,35.12106017
NM_001286748,MRPS27,12,11,100850,2835,98015,8910.454545,236.25,34.57319224
NM_001286751,MRPS27,11,10,100850,2760,98090,9809,250.9090909,35.53985507
NM_001284431,UTP15,12,11,17638,4934,12704,1154.909091,411.1666667,2.574787191
NM_032175,UTP15,13,12,17638,5108,12530,1044.166667,392.9230769,2.453014879
NM_001244364,ARHGEF28,28,27,128477,5258,123219,4563.666667,187.7857143,23.43457588
NM_001177693,ARHGEF28,36,35,315837,6310,309527,8843.628571,175.2777778,49.05340729
NM_001080479,ARHGEF28,37,36,315837,6389,309448,8595.777778,172.6756757,48.43449679
NM_001284430,UTP15,13,12,17638,5051,12587,1048.916667,388.5384615,2.491981786
NM_003633,ENC1,3,2,14020,5523,8497,4248.5,1841,1.538475466
NM_001256576,ENC1,3,2,14020,5387,8633,4316.5,1795.666667,1.602561723
NM_001256575,ENC1,4,3,14020,5649,8371,2790.333333,1412.25,1.481855196
NM_001256574,ENC1,4,3,14020,5661,8359,2786.333333,1415.25,1.476594241
NM_032380,GFM2,21,20,46169,3270,42899,2144.95,155.7142857,13.11896024
NM_170691,GFM2,20,19,46169,3128,43041,2265.315789,156.4,13.75991049
NM_001281302,GFM2,22,21,46169,3389,42780,2037.142857,154.0454545,12.62319268
NM_170681,GFM2,15,14,31029,2435,28594,2042.428571,162.3333333,11.74291581
NM_016218,POLK,15,14,87991,4527,83464,5961.714286,301.8,18.43693395
NM_001130105,COL4A3BP,19,18,140880,5513,135367,7520.388889,290.1578947,24.55414475
NM_031361,COL4A3BP,17,16,140528,5334,135194,8449.625,313.7647059,25.34570679
NM_001099271,POC5,12,11,43291,2173,41118,3738,181.0833333,18.92222734
NM_152408,POC5,11,10,38258,1971,36287,3628.7,179.1818182,18.41045155
NM_005713,COL4A3BP,18,17,140528,5413,135115,7947.941176,300.7222222,24.96120451
NM_001992,F2R,2,1,19729,3812,15917,15917,1906,4.175498426
NM_130772,S100Z,5,4,71232,1152,70080,17520,230.4,60.83333333
NM_006633,IQGAP2,36,35,304879,5874,299005,8543,163.1666667,50.90313245
NM_001285460,IQGAP2,35,34,160725,5479,155246,4566.058824,156.5428571,28.33473262
NM_003664,AP3B1,27,26,292431,4064,288367,11091.03846,150.5185185,70.95644685
NM_001271769,AP3B1,27,26,292431,4076,288355,11090.57692,150.962963,70.74460255
NM_004607,TBCA,4,3,85192,683,84509,28169.66667,170.75,123.7320644
NM_005779,LHFPL2,5,4,163612,5050,158562,39640.5,1010,31.39841584
NM_198709,ARSB,8,7,170434,2180,168254,24036.28571,272.5,77.18073394
NM_000046,ARSB,8,7,209322,6079,203243,29034.71429,759.875,33.43362395
NM_017614,BHMT2,8,7,20352,2659,17693,2527.571429,332.375,6.654005265
NM_001178005,BHMT2,7,6,20352,2466,17886,2981,352.2857143,7.253041363
NM_004866,SCAMP1,9,8,120225,6253,113972,14246.5,694.7777778,18.22677115
NM_001277077,HOMER1,6,5,140014,3928,136086,27217.2,654.6666667,34.64511202
NM_001174071,SERINC5,13,12,144850,1938,142912,11909.33333,149.0769231,73.74200206
NM_004272,HOMER1,9,8,140014,4321,135693,16961.625,480.1111111,31.40314742
NM_001277078,HOMER1,6,5,140014,3969,136045,27209,661.5,34.27689594
NM_153610,CMYA5,13,12,110392,12905,97487,8123.916667,992.6923077,7.554203797
NM_178276,SERINC5,13,12,144850,1947,142903,11908.58333,149.7692308,73.39650745
NM_006909,RASGRF2,27,26,269475,8183,261292,10049.69231,303.0740741,31.93107662
NM_205548,FAM151B,6,5,54584,1711,52873,10574.6,285.1666667,30.90181181
NM_002439,MSH3,24,23,222169,4471,217698,9465.130435,186.2916667,48.69112055
NM_001131028,ATG10,9,8,283374,2435,280939,35117.375,270.5555556,115.3753593
NM_031482,ATG10,8,7,283374,2299,281075,40153.57143,287.375,122.2596781
NM_022550,XRCC4,8,7,276264,1706,274558,39222.57143,213.25,160.936694
NM_022406,XRCC4,8,7,276264,1665,274599,39228.42857,208.125,164.9243243
NM_003401,XRCC4,8,7,276264,1659,274605,39229.28571,207.375,165.5244123
NM_001278642,EDIL3,10,9,444273,4740,439533,48837,474,92.72848101
NM_001884,HAPLN1,5,4,82881,4683,78198,19549.5,936.6,16.69827034
NM_005711,EDIL3,11,10,444273,4771,439502,43950.2,433.7272727,92.11947181
NM_002890,RASA1,25,24,123675,4411,119264,4969.333333,176.44,27.0378599
NM_022650,RASA1,25,24,123004,3805,119199,4966.625,152.2,31.32693824
NM_153354,TMEM161B,12,11,73675,2637,71038,6458,219.75,26.93894577
NM_001289008,TMEM161B,13,12,73675,2770,70905,5908.75,213.0769231,25.59747292
NM_001289007,TMEM161B,13,12,79248,2097,77151,6429.25,161.3076923,36.79113019
NM_006467,POLR3G,8,7,39690,3293,36397,5199.571429,411.625,11.05283936
NM_032290,ANKRD32,21,20,77184,3834,73350,3667.5,182.5714286,19.1314554
NM_001145678,KIAA0825,21,20,467755,7262,460493,23024.65,345.8095238,63.4113192
NM_002064,GLRX,3,2,9026,1650,7376,3688,550,4.47030303
NM_012081,ELL2,12,11,76975,6058,70917,6447,504.8333333,11.70633873
NM_152548,FAM81B,10,9,59098,1573,57525,6391.666667,157.3,36.57024793
NM_198150,ARSK,8,7,49983,3353,46630,6661.428571,419.125,13.906949
NM_001243659,GLRX,3,2,9026,1093,7933,3966.5,364.3333333,7.258005489
NM_001243658,GLRX,3,2,9026,1500,7526,3763,500,5.017333333
NM_001118890,GLRX,3,2,9026,1082,7944,3972,360.6666667,7.341959335
NM_001284212,CAST,28,27,71845,4211,67634,2504.962963,150.3928571,16.06126811
NM_001042440,CAST,30,29,112526,4614,107912,3721.103448,153.8,23.38794972
NM_005575,LNPEP,18,17,93771,4488,89283,5251.941176,249.3333333,19.89371658
NM_173060,CAST,29,28,71894,4321,67573,2413.321429,149,15.63827818
NM_001190442,CAST,31,30,112646,4487,108159,3605.3,144.7419355,24.10496991
NM_175920,LNPEP,18,17,70961,4280,66681,3922.411765,237.7777778,15.5796729
NM_001284213,CAST,27,26,71877,4152,67725,2604.807692,153.7777778,16.31141618
NM_198507,FAM174A,3,2,51318,1239,50079,25039.5,413,40.4188862
NM_180991,SLCO4C1,13,12,62563,5345,57218,4768.166667,411.1538462,10.7049579
NM_001276277,PPIP5K2,31,30,83268,6171,77097,2569.9,199.0645161,12.49343704
NM_138822,PAM,23,22,165283,5099,160184,7281.090909,221.6956522,31.41478721
NM_001177306,PAM,25,24,165283,5359,159924,6663.5,214.36,29.84213473
NM_000919,PAM,25,24,165283,5362,159921,6663.375,214.48,29.82487878
NM_001281471,PPIP5K2,33,32,83268,6277,76991,2405.96875,190.2121212,12.26557273
NM_015216,PPIP5K2,29,28,74216,5871,68345,2440.892857,202.4482759,11.64111736
NM_138821,PAM,24,23,165283,5037,160246,6967.217391,209.875,31.81377804
NM_138766,PAM,24,23,165283,5154,160129,6962.130435,214.75,31.06887854
NM_031438,NUDT12,7,6,13936,3495,10441,1740.166667,499.2857143,2.987410587
NM_001163315,FBXL17,9,8,523067,5209,517858,64732.25,578.7777778,99.41601075
NM_005246,FER,20,19,439852,2970,436882,22993.78947,148.5,147.0983165
NM_001039763,TMEM232,14,13,307254,3206,304048,23388.30769,229,94.83718029
NM_001744,CAMK4,11,10,260803,2252,258551,25855.1,204.7272727,114.8095027
NM_001127511,APC,14,13,138736,10818,127918,9839.846154,772.7142857,11.82455167
NM_022140,EPB41L4A,23,22,256697,4730,251967,11453.04545,205.6521739,53.26997886
NM_002387,MCC,17,16,272818,8240,264578,16536.125,484.7058824,32.10898058
NM_001242377,DCP2,10,9,45487,10103,35384,3931.555556,1010.3,3.502326042
NM_022828,YTHDC2,30,29,81595,6338,75257,2595.068966,211.2666667,11.873935
NM_152624,DCP2,11,10,45487,10209,35278,3527.8,928.0909091,3.455578411
NM_001085377,MCC,19,18,466733,8698,458035,25446.38889,457.7894737,52.65980685
NM_001278204,KCNN2,7,6,134183,2103,132080,22013.33333,300.4285714,62.80551593
NM_170775,KCNN2,6,5,62972,1463,61509,12301.8,243.8333333,42.0430622
NM_021614,KCNN2,8,7,134183,2523,131660,18808.57143,315.375,52.18390805
NM_001164468,TMED7-TICAM2,4,3,47539,3513,44026,14675.33333,878.25,12.53230857
NM_001164469,TMED7-TICAM2,4,3,47539,3631,43908,14636,907.75,12.09253649
NM_001284,AP3S1,6,5,72161,1295,70866,14173.2,215.8333333,54.72277992
NM_005023,PGGT1B,9,8,52044,2736,49308,6163.5,304,18.02192982
NM_181836,TMED7,3,2,12973,4066,8907,4453.5,1355.333333,2.190605017
NM_016144,COMMD10,7,6,208253,1431,206822,34470.33333,204.4285714,144.5296995
NM_020796,SEMA6A,19,18,131302,6879,124423,6912.388889,362.0526316,18.08736735
NM_173666,DTWD2,6,5,151673,4980,146693,29338.6,830,29.4564257
NM_001077654,TNFAIP8,2,1,125914,2007,123907,123907,1003.5,61.73741903
NM_001286815,TNFAIP8,3,2,125914,2126,123788,61894,708.6666667,58.22577611
NM_001286817,TNFAIP8,3,2,125914,2130,123784,61892,710,58.11455399
NM_016644,PRR16,3,2,222947,1766,221181,110590.5,588.6666667,125.2440544
NM_001195535,LOC100505841,3,2,22489,444,22045,11022.5,148,49.6509009
NM_001278199,SNX2,15,14,59545,7125,52420,3744.285714,475,7.357192982
NM_014035,SNX24,7,6,163744,2144,161600,26933.33333,306.2857143,75.37313433
NM_001242935,SNCAIP,10,9,151976,2598,149378,16597.55556,259.8,57.49730562
NM_003100,SNX2,15,14,59545,6574,52971,3783.642857,438.2666667,8.057651354
NM_005460,SNCAIP,11,10,151976,3580,148396,14839.6,325.4545455,41.45139665
NM_001270574,CSNK1G3,10,9,104947,4116,100831,11203.44444,411.6,24.4973275
NM_001270573,CSNK1G3,12,11,104947,4226,100721,9156.454545,352.1666667,23.83364884
NM_001270572,CSNK1G3,12,11,71629,4182,67447,6131.545455,348.5,16.12792922
NM_004384,CSNK1G3,12,11,71629,4251,67378,6125.272727,354.25,15.84991767
NM_001031812,CSNK1G3,13,12,104947,4652,100295,8357.916667,357.8461538,21.55954428
NM_001044723,CSNK1G3,13,12,71629,4276,67353,5612.75,328.9230769,15.75140318
NM_020747,ZNF608,9,8,108197,5654,102543,12817.875,628.2222222,18.13636364
NM_032177,PHAX,5,4,26339,3646,22693,5673.25,729.2,6.224081185
NM_032446,MEGF10,26,25,170456,7711,162745,6509.8,296.5769231,21.10556348
NM_001256545,MEGF10,25,24,170456,7659,162797,6783.208333,306.36,21.25564695
NM_178450,Mar-03,5,4,163096,4201,158895,39723.75,840.2,37.82313735
NM_001999,FBN2,65,64,280136,10789,269347,4208.546875,165.9846154,24.96496432
NM_014031,SLC27A6,11,10,68127,2627,65500,6550,238.8181818,24.93338409
NM_001017372,SLC27A6,10,9,68124,2848,65276,7252.888889,284.8,22.91994382
NM_175856,CHSY3,3,2,281806,3495,278311,139155.5,1165,79.63118741
NM_001038702,CDC42SE2,5,4,130682,3492,127190,31797.5,698.4,36.42325315
NM_020240,CDC42SE2,6,5,130682,3662,127020,25404,610.3333333,34.68596395
NM_001164389,RAPGEF6,25,24,199414,4534,194880,8120,181.36,42.98191442
NM_001164390,RAPGEF6,18,17,171623,3130,168493,9911.352941,173.8888889,53.83162939
NM_001164388,RAPGEF6,28,27,211317,8094,203223,7526.777778,289.0714286,25.10785767
NM_001164387,RAPGEF6,29,28,211317,8110,203207,7257.392857,279.6551724,25.05635018
NM_016340,RAPGEF6,28,27,211317,8385,202932,7516,299.4642857,24.20178891
NM_001164386,RAPGEF6,29,28,211317,8410,202907,7246.678571,290,24.12687277
NM_003687,PDLIM4,7,6,15798,2302,13496,2249.333333,328.8571429,5.862728063
NM_001205248,ACSL6,21,20,61942,6546,55396,2769.8,311.7142857,8.462572563
NM_001205251,ACSL6,20,19,61942,6320,55622,2927.473684,316,8.800949367
NM_001205250,ACSL6,21,20,62096,6556,55540,2777,312.1904762,8.471629042
NM_001009185,ACSL6,21,20,61690,6559,55131,2756.55,312.3333333,8.405397164
NM_003060,SLC22A5,10,9,25907,3290,22617,2513,329,6.874468085
NM_001205247,ACSL6,21,20,61690,6454,55236,2761.8,307.3333333,8.558413387
NM_015256,ACSL6,21,20,61690,6559,55131,2756.55,312.3333333,8.405397164
NM_001278059,LOC728637,12,11,138709,1452,137257,12477.90909,121,94.52961433
NM_001131027,PDLIM4,6,5,15798,2183,13615,2723,363.8333333,6.23683005
NM_014423,AFF4,21,20,88285,9601,78684,3934.2,457.1904762,8.195396313
NM_015082,FSTL4,16,15,416073,5398,410675,27378.33333,337.375,76.07910337
NM_016508,CDKL3,9,8,59075,1629,57446,7180.75,181,35.2645795
NM_001033503,SAR1B,8,7,31696,6659,25037,3576.714286,832.375,3.759873855
NM_001745,CAMLG,4,3,13682,2246,11436,3812,561.5,5.091718611
NM_016103,SAR1B,7,6,31696,6539,25157,4192.833333,934.1428571,3.847224346
NM_020199,C5orf15,3,2,13210,2284,10926,5463,761.3333333,4.783712785
NM_001113575,CDKL3,13,12,68652,2138,66514,5542.833333,164.4615385,31.11038354
NM_001277348,C5orf66,6,5,311402,2480,308922,61784.4,413.3333333,124.5653226
NM_020389,TRPC7,12,11,152167,2947,149220,13565.45455,245.5833333,50.6345436
NM_000358,TGFBI,17,16,34925,2822,32103,2006.4375,166,11.37597449
NM_001167577,TRPC7,11,10,152167,2763,149404,14940.4,251.1818182,54.07310894
NM_001167576,TRPC7,10,9,152167,2597,149570,16618.88889,259.7,57.59337697
NM_001258448,PKD2L2,15,14,51033,2275,48758,3482.714286,151.6666667,21.43208791
NM_014386,PKD2L2,14,13,51033,2232,48801,3753.923077,159.4285714,21.86424731
NM_017415,KLHL3,15,14,118592,6821,111771,7983.642857,454.7333333,16.38630699
NM_001258449,PKD2L2,13,12,51033,2330,48703,4058.583333,179.2307692,20.90257511
NM_001257195,KLHL3,13,12,88929,6570,82359,6863.25,505.3846154,12.53561644
NM_001257194,KLHL3,15,14,103812,6996,96816,6915.428571,466.4,13.83876501
NM_006696,BRD8,22,21,21787,3257,18530,882.3809524,148.0454545,5.689284618
NM_001790,CDC25C,14,13,46614,2184,44430,3417.692308,156,20.34340659
NM_016604,KDM3B,24,23,84433,6837,77596,3373.73913,284.875,11.34942226
NM_001903,CTNNA1,18,17,181618,3779,177839,10461.11765,209.9444444,47.05980418
NM_022809,CDC25C,11,10,46614,1962,44652,4465.2,178.3636364,22.75840979
NM_001164326,BRD8,20,19,21787,3000,18787,988.7894737,150,6.262333333
NM_001287583,CDC25C,14,13,53092,2297,50795,3907.307692,164.0714286,22.11362647
NM_139199,BRD8,27,26,38901,4094,34807,1338.730769,151.6296296,8.501954079
NM_001287582,CDC25C,14,13,46614,2180,44434,3418,155.7142857,20.38256881
NM_032289,PSD2,15,14,48644,4525,44119,3151.357143,301.6666667,9.750055249
NM_013983,NRG2,11,10,196522,3938,192584,19258.4,358,48.90401219
NM_013982,NRG2,11,10,196522,3956,192566,19256.6,359.6363636,48.67694641
NM_013981,NRG2,10,9,196522,3913,192609,21401,391.3,49.22284692
NM_004883,NRG2,10,9,196522,3931,192591,21399,393.1,48.99287713
NM_001184935,NRG2,8,7,196522,3731,192791,27541.57143,466.375,51.67274189
NM_001077693,ECSCR,6,5,58077,741,57336,11467.2,123.5,77.37651822
NM_020690,ANKHD1-EIF4EBP3,36,35,147766,8385,139381,3982.314286,232.9166667,16.62265951
NM_031860,PCDHA10,4,3,156463,4635,151828,50609.33333,1158.75,32.75685005
NM_031849,PCDHA6,4,3,184424,4642,179782,59927.33333,1160.5,38.72942697
NM_031411,PCDHA1,4,3,226210,4627,221583,73861,1156.75,47.88912903
NM_001945,HBEGF,6,5,13762,2364,11398,2279.6,394,4.821489002
NM_032412,CYSTM1,3,2,68723,913,67810,33905,304.3333333,74.27163198
NM_031857,PCDHA9,4,3,164574,5988,158586,52862,1497,26.48396794
NM_017747,ANKHD1,34,33,138044,8255,129789,3933,242.7941176,15.72247123
NM_018898,PCDHAC1,4,3,85629,5479,80150,26716.66667,1369.75,14.62858186
NM_018899,PCDHAC2,4,3,46184,6040,40144,13381.33333,1510,6.646357616
NM_018907,PCDHA4,4,3,205272,5369,199903,66634.33333,1342.25,37.23281803
NM_018906,PCDHA3,4,3,211148,5264,205884,68628,1316,39.11170213
NM_018905,PCDHA2,4,3,217487,5364,212123,70707.66667,1341,39.54567487
NM_018904,PCDHA13,4,3,130077,5264,124813,41604.33333,1316,23.71067629
NM_018903,PCDHA12,4,3,137044,5408,131636,43878.66667,1352,24.34097633
NM_018902,PCDHA11,4,3,144833,6852,137981,45993.66667,1713,20.13733217
NM_018901,PCDHA10,4,3,156463,5424,151039,50346.33333,1356,27.8464233
NM_018900,PCDHA1,4,3,226210,5419,220791,73597,1354.75,40.74386418
NM_018911,PCDHA8,4,3,171024,5264,165760,55253.33333,1316,31.4893617
NM_018910,PCDHA7,4,3,177962,5225,172737,57579,1306.25,33.05971292
NM_018908,PCDHA5,4,3,190570,5222,185348,61782.66667,1305.5,35.49368058
NM_018909,PCDHA6,4,3,184424,5434,178990,59663.33333,1358.5,32.9389032
NM_001079812,DIAPH1,27,26,104036,5790,98246,3778.692308,214.4444444,16.96822107
NM_022481,ARAP3,33,32,28834,5295,23539,735.59375,160.4545455,4.445514636
NM_018924,PCDHGB3,4,3,142586,4600,137986,45995.33333,1150,29.99695652
NM_018919,PCDHGA6,4,3,138897,4609,134288,44762.66667,1152.25,29.13603819
NM_018918,PCDHGA5,4,3,148650,4606,144044,48014.66667,1151.5,31.27312201
NM_018917,PCDHGA4,4,3,157956,4782,153174,51058,1195.5,32.03136763
NM_018912,PCDHGA1,4,3,182296,4606,177690,59230,1151.5,38.57794182
NM_018915,PCDHGA2,4,3,174221,4821,169400,56466.66667,1205.25,35.13793819
NM_018923,PCDHGB2,4,3,152845,4606,148239,49413,1151.5,32.18389058
NM_018922,PCDHGB1,4,3,162720,4594,158126,52708.66667,1148.5,34.42011319
NM_018920,PCDHGA7,4,3,130242,4770,125472,41824,1192.5,26.30440252
NM_018916,PCDHGA3,4,3,168947,4609,164338,54779.33333,1152.25,35.65589065
NM_005219,DIAPH1,28,27,104036,5818,98218,3637.703704,207.7857143,16.8817463
NM_003736,PCDHGB4,4,3,125096,4582,120514,40171.33333,1145.5,26.30161502
NM_001204258,NR3C1,9,8,125760,6793,118967,14870.875,754.7777778,17.51317533
NM_001204259,NR3C1,9,8,125760,6793,118967,14870.875,754.7777778,17.51317533
NM_001204260,NR3C1,9,8,125760,6793,118967,14870.875,754.7777778,17.51317533
NM_001204265,NR3C1,7,6,109813,4104,105709,17618.16667,586.2857143,25.75755361
NM_001204263,NR3C1,9,8,125760,6793,118967,14870.875,754.7777778,17.51317533
NM_001204262,NR3C1,9,8,125760,6793,118967,14870.875,754.7777778,17.51317533
NM_001204261,NR3C1,9,8,125760,6793,118967,14870.875,754.7777778,17.51317533
NM_001204264,NR3C1,9,8,125760,6793,118967,14870.875,754.7777778,17.51317533
NM_001024094,NR3C1,9,8,125760,6796,118964,14870.5,755.1111111,17.50500294
NM_001020825,NR3C1,9,8,125760,4163,121597,15199.625,462.5555556,29.20898391
NM_001018077,NR3C1,9,8,157583,7295,150288,18786,810.5555556,20.60150788
NM_000176,NR3C1,9,8,125760,6793,118967,14870.875,754.7777778,17.51317533
NM_001018076,NR3C1,9,8,126551,6419,120132,15016.5,713.2222222,18.71506465
NM_001018075,NR3C1,9,8,157583,6526,151057,18882.125,725.1111111,23.14695066
NM_001018074,NR3C1,9,8,157583,6623,150960,18870,735.8888889,22.79329609
NM_152550,SH3RF2,10,9,126755,3053,123702,13744.66667,305.3,40.51817884
NM_018989,RBM27,21,20,85623,6561,79062,3953.1,312.4285714,12.05029721
NM_006706,TCERG1,22,21,64198,4223,59975,2855.952381,191.9545455,14.20198911
NM_001040006,TCERG1,21,20,64198,4159,60039,3001.95,198.047619,14.4359221
NM_145001,STK32A,7,6,113815,894,112921,18820.16667,127.7142857,126.3098434
NM_181677,PPP2R2B,11,10,491967,2014,489953,48995.3,183.0909091,243.2735849
NM_181676,PPP2R2B,9,8,466634,2186,464448,58056,242.8888889,212.4647758
NM_001271948,PPP2R2B,10,9,289283,2584,286699,31855.44444,258.4,110.9516254
NM_001271899,PPP2R2B,10,9,492018,2057,489961,54440.11111,205.7,238.1920272
NM_001271900,PPP2R2B,11,10,492018,2252,489766,48976.6,204.7272727,217.4804618
NM_001112724,STK32A,13,12,149191,1706,147485,12290.41667,131.2307692,86.45076202
NM_181675,PPP2R2B,10,9,289283,2104,287179,31908.77778,210.4,136.4919202
NM_181674,PPP2R2B,10,9,466634,2381,464253,51583.66667,238.1,194.9823604
NM_181678,PPP2R2B,11,10,491967,2027,489940,48994,184.2727273,241.7069561
NM_001287740,STK32A,14,13,152841,4937,147904,11377.23077,352.6428571,29.95827426
NM_001270941,JAKMIP2,22,21,197409,9292,188117,8957.952381,422.3636364,20.2450495
NM_001127699,SPINK5,28,27,60970,2943,58027,2149.148148,105.1071429,19.71695549
NM_001127698,SPINK5,34,33,73392,3763,69629,2109.969697,110.6764706,18.50358756
NM_001040433,SPINK9,4,3,4292,457,3835,1278.333333,114.25,8.391684902
NM_006846,SPINK5,33,32,73392,3672,69720,2178.75,111.2727273,18.9869281
NM_205841,SPINK6,4,3,12345,737,11608,3869.333333,184.25,15.75033921
NM_001282282,JAKMIP2,21,20,197409,9014,188395,9419.75,429.2380952,20.90026625
NM_001270934,JAKMIP2,21,20,197409,9228,188181,9409.05,439.4285714,20.39239272
NM_001195290,SPINK6,5,4,12345,611,11734,2933.5,122.2,19.20458265
NM_014790,JAKMIP2,21,20,197409,9220,188189,9409.45,439.047619,20.41095445
NM_001040172,HTR4,6,5,160427,1239,159188,31837.6,206.5,128.4810331
NM_024577,SH3TC2,17,16,81026,26597,54429,3401.8125,1564.529412,2.046433808
NM_000870,HTR4,7,6,172977,3338,169639,28273.16667,476.8571429,50.82055123
NM_001286410,HTR4,6,5,155593,1289,154304,30860.8,214.8333333,119.708301
NM_014945,ABLIM3,24,23,118947,4359,114588,4982.086957,181.625,26.28768066
NM_001040173,HTR4,7,6,155511,2992,152519,25419.83333,427.4285714,50.9756016
NM_001172698,PPARGC1B,11,10,124772,10521,114251,11425.1,956.4545455,10.85932896
NM_014983,HMGXB3,20,19,52539,5426,47113,2479.631579,271.3,8.682823443
NM_001172699,PPARGC1B,11,10,83084,10552,72532,7253.2,959.2727273,6.873768006
NM_000440,PDE6A,22,21,86839,5664,81175,3865.47619,257.4545455,14.33174435
NM_001804,CDX1,3,2,17779,1775,16004,8002,591.6666667,9.016338028
NM_133263,PPARGC1B,12,11,124772,10639,114133,10375.72727,886.5833333,10.72779397
NM_015621,CCDC69,9,8,43043,3408,39635,4954.375,378.6666667,11.62998826
NM_078483,SLC36A1,11,10,44779,5784,38995,3899.5,525.8181818,6.741874136
NM_018047,RBM22,11,10,10319,2357,7962,796.2,214.2727273,3.37802291
NM_004045,ATOX1,4,3,15829,493,15336,5112,123.25,31.10750507
NM_000171,GLRA1,9,8,102325,1806,100519,12564.875,200.6666667,55.65836102
NM_001146040,GLRA1,9,8,102325,1830,100495,12561.875,203.3333333,54.91530055
NM_020167,NMUR2,4,3,13740,2068,11672,3890.666667,517,5.64410058
NM_198321,GALNT10,12,11,230250,5967,224283,20389.36364,497.25,37.58722976
NM_015465,GEMIN5,28,27,50802,5432,45370,1680.37037,194,8.352356406
NM_001252156,GEMIN5,28,27,50802,5429,45373,1680.481481,193.8928571,8.357524406
NM_000337,SGCD,9,8,441033,9798,431235,53904.375,1088.666667,44.01255358
NM_001128209,SGCD,8,7,441033,9751,431282,61611.71429,1218.875,44.22951492
NM_172244,SGCD,8,7,431305,1581,429724,61389.14286,197.625,271.8051866
NM_001172292,NIPAL4,5,4,14705,3227,11478,2869.5,645.4,3.55686396
NM_001146726,TIMD4,8,7,43975,1293,42682,6097.428571,161.625,33.01005414
NM_001037332,CYFIP2,31,30,129421,6822,122599,4086.633333,220.0645161,17.97112284
NM_001037333,CYFIP2,31,30,129517,6529,122988,4099.6,210.6129032,18.83718793
NM_138379,TIMD4,9,8,43975,1378,42597,5324.625,153.1111111,30.91219158
NM_014376,CYFIP2,31,30,126246,6646,119600,3986.666667,214.3870968,17.99578694
NM_001099287,NIPAL4,6,5,14705,3285,11420,2284,547.5,3.476407915
NM_005546,ITK,17,16,74204,4383,69821,4363.8125,257.8235294,15.92995665
NM_144726,RNF145,11,10,50419,3375,47044,4704.4,306.8181818,13.93896296
NM_001199383,RNF145,11,10,52148,3628,48520,4852,329.8181818,13.37375965
NM_001199382,RNF145,11,10,50241,3477,46764,4676.4,316.0909091,13.44952545
NM_001199381,RNF145,11,10,50725,3551,47174,4717.4,322.8181818,13.28470853
NM_001199380,RNF145,11,10,52646,3504,49142,4914.2,318.5454545,14.02454338
NM_025153,ATP10B,26,25,289094,7592,281502,11260.08,292,37.07876712
NM_001130958,FABP6,7,6,51357,750,50607,8434.5,107.1428571,67.476
NM_031908,C1QTNF2,3,2,22875,2400,20475,10237.5,800,8.53125
NM_001267035,PWWP2A,3,2,43562,3893,39669,19834.5,1297.666667,10.1898279
NM_001040442,FABP6,6,5,39683,669,39014,7802.8,111.5,58.31689088
NM_052927,PWWP2A,4,3,43562,4014,39548,13182.66667,1003.5,9.852516193
NM_000813,GABRB2,10,9,259696,7305,252391,28043.44444,730.5,34.5504449
NM_021911,GABRB2,11,10,259696,7420,252276,25227.6,674.5454545,33.99946092
NM_003062,SLIT3,36,35,639397,9749,629648,17989.94286,270.8055556,64.58590625
NM_001271946,SLIT3,36,35,639397,9770,629627,17989.34286,271.3888889,64.44493347
NM_001129891,FAM196B,4,3,117027,3552,113475,37825,888,31.94679054
NM_004946,DOCK2,52,51,446137,6149,439988,8627.215686,118.25,71.55439909
NM_001278339,KCNIP1,8,7,232599,2098,230501,32928.71429,262.25,109.8670162
NM_001034837,KCNIP1,9,8,232599,2057,230542,28817.75,228.5555556,112.0768109
NM_022897,RANBP17,28,27,438125,4594,433531,16056.7037,164.0714286,94.36895951
NM_014592,KCNIP1,8,7,232599,2023,230576,32939.42857,252.875,113.9772615
NM_001278340,KCNIP1,9,8,232599,2186,230413,28801.625,242.8888889,105.4039341
NM_012300,FBXW11,13,12,145323,4588,140735,11727.91667,352.9230769,30.67458588
NM_001017995,SH3PXD2B,13,12,121026,7790,113236,9436.333333,599.2307692,14.53607189
NM_033644,FBXW11,13,12,145323,4549,140774,11731.16667,349.9230769,30.94614201
NM_033645,FBXW11,12,11,145323,4485,140838,12803.45455,373.75,31.40200669
NM_005990,STK10,19,18,146274,6038,140236,7790.888889,317.7894737,23.22557138
NM_152277,UBTD2,3,2,74147,3018,71129,35564.5,1006,23.56825712
NM_001031711,ERGIC1,10,9,118467,2946,115521,12835.66667,294.6,39.21283096
NM_001142651,NEURL1B,5,4,50259,6412,43847,10961.75,1282.4,6.83827199
NM_003714,STC2,4,3,14782,5347,9435,3145,1336.75,1.764540864
NM_001168394,CREBRF,4,3,35980,2474,33506,11168.66667,618.5,13.5432498
NM_001168393,CREBRF,4,3,35980,2470,33510,11170,617.5,13.56680162
NM_153607,CREBRF,9,8,82938,7791,75147,9393.375,865.6666667,9.645360031
NM_006650,CPLX2,5,4,87415,4731,82684,20671,946.2,17.47706616
NM_198567,SIMC1,9,8,107622,2067,105555,13194.375,229.6666667,51.06676343
NM_052899,GPRIN1,2,1,14330,4210,10120,10120,2105,2.403800475
NM_014613,FAF2,11,10,61721,4526,57195,5719.5,411.4545455,12.6369863
NM_001265615,FAM153B,20,19,51091,1814,49277,2593.526316,90.7,27.16482911
NM_001190946,FAM193B,9,8,34760,2961,31799,3974.875,329,10.73927727
NM_133369,UNC5A,15,14,70341,3748,66593,4756.642857,249.8666667,17.76760939
NM_001167579,SLC34A1,9,8,6084,1924,4160,520,213.7777778,2.162162162
NM_001199298,UIMC1,15,14,101791,2605,99186,7084.714286,173.6666667,38.07523992
NM_001199297,UIMC1,16,15,101776,2816,98960,6597.333333,176,35.14204545
NM_003052,SLC34A1,13,12,14419,2599,11820,985,199.9230769,4.54790304
NM_016290,UIMC1,15,14,101439,2619,98820,7058.571429,174.6,37.73195876
NM_022455,NSD1,23,22,166383,13006,153377,6971.681818,565.4782609,11.79278794
NM_172349,NSD1,24,23,167136,12222,154914,6735.391304,509.25,12.67501227
NM_173465,COL23A1,29,28,352941,3092,349849,12494.60714,106.6206897,113.1465071
NM_021599,ADAMTS2,11,10,194547,2058,192489,19248.9,187.0909091,93.53206997
NM_001178090,ZNF454,5,4,25026,2116,22910,5727.5,423.2,10.82703214
NM_001178089,ZNF454,5,4,25026,2177,22849,5712.25,435.4,10.4956362
NM_005520,HNRNPH1,14,13,9545,2263,7282,560.1538462,161.6428571,3.217852408
NM_014244,ADAMTS2,22,21,234581,6776,227805,10847.85714,308,33.61939197
NM_001257293,HNRNPH1,14,13,9534,2293,7241,557,163.7857143,3.157871784
NM_014757,MAML1,5,4,44438,5728,38710,9677.5,1145.6,6.758030726
NM_182594,ZNF454,5,4,25026,2119,22907,5726.75,423.8,10.81028787
NM_002406,MGAT1,2,1,12509,2928,9581,9581,1464,3.272199454
NM_001135044,MAPK9,7,6,46045,2377,43668,7278,339.5714286,18.37105595
NM_001280801,RNF130,8,7,117053,2177,114876,16410.85714,272.125,52.7680294
NM_002752,MAPK9,12,11,58478,4347,54131,4921,362.25,12.45249597
NM_015455,CNOT6,12,11,83938,6188,77750,7068.181818,515.6666667,12.56464124
NM_018434,RNF130,9,8,117053,2272,114781,14347.625,252.4444444,50.51980634
NM_139070,MAPK9,12,11,58478,4347,54131,4921,362.25,12.45249597
NM_139069,MAPK9,12,11,58478,4352,54126,4920.545455,362.6666667,12.43704044
NM_139068,MAPK9,12,11,58478,4352,54126,4920.545455,362.6666667,12.43704044
NM_001114619,MGAT1,2,1,13363,2649,10714,10714,1324.5,4.044545111
NM_001114620,MGAT1,2,1,13363,2860,10503,10503,1430,3.672377622
NM_001114618,MGAT1,3,2,19278,3173,16105,8052.5,1057.666667,5.075638197
NM_001114617,MGAT1,3,2,19598,3087,16511,8255.5,1029,5.348558471
NM_175062,RASGEF1C,14,13,108337,2230,106107,8162.076923,159.2857143,47.58161435
NM_152547,BTNL9,11,10,21300,3511,17789,1778.9,319.1818182,5.066647679
NM_145265,CCDC127,3,2,13424,1423,12001,6000.5,474.3333333,8.433591005
NM_001080478,LRRC14B,2,1,3844,1575,2269,2269,787.5,1.440634921
NM_052909,PLEKHG4B,18,17,49716,11533,38183,2246.058824,640.7222222,3.310760427
NM_004168,SDHA,15,14,38460,2404,36056,2575.428571,160.2666667,14.99833611
NM_013232,PDCD6,6,5,43355,1141,42214,8442.8,190.1666667,36.99737073
NM_001267558,PDCD6,7,6,43355,1057,42298,7049.666667,151,40.01702933
NM_001267556,PDCD6,6,5,43355,1135,42220,8444,189.1666667,37.19823789
NM_001267559,PDCD6,4,3,43355,870,42485,14161.66667,217.5,48.83333333
NM_001267557,PDCD6,4,3,43355,935,42420,14140,233.75,45.36898396
NM_007277,EXOC3,13,12,24077,2775,21302,1775.166667,213.4615385,7.676396396
NM_138464,C5orf55,1,0,1617,1617,NA,NA,1617,NA
NM_018140,CEP72,12,11,41263,2426,38837,3530.636364,202.1666667,16.00865622
NM_007030,TPPP,4,3,33535,6026,27509,9169.666667,1506.5,4.565051444
NM_024786,ZDHHC11,13,12,55383,2619,52764,4397,201.4615385,20.14662085
NM_001009877,BRD9,16,15,28826,2537,26289,1752.6,158.5625,10.36223886
NM_023924,BRD9,16,15,29091,2710,26381,1758.733333,169.375,9.734686347
NM_001166260,TRIP13,9,8,16080,1491,14589,1823.625,165.6666667,9.784708249
NM_033120,NKD2,10,9,29852,1901,27951,3105.666667,190.1,14.70331405
NM_001271082,NKD2,11,10,29852,2081,27771,2777.1,189.1818182,13.34502643
NM_006598,SLC12A7,24,23,61685,5328,56357,2450.304348,222,10.57751502
NM_198253,TERT,16,15,41877,4029,37848,2523.2,251.8125,9.393894267
NM_001193376,TERT,15,14,41877,3839,38038,2717,255.9333333,9.908309456
NM_182632,SLC6A18,12,11,20836,2133,18703,1700.272727,177.75,8.768401313
NM_001003841,SLC6A19,12,11,23522,5184,18338,1667.090909,432,3.53742284
NM_030782,CLPTM1L,17,16,27004,2164,24840,1552.5,127.2941176,11.47874307
NM_024830,LPCAT1,14,13,62536,3960,58576,4505.846154,282.8571429,14.79191919
NM_032479,MRPL36,2,1,1459,616,843,843,308,1.368506494
NM_004553,NDUFS6,4,3,14673,552,14121,4707,138,25.58152174
NM_001278635,IRX4,7,6,9559,2410,7149,1191.5,344.2857143,2.966390041
NM_001278634,IRX4,6,5,9559,2331,7228,1445.6,388.5,3.100815101
NM_001278633,IRX4,7,6,9754,2405,7349,1224.833333,343.5714286,3.055717256
NM_001278632,IRX4,6,5,9754,2326,7428,1485.6,387.6666667,3.193465176
NM_016358,IRX4,5,4,5341,2226,3115,778.75,445.2,1.399371069
NM_001134222,IRX2,5,4,5492,2308,3184,796,461.6,1.379549393
NM_033267,IRX2,4,3,5492,3061,2431,810.3333333,765.25,0.794184907
NM_024337,IRX1,4,3,5351,1862,3489,1163,465.5,1.873791622
NM_015325,KIAA0947,19,18,67563,7967,59596,3310.888889,419.3157895,7.48035647
NM_032286,MED10,4,3,6602,1032,5570,1856.666667,258,5.397286822
NM_001145161,UBE2QL1,2,1,48100,6131,41969,41969,3065.5,6.845375958
NM_017755,NSUN2,19,18,34123,3391,30732,1707.333333,178.4736842,9.062813329
NM_001047,SRD5A1,5,4,36177,2269,33908,8477,453.8,14.94402821
NM_001193455,NSUN2,18,17,34123,3285,30838,1814,182.5,9.387519026
NM_006999,PAPD7,13,12,42445,3874,38571,3214.25,298,9.956375839
NM_001171806,PAPD7,7,6,11062,3470,7592,1265.333333,495.7142857,2.187896254
NM_001171805,PAPD7,13,12,42445,3871,38574,3214.5,297.7692308,9.964866959
NM_001089584,C5orf49,3,2,21114,2388,18726,9363,796,7.841708543
NM_024010,MTRR,15,14,32020,3287,28733,2052.357143,219.1333333,8.741405537
NM_002454,MTRR,15,14,32020,3313,28707,2050.5,220.8666667,8.664956233
NM_019599,TAS2R1,1,0,1356,1356,NA,NA,1356,NA
NM_012073,CCT5,11,10,16221,3414,12807,1280.7,310.3636364,3.751318102
NM_199133,FAM173B,5,4,24403,2676,21727,5431.75,535.2,8.119207773
NM_001258389,FAM173B,5,4,24403,2632,21771,5442.75,526.4,8.271656535
NM_001258388,FAM173B,4,3,24403,2624,21779,7259.666667,656,8.29992378
NM_138809,CMBL,6,5,30463,4053,26410,5282,675.5,6.516160868
NM_001201466,ROPN1L,6,5,23166,961,22205,4441,160.1666667,23.10613944
NM_031916,ROPN1L,5,4,23166,1083,22083,5520.75,216.6,20.39058172
NM_019018,FAM105A,8,7,34398,7056,27342,3906,882,3.875
NM_019000,FAM134B,7,6,35962,3167,32795,5465.833333,452.4285714,10.35522577
NM_033414,ZNF622,6,5,14268,1698,12570,2514,283,7.402826855
NM_006317,BASP1,2,1,59286,1890,57396,57396,945,30.36825397
NM_001271606,BASP1,2,1,60024,1715,58309,58309,857.5,33.99941691
NM_020227,PRDM9,11,10,20984,3702,17282,1728.2,336.5454545,4.668287412
NM_018356,C5orf22,9,8,22794,3621,19173,2396.625,402.3333333,5.294946147
NM_022130,GOLPH3,4,3,49603,2680,46923,15641,670,17.50858209
NM_006713,SUB1,5,4,18582,3512,15070,3767.5,702.4,4.291002278
NM_001258438,TARS,20,19,27316,2985,24331,1280.578947,149.25,8.151088777
NM_001258437,TARS,20,19,27396,2712,24684,1299.157895,135.6,9.101769912
NM_152295,TARS,19,18,27316,2885,24431,1357.277778,151.8421053,8.468284229
NM_016568,RXFP3,1,0,2534,2534,NA,NA,2534,NA
NM_203382,AMACR,4,3,21131,3195,17936,5978.666667,798.75,5.613771518
NM_030945,C1QTNF3,6,5,25410,3613,21797,4359.4,602.1666667,6.032936618
NM_001167595,AMACR,6,5,21131,2609,18522,3704.4,434.8333333,7.099271752
NM_014324,AMACR,5,4,21131,3357,17774,4443.5,671.4,5.294608281
NM_181435,C1QTNF3,6,5,25410,3832,21578,4315.6,638.6666667,5.631002088
NM_194283,DNAJC21,13,12,29373,6221,23152,1929.333333,478.5384615,3.721588169
NM_001012339,DNAJC21,12,11,29373,6085,23288,2117.090909,507.0833333,3.827115859
NM_018321,BRIX1,10,9,9969,1283,8686,965.1111111,128.3,6.770070148
NM_002853,RAD1,6,5,10416,4688,5728,1145.6,781.3333333,1.221843003
NM_001204317,PRLR,9,8,69365,1622,67743,8467.875,180.2222222,41.76510481
NM_001204316,PRLR,10,9,69365,1777,67588,7509.777778,177.7,38.03489026
NM_031900,AGXT2,14,13,50036,2420,47616,3662.769231,172.8571429,19.67603306
NM_001204315,PRLR,10,9,53035,1412,51623,5735.888889,141.2,36.5601983
NM_001204318,PRLR,7,6,69365,1450,67915,11319.16667,207.1428571,46.83793103
NM_001204314,PRLR,7,6,62424,11067,51357,8559.5,1581,4.640552995
NM_002185,IL7R,8,7,22730,4608,18122,2588.857143,576,3.932725694
NM_001171873,UGT3A1,6,5,40274,3103,37171,7434.2,517.1666667,11.97905253
NM_152404,UGT3A1,7,6,38346,2885,35461,5910.166667,412.1428571,12.2915078
NM_001007527,LMBRD2,18,17,48603,3255,45348,2667.529412,180.8333333,13.93179724
NM_001161429,RANBP3L,15,14,52909,2633,50276,3591.142857,175.5333333,19.09456893
NM_001085411,NADK2,12,11,49211,3896,45315,4119.545455,324.6666667,11.63116016
NM_145000,RANBP3L,14,13,52909,2557,50352,3873.230769,182.6428571,19.69182636
NM_153013,NADK2,12,11,49692,3780,45912,4173.818182,315,12.14603175
NM_001287340,NADK2,12,11,48804,3629,45175,4106.818182,302.4166667,12.44833287
NM_001287341,NADK2,13,12,49692,3847,45845,3820.416667,295.9230769,11.91707824
NM_004172,SLC1A3,10,9,81981,4180,77801,8644.555556,418,18.61267943
NM_001166696,SLC1A3,2,1,2944,1352,1592,1592,676,1.177514793
NM_001166695,SLC1A3,9,8,81981,4044,77937,9742.125,449.3333333,19.27225519
NM_001289939,SLC1A3,9,8,81981,4041,77940,9742.5,449,19.28730512
NM_001289940,SLC1A3,8,7,81981,3842,78139,11162.71429,480.25,20.33810515
NM_001278098,GDNF,3,2,22147,3641,18506,9253,1213.666667,5.082669596
NM_001190469,GDNF,3,2,23152,3755,19397,9698.5,1251.666667,5.165645806
NM_001190468,GDNF,3,2,23152,3833,19319,9659.5,1277.666667,5.040177407
NM_199231,GDNF,3,2,22816,3658,19158,9579,1219.333333,5.237288136
NM_001278094,GDNF-AS1,2,1,2375,1942,433,433,971,0.222966014
NM_000514,GDNF,3,2,27005,3813,23192,11596,1271,6.082349856
NM_182801,EGFLAM,6,5,20006,2293,17713,3542.6,382.1666667,7.724814653
NM_001168355,OSMR,7,6,40801,1747,39054,6509,249.5714286,22.3548941
NM_001343,DAB2,15,14,53561,4616,48945,3496.071429,307.7333333,10.60333622
NM_001244871,DAB2,14,13,53561,4552,49009,3769.923077,325.1428571,10.76647627
NM_000958,PTGER4,3,2,13807,3419,10388,5194,1139.666667,3.038315297
NM_012382,TTC33,5,4,44396,5511,38885,9721.25,1102.2,7.055888224
NM_032587,CARD6,3,2,14048,4100,9948,4974,1366.666667,2.426341463
NM_000997,RPL37,4,3,3959,1574,2385,795,393.5,1.515247776
NM_000587,C7,18,17,73445,4031,69414,4083.176471,223.9444444,17.22004465
NM_012176,FBXO4,7,6,16318,1516,14802,2467,216.5714286,9.763852243
NM_033484,FBXO4,5,4,9831,1734,8097,2024.25,346.8,4.669550173
NM_175921,C5orf51,6,5,17270,5228,12042,2408.4,871.3333333,2.303366488
NM_005410,SEPP1,5,4,12044,2091,9953,2488.25,418.2,4.759923482
NM_001134848,CCDC152,9,8,45621,3500,42121,5265.125,388.8888889,12.03457143
NM_001085486,SEPP1,6,5,12044,2121,9923,1984.6,353.5,4.67845356
NM_001093726,SEPP1,6,5,12044,2180,9864,1972.8,363.3333333,4.524770642
NM_001014279,ANXA2R,1,0,1267,1267,NA,NA,1267,NA
NM_002130,HMGCS1,10,9,26044,5401,20643,2293.666667,540.1,3.822069987
NM_001098272,HMGCS1,11,10,26044,5461,20583,2058.3,496.4545455,3.76908991
NM_198566,C5orf34,13,12,28472,2546,25926,2160.5,195.8461538,10.18303221
NM_022483,C5orf28,3,2,39640,2764,36876,18438,921.3333333,13.34153401
NM_183323,PAIP1,11,10,31153,2374,28779,2877.9,215.8181818,12.12257793
NM_006451,PAIP1,11,10,30827,2806,28021,2802.1,255.0909091,9.986101212
NM_182789,PAIP1,11,10,30827,2569,28258,2825.8,233.5454545,10.99961074
NM_004465,FGF10,3,2,83689,630,83059,41529.5,210,131.8396825
NM_016640,MRPS30,5,4,6593,1677,4916,1229,335.4,2.931425164
NM_198449,EMB,9,8,45205,4318,40887,5110.875,479.7777778,9.468967114
NM_002202,ISL1,6,5,11607,2723,8884,1776.8,453.8333333,3.262578039
NM_015946,PELO,3,2,14680,2924,11756,5878,974.6666667,4.020519836
NM_004531,MOCS2,7,6,14095,4188,9907,1651.166667,598.2857143,2.36556829
NM_176806,MOCS2,7,6,14095,3727,10368,1728,532.4285714,2.781862087
NM_006350,FST,6,5,6042,2104,3938,787.6,350.6666667,1.871673004
NM_013409,FST,6,5,6042,1840,4202,840.4,306.6666667,2.283695652
NM_052870,SNX18,1,0,3243,3243,NA,NA,3243,NA
NM_001145427,SNX18,2,1,28829,5378,23451,23451,2689,4.360542953
NM_006308,HSPB3,1,0,785,785,NA,NA,785,NA
NM_001102575,SNX18,2,1,28825,5221,23604,23604,2610.5,4.520972994
NM_001135604,ESM1,2,1,7721,1941,5780,5780,970.5,2.977846471
NM_002104,GZMK,5,4,9855,1050,8805,2201.25,210,8.385714286
NM_007036,ESM1,3,2,7721,2092,5629,2814.5,697.3333333,2.690726577
NM_001145734,CDC20B,11,10,60208,2869,57339,5733.9,260.8181818,19.98570931
NM_006144,GZMA,5,4,7608,901,6707,1676.75,180.2,7.443951165
NM_001170402,CDC20B,12,11,60208,2996,57212,5201.090909,249.6666667,19.09612817
NM_152623,CDC20B,12,11,60208,2984,57224,5202.181818,248.6666667,19.1769437
NM_001190787,MCIDAS,7,6,7720,2111,5609,934.8333333,301.5714286,2.657034581
NM_001008397,GPX8,3,2,7147,3753,3394,1697,1251,0.904343192
NM_021147,CCNO,3,2,2529,1435,1094,547,478.3333333,0.762369338
NM_019030,DHX29,27,26,51450,4500,46950,1805.769231,166.6666667,10.43333333
NM_173514,SLC38A9,16,15,86492,2552,83940,5596,159.5,32.89184953
NM_001258287,SLC38A9,14,13,67210,2696,64514,4962.615385,192.5714286,23.92952522
NM_001258286,SLC38A9,14,13,67210,2700,64510,4962.307692,192.8571429,23.89259259
NM_001282429,SLC38A9,15,14,86492,2418,84074,6005.285714,161.2,34.7700579
NM_001166534,DDX4,15,14,50263,2394,47869,3419.214286,159.6,19.99540518
NM_001190981,IL6ST,16,15,59898,8888,51010,3400.666667,555.5,5.73919892
NM_002184,IL6ST,17,16,59898,9072,50826,3176.625,533.6470588,5.602513228
NM_175767,IL6ST,16,15,59898,8988,50910,3394,561.75,5.664218959
NM_001171990,SETD9,6,5,16274,1404,14870,2974,234,10.59116809
NM_005921,MAP3K1,20,19,81080,7531,73549,3871,376.55,9.766166512
NM_153706,SETD9,6,5,8080,1728,6352,1270.4,288,3.675925926
NM_001127236,GPBP1,11,10,50607,3438,47169,4716.9,312.5454545,13.71989529
NM_001017992,ACTBL2,1,0,2795,2795,NA,NA,2795,NA
NM_006622,PLK2,14,13,6158,2852,3306,254.3076923,203.7142857,1.159186536
NM_152687,GAPT,3,2,4857,2219,2638,1319,739.6666667,1.188823795
NM_001252226,PLK2,15,14,6158,2811,3347,239.0714286,187.4,1.190679473
NM_001197223,PDE4D,10,9,30895,7588,23307,2589.666667,758.8,3.071560358
NM_024930,ELOVL7,9,8,92487,3890,88597,11074.625,432.2222222,22.77557841
NM_001104558,ELOVL7,8,7,92487,3838,88649,12664.14286,479.75,23.09770714
NM_000082,ERCC8,12,11,71248,2056,69192,6290.181818,171.3333333,33.6536965
NM_001048249,SMIM15,3,2,4768,2893,1875,937.5,964.3333333,0.648116142
NM_014473,DIMT1,12,11,15379,1569,13810,1255.454545,130.75,8.801784576
NM_181506,LRRC70,2,1,2715,2251,464,464,1125.5,0.206130609
NM_000524,HTR1A,1,0,2246,2246,NA,NA,2246,NA
NM_178532,RNF180,5,4,51670,1458,50212,12553,291.6,34.43895748
NM_001271891,RGS7BP,4,3,36646,3610,33036,11012,902.5,9.151246537
NM_001271890,RGS7BP,4,3,36646,3612,33034,11011.33333,903,9.145625692
NM_173829,SREK1IP1,5,4,50520,6858,43662,10915.5,1371.6,6.366579178
NM_001164442,FAM159B,3,2,27884,970,26914,13457,323.3333333,27.74639175
NM_001267038,CENPK,11,10,45404,1708,43696,4369.6,155.2727273,25.58313817
NM_022145,CENPK,11,10,45404,1742,43662,4366.2,158.3636364,25.06429392
NM_024941,TRAPPC13,13,12,41398,3113,38285,3190.416667,239.4615385,12.29842596
NM_001243737,TRAPPC13,12,11,41398,3097,38301,3481.909091,258.0833333,12.36712948
NM_001656,TRIM23,11,10,34682,3911,30771,3077.1,355.5454545,7.867808745
NM_033227,TRIM23,13,12,34682,2428,32254,2687.833333,186.7692308,13.28418451
NM_033228,TRIM23,13,12,34682,2399,32283,2690.25,184.5384615,13.45685702
NM_001093755,TRAPPC13,13,12,41398,3116,38282,3190.166667,239.6923077,12.28562259
NM_001093756,TRAPPC13,12,11,41398,3094,38304,3482.181818,257.8333333,12.3800905
NM_020726,NLN,13,12,107090,8674,98416,8201.333333,667.2307692,11.34609177
NM_139168,SREK1,13,12,38783,6948,31835,2652.916667,534.4615385,4.58189407
NM_001077199,SREK1,12,11,39400,6794,32606,2964.181818,566.1666667,4.799234619
NM_001270493,SREK1,3,2,13524,2133,11391,5695.5,711,5.340365682
NM_001270492,SREK1,13,12,39400,6916,32484,2707,532,4.696934644
NM_005582,CD180,3,2,14515,2718,11797,5898.5,906,4.340323767
NM_181504,PIK3R1,10,9,11184,5685,5499,611,568.5,0.967282322
NM_181524,PIK3R1,10,9,13399,5817,7582,842.4444444,581.7,1.303421007
NM_001242466,PIK3R1,9,8,9255,5547,3708,463.5,616.3333333,0.668469443
NM_181523,PIK3R1,16,15,86067,6991,79076,5271.733333,436.9375,11.31111429
NM_024055,SLC30A5,4,3,10793,1363,9430,3143.333333,340.75,6.918561996
NM_001251969,SLC30A5,3,2,10793,1239,9554,4777,413,7.711057304
NM_031966,CCNB1,9,8,11235,2176,9059,1132.375,241.7777778,4.163143382
NM_033281,MRPS36,4,3,12414,1333,11081,3693.666667,333.25,8.312828207
NM_022909,CENPH,9,8,20811,1398,19413,2426.625,155.3333333,13.88626609
NM_016283,AK6,5,4,17858,951,16907,4226.75,190.2,17.77812829
NM_001015891,AK6,5,4,18289,1188,17101,4275.25,237.6,14.39478114
NM_001015892,TAF9,3,2,5272,1465,3807,1903.5,488.3333333,2.598634812
NM_003187,TAF9,3,2,4841,1228,3613,1806.5,409.3333333,2.94218241
NM_176816,CCDC125,11,10,39893,3627,36266,3626.6,329.7272727,9.99889716
NM_001244734,MARVELD2,6,5,26953,2130,24823,4964.6,355,11.65399061
NM_001038603,MARVELD2,7,6,26953,2167,24786,4131,309.5714286,11.43793263
NM_001042490,GTF2H2D,17,16,32280,1820,30460,1903.75,107.0588235,16.73626374
NM_001098728,GTF2H2C,16,15,32680,2121,30559,2037.266667,132.5625,14.4078265
NM_001178087,SERF1B,3,2,7447,702,6745,3372.5,234,9.608262108
NM_022968,SERF1A,3,2,7455,710,6745,3372.5,236.6666667,9.5
NM_022875,SMN2,8,7,28074,1582,26492,3784.571429,197.75,16.74589128
NM_022877,SMN2,7,6,28074,1485,26589,4431.5,212.1428571,17.90505051
NM_022876,SMN2,8,7,28074,1540,26534,3790.571429,192.5,17.22987013
NM_000344,SMN1,9,8,28070,1633,26437,3304.625,181.4444444,16.18922229
NM_017411,SMN2,9,8,28074,1637,26437,3304.625,181.8888889,16.14966402
NM_022874,SMN1,8,7,28070,1536,26534,3790.571429,192,17.27473958
NM_001178087,SERF1B,3,2,7448,702,6746,3373,234,9.60968661
NM_021967,SERF1A,3,2,17869,1916,15953,7976.5,638.6666667,8.326200418
NM_022875,SMN2,8,7,28076,1582,26494,3784.857143,197.75,16.7471555
NM_022877,SMN2,7,6,28076,1485,26591,4431.833333,212.1428571,17.90639731
NM_022876,SMN2,8,7,28076,1540,26536,3790.857143,192.5,17.23116883
NM_022978,SERF1B,3,2,17857,1904,15953,7976.5,634.6666667,8.378676471
NM_000344,SMN1,9,8,28072,1633,26439,3304.875,181.4444444,16.19044703
NM_017411,SMN2,9,8,28076,1637,26439,3304.875,181.8888889,16.15088577
NM_022968,SERF1A,3,2,7456,710,6746,3373,236.6666667,9.501408451
NM_022874,SMN1,8,7,28072,1536,26536,3790.857143,192,17.27604167
NM_001515,GTF2H2,16,15,32548,1967,30581,2038.733333,122.9375,15.54702593
NM_022892,NAIP,15,14,56633,5895,50738,3624.142857,393,8.606955047
NM_004536,NAIP,17,16,56633,6568,50065,3129.0625,386.3529412,7.622563946
NM_004291,CARTPT,3,2,1887,918,969,484.5,306,1.055555556
NM_024754,PTCD2,10,9,38988,2119,36869,4096.555556,211.9,17.39924493
NM_001284405,PTCD2,9,8,38988,2039,36949,4618.625,226.5555556,18.12113781
NM_001284403,PTCD2,7,6,38988,1789,37199,6199.833333,255.5714286,20.79318055
NM_001284404,PTCD2,8,7,38988,1920,37068,5295.428571,240,19.30625
NM_152625,ZNF366,5,4,64017,2775,61242,15310.5,555,22.06918919
NM_002270,TNPO1,25,24,97799,8584,89215,3717.291667,343.36,10.39317335
NM_153188,TNPO1,25,24,66287,8571,57716,2404.833333,342.84,6.733870027
NM_173490,TMEM171,4,3,11258,1270,9988,3329.333333,317.5,7.864566929
NM_001161342,TMEM171,4,3,11258,1267,9991,3330.333333,316.75,7.885556433
NM_153217,TMEM174,2,1,1949,1760,189,189,880,0.107386364
NM_004472,FOXD1,1,0,2269,2269,NA,NA,2269,NA
NM_023039,ANKRA2,9,8,13488,2207,11281,1410.125,245.2222222,5.111463525
NM_001037637,BTF3,6,5,7200,1255,5945,1189,209.1666667,4.737051793
NM_001207,BTF3,6,5,7200,1014,6186,1237.2,169,6.100591716
NM_000521,HEXB,14,13,36146,1915,34231,2633.153846,136.7857143,17.87519582
NM_015566,FAM169A,13,12,89266,6003,83263,6938.583333,461.7692308,13.87023155
NM_014886,NSA2,6,5,9923,1400,8523,1704.6,233.3333333,6.087857143
NM_001271665,NSA2,5,4,9923,1206,8717,2179.25,241.2,7.228026534
NM_016591,GCNT4,1,0,3437,3437,NA,NA,3437,NA
NM_001130996,HMGCR,19,18,24935,4442,20493,1138.5,233.7894737,4.613462404
NM_000859,HMGCR,20,19,24935,4602,20333,1070.157895,230.1,4.418296393
NM_001276713,ANKDD1B,14,13,60372,2566,57806,4446.615385,183.2857143,22.52766952
NM_001285461,IQGAP2,24,23,99039,4128,94911,4126.565217,172,22.99200581
NM_001256566,F2RL2,2,1,7933,3280,4653,4653,1640,1.418597561
NM_004101,F2RL2,2,1,7954,3431,4523,4523,1715.5,1.318274556
NM_001285462,IQGAP2,24,23,99039,4179,94860,4124.347826,174.125,22.69921034
NM_005242,F2RL1,2,1,16309,2885,13424,13424,1442.5,4.653032929
NM_001882,CRHBP,7,6,16621,1845,14776,2462.666667,263.5714286,8.008672087
NM_032367,ZBED3,3,2,10500,1422,9078,4539,474,6.383966245
NM_018046,AGGF1,14,13,34850,4522,30328,2332.923077,323,6.706766917
NM_018268,WDR41,13,12,60265,2571,57694,4807.833333,197.7692308,22.4402956
NM_032109,OTP,3,2,9987,2681,7306,3653,893.6666667,2.725102574
NM_013391,DMGDH,16,15,72112,3189,68923,4594.866667,199.3125,21.61273126
NM_001713,BHMT,8,7,20511,2508,18003,2571.857143,313.5,7.178229665
NM_152405,JMY,11,10,91115,9140,81975,8197.5,830.9090909,8.968818381
NM_001114393,PAPD4,16,15,74230,3264,70966,4731.066667,204,21.74203431
NM_001114394,PAPD4,15,14,74230,3538,70692,5049.428571,235.8666667,19.9807801
NM_173797,PAPD4,16,15,74230,3298,70932,4728.8,206.125,21.50758035
NM_001010891,MTX3,8,7,14551,7853,6698,956.8571429,981.625,0.85292245
NM_001167741,MTX3,8,7,14551,7872,6679,954.1428571,984,0.848450203
NM_003248,THBS4,22,21,47939,3242,44697,2128.428571,147.3636364,13.78685996
NM_001174072,SERINC5,12,11,117350,6491,110859,10078.09091,540.9166667,17.07887845
NM_032567,SPZ1,1,0,1872,1872,NA,NA,1872,NA
NM_014733,ZFYVE16,18,17,71858,7310,64548,3796.941176,406.1111111,8.830095759
NM_001105251,ZFYVE16,19,18,71858,7439,64419,3578.833333,391.5263158,8.659631671
NM_001284237,ZFYVE16,4,3,32365,2947,29418,9806,736.75,9.982354937
NM_001284236,ZFYVE16,19,18,71858,7365,64493,3582.944444,387.6315789,8.756687033
NM_001004441,ANKRD34B,5,4,13732,3940,9792,2448,788,2.485279188
NM_001190470,MTRNR2L2,1,0,1037,1037,NA,NA,1037,NA
NM_000791,DHFR,6,5,28757,3923,24834,4966.8,653.8333333,6.330359419
NM_001099736,CKMT2,10,9,33080,1492,31588,3509.777778,149.2,21.17158177
NM_001099735,CKMT2,10,9,33080,1488,31592,3510.222222,148.8,21.2311828
NM_032280,ZCCHC9,6,5,11565,1796,9769,1953.8,299.3333333,5.439309577
NM_001825,CKMT2,11,10,33080,1653,31427,3142.7,150.2727273,19.01209921
NM_001131035,ZCCHC9,6,5,11565,1439,10126,2025.2,239.8333333,7.036831133
NM_001131036,ZCCHC9,6,5,11565,1411,10154,2030.8,235.1666667,7.19631467
NM_130767,ACOT12,15,14,64043,2004,62039,4431.357143,133.6,30.95758483
NM_001017971,ATP6AP1L,4,3,12983,762,12221,4073.666667,190.5,16.03805774
NM_001025,RPS23,4,3,5098,3318,1780,593.3333333,829.5,0.536467752
NM_174909,TMEM167A,4,3,24609,4591,20018,6672.666667,1147.75,4.360270094
NM_001867,COX7C,3,2,2801,410,2391,1195.5,136.6666667,5.831707317
NM_001199189,CCNH,9,8,18644,1518,17126,2140.75,168.6666667,11.28194993
NM_001239,CCNH,9,8,18773,1404,17369,2171.125,156,12.37108262
NM_203406,MBLAC2,2,1,16567,4282,12285,12285,2141,2.868986455
NM_004365,CETN3,5,4,16076,986,15090,3772.5,197.2,15.30425963
NM_198273,LYSMD3,3,2,13958,4263,9695,4847.5,1421,2.274220033
NM_001286812,LYSMD3,3,2,13958,4204,9754,4877,1401.333333,2.320171265
NM_020801,ARRDC3,8,7,14610,4169,10441,1491.571429,521.125,2.504437515
NM_005654,NR2F1,3,2,10745,3200,7545,3772.5,1066.666667,2.3578125
NM_153216,POU5F2,1,0,1296,1296,NA,NA,1296,NA
NM_173665,KIAA0825,5,4,99393,2267,97126,24281.5,453.4,42.84340538
NM_014639,TTC37,43,42,91112,5747,85365,2032.5,133.6511628,14.85383678
NM_001131066,RFESD,6,5,10370,1651,8719,1743.8,275.1666667,5.281041793
NM_001131065,RFESD,6,5,10268,2806,7462,1492.4,467.6666667,2.659301497
NM_031952,SPATA9,5,4,24696,1233,23463,5865.75,246.6,19.02919708
NM_199243,GPR150,1,0,1306,1306,NA,NA,1306,NA
NM_173362,RFESD,5,4,10268,2707,7561,1890.25,541.4,2.793128925
NM_014899,RHOBTB3,12,11,65223,5578,59645,5422.272727,464.8333333,10.69290068
NM_001177876,PCSK1,8,7,22651,4078,18573,2653.285714,509.75,4.55443845
NM_001177875,PCSK1,14,13,41825,4838,36987,2845.153846,345.5714286,7.645101282
NM_000439,PCSK1,14,13,42947,5180,37767,2905.153846,370,7.290926641
NM_001040458,ERAP1,19,18,33706,5104,28602,1589,268.6315789,5.603840125
NM_001198541,ERAP1,19,18,39662,4862,34800,1933.333333,255.8947368,7.157548334
NM_016442,ERAP1,20,19,47380,5604,41776,2198.736842,280.2,7.454675232
NM_001130140,ERAP2,19,18,43764,5272,38492,2138.444444,277.4736842,7.301213961
NM_022350,ERAP2,19,18,43764,5709,38055,2114.166667,300.4736842,6.665790857
NM_001159749,RIOK2,8,7,16557,2236,14321,2045.857143,279.5,6.404740608
NM_018343,RIOK2,10,9,22436,3973,18463,2051.444444,397.3,4.647118047
NM_001012761,RGMB,5,4,27201,4585,22616,5654,917,4.932606325
NM_001270,CHD1,35,34,71332,6492,64840,1907.058824,185.4857143,9.987677141
NM_005668,ST8SIA4,5,4,96352,6327,90025,22506.25,1265.4,14.22870239
NM_175052,ST8SIA4,3,2,17976,1868,16108,8054,622.6666667,8.623126338
NM_017676,GIN1,8,7,34140,3557,30583,4369,444.625,8.597975822
NM_033211,C5orf30,3,2,19921,3013,16908,8454,1004.333333,5.611682708
NM_014819,PJA2,10,9,75267,4879,70388,7820.888889,487.9,14.42672679
NM_138773,SLC25A46,8,7,23732,2334,21398,3056.857143,291.75,9.167952014
NM_033035,TSLP,4,3,6334,2633,3701,1233.666667,658.25,1.405620965
NM_139281,WDR36,23,22,38332,6615,31717,1441.681818,287.6086957,4.794708995
NM_138551,TSLP,2,1,4712,2413,2299,2299,1206.5,0.952755906
NM_139164,STARD4,6,5,14137,2270,11867,2373.4,378.3333333,5.227753304
NM_001142479,NREP,5,4,28254,2110,26144,6536,422,12.39052133
NM_001142478,NREP,5,4,28401,2073,26328,6582,414.6,12.70043415
NM_001142477,NREP,5,4,28795,2097,26698,6674.5,419.4,12.73152122
NM_001142476,NREP,5,4,28917,2206,26711,6677.75,441.2,12.10834089
NM_001142483,NREP,3,2,26950,2307,24643,12321.5,769,10.68183788
NM_001142482,NREP,5,4,28106,2020,26086,6521.5,404,12.91386139
NM_001142481,NREP,5,4,28108,2013,26095,6523.75,402.6,12.96323895
NM_001142480,NREP,5,4,28254,2104,26150,6537.5,420.8,12.42870722
NM_004772,NREP,4,3,27947,2000,25947,8649,500,12.9735
NM_001127510,APC,17,16,108382,10855,97527,6095.4375,638.5294118,8.984523261
NM_000038,APC,16,15,108382,10746,97636,6509.066667,671.625,9.085799367
NM_005669,REEP5,5,4,45952,3121,42831,10707.75,624.2,13.72348606
NM_032028,TSSK1B,1,0,2479,2479,NA,NA,2479,NA
NM_001017398,TRIM36,2,1,3009,908,2101,2101,454,2.313876652
NM_001017397,TRIM36,2,1,9446,695,8751,8751,347.5,12.59136691
NM_018700,TRIM36,10,9,55786,4447,51339,5704.333333,444.7,11.54463683
NM_152549,CCDC112,10,9,29104,2552,26552,2950.222222,255.2,10.40438871
NM_001040440,CCDC112,10,9,29575,2506,27069,3007.666667,250.6,10.80167598
NM_020177,FEM1C,3,2,23985,5816,18169,9084.5,1938.666667,3.123968363
NM_021649,TICAM2,2,1,23839,3059,20780,20780,1529.5,6.793069631
NM_001801,CDO1,5,4,11977,1619,10358,2589.5,323.8,6.397776405
NM_001277783,ATG12,3,2,13656,4195,9461,4730.5,1398.333333,2.255303933
NM_004707,ATG12,4,3,13656,4333,9323,3107.666667,1083.25,2.151627048
NM_001195581,ARL14EPL,3,2,7666,645,7021,3510.5,215,10.88527132
NM_001286814,TNFAIP8,2,1,61431,2248,59183,59183,1124,26.3269573
NM_001286813,TNFAIP8,3,2,39833,2511,37322,18661,837,14.86340104
NM_014350,TNFAIP8,2,1,38786,2093,36693,36693,1046.5,17.53129479
NM_000414,HSD17B4,24,23,89894,2709,87185,3790.652174,112.875,32.18346253
NM_001199292,HSD17B4,23,22,89894,2654,87240,3965.454545,115.3913043,32.87113791
NM_001199291,HSD17B4,25,24,89830,2899,86931,3622.125,115.96,29.98654709
NM_001163991,FAM170A,4,3,6265,1238,5027,1675.666667,309.5,4.060581583
NM_182761,FAM170A,5,4,6265,1380,4885,1221.25,276,3.539855072
NM_177478,FTMT,1,0,875,875,NA,NA,875,NA
NM_152546,SRFBP1,8,7,66641,2844,63797,9113.857143,355.5,22.43213783
NM_001178102,LOX,6,5,14030,4399,9631,1926.2,733.1666667,2.189361218
NM_002317,LOX,7,6,15167,5184,9983,1663.833333,740.5714286,1.925733025
NM_207317,ZNF474,2,1,24053,1959,22094,22094,979.5,11.27820316
NM_000943,PPIC,5,4,13349,1241,12108,3027,248.2,9.756647865
NM_001136239,PRDM6,8,7,98906,3035,95871,13695.85714,379.375,31.58846787
NM_001201377,ALDH7A1,18,17,53551,4954,48597,2858.647059,275.2222222,9.809648769
NM_001202404,ALDH7A1,16,15,53551,4760,48791,3252.733333,297.5,10.25021008
NM_001182,ALDH7A1,18,17,53551,4954,48597,2858.647059,275.2222222,9.809648769
NM_207408,C5orf48,3,2,4562,462,4100,2050,154,8.874458874
NM_001198557,LMNB1,11,10,59869,2261,57608,5760.8,205.5454545,25.4789916
NM_005573,LMNB1,11,10,60399,3414,56985,5698.5,310.3636364,16.69156415
NM_001164479,C5orf63,5,4,30936,5685,25251,6312.75,1137,4.441688654
NM_001164478,C5orf63,5,4,22190,971,21219,5304.75,194.2,21.85272915
NM_001127385,CTXN3,3,2,5617,1495,4122,2061,498.3333333,2.757190635
NM_001048252,CTXN3,3,2,9611,1686,7925,3962.5,562,4.700474496
NM_001256461,SLC12A2,26,25,105899,6838,99061,3962.44,263,14.48683826
NM_001046,SLC12A2,27,26,105899,6887,99012,3808.153846,255.0740741,14.37665166
NM_016048,ISOC1,5,4,19279,1945,17334,4333.5,389,8.912082262
NM_001257308,KIAA1024L,3,2,16874,576,16298,8149,192,28.29513889
NM_005340,HINT1,3,2,6067,691,5376,2688,230.3333333,7.780028944
NM_181705,LYRM7,5,4,34480,6218,28262,7065.5,1243.6,4.54519138
NM_000758,CSF2,4,3,2380,789,1591,530.3333333,197.25,2.016476553
NM_000588,IL3,5,4,2551,929,1622,405.5,185.8,1.745963402
NM_001017973,P4HA2,15,14,34633,2580,32053,2289.5,172,12.42364341
NM_001142599,P4HA2,16,15,35254,2251,33003,2200.2,140.6875,14.66148378
NM_001142598,P4HA2,16,15,35254,2245,33009,2200.6,140.3125,14.70334076
NM_001017974,P4HA2,15,14,35254,2108,33146,2367.571429,140.5333333,15.72390892
NM_004199,P4HA2,15,14,34633,2586,32047,2289.071429,172.4,12.39249807
NM_003059,SLC22A4,10,9,49756,2202,47554,5283.777778,220.2,21.59582198
NM_002198,IRF1,10,9,9166,3564,5602,622.4444444,356.4,1.571829405
NM_005732,RAD50,25,24,87699,6622,81077,3378.208333,264.88,12.243582
NM_000879,IL5,4,3,2080,820,1260,420,205,1.536585366
NM_007054,KIF3A,17,16,44944,6274,38670,2416.875,369.0588235,6.163532037
NM_172348,IL4,3,2,8694,573,8121,4060.5,191,14.17277487
NM_002188,IL13,4,3,2938,1286,1652,550.6666667,321.5,1.284603421
NM_015146,Sep-08,10,9,21372,4354,17018,1890.888889,435.4,3.908589802
NM_000589,IL4,4,3,8694,622,8072,2690.666667,155.5,12.97749196
NM_001098813,Sep-08,10,9,21866,4280,17586,1954,428,4.108878505
NM_001098812,Sep-08,10,9,21372,4086,17286,1920.666667,408.6,4.230543319
NM_001098811,Sep-08,10,9,26560,2899,23661,2629,289.9,8.161779924
NM_001039780,CCNI2,6,5,6960,2600,4360,872,433.3333333,1.676923077
NM_001287252,CCNI2,6,5,6960,2648,4312,862.4,441.3333333,1.628398792
NM_001287253,CCNI2,6,5,6960,2603,4357,871.4,433.8333333,1.673837879
NM_133456,SHROOM1,7,6,4171,3376,795,132.5,482.2857143,0.235485782
NM_001172700,SHROOM1,10,9,8759,4029,4730,525.5555556,402.9,1.173988583
NM_014402,UQCRQ,3,2,2219,1588,631,315.5,529.3333333,0.397355164
NM_001288826,GDF9,4,3,5399,1805,3594,1198,451.25,1.991135734
NM_052971,LEAP2,3,2,1226,710,516,258,236.6666667,0.726760563
NM_001288827,GDF9,4,3,5150,1802,3348,1116,450.5,1.857935627
NM_001288824,GDF9,3,2,5704,1828,3876,1938,609.3333333,2.120350109
NM_005260,GDF9,2,1,3353,1774,1579,1579,887,0.890078918
NM_001288825,GDF9,4,3,5704,1945,3759,1253,486.25,1.932647815
NM_175873,SOWAHA,1,0,3458,3458,NA,NA,3458,NA
NM_001288828,GDF9,4,3,5399,1725,3674,1224.666667,431.25,2.129855072
NM_017665,ZCCHC10,4,3,29564,2125,27439,9146.333333,531.25,12.91247059
NM_002154,HSPA4,19,18,53049,3404,49645,2758.055556,179.1578947,14.58431257
NM_003374,VDAC1,9,8,33260,2002,31258,3907.25,222.4444444,15.61338661
NM_201632,TCF7,9,8,32624,2842,29782,3722.75,315.7777778,10.47923997
NM_006930,SKP1,5,4,20644,2704,17940,4485,540.8,6.634615385
NM_213648,TCF7,8,7,32624,3075,29549,4221.285714,384.375,9.609430894
NM_201634,TCF7,10,9,32624,2939,29685,3298.333333,293.9,10.10037428
NM_170679,SKP1,6,5,20644,2019,18625,3725,336.5,9.224863794
NM_003202,TCF7,10,9,33520,3287,30233,3359.222222,328.7,9.197748707
NM_002715,PPP2CA,7,6,29804,2650,27154,4525.666667,378.5714286,10.24679245
NM_001134851,TCF7,9,8,32624,3325,29299,3662.375,369.4444444,8.811729323
NM_080656,CDKN2AIPNL,3,2,9844,1257,8587,4293.5,419,6.831344471
NM_003337,UBE2B,6,5,20931,2637,18294,3658.8,439.5,6.937428896
NM_015288,JADE2,11,10,57122,6474,50648,5064.8,588.5454545,7.823293173
NM_001252231,SEC24A,13,12,44915,2752,42163,3513.583333,211.6923077,15.32085756
NM_021982,SEC24A,23,22,79128,6414,72714,3305.181818,278.8695652,11.33676333
NM_014829,DDX46,23,22,72353,5703,66650,3029.545455,247.9565217,11.68683149
NM_001135586,C5orf24,2,1,13769,5085,8684,8684,2542.5,1.707767945
NM_152409,C5orf24,2,1,14057,4898,9159,9159,2449,1.869946917
NM_032151,PCBD2,4,3,57528,2382,55146,18382,595.5,23.1511335
NM_178019,CATSPER3,8,7,43803,1375,42428,6061.142857,171.875,30.85672727
NM_002653,PITX1,3,2,6542,2386,4156,2078,795.3333333,1.741827326
NM_138610,H2AFY,9,8,64859,1933,62926,7865.75,214.7777778,32.55354371
NM_138609,H2AFY,9,8,64859,1924,62935,7866.875,213.7777778,32.71049896
NM_004893,H2AFY,9,8,65508,1892,63616,7952,210.2222222,33.62367865
NM_001040158,H2AFY,9,8,64859,1930,62929,7866.125,214.4444444,32.60569948
NM_006161,NEUROG1,1,0,1669,1669,NA,NA,1669,NA
NM_130848,C5orf20,1,0,3136,3136,NA,NA,3136,NA
NM_001099221,TIFAB,2,1,3533,1275,2258,2258,637.5,1.770980392
NM_004887,CXCL14,4,3,8600,1977,6623,2207.666667,494.25,3.350025291
NM_145282,SLC25A48,5,4,53963,1204,52759,13189.75,240.8,43.81976744
NM_000590,IL9,5,4,3583,596,2987,746.75,119.2,5.011744966
NM_002302,LECT2,4,3,8125,1081,7044,2348,270.25,6.516188714
NM_005903,SMAD5,8,7,49888,7019,42869,6124.142857,877.375,6.10756518
NM_001001420,SMAD5,7,6,49888,6943,42945,7157.5,991.8571429,6.185366556
NM_001001419,SMAD5,9,8,49888,7104,42784,5348,789.3333333,6.022522523
NM_006805,HNRNPA0,1,0,2968,2968,NA,NA,2968,NA
NM_006790,MYOT,10,9,19997,2282,17715,1968.333333,228.2,7.762927257
NM_001135940,MYOT,10,9,19997,1800,18197,2021.888889,180,10.10944444
NM_058244,WNT8A,6,5,7427,1504,5923,1184.6,250.6666667,3.938164894
NM_003551,NME5,6,5,24273,1232,23041,4608.2,205.3333333,18.70211039
NM_005733,KIF20A,19,18,8989,3490,5499,305.5,183.6842105,1.575644699
NM_001496,GFRA3,8,7,22186,1939,20247,2892.428571,242.375,10.4419804
NM_004661,CDC23,16,15,25697,3171,22526,1501.733333,198.1875,7.103752759
NM_016605,FAM53C,5,4,11716,4399,7317,1829.25,879.8,1.663332576
NM_001135647,FAM53C,5,4,12196,4424,7772,1943,884.8,1.756781193
NM_001256302,ETF1,11,10,37209,3958,33251,3325.1,359.8181818,8.400960081
NM_001282185,ETF1,10,9,35620,3643,31977,3553,364.3,8.777655778
NM_016606,REEP2,8,7,7970,2193,5777,825.2857143,274.125,2.634290926
NM_001964,EGR1,2,1,3825,3138,687,687,1569,0.218929254
NM_001271803,REEP2,8,7,7970,2199,5771,824.4285714,274.875,2.624374716
NM_004730,ETF1,11,10,37209,3759,33450,3345,341.7272727,8.898643256
NM_004134,HSPA9,17,16,20749,3523,17226,1076.625,207.2352941,4.889582742
NM_015564,LRRTM2,2,1,5980,5630,350,350,2815,0.062166963
NM_001194956,MATR3,14,13,37929,4207,33722,2594,300.5,8.015688139
NM_199189,MATR3,18,17,57927,5622,52305,3076.764706,312.3333333,9.303628602
NM_001194955,MATR3,15,14,37929,5297,32632,2330.857143,353.1333333,6.16046819
NM_001194954,MATR3,17,16,57927,5539,52388,3274.25,325.8235294,9.458024914
NM_001282278,MATR3,17,16,57927,4532,53395,3337.1875,266.5882353,11.78177405
NM_018834,MATR3,15,14,38035,5180,32855,2346.785714,345.3333333,6.342664093
NM_001161546,PROB1,1,0,3252,3252,NA,NA,3252,NA
NM_016459,MZB1,4,3,2350,831,1519,506.3333333,207.75,1.827918171
NM_194296,SPATA24,6,5,7322,684,6638,1327.6,114,9.704678363
NM_005847,SLC23A1,15,14,16156,2364,13792,985.1428571,157.6,5.834179357
NM_016480,PAIP2,4,3,27890,1485,26405,8801.666667,371.25,17.78114478
NM_152686,DNAJC18,8,7,29324,5110,24214,3459.142857,638.75,4.738551859
NM_152685,SLC23A1,15,14,16156,2376,13780,984.2857143,158.4,5.7996633
NM_001033112,PAIP2,4,3,27288,1519,25769,8589.666667,379.75,16.9644503
NM_198282,TMEM173,8,7,7232,2183,5049,721.2857143,272.875,2.312872194
NM_016463,CXXC5,3,2,34381,1450,32931,16465.5,483.3333333,22.71103448
NM_003339,UBE2D2,7,6,67269,2709,64560,10760,387,23.8316722
NM_181838,UBE2D2,8,7,67269,2874,64395,9199.285714,359.25,22.40605428
NM_005859,PURA,1,0,5295,5295,NA,NA,5295,NA
NM_001007189,IGIP,1,0,2872,2872,NA,NA,2872,NA
NM_002622,PFDN1,4,3,58056,1328,56728,18909.33333,332,42.71686747
NM_024668,ANKHD1,11,10,70665,2186,68479,6847.9,198.7272727,31.32616651
NM_001258427,SLC4A9,21,20,14937,3160,11777,588.85,150.4761905,3.726898734
NM_001258426,SLC4A9,22,21,14937,3251,11686,556.4761905,147.7727273,3.594586281
NM_031467,SLC4A9,22,21,14937,3293,11644,554.4761905,149.6818182,3.535985424
NM_001197030,ANKHD1,10,9,70665,2075,68590,7621.111111,207.5,33.05542169
NM_017978,ANKHD1,11,10,70665,2153,68512,6851.2,195.7272727,31.82164422
NM_001258428,SLC4A9,22,21,14937,3422,11515,548.3333333,155.5454545,3.364991233
NM_003732,EIF4EBP3,3,2,1914,694,1220,610,231.3333333,1.757925072
NM_133172,APBB3,12,11,6338,2164,4174,379.4545455,180.3333333,1.92883549
NM_080670,SLC35A4,3,2,4265,2660,1605,802.5,886.6666667,0.603383459
NM_133174,APBB3,12,11,6338,2143,4195,381.3636364,178.5833333,1.957536164
NM_133173,APBB3,12,11,6338,2149,4189,380.8181818,179.0833333,1.949278734
NM_006051,APBB3,12,11,6338,2170,4168,378.9090909,180.8333333,1.920737327
NM_001253764,SRA1,3,2,7391,1267,6124,3062,422.3333333,4.833464878
NM_001035235,SRA1,5,4,8028,1954,6074,1518.5,390.8,3.108495394
NM_006083,IK,20,19,14683,1955,12728,669.8947368,97.75,6.510485934
NM_144723,ZMAT2,6,5,6209,1518,4691,938.2,253,3.090250329
NM_001278731,HARS2,12,11,7894,2447,5447,495.1818182,203.9166667,2.225991009
NM_001278732,HARS2,11,10,7894,2399,5495,549.5,218.0909091,2.290537724
NM_001174104,CD14,3,2,1975,1651,324,162,550.3333333,0.1962447
NM_001174105,CD14,3,2,1975,1530,445,222.5,510,0.290849673
NM_194249,DND1,4,3,2792,1607,1185,395,401.75,0.73739888
NM_012208,HARS2,13,12,7894,2523,5371,447.5833333,194.0769231,2.128814903
NM_002488,NDUFA2,3,2,2424,729,1695,847.5,243,2.325102881
NM_017706,WDR55,7,6,6171,2587,3584,597.3333333,369.5714286,1.385388481
NM_018502,TMCO6,12,11,5979,1901,4078,370.7272727,158.4166667,2.145186744
NM_001040021,CD14,3,2,1975,1551,424,212,517,0.273372018
NM_000591,CD14,2,1,1724,1637,87,87,818.5,0.053145999
NM_001185012,NDUFA2,3,2,2424,776,1648,824,258.6666667,2.12371134
NM_001258040,HARS,12,11,17825,2198,15627,1420.636364,183.1666667,7.109645132
NM_001258041,HARS,13,12,17825,2259,15566,1297.166667,173.7692308,6.890659584
NM_001258042,HARS,12,11,17825,2138,15687,1426.090909,178.1666667,7.337231057
NM_001289092,HARS,11,10,17825,2095,15730,1573,190.4545455,7.508353222
NM_001289093,HARS,10,9,17825,1974,15851,1761.222222,197.4,8.029888551
NM_001289094,HARS,13,12,17825,2232,15593,1299.416667,171.6923077,6.986111111
NM_002109,HARS,13,12,17825,2319,15506,1292.166667,178.3846154,6.686502803
NM_031859,PCDHA10,1,0,2702,2702,NA,NA,2702,NA
NM_031856,PCDHA8,1,0,2446,2446,NA,NA,2446,NA
NM_031852,PCDHA7,1,0,2371,2371,NA,NA,2371,NA
NM_031848,PCDHA6,1,0,2583,2583,NA,NA,2583,NA
NM_031497,PCDHA3,1,0,2476,2476,NA,NA,2476,NA
NM_031495,PCDHA2,1,0,2620,2620,NA,NA,2620,NA
NM_031501,PCDHA5,1,0,2452,2452,NA,NA,2452,NA
NM_031500,PCDHA4,1,0,2595,2595,NA,NA,2595,NA
NM_031410,PCDHA1,1,0,2726,2726,NA,NA,2726,NA
NM_031496,PCDHA2,2,1,10762,3056,7706,7706,1528,2.521596859
NM_014005,PCDHA9,1,0,6389,6389,NA,NA,6389,NA
NM_031883,PCDHAC2,1,0,2656,2656,NA,NA,2656,NA
NM_031882,PCDHAC1,1,0,2797,2797,NA,NA,2797,NA
NM_031865,PCDHA13,1,0,2428,2428,NA,NA,2428,NA
NM_031864,PCDHA12,1,0,2589,2589,NA,NA,2589,NA
NM_031861,PCDHA11,1,0,4089,4089,NA,NA,4089,NA
NM_013340,PCDHB1,1,0,2588,2588,NA,NA,2588,NA
NM_018938,PCDHB4,1,0,3873,3873,NA,NA,3873,NA
NM_018937,PCDHB3,1,0,3578,3578,NA,NA,3578,NA
NM_018936,PCDHB2,1,0,2775,2775,NA,NA,2775,NA
NM_019120,PCDHB8,1,0,2712,2712,NA,NA,2712,NA
NM_018940,PCDHB7,1,0,3757,3757,NA,NA,3757,NA
NM_018939,PCDHB6,1,0,3031,3031,NA,NA,3031,NA
NM_018935,PCDHB15,1,0,2886,2886,NA,NA,2886,NA
NM_018934,PCDHB14,1,0,3964,3964,NA,NA,3964,NA
NM_018933,PCDHB13,1,0,3504,3504,NA,NA,3504,NA
NM_018932,PCDHB12,1,0,3409,3409,NA,NA,3409,NA
NM_018931,PCDHB11,1,0,3272,3272,NA,NA,3272,NA
NM_018930,PCDHB10,1,0,3263,3263,NA,NA,3263,NA
NM_019119,PCDHB9,1,0,4412,4412,NA,NA,4412,NA
NM_015669,PCDHB5,1,0,2923,2923,NA,NA,2923,NA
NM_020957,PCDHB16,1,0,4533,4533,NA,NA,4533,NA
NM_032098,PCDHGB4,1,0,2413,2413,NA,NA,2413,NA
NM_032097,PCDHGB3,1,0,2446,2446,NA,NA,2446,NA
NM_032096,PCDHGB2,1,0,2437,2437,NA,NA,2437,NA
NM_032095,PCDHGB1,1,0,2434,2434,NA,NA,2434,NA
NM_031993,PCDHGA1,1,0,2473,2473,NA,NA,2473,NA
NM_032087,PCDHGA7,1,0,2883,2883,NA,NA,2883,NA
NM_032086,PCDHGA6,1,0,2458,2458,NA,NA,2458,NA
NM_032054,PCDHGA5,1,0,2443,2443,NA,NA,2443,NA
NM_032053,PCDHGA4,1,0,2707,2707,NA,NA,2707,NA
NM_032011,PCDHGA3,1,0,2491,2491,NA,NA,2491,NA
NM_032009,PCDHGA2,1,0,2736,2736,NA,NA,2736,NA
NM_031947,SLC25A2,1,0,1418,1418,NA,NA,1418,NA
NM_005642,TAF7,1,0,2296,2296,NA,NA,2296,NA
NM_032099,PCDHGB5,1,0,2458,2458,NA,NA,2458,NA
NM_032094,PCDHGA12,1,0,2633,2633,NA,NA,2633,NA
NM_032092,PCDHGA11,4,3,92011,4321,87690,29230,1080.25,20.29391345
NM_032091,PCDHGA11,1,0,3118,3118,NA,NA,3118,NA
NM_032101,PCDHGB7,1,0,2784,2784,NA,NA,2784,NA
NM_032090,PCDHGA10,1,0,2554,2554,NA,NA,2554,NA
NM_032089,PCDHGA9,1,0,2488,2488,NA,NA,2488,NA
NM_032100,PCDHGB6,1,0,2464,2464,NA,NA,2464,NA
NM_032407,PCDHGC5,1,0,2638,2638,NA,NA,2638,NA
NM_032406,PCDHGC4,1,0,2617,2617,NA,NA,2617,NA
NM_032402,PCDHGC3,1,0,2795,2795,NA,NA,2795,NA
NM_003735,PCDHGA12,4,3,82390,4778,77612,25870.66667,1194.5,16.24361658
NM_032403,PCDHGC3,4,3,36977,2328,34649,11549.66667,582,14.88359107
NM_032088,PCDHGA8,4,3,121065,5507,115558,38519.33333,1376.75,20.98383875
NM_014004,PCDHGA8,1,0,3489,3489,NA,NA,3489,NA
NM_002588,PCDHGC3,4,3,36977,4728,32249,10749.66667,1182,6.820854484
NM_018921,PCDHGA9,4,3,110028,4609,105419,35139.66667,1152.25,22.87242352
NM_018914,PCDHGA11,4,3,92011,4876,87135,29045,1219,17.87018048
NM_018913,PCDHGA10,4,3,99805,4621,95184,31728,1155.25,20.59813893
NM_018929,PCDHGC5,4,3,23740,4645,19095,6365,1161.25,4.110871905
NM_018928,PCDHGC4,4,3,27807,4627,23180,7726.666667,1156.75,5.009725524
NM_018927,PCDHGB7,4,3,95290,4769,90521,30173.66667,1192.25,18.98112812
NM_018926,PCDHGB6,4,3,104778,4603,100175,33391.66667,1150.75,21.76298066
NM_018925,PCDHGB5,4,3,114853,4582,110271,36757,1145.5,24.06612833
NM_001130029,RELL2,8,7,4116,2163,1953,279,270.375,0.902912621
NM_173828,RELL2,7,6,4116,2590,1526,254.3333333,370,0.589189189
NM_033449,FCHSD1,20,19,12119,4340,7779,409.4210526,217,1.792396313
NM_003883,HDAC3,15,14,15982,1960,14022,1001.571429,130.6666667,7.154081633
NM_001278615,PCDH1,2,1,3552,2909,643,643,1454.5,0.221038157
NM_001278613,PCDH1,3,2,6977,3753,3224,1612,1251,0.859046096
NM_032420,PCDH1,5,4,25301,4798,20503,5125.75,959.6,4.27323885
NM_002587,PCDH1,3,2,15760,3830,11930,5965,1276.666667,3.114882507
NM_005471,GNPDA1,7,6,12388,2304,10084,1680.666667,329.1428571,4.376736111
NM_001201365,RNF14,9,8,23456,4183,19273,2409.125,464.7777778,4.607458762
NM_001142603,KIAA0141,13,12,18229,4178,14051,1170.916667,321.3846154,3.363092389
NM_016580,PCDH12,4,3,15479,6566,8913,2971,1641.5,1.357447457
NM_014773,KIAA0141,12,11,18229,4970,13259,1205.363636,414.1666667,2.667806841
NM_004290,RNF14,9,8,21407,4397,17010,2126.25,488.5555556,3.868546736
NM_183399,RNF14,8,7,23456,4008,19448,2778.285714,501,4.852295409
NM_183398,RNF14,8,7,21407,4244,17163,2451.857143,530.5,4.044062205
NM_183401,RNF14,9,8,21146,4203,16943,2117.875,467,4.031168213
NM_183400,RNF14,8,7,21407,4222,17185,2455,527.75,4.070345808
NM_030571,NDFIP1,8,7,45686,3605,42081,6011.571429,450.625,11.67295423
NM_001127496,SPRY4,2,1,14630,4943,9687,9687,2471.5,1.959741048
NM_030964,SPRY4,3,2,14630,4995,9635,4817.5,1665,1.928928929
NM_033136,FGF1,3,2,94319,4052,90267,45133.5,1350.666667,22.27714709
NM_001144892,FGF1,4,3,29179,3677,25502,8500.666667,919.25,6.935545281
NM_001257209,FGF1,4,3,93527,3823,89704,29901.33333,955.75,23.46429506
NM_000800,FGF1,4,3,94319,4157,90162,30054,1039.25,21.68919894
NM_001257205,FGF1,4,3,105894,4067,101827,33942.33333,1016.75,25.03737399
NM_033137,FGF1,2,1,21985,3509,18476,18476,1754.5,5.265317754
NM_001144934,FGF1,5,4,105894,3871,102023,25505.75,774.2,26.35572204
NM_001144935,FGF1,4,3,105894,3776,102118,34039.33333,944,27.04396186
NM_001257212,FGF1,4,3,29179,3674,25505,8501.666667,918.5,6.942025041
NM_001257210,FGF1,4,3,52125,3807,48318,16106,951.75,12.69188337
NM_001257211,FGF1,4,3,93527,3805,89722,29907.33333,951.25,23.58002628
NM_001257208,FGF1,4,3,93527,3808,89719,29906.33333,952,23.56066176
NM_001257207,FGF1,5,4,94319,3811,90508,22627,762.2,23.74914721
NM_001257206,FGF1,4,3,105894,4064,101830,33943.33333,1016,25.05659449
NM_021182,HMHB1,2,1,8560,386,8174,8174,193,21.1761658
NM_030799,YIPF5,6,5,12557,3208,9349,1869.8,534.6666667,2.914276808
NM_001024947,YIPF5,6,5,12557,3459,9098,1819.6,576.5,2.630239954
NM_001271732,YIPF5,5,4,12557,3338,9219,2304.75,667.6,2.761833433
NM_182960,PRELID2,8,7,79027,4888,74139,10591.28571,611,15.16755319
NM_205846,PRELID2,7,6,79027,4851,74176,12362.66667,693,15.29086786
NM_138492,PRELID2,8,7,79027,5055,73972,10567.42857,631.875,14.63343225
NM_001080516,GRXCR2,3,2,13237,750,12487,6243.5,250,16.64933333
NM_001029869,PLAC8L1,4,3,20072,729,19343,6447.666667,182.25,26.53360768
NM_020117,LARS,32,31,69707,4881,64826,2091.16129,152.53125,13.28129482
NM_002700,POU4F3,2,1,1498,1184,314,314,592,0.265202703
NM_194251,GPR151,1,0,1261,1261,NA,NA,1261,NA
NM_003122,SPINK1,4,3,7119,445,6674,2224.666667,111.25,14.99775281
NM_206966,C5orf46,4,3,13832,546,13286,4428.666667,136.5,24.33333333
NM_054023,SCGB3A2,3,2,3484,521,2963,1481.5,173.6666667,5.687140115
NM_001001325,SPINK14,4,3,5667,298,5369,1789.666667,74.5,18.01677852
NM_032566,SPINK7,4,3,3493,553,2940,980,138.25,5.316455696
NM_001040129,SPINK13,5,4,17352,514,16838,4209.5,102.8,32.75875486
NM_030793,FBXO38,22,21,58903,4221,54682,2603.904762,191.8636364,12.95475006
NM_001271723,FBXO38,21,20,58903,3710,55193,2759.65,176.6666667,14.87681941
NM_000024,ADRB2,1,0,2043,2043,NA,NA,2043,NA
NM_001146337,AFAP1L1,18,17,69968,4101,65867,3874.529412,227.8333333,16.06120458
NM_024028,PCYOX1L,6,5,11653,2557,9096,1819.2,426.1666667,3.557293704
NM_152406,AFAP1L1,19,18,69968,4231,65737,3652.055556,222.6842105,15.53698889
NM_014443,IL17B,3,2,5010,698,4312,2156,232.6666667,6.17765043
NM_152407,GRPEL2,4,3,9171,4109,5062,1687.333333,1027.25,1.23192991
NM_001001669,ARHGEF37,13,12,53394,4878,48516,4043,375.2307692,9.945879459
NM_000112,SLC26A2,3,2,26665,8078,18587,9293.5,2692.666667,2.300940827
NM_001243253,TIGD6,2,1,7487,3990,3497,3497,1995,0.876441103
NM_030953,TIGD6,2,1,8046,4003,4043,4043,2001.5,1.009992506
NM_002609,PDGFRB,23,22,42022,5737,36285,1649.318182,249.4347826,6.324734182
NM_005211,CSF1R,22,21,60083,4011,56072,2670.095238,182.3181818,13.97955622
NM_001288705,CSF1R,21,20,33351,3931,29420,1471,187.1904762,7.484100738
NM_015981,CAMK2A,19,18,70351,4923,65428,3634.888889,259.1052632,13.29027016
NM_014228,SLC6A7,14,13,21117,3753,17364,1335.692308,268.0714286,4.626698641
NM_001012301,ARSI,2,1,6618,3169,3449,3449,1584.5,1.088355948
NM_171825,CAMK2A,18,17,70351,4889,65462,3850.705882,271.6111111,13.38965024
NM_001195141,TCOF1,26,25,42671,5008,37663,1506.52,192.6153846,7.520567093
NM_001135244,TCOF1,26,25,42671,5011,37660,1506.4,192.7307692,7.515465975
NM_001135243,TCOF1,27,26,42671,5123,37548,1444.153846,189.7407407,7.329299239
NM_001135245,TCOF1,26,25,42671,4894,37777,1511.08,188.2307692,7.719043727
NM_001025159,CD74,9,8,11301,1690,9611,1201.375,187.7777778,5.686982249
NM_001025158,CD74,6,5,11301,1311,9990,1998,218.5,7.6201373
NM_000356,TCOF1,26,25,42671,4891,37780,1511.2,188.1153846,7.72439174
NM_004355,CD74,8,7,11301,1497,9804,1400.571429,187.125,6.549098196
NM_001008657,TCOF1,18,17,26995,3880,23115,1359.705882,215.5555556,5.957474227
NM_005617,RPS14,5,4,5529,574,4955,1238.75,114.8,8.632404181
NM_001025070,RPS14,5,4,5529,785,4744,1186,157,6.043312102
NM_001025071,RPS14,5,4,5529,791,4738,1184.5,158.2,5.98988622
NM_001543,NDST1,15,14,50101,8045,42056,3004,536.3333333,5.227594779
NM_133371,MYOZ3,7,6,18529,3496,15033,2505.5,499.4285714,4.300057208
NM_007286,SYNPO,3,2,18587,5400,13187,6593.5,1800,2.442037037
NM_001122853,MYOZ3,7,6,18529,3844,14685,2447.5,549.1428571,3.820239334
NM_001109974,SYNPO,2,1,11698,4610,7088,7088,2305,1.537527115
NM_001166209,SYNPO,3,2,34699,5108,29591,14795.5,1702.666667,5.793069695
NM_001166208,SYNPO,3,2,51263,5175,46088,23044,1725,8.90589372
NM_016221,DCTN4,13,12,50350,3900,46450,3870.833333,300,11.91025641
NM_032947,SMIM3,2,1,18792,2336,16456,16456,1168,7.044520548
NM_001135644,DCTN4,13,12,49775,4068,45707,3808.916667,312.9230769,11.23574238
NM_001135643,DCTN4,14,13,50350,3922,46428,3571.384615,280.1428571,11.83783784
NM_052860,ZNF300,6,5,10593,3274,7319,1463.8,545.6666667,2.235491753
NM_001172832,ZNF300,5,4,10593,3231,7362,1840.5,646.2,2.278551532
NM_001145805,IRGM,2,1,2148,1661,487,487,830.5,0.293196869
NM_001172831,ZNF300,7,6,10593,3330,7263,1210.5,475.7142857,2.181081081
NM_002084,GPX3,5,4,8557,1766,6791,1697.75,353.2,3.845413364
NM_001252390,TNIP1,18,17,57719,2805,54914,3230.235294,155.8333333,19.5771836
NM_006058,TNIP1,18,17,51143,2940,48203,2835.470588,163.3333333,16.39557823
NM_001258456,TNIP1,15,14,35190,2443,32747,2339.071429,162.8666667,13.40442079
NM_001252393,TNIP1,18,17,51143,2866,48277,2839.823529,159.2222222,16.84473133
NM_001252392,TNIP1,18,17,57245,2763,54482,3204.823529,153.5,19.71842201
NM_001252391,TNIP1,18,17,57245,2837,54408,3200.470588,157.6111111,19.17800493
NM_001252386,TNIP1,17,16,51143,2767,48376,3023.5,162.7647059,17.4831948
NM_001252385,TNIP1,18,17,51143,2957,48186,2834.470588,164.2777778,16.29556983
NM_001258455,TNIP1,16,15,35190,2541,32649,2176.6,158.8125,12.84887839
NM_001258454,TNIP1,18,17,51147,2940,48207,2835.705882,163.3333333,16.39693878
NM_001155,ANXA6,26,25,57178,3018,54160,2166.4,116.0769231,17.94565938
NM_001193544,ANXA6,25,24,40951,2894,38057,1585.708333,115.76,13.15031099
NM_001167607,GM2A,4,3,17342,3482,13860,4620,870.5,3.980470994
NM_001145017,SLC36A3,11,10,27410,2994,24416,2441.6,272.1818182,8.15497662
NM_000405,GM2A,4,3,17342,3692,13650,4550,923,3.697183099
NM_181776,SLC36A2,10,9,32614,3431,29183,3242.555556,343.1,8.505683474
NM_181774,SLC36A3,10,9,27410,2870,24540,2726.666667,287,8.550522648
NM_001447,FAT2,23,22,64854,14559,50295,2286.136364,633,3.454564187
NM_003118,SPARC,10,9,25960,3600,22360,2484.444444,360,6.211111111
NM_001278082,LOC100652758,2,1,1717,1177,540,540,588.5,0.458793543
NM_198395,G3BP1,12,11,33441,2816,30625,2784.090909,234.6666667,10.87535511
NM_005754,G3BP1,12,11,33441,2847,30594,2781.272727,237.25,10.74604847
NM_005927,MFAP3,3,2,18497,5052,13445,6722.5,1684,2.661322249
NM_001242336,MFAP3,3,2,18497,5349,13148,6574,1783,2.458029538
NM_018691,FAM114A2,14,13,47230,2894,44336,3410.461538,206.7142857,15.31997236
NM_001135037,MFAP3,2,1,18497,4590,13907,13907,2295,3.029847495
NM_001131063,SAP30L,3,2,15098,6090,9008,4504,2030,1.479146141
NM_001131062,SAP30L,3,2,15098,6105,8993,4496.5,2035,1.473054873
NM_024632,SAP30L,4,3,15098,6229,8869,2956.333333,1557.25,1.423824049
NM_004821,HAND1,2,1,3294,1740,1554,1554,870,0.893103448
NM_032385,FAXDC2,9,8,32163,3006,29157,3644.625,334,9.699600798
NM_004779,CNOT8,7,6,18156,2490,15666,2611,355.7142857,6.291566265
NM_014180,MRPL22,7,6,28340,3180,25160,4193.333333,454.2857143,7.911949686
NM_001099293,KIF4B,1,0,4427,4427,NA,NA,4427,NA
NM_001014990,MRPL22,6,5,28340,3061,25279,5055.8,510.1666667,8.258412284
NM_001099414,HAVCR1,9,8,28958,1502,27456,3432,166.8888889,18.27962716
NM_012206,HAVCR1,8,7,28958,1849,27109,3872.714286,231.125,14.66143862
NM_001173393,HAVCR1,9,8,29441,1368,28073,3509.125,152,20.52119883
NM_130899,FAM71B,2,1,3937,2034,1903,1903,1017,0.935594887
NM_032782,HAVCR2,7,6,23407,2437,20970,3495,348.1428571,8.604842019
NM_001100816,MED7,2,1,4337,1386,2951,2951,693,2.129148629
NM_004270,MED7,2,1,4472,1102,3370,3370,551,3.058076225
NM_001001343,FNDC9,2,1,4124,2128,1996,1996,1064,0.937969925
NM_033274,ADAM19,23,22,98521,6552,91969,4180.409091,284.8695652,14.03678266
NM_007017,SOX30,4,3,26743,2776,23967,7989,694,8.633645533
NM_178424,SOX30,5,4,26743,3270,23473,5868.25,654,7.178287462
NM_001145132,C5orf52,3,2,8603,700,7903,3951.5,233.3333333,11.29
NM_017872,THG1L,6,5,8451,1311,7140,1428,218.5,5.446224256
NM_001195555,CLINT1,12,11,73434,4052,69382,6307.454545,337.6666667,17.12290227
NM_001195556,CLINT1,12,11,73434,4029,69405,6309.545455,335.75,17.2263589
NM_014666,CLINT1,12,11,73434,3998,69436,6312.363636,333.1666667,17.36768384
NM_173491,LSM11,4,3,12993,2565,10428,3476,641.25,4.065497076
NM_145049,UBLCP1,11,10,22961,2403,20558,2055.8,218.4545455,8.555139409
NM_002187,IL12B,8,7,15692,2355,13337,1905.285714,294.375,5.663269639
NM_001282500,TTC1,8,7,56447,1487,54960,7851.428571,185.875,36.9603228
NM_003314,TTC1,8,7,56447,1490,54957,7851,186.25,36.88389262
NM_001130864,PWWP2A,2,1,28107,3369,24738,24738,1684.5,7.342831701
NM_024565,CCNJL,7,6,60904,3281,57623,9603.833333,468.7142857,17.56263334
NM_001445,FABP6,4,3,9294,582,8712,2904,145.5,14.96907216
NM_001282382,PTTG1,5,4,6836,1080,5756,1439,216,5.32962963
NM_001282383,PTTG1,6,5,6836,935,5901,1180.2,155.8333333,6.311229947
NM_006425,SLU7,16,15,17522,3576,13946,929.7333333,223.5,3.899888143
NM_022090,C5orf54,2,1,6907,2809,4098,4098,1404.5,1.458882164
NM_004219,PTTG1,6,5,6939,774,6165,1233,129,7.965116279
NM_000811,GABRA6,9,8,16942,2528,14414,1801.75,280.8888889,5.701740506
NM_001127648,GABRA1,9,8,49264,4031,45233,5654.125,447.8888889,11.22128504
NM_001127645,GABRA1,10,9,51425,4010,47415,5268.333333,401,11.82418953
NM_001127644,GABRA1,10,9,52027,4422,47605,5289.444444,442.2,10.76549073
NM_001127643,GABRA1,11,10,52282,4274,48008,4800.8,388.5454545,11.23256902
NM_000806,GABRA1,11,10,52770,4387,48383,4838.3,398.8181818,11.02872122
NM_198904,GABRG2,10,9,87899,3967,83932,9325.777778,396.7,21.15754979
NM_198903,GABRG2,11,10,87899,4088,83811,8381.1,371.6363636,20.50171233
NM_000816,GABRG2,9,8,87899,3942,83957,10494.625,438,21.29807204
NM_199246,CCNG1,8,7,7447,2376,5071,724.4285714,297,2.134259259
NM_145266,NUDCD2,4,3,6559,952,5607,1869,238,5.889705882
NM_001142557,HMMR,15,14,31438,2931,28507,2036.214286,195.4,9.726032071
NM_012485,HMMR,17,16,31438,3112,28326,1770.375,183.0588235,9.10218509
NM_012484,HMMR,18,17,31438,3158,28280,1663.529412,175.4444444,8.955034832
NM_001142556,HMMR,18,17,31438,3161,28277,1663.352941,175.6111111,8.94558684
NM_004060,CCNG1,7,6,7447,2475,4972,828.6666667,353.5714286,2.008888889
NM_182796,MAT2B,7,6,16291,2300,13991,2331.833333,328.5714286,6.083043478
NM_013283,MAT2B,7,6,13827,2161,11666,1944.333333,308.7142857,5.398426654
NM_024594,PANK3,7,6,23988,3394,20594,3432.333333,484.8571429,6.067766647
NM_002887,RARS,15,14,32848,2153,30695,2192.5,143.5333333,14.25685091
NM_017785,SPDL1,12,11,21145,2679,18466,1678.727273,223.25,6.892870474
NM_012188,FOXI1,2,1,3814,2298,1516,1516,1149,0.659704091
NM_144769,FOXI1,2,1,3814,2013,1801,1801,1006.5,0.89468455
NM_005565,LCP2,21,20,49736,2443,47293,2364.65,116.3333333,19.35857552
NM_001102609,C5orf58,4,3,13287,514,12773,4257.666667,128.5,24.85019455
NM_004137,KCNMB1,4,3,11518,1566,9952,3317.333333,391.5,6.3550447
NM_014211,GABRP,10,9,30329,3319,27010,3001.111111,331.9,8.137993371
NM_021025,TLX3,3,2,2852,1496,1356,678,498.6666667,0.906417112
NM_001037738,NPM1,10,9,19025,1357,17668,1963.111111,135.7,13.01989683
NM_199185,NPM1,10,9,23182,1372,21810,2423.333333,137.2,15.89650146
NM_002520,NPM1,11,10,23182,1460,21722,2172.2,132.7272727,14.87808219
NM_003862,FGF18,5,4,37965,1987,35978,8994.5,397.4,18.10669351
NM_001171183,EFCAB9,4,3,9284,708,8576,2858.666667,177,12.11299435
NM_001287812,RP11-779O18.1,4,3,7061,771,6290,2096.666667,192.75,8.158236057
NM_004417,DUSP1,4,3,3112,2028,1084,361.3333333,507,0.534516765
NM_016093,RPL26L1,4,3,10337,714,9623,3207.666667,178.5,13.47759104
NM_003945,ATP6V0E1,4,3,51139,886,50253,16751,221.5,56.71896163
NM_013979,BNIP1,7,6,19947,1393,18554,3092.333333,199,13.31945441
NM_013980,BNIP1,6,5,19947,1290,18657,3731.4,215,14.4627907
NM_013978,BNIP1,5,4,19947,1160,18787,4696.75,232,16.19568966
NM_001205,BNIP1,6,5,19947,1263,18684,3736.8,210.5,14.79334917
NM_001166176,NKX2-5,2,1,3210,1926,1284,1284,963,0.666666667
NM_001166175,NKX2-5,2,1,3210,1963,1247,1247,981.5,0.635252165
NM_004387,NKX2-5,2,1,3210,1671,1539,1539,835.5,0.921005386
NM_001159651,BOD1,3,2,9520,1740,7780,3890,580,4.471264368
NM_138369,BOD1,4,3,9520,1938,7582,2527.333333,484.5,3.912280702
NM_030627,CPEB4,10,9,71984,7779,64205,7133.888889,777.9,8.253631572
NM_015980,HMP19,5,4,63577,2457,61120,15280,491.4,24.87586488
NM_001144954,C5orf47,5,4,16983,2527,14456,3614,505.4,5.720617333
NM_002449,MSX2,2,1,6329,2210,4119,4119,1105,1.863800905
NM_022754,SFXN1,11,10,50109,3002,47107,4710.7,272.9090909,15.69187209
NM_000794,DRD1,2,1,3490,3375,115,115,1687.5,0.034074074
NM_022304,HRH2,1,0,3096,3096,NA,NA,3096,NA
NM_001008220,CPLX2,4,3,12524,4680,7844,2614.666667,1170,1.676068376
NM_032361,THOC3,6,5,8786,1607,7179,1435.8,267.8333333,4.467330429
NM_016391,NOP16,5,4,4825,1057,3768,942,211.4,3.564806055
NM_001079685,KIAA1191,8,7,15748,2730,13018,1859.714286,341.25,4.768498168
NM_001079684,KIAA1191,8,7,15748,2751,12997,1856.714286,343.875,4.724463831
NM_007097,CLTB,6,5,24116,1221,22895,4579,203.5,18.75102375
NM_020444,KIAA1191,9,8,15748,2839,12909,1613.625,315.4444444,4.5470236
NM_001256540,NOP16,5,4,4825,966,3859,964.75,193.2,3.994824017
NM_001256539,NOP16,5,4,4825,969,3856,964,193.8,3.979360165
NM_001834,CLTB,5,4,24116,1166,22950,5737.5,233.2,19.68267581
NM_138820,HIGD2A,2,1,969,613,356,356,306.5,0.580750408
NM_173664,ARL10,4,3,8003,2409,5594,1864.666667,602.25,2.322125363
NM_001287335,KIAA1191,6,5,15748,2462,13286,2657.2,410.3333333,5.39642567
NM_001287336,KIAA1191,7,6,15748,2642,13106,2184.333333,377.4285714,4.960635882
NM_014901,RNF44,11,10,10723,4164,6559,655.9,378.5454545,1.575168108
NM_001171976,CDHR2,32,31,53259,4335,48924,1578.193548,135.46875,11.28581315
NM_017675,CDHR2,32,31,46428,4149,42279,1363.83871,129.65625,10.19016631
NM_001006616,TSPAN17,9,8,11673,2556,9117,1139.625,284,3.566901408
NM_003085,SNCB,6,5,10349,1299,9050,1810,216.5,6.966897614
NM_012171,TSPAN17,9,8,11673,2597,9076,1134.5,288.5555556,3.494801694
NM_001099408,EIF4E1B,9,8,15961,1983,13978,1747.25,220.3333333,7.048915784
NM_130465,TSPAN17,9,8,11673,2588,9085,1135.625,287.5555556,3.510432767
NM_001001502,SNCB,7,6,10349,1457,8892,1482,208.1428571,6.10295127
NM_002115,HK3,19,18,18465,3087,15378,854.3333333,162.4736842,4.981535471
NM_012279,ZNF346,7,6,44050,3080,40970,6828.333333,440,13.30194805
NM_213647,FGFR4,18,17,11207,3087,8120,477.6470588,171.5,2.630385488
NM_022963,FGFR4,16,15,8577,2807,5770,384.6666667,175.4375,2.055575347
NM_002011,FGFR4,18,17,11207,3043,8164,480.2352941,169.0555556,2.682878738
NM_130781,RAB24,9,8,2556,1544,1012,126.5,171.5555556,0.655440415
NM_006816,LMAN2,8,7,20324,1840,18484,2640.571429,230,10.04565217
NM_031300,MXD3,6,5,5088,1471,3617,723.4,245.1666667,2.458871516
NM_001031677,RAB24,8,7,2556,1629,927,132.4285714,203.625,0.569060773
NM_013237,PRELID1,5,4,3199,1278,1921,480.25,255.6,1.50312989
NM_006480,RGS14,15,14,14757,2421,12336,881.1428571,161.4,5.095415118
NM_001271828,PRELID1,5,4,3199,1245,1954,488.5,249,1.569477912
NM_001142935,MXD3,6,5,6793,2668,4125,825,444.6666667,1.546101949
NM_024872,DOK3,6,5,6109,1735,4374,874.8,289.1666667,2.521037464
NM_016222,DDX41,17,16,5391,2121,3270,204.375,124.7647059,1.541725601
NM_203352,PDLIM7,13,12,14213,1624,12589,1049.083333,124.9230769,7.751847291
NM_002082,GRK6,16,15,16165,2968,13197,879.8,185.5,4.446428571
NM_080881,DBN1,15,14,16259,3073,13186,941.8571429,204.8666667,4.290920924
NM_213636,PDLIM7,8,7,7361,1017,6344,906.2857143,127.125,6.237954769
NM_001029886,PFN3,1,0,531,531,NA,NA,531,NA
NM_001144876,DOK3,5,4,8523,2116,6407,1601.75,423.2,3.027882798
NM_030567,PRR7,4,3,9493,1484,8009,2669.666667,371,5.39690027
NM_001174102,PRR7,3,2,7959,1311,6648,3324,437,5.070938215
NM_001174101,PRR7,3,2,9493,1398,8095,4047.5,466,5.790414878
NM_005451,PDLIM7,13,12,14213,1726,12487,1040.583333,132.7692308,7.234646582
NM_001144875,DOK3,6,5,8523,2341,6182,1236.4,390.1666667,2.640751815
NM_001004106,GRK6,16,15,16165,2966,13199,879.9333333,185.375,4.450101146
NM_000505,F12,14,13,7440,2065,5375,413.4615385,147.5,2.602905569
NM_004395,DBN1,14,13,17082,2956,14126,1086.615385,211.1428571,4.778755074
NM_001004105,GRK6,16,15,14669,1962,12707,847.1333333,122.625,6.476554536
NM_017510,TMED9,5,4,3888,1398,2490,622.5,279.6,1.78111588
NM_007255,B4GALT7,6,5,10229,1733,8496,1699.2,288.8333333,4.902481246
NM_173663,FAM153A,20,19,57142,1814,55328,2912,90.7,30.50055127
NM_006261,PROP1,3,2,4009,1467,2542,1271,489,1.732788003
NM_017838,NHP2,4,3,4498,858,3640,1213.333333,214.5,4.242424242
NM_001034833,NHP2,3,2,4498,751,3747,1873.5,250.3333333,4.989347537
NM_015111,N4BP3,5,4,12553,5992,6561,1640.25,1198.4,1.094959947
NM_022762,RMND5B,11,10,17611,1977,15634,1563.4,179.7272727,7.907941325
NM_001288795,RMND5B,11,10,17611,1966,15645,1564.5,178.7272727,7.957782299
NM_001288794,RMND5B,12,11,17611,2118,15493,1408.454545,176.5,7.314919736
NM_001278346,PHYKPL,13,12,24350,2934,21416,1784.666667,225.6923077,7.29925017
NM_031266,HNRNPAB,8,7,6678,1824,4854,693.4285714,228,2.661184211
NM_004499,HNRNPAB,7,6,6678,1682,4996,832.6666667,240.2857143,2.970273484
NM_153373,PHYKPL,13,12,24350,2111,22239,1853.25,162.3846154,10.53481762
NM_020666,CLK4,13,12,24391,2520,21871,1822.583333,193.8461538,8.678968254
NM_005649,ZNF354A,5,4,19183,2560,16623,4155.75,512,6.493359375
NM_030613,ZFP2,5,4,37296,2410,34886,8721.5,482,14.47551867
NM_058230,ZNF354B,5,4,24472,2202,22270,5567.5,440.4,10.11353315
NM_001136116,ZNF879,5,4,10614,2609,8005,2001.25,521.8,3.068225374
NM_014594,ZNF354C,5,4,20086,2378,17708,4427,475.6,7.446593776
NM_000843,GRM6,10,9,16796,6151,10645,1182.777778,615.1,1.730612908
NM_001040451,RUFY1,17,16,50336,2674,47662,2978.875,157.2941176,17.82423336
NM_001040452,RUFY1,18,17,50336,2486,47850,2814.705882,138.1111111,19.24778761
NM_025158,RUFY1,18,17,59467,2661,56806,3341.529412,147.8333333,21.34761368
NM_001024649,CANX,15,14,32711,4912,27799,1985.642857,327.4666667,5.659405537
NM_001746,CANX,15,14,32711,4965,27746,1981.857143,331,5.588318228
NM_001142306,C5orf60,6,5,3491,1201,2290,458,200.1666667,1.90674438
NM_001164444,CBY3,2,1,2418,812,1606,1606,406,1.977832512
NM_016175,C5orf45,7,6,21576,1208,20368,3394.666667,172.5714286,16.86092715
NM_145867,LTC4S,5,4,2529,672,1857,464.25,134.4,2.763392857
NM_003900,SQSTM1,8,7,17237,2910,14327,2046.714286,363.75,4.923367698
NM_001142299,SQSTM1,9,8,31076,2841,28235,3529.375,315.6666667,9.938401971
NM_001142298,SQSTM1,9,8,31691,2924,28767,3595.875,324.8888889,9.838235294
NM_014275,MGAT4B,15,14,9356,2478,6878,491.2857143,165.2,2.775625504
NM_001017987,C5orf45,5,4,21576,1041,20535,5133.75,208.2,19.72622478
NM_054013,MGAT4B,14,13,5279,2917,2362,181.6923077,208.3571429,0.80973603
NM_005110,GFPT2,19,18,52617,3030,49587,2754.833333,159.4736842,16.36534653
NM_052863,SCGB3A1,3,2,1384,469,915,457.5,156.3333333,1.950959488
NM_002020,FLT4,30,29,41873,4534,37339,1287.551724,151.1333333,8.235333039
NM_182925,FLT4,30,29,48120,5887,42233,1456.310345,196.2333333,7.173942585
NM_001001657,OR2Y1,1,0,937,937,NA,NA,937,NA
NM_001172638,ZFP62,2,1,13677,3953,9724,9724,1976.5,2.45990387
NM_152283,ZFP62,3,2,13677,4027,9650,4825,1342.333333,2.396324808
NM_197975,BTNL3,8,7,17884,2448,15436,2205.142857,306,6.305555556
NM_206880,OR2V2,1,0,949,949,NA,NA,949,NA
NM_001258283,OR2V1,1,0,949,949,NA,NA,949,NA
NM_203295,TRIM7,7,6,10418,2650,7768,1294.666667,378.5714286,2.931320755
NM_203294,TRIM7,7,6,10418,2582,7836,1306,368.8571429,3.0348567
NM_203293,TRIM7,7,6,11371,2968,8403,1400.5,424,2.831199461
NM_033549,TRIM41,6,5,12547,3669,8878,1775.6,611.5,2.419732897
NM_032765,TRIM52,2,1,4735,2230,2505,2505,1115,1.123318386
NM_006098,GNB2L1,8,7,6980,1117,5863,837.5714286,139.625,5.248880931
NM_201627,TRIM41,8,7,12547,2731,9816,1402.285714,341.375,3.594287807
NM_033342,TRIM7,2,1,2173,1226,947,947,613,0.772430669
NM_203297,TRIM7,5,4,7008,3014,3994,998.5,602.8,1.325149303
NM_203296,TRIM7,7,6,10418,2859,7559,1259.833333,408.4285714,2.643931445
NM_001005277,OR4F16,1,0,940,940,NA,NA,940,NA
NM_001005224,OR4F3,1,0,940,940,NA,NA,940,NA
NM_001005221,OR4F29,1,0,940,940,NA,NA,940,NA
NM_001136126,CCND3,4,3,113963,1870,112093,37364.33333,467.5,59.94278075
NM_001287434,CCND3,5,4,113963,2053,111910,27977.5,410.6,54.51047248
NM_001136017,CCND3,5,4,113963,2087,111876,27969,417.4,53.60613321
NM_015599,PGM3,13,12,28421,6119,22302,1858.5,470.6923077,3.644713188
NM_001199919,PGM3,14,13,27165,2089,25076,1928.923077,149.2142857,12.00382958
NM_001199917,PGM3,14,13,29064,6256,22808,1754.461538,446.8571429,3.645780051
NM_001199918,PGM3,12,11,28421,5916,22505,2045.909091,493,3.804090602
NM_001029884,PLEKHG1,17,16,243802,7254,236548,14784.25,426.7058824,32.609319
NM_205864,CAGE1,11,10,63057,2862,60195,6019.5,260.1818182,21.03249476
NM_001164841,LYRM4,4,3,152532,1626,150906,50302,406.5,92.80811808
NM_000129,F13A1,15,14,176615,3878,172737,12338.35714,258.5333333,44.54280557
NM_001170693,CAGE1,13,12,60614,3087,57527,4793.916667,237.4615385,18.63524457
NM_001170692,CAGE1,14,13,63057,3269,59788,4599.076923,233.5,18.28938513
NM_020408,LYRM4,3,2,152532,1500,151032,75516,500,100.688
NM_001500,GMDS,11,10,621835,1711,620124,62012.4,155.5454545,362.4336645
NM_001253846,GMDS,11,10,552192,1457,550735,55073.5,132.4545455,377.9924502
NM_001164840,LYRM4,3,2,74351,808,73543,36771.5,269.3333333,91.01856436
NM_004332,BPHL,7,6,34508,1555,32953,5492.166667,222.1428571,21.19163987
NM_005493,RANBP9,14,13,90068,3127,86941,6687.769231,223.3571429,27.80332587
NM_001105568,KIF13A,38,37,228442,7122,221320,5981.621622,187.4210526,31.07554058
NM_017774,CDKAL1,16,15,697948,3287,694661,46310.73333,205.4375,211.3358686
NM_022113,KIF13A,39,38,223932,6034,217898,5734.157895,154.7179487,36.11170036
NM_001105567,KIF13A,37,36,223932,5888,218044,6056.777778,159.1351351,37.03192935
NM_001105566,KIF13A,38,37,223932,5928,218004,5892,156,36.77530364
NM_015345,DAAM2,25,24,111882,6272,105610,4400.416667,250.88,16.83832908
NM_001206927,DNAH8,93,92,315459,14732,300727,3268.771739,158.4086022,20.41318219
NM_024294,C6orf106,5,4,109572,4434,105138,26284.5,886.8,23.71177267
NM_001257357,RAB44,14,13,35334,4247,31087,2391.307692,303.3571429,7.319755121
NM_022758,C6orf106,4,3,109572,4235,105337,35112.33333,1058.75,24.8729634
NM_001145775,FKBP5,12,11,155000,3952,151048,13731.63636,329.3333333,38.22064777
NM_001145777,FKBP5,7,6,108387,7391,100996,16832.66667,1055.857143,13.66472737
NM_001145776,FKBP5,11,10,115332,3838,111494,11149.4,348.9090909,29.05002606
NM_001201427,DAAM2,25,24,112496,6211,106285,4428.541667,248.44,17.11238126
NM_004117,FKBP5,11,10,115359,3793,111566,11156.6,344.8181818,29.41365674
NM_001261823,SUPT3H,10,9,551323,4243,547080,60786.66667,424.3,128.9370728
NM_033112,RRP36,7,6,7954,1166,6788,1131.333333,166.5714286,5.82161235
NM_021572,ENPP5,4,3,10957,2947,8010,2670,736.75,2.718018324
NM_003599,SUPT3H,11,10,551323,4335,546988,54698.8,394.0909091,126.1794694
NM_181356,SUPT3H,13,12,551323,4522,546801,45566.75,347.8461538,120.9201681
NM_012288,TRAM2,11,10,79664,7068,72596,7259.6,642.5454545,10.27108093
NM_001144770,DST,95,94,393931,17853,376078,4000.829787,187.9263158,21.06525514
NM_001144769,DST,97,96,496643,18184,478459,4983.947917,187.4639175,26.31208755
NM_183380,DST,94,93,385680,18126,367554,3952.193548,192.8297872,20.27772261
NM_001142801,EYS,12,11,377951,5458,372493,33863,454.8333333,68.24716013
NM_001142800,EYS,43,42,1987244,10632,1976612,47062.19048,247.255814,185.9115877
NM_152688,KHDRBS2,9,8,606237,2309,603928,75491,256.5555556,261.5539194
NM_198283,EYS,10,9,244893,2240,242653,26961.44444,224,108.3272321
NM_001159588,CD109,32,31,132535,9254,123281,3976.806452,289.1875,13.32191485
NM_001160130,KCNQ5,13,12,577004,6568,570436,47536.33333,505.2307692,86.85079172
NM_133493,CD109,33,32,132529,9480,123049,3845.28125,287.2727273,12.97985232
NM_019842,KCNQ5,14,13,577004,6596,570408,43877.53846,471.1428571,86.47786537
NM_001159587,CD109,33,32,132535,9435,123100,3846.875,285.9090909,13.04716481
NM_001160134,KCNQ5,12,11,577004,6264,570740,51885.45455,522,91.11430396
NM_001160133,KCNQ5,15,14,577004,6654,570350,40739.28571,443.6,85.71535918
NM_001160132,KCNQ5,14,13,577004,6626,570378,43875.23077,473.2857143,86.08179897
NM_003318,TTK,22,21,37924,3032,34892,1661.52381,137.8181818,11.50791557
NM_017934,PHIP,40,39,143877,12006,131871,3381.307692,300.15,10.98375812
NM_001166691,TTK,22,21,37924,3041,34883,1661.095238,138.2272727,11.47089773
NM_004999,MYO6,35,34,170347,8697,161650,4754.411765,248.4857143,18.58686904
NM_001242809,ANKRD6,16,15,200658,5371,195287,13019.13333,335.6875,36.35952337
NM_145333,MAP3K7,15,14,73730,4985,68745,4910.357143,332.3333333,13.79037111
NM_145331,MAP3K7,17,16,73730,5184,68546,4284.125,304.9411765,13.22260802
NM_145332,MAP3K7,16,15,73730,5067,68663,4577.533333,316.6875,13.55101638
NM_014895,KIAA1009,27,26,103395,5183,98212,3777.384615,191.962963,18.94887131
NM_003188,MAP3K7,16,15,73730,5102,68628,4575.2,318.875,13.45119561
NM_001242813,ANKRD6,15,14,200658,5265,195393,13956.64286,351,37.11168091
NM_014942,ANKRD6,16,15,200658,5356,195302,13020.13333,334.75,36.46415235
NM_001286206,KIAA1009,27,26,103395,5129,98266,3779.461538,189.962963,19.15890037
NM_001286250,KLHL32,10,9,216136,3709,212427,23603,370.9,57.27338905
NM_006581,FUT9,3,2,199645,12801,186844,93422,4267,14.59604718
NM_052904,KLHL32,11,10,216136,3818,212318,21231.8,347.0909091,55.60974332
NM_001286252,KLHL32,7,6,190124,2066,188058,31343,295.1428571,91.02516941
NM_001286251,KLHL32,9,8,216136,3609,212527,26565.875,401,58.88805763
NM_001286254,KLHL32,9,8,130557,2651,127906,15988.25,294.5555556,48.24820822
NM_014845,FIG4,23,22,134212,3128,131084,5958.363636,136,41.90664962
NM_001287215,AMD1,9,8,81093,3195,77898,9737.25,355,24.38122066
NM_001029858,SLC35F1,8,7,410152,4860,405292,57898.85714,607.5,83.39341564
NM_152730,TBC1D32,32,31,255008,5153,249855,8059.83871,161.03125,48.48728896
NM_001251987,TRDN,21,20,287620,4775,282845,14142.25,227.3809524,59.23455497
NM_006073,TRDN,41,40,420756,4811,415945,10398.625,117.3414634,86.45707753
NM_001040214,NKAIN2,7,6,1021719,3322,1018397,169732.8333,474.5714286,306.5614088
NM_005907,MAN1A1,13,12,172567,5040,167527,13960.58333,387.6923077,33.23948413
NM_153355,NKAIN2,6,5,1021719,3120,1018599,203719.8,520,326.4740385
NM_033515,ARHGAP18,15,14,133132,3514,129618,9258.428571,234.2666667,36.88616961
NM_001278724,IL20RA,6,5,45211,3462,41749,8349.8,577,12.05921433
NM_022121,PERP,3,2,19020,4305,14715,7357.5,1435,3.418118467
NM_001278722,IL20RA,7,6,44343,3389,40954,6825.666667,484.1428571,12.08439068
NM_016217,HECA,4,3,45699,5625,40074,13358,1406.25,7.124266667
NM_001278723,IL20RA,6,5,45211,3528,41683,8336.6,588,11.8149093
NM_022568,ALDH8A1,7,6,32734,2565,30169,5028.166667,366.4285714,11.76179337
NM_001193480,ALDH8A1,6,5,32734,2414,30320,6064,402.3333333,12.56006628
NM_014432,IL20RA,7,6,45211,3708,41503,6917.166667,529.7142857,11.19282632
NM_018945,PDE7B,13,12,343877,5400,338477,28206.41667,415.3846154,62.68092593
NM_170771,ALDH8A1,6,5,32734,2402,30332,6066.4,400.3333333,12.62781016
NM_007124,UTRN,74,73,561299,12505,548794,7517.726027,168.9864865,43.88596561
NM_001030060,SAMD5,2,1,61331,6326,55005,55005,3163,8.695067973
NM_016108,AIG1,6,5,279503,1474,278029,55605.8,245.6666667,188.6221167
NM_007044,KATNA1,11,10,53931,1997,51934,5193.4,181.5454545,26.00600901
NM_001204076,KATNA1,8,7,53931,1639,52292,7470.285714,204.875,31.90482001
NM_001286587,AIG1,7,6,280982,1418,279564,46594,202.5714286,197.1537377
NM_001122742,ESR1,10,9,412779,6475,406304,45144.88889,647.5,62.74965251
NM_020732,ARID1B,20,19,432851,9658,423193,22273.31579,482.9,43.81787119
NM_016224,SNX9,18,17,121908,4309,117599,6917.588235,239.3888889,27.29148294
NM_017519,ARID1B,19,18,432851,9618,423233,23512.94444,506.2105263,44.00426284
NM_001080379,PACRG,5,4,587524,1550,585974,146493.5,310,378.0477419
NM_001080378,PACRG,6,5,588362,1509,586853,117370.6,251.5,388.9019218
NM_013987,PARK2,11,10,1380246,4000,1376246,137624.6,363.6363636,344.0615
NM_013988,PARK2,9,8,1380246,3635,1376611,172076.375,403.8888889,378.7100413
NM_005922,MAP3K4,27,26,125597,5511,120086,4618.692308,204.1111111,21.79023771
NM_006724,MAP3K4,26,25,125597,5360,120237,4809.48,206.1538462,22.43227612
NM_000876,IGF2R,48,47,137454,9139,128315,2730.106383,190.3958333,14.04037641
NM_152410,PACRG,7,6,588362,1627,586735,97789.16667,232.4285714,360.6238476
NM_004562,PARK2,12,11,1380246,4085,1376161,125105.5455,340.4166667,336.8815177
NM_001202550,WDR27,22,21,244858,3111,241747,11511.7619,141.4090909,77.70716811
NM_182552,WDR27,26,25,244858,3618,241240,9649.6,139.1538462,66.6777225
NM_018303,EXOC2,28,27,208005,4502,203503,7537.148148,160.7857143,45.20279876
NM_002460,IRF4,9,8,19706,5336,14370,1796.25,592.8888889,2.693028486
NM_001195286,IRF4,9,8,19706,5333,14373,1796.625,592.5555556,2.695105944
NM_000904,NQO2,7,6,19929,1146,18783,3130.5,163.7142857,16.39005236
NM_001286455,SLC22A23,10,9,176041,5693,170348,18927.55556,569.3,29.92236079
NM_015482,SLC22A23,10,9,187588,6153,181435,20159.44444,615.3,29.487242
NM_003913,PRPF4B,15,14,43650,7497,36153,2582.357143,499.8,4.822328932
NM_021945,SLC22A23,11,10,176041,5939,170102,17010.2,539.9090909,28.64152214
NM_001286456,SLC22A23,4,3,133237,1596,131641,43880.33333,399,82.48182957
NM_001143970,CDYL,7,6,119448,3317,116131,19355.16667,473.8571429,35.01085318
NM_004824,CDYL,7,6,179100,3468,175632,29272,495.4285714,50.64359862
NM_006567,FARS2,7,6,510234,1848,508386,84731,264,275.1006494
NM_001168344,RREB1,12,11,144385,8544,135841,12349.18182,712,15.89899345
NM_001003699,RREB1,13,12,144129,8746,135383,11281.91667,672.7692308,15.47941916
NM_001003698,RREB1,12,11,144129,8580,135549,12322.63636,715,15.79825175
NM_001003700,RREB1,12,11,144129,7947,136182,12380.18182,662.25,17.13627784
NM_001718,BMP6,7,6,154952,3112,151840,25306.66667,444.5714286,48.79177378
NM_152551,SNRNP48,9,8,21770,4182,17588,2198.5,464.6666667,4.205643233
NM_001142393,NEDD9,8,7,199052,4739,194313,27759,592.375,41.00295421
NM_145655,GCNT2,3,2,43610,4203,39407,19703.5,1401,9.375921961
NM_017770,ELOVL2,8,7,63633,4081,59552,8507.428571,510.125,14.59250184
NM_004752,GCM2,5,4,8644,2370,6274,1568.5,474,2.647257384
NM_145649,GCNT2,5,4,108035,4526,103509,25877.25,905.2,22.86986301
NM_001491,GCNT2,3,2,73654,4675,68979,34489.5,1558.333333,14.75486631
NM_002114,HIVEP1,9,8,152510,8883,143627,17953.375,987,16.1687493
NM_030948,PHACTR1,15,14,571040,2896,568144,40581.71429,193.0666667,196.1823204
NM_001242648,PHACTR1,15,14,571040,2706,568334,40595.28571,180.4,210.0273466
NM_001242628,GFOD1,2,1,122830,2483,120347,120347,1241.5,48.46838502
NM_001242630,GFOD1,2,1,44784,2538,42246,42246,1269,16.64539007
NM_018988,GFOD1,2,1,124284,3310,120974,120974,1655,36.54803625
NM_032122,DTNBP1,10,9,140259,1429,138830,15425.55556,142.9,97.15185444
NM_183040,DTNBP1,9,8,139490,1965,137525,17190.625,218.3333333,69.98727735
NM_001267040,JARID2,18,17,273189,5615,267574,15739.64706,311.9444444,47.65342832
NM_001271669,DTNBP1,8,7,140252,1315,138937,19848.14286,164.375,105.6555133
NM_001271668,DTNBP1,9,8,140252,1370,138882,17360.25,152.2222222,101.3737226
NM_001271667,DTNBP1,10,9,140252,1467,138785,15420.55556,146.7,94.60463531
NM_004973,JARID2,18,17,276069,6115,269954,15879.64706,339.7222222,44.14619787
NM_000332,ATXN1,9,8,462380,10645,451735,56466.875,1182.777778,42.4363551
NM_001128164,ATXN1,8,7,462380,10595,451785,64540.71429,1324.375,42.64134025
NM_006877,GMPR,9,8,56971,1524,55447,6930.875,169.3333333,36.38254593
NM_006366,CAP2,13,12,164289,3040,161249,13437.41667,233.8461538,53.04243421
NM_001278210,NUP153,21,20,91801,5832,85969,4298.45,277.7142857,14.74091221
NM_001278209,NUP153,23,22,91801,6053,85748,3897.636364,263.173913,14.16619858
NM_005124,NUP153,22,21,91801,5959,85842,4087.714286,270.8636364,14.40543715
NM_001243423,KIF13A,3,2,37219,1333,35886,17943,444.3333333,26.92123031
NM_153042,KDM1B,18,17,68467,3893,64574,3798.470588,216.2777778,16.58720781
NM_001080480,MBOAT1,13,12,112781,4332,108449,9037.416667,333.2307692,25.0343952
NM_001243076,E2F3,7,6,90037,4432,85605,14267.5,633.1428571,19.31520758
NM_001949,E2F3,7,6,91810,5016,86794,14465.66667,716.5714286,17.30342903
NM_001168377,KIAA0319,19,18,102053,6641,95412,5300.666667,349.5263158,14.36711339
NM_016356,DCDC2,10,9,186299,4718,181581,20175.66667,471.8,38.48685884
NM_001080,ALDH5A1,10,9,42240,5141,37099,4122.111111,514.1,7.216300331
NM_001195610,DCDC2,11,10,211539,4626,206913,20691.3,420.5454545,44.72827497
NM_014809,KIAA0319,21,20,102053,6826,95227,4761.35,325.047619,13.95062994
NM_001168376,KIAA0319,20,19,101919,6640,95279,5014.684211,332,14.34924699
NM_001168375,KIAA0319,21,20,101919,6801,95118,4755.9,323.8571429,13.98588443
NM_001168374,KIAA0319,22,21,102053,6918,95135,4530.238095,314.4545455,13.75180688
NM_170740,ALDH5A1,11,10,42240,5181,37059,3705.9,471,7.152866242
NM_014722,FAM65B,23,22,106891,5701,101190,4599.545455,247.8695652,17.74951763
NM_001286446,FAM65B,14,13,202803,3537,199266,15328.15385,252.6428571,56.33757422
NM_001286445,FAM65B,22,21,131773,5412,126361,6017.190476,246,23.34830007
NM_006998,SCGN,11,10,49581,1490,48091,4809.1,135.4545455,32.27583893
NM_001173977,LRRC16A,37,36,341104,5450,335654,9323.722222,147.2972973,61.58788991
NM_017640,LRRC16A,37,36,341104,5468,335636,9323.222222,147.7837838,61.38185808
NM_005074,SLC17A1,13,12,49163,1856,47307,3942.25,142.7692308,25.48868534
NM_001197234,BTN2A1,8,7,18719,1759,16960,2422.857143,219.875,9.641841956
NM_003447,ZNF165,4,3,8860,2381,6479,2159.666667,595.25,2.721125577
NM_001010877,ZNF311,7,6,10445,2705,7740,1290,386.4285714,2.861367837
NM_014641,MDC1,15,14,17876,7383,10493,749.5,492.2,1.421237979
NM_001090,ABCF1,24,23,20141,3374,16767,729,140.5833333,4.969472436
NM_001025091,ABCF1,25,24,20141,3489,16652,693.8333333,139.56,4.772714245
NM_002441,MSH5,25,24,22732,2963,19769,823.7083333,118.52,6.671954101
NM_025259,MSH5,25,24,22732,2769,19963,831.7916667,110.76,7.2094619
NM_025256,EHMT2,27,26,17950,3913,14037,539.8846154,144.9259259,3.587273192
NM_032454,STK19,1,0,445,445,NA,NA,445,NA
NM_019602,BTNL2,6,5,12389,1374,11015,2203,229,8.016739447
NM_006709,EHMT2,28,27,17950,4016,13934,516.0740741,143.4285714,3.469621514
NM_004197,STK19,1,0,445,445,NA,NA,445,NA
NM_172166,MSH5,25,24,22732,2805,19927,830.2916667,112.2,7.104099822
NM_172165,MSH5,25,24,22732,2808,19924,830.1666667,112.32,7.095441595
NM_001289413,EHMT2,26,25,17449,4057,13392,535.68,156.0384615,3.300961301
NM_152735,ZBTB9,2,1,2966,2713,253,253,1356.5,0.0932547
NM_002131,HMGA1,6,5,9433,1966,7467,1493.4,327.6666667,3.798067141
NM_001202470,RPS10-NUDT3,9,8,138931,2536,136395,17049.375,281.7777778,53.78351735
NM_020804,PACSIN1,10,9,69164,4311,64853,7205.888889,431.1,15.04360937
NM_006703,NUDT3,5,4,105486,2399,103087,25771.75,479.8,42.97082118
NM_001256811,GRM4,10,9,127496,7287,120209,13356.55556,728.7,16.49636339
NM_001256809,GRM4,9,8,136981,6810,130171,16271.375,756.6666667,19.11468429
NM_145901,HMGA1,5,4,9360,2165,7195,1798.75,433,3.323325635
NM_145899,HMGA1,6,5,9433,1999,7434,1486.8,333.1666667,3.71885943
NM_000841,GRM4,11,10,127496,7429,120067,12006.7,675.3636364,16.16193297
NM_001282847,GRM4,10,9,127496,7211,120285,13365,721.1,16.6807655
NM_145905,HMGA1,5,4,7442,1854,5588,1397,370.8,3.014023732
NM_145903,HMGA1,5,4,9433,1851,7582,1895.5,370.2,4.096164236
NM_145902,HMGA1,5,4,9360,2132,7228,1807,426.4,3.390243902
NM_003427,ZNF76,14,13,36252,2667,33585,2583.461538,190.5,12.5928009
NM_001171819,PPARD,7,6,85635,3523,82112,13685.33333,503.2857143,23.30740846
NM_006238,PPARD,8,7,85635,3755,81880,11697.14286,469.375,21.80559254
NM_001171820,PPARD,6,5,85635,3459,82176,16435.2,576.5,23.75715525
NM_001171818,PPARD,9,8,85635,3852,81783,10222.875,428,21.23130841
NM_003093,SNRPC,6,5,16765,1223,15542,3108.4,203.8333333,12.70809485
NM_015245,ANKS1A,24,23,202154,6375,195779,8512.130435,265.625,30.71043137
NM_177435,PPARD,7,6,82840,2011,80829,13471.5,287.2857143,40.1934361
NM_001193476,SLC26A8,20,19,81016,3430,77586,4083.473684,171.5,22.61982507
NM_015695,BRPF3,13,12,36019,6036,29983,2498.583333,464.3076923,4.967362492
NM_052961,SLC26A8,20,19,81124,3454,77670,4087.894737,172.7,22.48697163
NM_173562,KCTD20,8,7,48378,5627,42751,6107.285714,703.375,7.597476453
NM_003017,SRSF3,6,5,10156,3150,7006,1401.2,525,2.224126984
NM_001286579,KCTD20,5,4,48378,5126,43252,10813,1025.2,8.43776824
NM_139012,MAPK14,12,11,83561,4365,79196,7199.636364,363.75,18.14341352
NM_139013,MAPK14,10,9,75083,1441,73642,8182.444444,144.1,51.10478834
NM_139014,MAPK14,11,10,83561,4285,79276,7927.6,389.5454545,18.5008168
NM_001315,MAPK14,12,11,83561,4365,79196,7199.636364,363.75,18.14341352
NM_138718,SLC26A8,18,17,80988,3175,77813,4577.235294,176.3888889,24.5080315
NM_182548,LHFPL5,4,3,18783,2151,16632,5544,537.75,7.732217573
NM_001286580,KCTD20,7,6,48378,5352,43026,7171,764.5714286,8.039237668
NM_016059,PPIL1,4,3,20196,1740,18456,6152,435,10.60689655
NM_003958,RNF8,8,7,40768,5639,35129,5018.428571,704.875,6.229650647
NM_183078,RNF8,7,6,40768,5433,35335,5889.166667,776.1428571,6.503773238
NM_153487,MDGA1,17,16,65484,8924,56560,3535,524.9411765,6.337965038
NM_145316,TMEM217,4,3,45461,1594,43867,14622.33333,398.5,27.52007528
NM_001286401,TMEM217,3,2,45979,2026,43953,21976.5,675.3333333,21.69447187
NM_001162900,TMEM217,2,1,40515,1995,38520,38520,997.5,19.30827068
NM_006708,GLO1,6,5,27252,2052,25200,5040,342,12.28070175
NM_021943,ZFAND3,6,5,335094,3339,331755,66351,556.5,99.35759209
NM_001172418,BTBD9,11,10,427618,8632,418986,41898.6,784.7272727,48.53869323
NM_052893,BTBD9,12,11,471699,8961,462738,42067.09091,746.75,51.63910278
NM_001099272,BTBD9,11,10,471699,8760,462939,46293.9,796.3636364,52.84691781
NM_152733,BTBD9,10,9,427618,8496,419122,46569.11111,849.6,49.3316855
NM_001289024,KIF6,10,9,96276,2455,93821,10424.55556,245.5,38.21629328
NM_145027,KIF6,23,22,390307,3995,386312,17559.63636,173.6956522,96.69887359
NM_003740,KCNK5,5,4,40506,3788,36718,9179.5,757.6,9.693241816
NM_001289020,KIF6,22,21,390307,3943,386364,18398.28571,179.2272727,97.9873193
NM_001289021,KIF6,22,21,390307,3826,386481,18403.85714,173.9090909,101.0143753
NM_020737,LRFN2,3,2,195755,3147,192608,96304,1049,61.20368605
NM_006789,APOBEC2,3,2,11692,1637,10055,5027.5,545.6666667,6.142333537
NM_001271945,TFEB,9,8,50425,2172,48253,6031.625,241.3333333,22.21593002
NM_001271943,TFEB,8,7,51551,2005,49546,7078,250.625,24.71122195
NM_001167827,TFEB,9,8,52283,2197,50086,6260.75,244.1111111,22.79745107
NM_007162,TFEB,10,9,51084,2364,48720,5413.333333,236.4,20.60913706
NM_001286554,USP49,6,5,81743,8812,72931,14586.2,1468.666667,8.276327735
NM_018561,USP49,7,6,97718,3184,94534,15755.66667,454.8571429,29.69032663
NM_138457,FOXP4,17,16,55960,5927,50033,3127.0625,348.6470588,8.441538721
NM_001271944,TFEB,9,8,51551,2261,49290,6161.25,251.2222222,21.80008846
NM_001012427,FOXP4,17,16,55960,5960,50000,3125,350.5882353,8.389261745
NM_001012426,FOXP4,17,16,55960,5966,49994,3124.625,350.9411765,8.379818974
NM_015255,UBR2,47,46,129485,7945,121540,2642.173913,169.0425532,15.29767149
NM_033502,TRERF1,18,17,227116,7598,219518,12912.82353,422.1111111,28.89155041
NM_001164446,C6orf132,5,4,41860,6747,35113,8778.25,1349.4,5.204238921
NM_001193343,MRPS18A,5,4,16617,1124,15493,3873.25,224.8,13.78380783
NM_020750,XPO5,32,31,53746,5396,48350,1559.677419,168.625,8.960340993
NM_032538,TTBK1,15,14,44777,7143,37634,2688.142857,476.2,5.268654627
NM_152881,PTK7,17,16,85454,3900,81554,5097.125,229.4117647,20.91128205
NM_152880,PTK7,19,18,85454,4172,81282,4515.666667,219.5789474,19.48274209
NM_002821,PTK7,20,19,85454,4293,81161,4271.631579,214.65,18.90542744
NM_018135,MRPS18A,6,5,16617,1195,15422,3084.4,199.1666667,12.90543933
NM_001270398,PTK7,20,19,84908,4166,80742,4249.578947,208.3,19.38118099
NM_152882,PTK7,19,18,85454,4124,81330,4518.333333,217.0526316,19.72114452
NM_016929,CLIC5,6,5,117438,5744,111694,22338.8,957.3333333,19.44533426
NM_001278478,RUNX2,6,5,128507,5241,123266,24653.2,873.5,23.51955734
NM_001024630,RUNX2,9,8,222767,5562,217205,27150.625,618,39.05160014
NM_001015051,RUNX2,8,7,222767,5495,217272,31038.85714,686.875,39.5399454
NM_001114086,CLIC5,6,5,181897,5980,175917,35183.4,996.6666667,29.41755853
NM_005588,MEP1A,14,13,46427,2943,43484,3344.923077,210.2142857,14.77539925
NM_016593,CYP39A1,12,11,103252,2456,100796,9163.272727,204.6666667,41.04071661
NM_001251974,RCAN2,5,4,270595,3301,267294,66823.5,660.2,80.97364435
NM_001278738,CYP39A1,12,11,103252,2396,100856,9168.727273,199.6666667,42.09348915
NM_001278739,CYP39A1,11,10,103252,2280,100972,10097.2,207.2727273,44.28596491
NM_001168359,TDRD6,3,2,16446,8890,7556,3778,2963.333333,0.849943757
NM_005822,RCAN2,4,3,105164,3422,101742,33914,855.5,29.73173583
NM_001010870,TDRD6,4,3,16446,8981,7465,2488.333333,2245.25,0.831199198
NM_001251973,RCAN2,5,4,271339,3348,267991,66997.75,669.6,80.04510155
NM_012120,CD2AP,18,17,149473,5427,144046,8473.294118,301.5,26.54247282
NM_001013732,PTCHD4,3,2,190663,2853,187810,93905,951,65.82895198
NM_207499,PTCHD4,3,2,169082,3271,165811,82905.5,1090.333333,50.69122592
NM_001261822,CRISP2,9,8,21234,1385,19849,2481.125,153.8888889,14.33140794
NM_001205220,CRISP1,8,7,42832,1898,40934,5847.714286,237.25,21.56691254
NM_170609,CRISP1,7,6,32241,1797,30444,5074,256.7142857,16.94156928
NM_001142435,CRISP2,9,8,21234,1379,19855,2481.875,153.2222222,14.39811458
NM_001142417,CRISP2,10,9,21234,1397,19837,2204.111111,139.7,14.19971367
NM_001142408,CRISP2,10,9,21234,1417,19817,2201.888889,141.7,13.98517996
NM_001142407,CRISP2,9,8,21234,1359,19875,2484.375,151,14.62472406
NM_001131,CRISP1,8,7,32241,1887,30354,4336.285714,235.875,16.08585056
NM_003296,CRISP2,10,9,21234,1423,19811,2201.222222,142.3,13.92199578
NM_000255,MUT,13,12,32970,3899,29071,2422.583333,299.9230769,7.456014363
NM_172238,TFAP2D,8,7,59491,2048,57443,8206.142857,256,28.04833984
NM_138694,PKHD1,67,66,472280,16302,455978,6908.757576,243.3134328,27.97067844
NM_001172420,EFHC1,12,11,74780,5506,69274,6297.636364,458.8333333,12.5815474
NM_018100,EFHC1,11,10,75591,5593,69998,6999.8,508.4545455,12.51528697
NM_170724,PKHD1,61,60,366778,11665,355113,5918.55,191.2295082,30.44260609
NM_033480,FBXO9,13,12,35415,4700,30715,2559.583333,361.5384615,6.535106383
NM_012347,FBXO9,12,11,29901,4449,25452,2313.818182,370.75,5.720836143
NM_033481,FBXO9,13,12,35876,4577,31299,2608.25,352.0769231,6.838322045
NM_001281747,MLIP,14,13,154864,3383,151481,11652.38462,241.6428571,44.7771209
NM_001281746,MLIP,12,11,199170,5755,193415,17583.18182,479.5833333,33.60816681
NM_138569,MLIP,13,12,247366,1828,245538,20461.5,140.6153846,134.3205689
NM_018214,LRRC1,14,13,129143,3194,125949,9688.384615,228.1428571,39.43299937
NM_001042406,HMGCLL1,9,8,144843,2480,142363,17795.375,275.5555556,57.40443548
NM_001287753,HMGCLL1,6,5,144843,2168,142675,28535,361.3333333,65.80950185
NM_001287741,HMGCLL1,8,7,144843,2383,142460,20351.42857,297.875,59.78178766
NM_001526,HCRTR2,7,6,108349,1823,106526,17754.33333,260.4285714,58.43444871
NM_019036,HMGCLL1,10,9,144843,2571,142272,15808,257.1,55.33722287
NM_001287746,HMGCLL1,10,9,144843,2577,142266,15807.33333,257.7,55.20605355
NM_001010872,FAM83B,5,4,98330,6249,92081,23020.25,1249.8,14.73531765
NM_021073,BMP5,7,6,120139,2177,117962,19660.33333,311,54.18557648
NM_015548,DST,84,83,184911,16726,168185,2026.325301,199.1190476,10.05530312
NM_001723,DST,24,23,28321,9022,19299,839.0869565,375.9166667,2.139104411
NM_030820,COL21A1,30,29,190992,4203,186789,6441,140.1,44.44182727
NM_001031623,ZNF451,15,14,80272,5256,75016,5358.285714,350.4,14.27245053
NM_152731,BEND6,7,6,72371,2705,69666,11611,386.4285714,25.75452865
NM_015555,ZNF451,14,13,80272,5111,75161,5781.615385,365.0714286,14.70573273
NM_000947,PRIM2,15,14,330963,2304,328659,23475.64286,153.6,142.6471354
NM_001704,BAI3,32,31,753773,5669,748104,24132.3871,177.15625,131.9640148
NM_020819,FAM135A,21,20,147772,5615,142157,7107.85,267.3809524,25.3173642
NM_001858,COL19A1,51,50,345711,8776,336935,6738.7,172.0784314,38.39277575
NM_018368,LMBRD1,16,15,121410,2324,119086,7939.066667,145.25,51.24182444
NM_001162529,FAM135A,20,19,134737,5954,128783,6778.052632,297.7,21.62966073
NM_001105531,FAM135A,22,21,147772,5753,142019,6762.809524,261.5,24.68607683
NM_001281440,SMAP1,11,10,193485,3163,190322,19032.2,287.5454545,60.17135631
NM_001281439,SMAP1,11,10,194244,3354,190890,19089,304.9090909,56.91413238
NM_021940,SMAP1,10,9,194244,3265,190979,21219.88889,326.5,58.49280245
NM_001044305,SMAP1,11,10,194244,3347,190897,19089.7,304.2727273,57.03525545
NM_014989,RIMS1,34,33,516441,7863,508578,15411.45455,231.2647059,64.67989317
NM_001168409,RIMS1,22,21,186702,5074,181628,8648.952381,230.6363636,35.79582184
NM_001168410,RIMS1,22,21,186384,5361,181023,8620.142857,243.6818182,33.76664801
NM_001168408,RIMS1,21,20,190333,5216,185117,9255.85,248.3809524,35.49022239
NM_001168407,RIMS1,25,24,190333,5805,184528,7688.666667,232.2,31.78776916
NM_012434,SLC17A5,11,10,60637,3325,57312,5731.2,302.2727273,17.23669173
NM_133645,MTO1,13,12,39727,3012,36715,3059.583333,231.6923077,12.18957503
NM_012123,MTO1,12,11,39727,2936,36791,3344.636364,244.6666667,12.53099455
NM_001123226,MTO1,13,12,39727,3057,36670,3055.833333,235.1538462,11.99542035
NM_015687,FILIP1,6,5,185698,4628,181070,36214,771.3333333,39.12489196
NM_015571,SENP6,24,23,116374,6666,109708,4769.913043,277.75,16.45784578
NM_080645,COL12A1,51,50,121583,8138,113445,2268.9,159.5686275,13.94015729
NM_001100409,SENP6,23,22,116374,6644,109730,4987.727273,288.8695652,16.51565322
NM_004370,COL12A1,66,65,121583,11645,109938,1691.353846,176.4393939,9.440790039
NM_001282368,IMPG1,16,15,151566,3341,148225,9881.666667,208.8125,44.36545944
NM_001563,IMPG1,17,16,151566,3576,147990,9249.375,210.3529412,41.38422819
NM_001282136,MEI4,4,3,234105,2591,231514,77171.33333,647.75,89.3531455
NM_031469,SH3BGRL2,4,3,72371,4650,67721,22573.66667,1162.5,14.56365591
NM_181714,LCA5,9,8,52441,4728,47713,5964.125,525.3333333,10.09158206
NM_001122769,LCA5,8,7,52441,4572,47869,6838.428571,571.5,10.470035
NM_183050,BCKDHB,10,9,239645,3722,235923,26213.66667,372.2,63.38608275
NM_000056,BCKDHB,11,10,239645,1561,238084,23808.4,141.9090909,152.5201794
NM_198920,UBE3D,10,9,173361,1843,171518,19057.55556,184.3,93.06456864
NM_014841,SNAP91,29,28,156524,4480,152044,5430.142857,154.4827586,33.93839286
NM_001256718,SNAP91,28,27,155917,4171,151746,5620.222222,148.9642857,36.38120355
NM_001256717,SNAP91,30,29,156524,4545,151979,5240.655172,151.5,33.43872387
NM_001242794,SNAP91,20,19,156524,3346,153178,8062,167.3,45.77943814
NM_001242793,SNAP91,28,27,156524,4185,152339,5642.185185,149.4642857,36.40119474
NM_001242792,SNAP91,29,28,156244,4477,151767,5420.25,154.3793103,33.8992629
NM_002395,ME1,14,13,220830,3531,217299,16715.30769,252.2142857,61.54035684
NM_001080508,TBX18,8,7,31740,6074,25666,3666.571429,759.25,4.225551531
NM_020468,SNX14,26,25,88416,3371,85045,3401.8,129.6538462,25.22841887
NM_153816,SNX14,29,28,88416,3533,84883,3031.535714,121.8275862,24.02575715
NM_015021,ZNF292,8,7,108139,10108,98031,14004.42857,1263.5,9.698357736
NM_000865,HTR1E,2,1,79375,2050,77325,77325,1025,37.7195122
NM_016083,CNR1,2,1,26184,5720,20464,20464,2860,3.577622378
NM_001160259,CNR1,2,1,26184,5776,20408,20408,2888,3.533240997
NM_012381,ORC3,20,19,77389,2589,74800,3936.842105,129.45,28.89146389
NM_006416,SLC35A1,8,7,39416,1914,37502,5357.428571,239.25,19.59352142
NM_001160258,CNR1,4,3,26184,5903,20281,6760.333333,1475.75,3.435710656
NM_001160226,CNR1,3,2,26184,5864,20320,10160,1954.666667,3.46521146
NM_001197259,ORC3,19,18,77389,2490,74899,4161.055556,131.0526316,30.07991968
NM_181837,ORC3,20,19,77389,2592,74797,3936.684211,129.6,28.85686728
NM_001168398,SLC35A1,7,6,39416,1736,37680,6280,248,21.70506912
NM_016021,UBE2J1,8,7,26277,4350,21927,3132.428571,543.75,5.040689655
NM_001256704,GABRR1,11,10,40275,3274,37001,3700.1,297.6363636,11.3014661
NM_001256703,GABRR1,9,8,40275,3119,37156,4644.5,346.5555556,11.91279256
NM_002042,GABRR1,10,9,40275,3171,37104,4122.666667,317.1,11.70104068
NM_001267582,GABRR1,12,11,53786,2943,50843,4622.090909,245.25,17.27590894
NM_001286426,RNGTT,15,14,353734,4782,348952,24925.14286,318.8,72.97197825
NM_001286428,RNGTT,14,13,353734,4671,349063,26851,333.6428571,74.72982231
NM_003800,RNGTT,16,15,353734,4852,348882,23258.8,303.25,71.90478153
NM_021813,BACH2,9,8,370317,9224,361093,45136.625,1024.888889,39.14711622
NM_012115,CASP8AP2,10,9,44538,6773,37765,4196.111111,677.3,5.575815739
NM_014611,MDN1,102,101,176213,17502,158711,1571.39604,171.5882353,9.068163638
NM_001242814,ANKRD6,13,12,66998,4974,62024,5168.666667,382.6153846,12.46964214
NM_001242811,ANKRD6,16,15,71518,5754,65764,4384.266667,359.625,11.4292666
NM_001137667,CASP8AP2,10,9,44538,6734,37804,4200.444444,673.4,5.613899614
NM_001137668,CASP8AP2,10,9,44538,6601,37937,4215.222222,660.1,5.747159521
NM_001170794,BACH2,7,6,370382,9116,361266,60211,1302.285714,39.62988153
NM_001288629,EPHA7,17,16,179562,6644,172918,10807.375,390.8235294,26.02618904
NM_004440,EPHA7,17,16,179562,6659,172903,10806.4375,391.7058824,25.96531011
NM_015323,UFL1,19,18,33451,4224,29227,1623.722222,222.3157895,6.919270833
NM_030784,GPR63,2,1,43357,5972,37385,37385,2986,6.260046885
NM_001143957,GPR63,3,2,43357,6091,37266,18633,2030.333333,6.118207191
NM_198468,MMS22L,25,24,141017,8668,132349,5514.541667,346.72,15.26868943
NM_012160,FBXL4,9,8,74283,2819,71464,8933,313.2222222,25.35083363
NM_001278716,FBXL4,10,9,74283,2938,71345,7927.222222,293.8,24.28352621
NM_032511,FAXC,6,5,76740,9766,66974,13394.8,1627.666667,6.857874258
NM_032503,MCHR2,6,5,74330,2150,72180,14436,358.3333333,33.57209302
NM_001013399,CCNC,12,11,26429,2097,24332,2212,174.75,11.60324273
NM_001040179,MCHR2,6,5,74315,2374,71941,14388.2,395.6666667,30.30370682
NM_005190,CCNC,12,11,26429,2319,24110,2191.818182,193.25,10.39672273
NM_006828,ASCC3,42,41,373179,8195,364984,8902.04878,195.1190476,44.53740085
NM_022091,ASCC3,4,3,25071,3498,21573,7191,874.5,6.167238422
NM_001284271,ASCC3,13,12,166243,2848,163395,13616.25,219.0769231,57.37183989
NM_001166247,GRIK2,17,16,671099,4741,666358,41647.375,278.8823529,140.5522042
NM_021956,GRIK2,16,15,671099,4608,666491,44432.73333,288,144.6378038
NM_175768,GRIK2,17,16,671099,4696,666403,41650.1875,276.2352941,141.9086457
NM_020771,HACE1,24,23,131828,4600,127228,5531.652174,191.6666667,27.65826087
NM_002726,PREP,15,14,125559,2958,122601,8757.214286,197.2,41.44726166
NM_001004317,LIN28B,4,3,126286,5509,120777,40259,1377.25,21.9235796
NM_001286107,ATG5,7,6,141345,3123,138222,23037,446.1428571,44.25936599
NM_001286108,ATG5,8,7,141345,3248,138097,19728.14286,406,42.51754926
NM_004849,ATG5,8,7,141345,3252,138093,19727.57143,406.5,42.46402214
NM_001286106,ATG5,8,7,140960,3117,137843,19691.85714,389.625,44.22297081
NM_001286111,ATG5,5,4,141345,2879,138466,34616.5,575.8,48.09517193
NM_020381,PDSS2,8,7,307020,3560,303460,43351.42857,445,85.24157303
NM_018292,QRSL1,11,10,38853,4129,34724,3472.4,375.3636364,8.409784451
NM_018013,SOBP,7,6,171198,6239,164959,27493.16667,891.2857143,26.43997435
NM_198081,SCML4,8,7,122162,4547,117615,16802.14286,568.375,25.86650539
NM_201559,FOXO3,4,3,124947,7318,117629,39209.66667,1829.5,16.0739273
NM_007214,SEC63,21,20,90524,6521,84003,4200.15,310.5238095,12.88191995
NM_145315,LACE1,13,12,228155,2268,225887,18823.91667,174.4615385,99.59744268
NM_001455,FOXO3,3,2,123904,7344,116560,58280,2448,15.87145969
NM_001286408,SCML4,7,6,122162,4331,117831,19638.5,618.7142857,27.20641884
NM_032131,ARMC2,18,17,126058,3754,122304,7194.352941,208.5555556,32.57964838
NM_001277339,LOC100996634,10,9,33902,1979,31923,3547,197.9,16.13087418
NM_001199933,SESN1,10,9,23120,2691,20429,2269.888889,269.1,7.591601635
NM_001083535,CEP57L1,13,12,68761,2915,65846,5487.166667,224.2307692,22.58867925
NM_001145128,AK9,41,40,198358,6367,191991,4799.775,155.2926829,30.1540757
NM_145025,AK9,12,11,59517,2569,56948,5177.090909,214.0833333,22.1673803
NM_014454,SESN1,10,9,108070,3205,104865,11651.66667,320.5,32.71918877
NM_001271852,CEP57L1,11,10,68761,2762,65999,6599.9,251.0909091,23.89536568
NM_001271853,CEP57L1,11,10,68761,2776,65985,6598.5,252.3636364,23.76981268
NM_001199934,SESN1,10,9,22553,2733,19820,2202.222222,273.3,7.252103915
NM_001286609,ARMC2,17,16,126058,3680,122378,7648.625,216.4705882,33.2548913
NM_001024936,WASF1,9,8,80187,2986,77201,9650.125,331.7777778,25.85432016
NM_001024935,WASF1,10,9,80187,3085,77102,8566.888889,308.5,24.99254457
NM_001024934,WASF1,10,9,80187,3132,77055,8561.666667,313.2,24.60249042
NM_015076,CDK19,13,12,205233,6152,199081,16590.08333,473.2307692,32.36037061
NM_033125,SLC22A16,8,7,51954,1993,49961,7137.285714,249.125,25.06823884
NM_001123364,METTL24,5,4,112328,1106,111222,27805.5,221.2,100.562387
NM_003931,WASF1,11,10,80187,3231,76956,7695.6,293.7272727,23.818013
NM_153048,FYN,11,10,98801,2970,95831,9583.1,270,32.26632997
NM_001286431,REV3L,35,34,184686,11106,173580,5105.294118,317.3142857,15.62938952
NM_002037,FYN,14,13,213122,3642,209480,16113.84615,260.1428571,57.51784734
NM_002912,REV3L,33,32,184686,10869,173817,5431.78125,329.3636364,15.99199558
NM_018593,SLC16A10,6,5,135827,2897,132930,26586,482.8333333,45.88539869
NM_138408,GTF3C6,6,5,9330,956,8374,1674.8,159.3333333,8.759414226
NM_001286432,REV3L,34,33,184686,10998,173688,5263.272727,323.4705882,15.79268958
NM_002290,LAMA4,39,38,146785,7394,139391,3668.184211,189.5897436,18.85190695
NM_001105207,LAMA4,39,38,146785,7411,139374,3667.736842,190.025641,18.80636891
NM_001105206,LAMA4,39,38,146785,7415,139370,3667.631579,190.1282051,18.79568442
NM_002269,KPNA5,15,14,60665,2173,58492,4178,144.8666667,26.9176254
NM_152729,NT5DC1,12,11,144856,3141,141715,12883.18182,261.75,45.11779688
NM_001080976,DSE,6,5,158161,4011,154150,30830,668.5,38.43181252
NM_002944,ROS1,43,42,137490,7411,130079,3097.119048,172.3488372,17.55215221
NM_173674,DCBLD1,15,14,87202,1993,85209,6086.357143,132.8666667,42.75413949
NM_001042475,CEP85L,13,12,191087,7652,183435,15286.25,588.6153846,23.97216414
NM_001178035,CEP85L,14,13,249305,7141,242164,18628,510.0714286,33.91177706
NM_001288576,FAM184A,16,15,189366,3418,185948,12396.53333,213.625,54.40257461
NM_017696,MCM9,12,11,118293,4834,113459,10314.45455,402.8333333,23.47103848
NM_001100411,FAM184A,17,16,189366,3524,185842,11615.125,207.2941176,52.73609535
NM_206921,CEP85L,6,5,160427,2285,158142,31628.4,380.8333333,69.20875274
NM_000165,GJA1,2,1,14130,3132,10998,10998,1566,3.511494253
NM_001010852,CLVS2,6,5,76950,11483,65467,13093.4,1913.833333,5.701210485
NM_001270393,PKIB,8,7,254458,2004,252454,36064.85714,250.5,125.9750499
NM_032471,PKIB,4,3,116143,1816,114327,38109,454,62.95539648
NM_181795,PKIB,5,4,116143,1884,114259,28564.75,376.8,60.6470276
NM_181794,PKIB,7,6,254458,1883,252575,42095.83333,269,134.1343601
NM_001270394,PKIB,8,7,254458,1945,252513,36073.28571,243.125,129.8267352
NM_001256021,TRDN,8,7,135267,3010,132257,18893.85714,376.25,43.93920266
NM_001256022,TRDN,6,5,108412,1419,106993,21398.6,236.5,75.40028189
NM_001256020,TRDN,9,8,172844,1853,170991,21373.875,205.8888889,92.27792768
NM_001003397,TPD52L1,5,4,109767,1275,108492,27123,255,85.09176471
NM_001003396,TPD52L1,6,5,109767,1315,108452,21690.4,219.1666667,82.4730038
NM_001003395,TPD52L1,7,6,109226,1398,107828,17971.33333,199.7142857,77.13018598
NM_001286398,RNF217,6,5,123795,5036,118759,23751.8,839.3333333,23.58200953
NM_003287,TPD52L1,7,6,109767,1377,108390,18065,196.7142857,78.71459695
NM_152553,RNF217,9,8,102976,4620,98356,12294.5,513.3333333,21.28917749
NM_001031712,TRMT11,13,12,52846,1964,50882,4240.166667,151.0769231,25.90733198
NM_001199621,NCOA7,15,14,141269,6218,135051,9646.5,414.5333333,21.71936314
NM_001199620,NCOA7,18,17,150871,6576,144295,8487.941176,365.3333333,21.94267032
NM_001199619,NCOA7,17,16,150871,6457,144414,9025.875,379.8235294,22.36549481
NM_181782,NCOA7,16,15,141269,6473,134796,8986.4,404.5625,20.82434729
NM_001122842,NCOA7,16,15,141269,6440,134829,8988.6,402.5,20.93618012
NM_001012279,SOGA3,12,11,80951,11830,69121,6283.727273,985.8333333,5.842857143
NM_018479,ECHDC1,5,4,54899,2291,52608,13152,458.2,22.9628983
NM_001105545,ECHDC1,4,3,54899,2068,52831,17610.33333,517,25.54690522
NM_001105544,ECHDC1,5,4,54899,2122,52777,13194.25,424.4,24.87134779
NM_001002030,ECHDC1,6,5,54899,2345,52554,10510.8,390.8333333,22.41108742
NM_001010923,THEMIS,6,5,192889,3872,189017,37803.4,645.3333333,48.81637397
NM_001164687,THEMIS,6,5,210439,3836,206603,41320.6,639.3333333,53.85896767
NM_001164685,THEMIS,7,6,192889,3990,188899,31483.16667,570,47.34310777
NM_002844,PTPRK,30,29,551897,6117,545780,18820,203.9,89.22347556
NM_001135648,PTPRK,31,30,551948,6187,545761,18192.03333,199.5806452,88.21092614
NM_001079823,LAMA2,64,63,633426,9744,623682,9899.714286,152.25,64.0067734
NM_000426,LAMA2,65,64,633426,9757,623669,9744.828125,150.1076923,63.92015989
NM_032438,L3MBTL3,23,22,122868,4238,118630,5392.272727,184.2608696,27.99197735
NM_001010876,TMEM244,5,4,30029,550,29479,7369.75,110,53.59818182
NM_001258275,SAMD3,14,13,221125,2404,218721,16824.69231,171.7142857,90.98211314
NM_001007102,L3MBTL3,22,21,122868,4162,118706,5652.666667,189.1818182,28.52138395
NM_001135555,EPB41L2,15,14,223976,3488,220488,15749.14286,232.5333333,63.21330275
NM_001135554,EPB41L2,15,14,223976,3475,220501,15750.07143,231.6666667,63.45352518
NM_016377,AKAP7,8,7,147851,2942,144909,20701.28571,367.75,49.25526852
NM_001431,EPB41L2,20,19,223976,4476,219500,11552.63158,223.8,49.03932082
NM_001252660,EPB41L2,17,16,161421,3679,157742,9858.875,216.4117647,42.87632509
NM_138633,AKAP7,3,2,33378,2536,30842,15421,845.3333333,12.16167192
NM_001199388,EPB41L2,18,17,223976,4028,219948,12938.11765,223.7777778,54.60476663
NM_005021,ENPP3,25,24,110110,3190,106920,4455,127.6,33.51724138
NM_004842,AKAP7,2,1,33378,2466,30912,30912,1233,12.53527981
NM_015529,MOXD1,12,11,105472,3051,102421,9311,254.25,33.5696493
NM_172105,EYA4,20,19,290765,5713,285052,15002.73684,285.65,49.89532645
NM_172103,EYA4,19,18,290765,5643,285122,15840.11111,297,50.52667021
NM_004100,EYA4,20,19,290765,5713,285052,15002.73684,285.65,49.89532645
NM_145176,SLC2A12,5,4,65072,5604,59468,14867,1120.8,10.61170592
NM_001143676,SGK1,14,13,148814,3215,145599,11199.92308,229.6428571,45.2874028
NM_017651,AHI1,28,27,213795,5591,208204,7711.259259,199.6785714,37.23913432
NM_005375,MYB,15,14,37859,3329,34530,2466.428571,221.9333333,10.37248423
NM_001134832,AHI1,23,22,109983,3681,106302,4831.909091,160.0434783,28.87856561
NM_001134831,AHI1,29,28,213795,5677,208118,7432.785714,195.7586207,36.65985556
NM_001134830,AHI1,27,26,213795,5528,208267,8010.269231,204.7407407,37.67492764
NM_001130173,MYB,16,15,37860,3694,34166,2277.733333,230.875,9.249052518
NM_001130172,MYB,15,14,37860,3321,34539,2467.071429,221.4,10.40018067
NM_001161660,MYB,14,13,37860,3224,34636,2664.307692,230.2857143,10.74317618
NM_001161659,MYB,14,13,37860,3218,34642,2664.769231,229.8571429,10.76507147
NM_001161658,MYB,16,15,37860,3646,34214,2280.933333,227.875,9.383982447
NM_001161657,MYB,14,13,37860,3074,34786,2675.846154,219.5714286,11.31620039
NM_001161656,MYB,16,15,37860,3685,34175,2278.333333,230.3125,9.274084125
NM_005923,MAP3K5,30,29,235471,5225,230246,7939.517241,174.1666667,44.0662201
NM_001198608,MAP7,18,17,183934,4530,179404,10553.17647,251.6666667,39.60353201
NM_000288,PEX7,10,9,91372,1492,89880,9986.666667,149.2,60.24128686
NM_001198619,MAP7,18,17,184431,4266,180165,10597.94118,237,42.23277075
NM_001198618,MAP7,18,17,184327,4393,179934,10584.35294,244.0555556,40.95925336
NM_001198617,MAP7,16,15,208540,4342,204198,13613.2,271.375,47.02855827
NM_001198616,MAP7,17,16,208540,4514,204026,12751.625,265.5294118,45.19849358
NM_001198615,MAP7,18,17,124596,4263,120333,7078.411765,236.8333333,28.22730471
NM_001198614,MAP7,19,18,184327,4534,179793,9988.5,238.6315789,39.65438906
NM_001198611,MAP7,17,16,183934,4418,179516,11219.75,259.8823529,40.63286555
NM_001198609,MAP7,18,17,183934,4554,179380,10551.76471,253,39.38954765
NM_003980,MAP7,18,17,208540,4626,203914,11994.94118,257,44.07998271
NM_181309,IL22RA2,6,5,29830,2807,27023,5404.6,467.8333333,9.627003919
NM_052962,IL22RA2,7,6,29830,2904,26926,4487.666667,414.8571429,9.272038567
NM_181310,IL22RA2,5,4,29830,2636,27194,6798.5,527.2,10.31638847
NM_020464,NHSL1,7,6,150489,7497,142992,23832,1071,19.07322929
NM_001242740,LOC100507462,4,3,48470,2716,45754,15251.33333,679,16.8460972
NM_001144060,NHSL1,8,7,77400,7018,70382,10054.57143,877.25,10.02878313
NM_001195037,ECT2L,21,20,107961,4364,103597,5179.85,207.8095238,23.73900092
NM_001077706,ECT2L,22,21,107961,4505,103456,4926.47619,204.7727273,22.96470588
NM_020340,KIAA1244,34,33,182749,14916,167833,5085.848485,438.7058824,11.25187718
NM_153235,TXLNB,10,9,52011,4694,47317,5257.444444,469.4,10.0803153
NM_001286372,VTA1,6,5,73788,3185,70603,14120.6,530.8333333,22.16734694
NM_001286371,VTA1,7,6,73788,3281,70507,11751.16667,468.7142857,21.48948491
NM_016485,VTA1,8,7,73788,3363,70425,10060.71429,420.375,20.941124
NM_001032394,GPR126,25,24,144349,6902,137447,5726.958333,276.08,19.91408287
NM_006734,HIVEP2,10,9,193736,9734,184002,20444.66667,973.4,18.90302034
NM_198569,GPR126,25,24,144349,6940,137409,5725.375,277.6,19.79956772
NM_020455,GPR126,26,25,144349,6987,137362,5494.48,268.7307692,19.65965364
NM_001286589,AIG1,4,3,129762,3461,126301,42100.33333,865.25,36.49263219
NM_001032395,GPR126,24,23,144349,6855,137494,5978,285.625,20.05747629
NM_001286588,AIG1,4,3,129762,3702,126060,42020,925.5,34.05186386
NM_006718,PLAGL1,7,6,68106,3413,64693,10782.16667,487.5714286,18.95487841
NM_001080954,PLAGL1,7,6,68106,3380,64726,10787.66667,482.8571429,19.14970414
NM_001100166,PHACTR2,12,11,223007,9303,213704,19427.63636,775.25,22.97151457
NM_001080953,PLAGL1,7,6,68106,3381,64725,10787.5,483,19.14374445
NM_001080952,PLAGL1,7,6,68106,3427,64679,10779.83333,489.5714286,18.87335862
NM_001080951,PLAGL1,8,7,124300,3287,121013,17287.57143,410.875,36.81563736
NM_001080956,PLAGL1,6,5,68106,2918,65188,13037.6,486.3333333,22.33995888
NM_001080955,PLAGL1,6,5,124300,2734,121566,24313.2,455.6666667,44.46452085
NM_032860,LTV1,11,10,20437,1825,18612,1861.2,165.9090909,10.19835616
NM_014721,PHACTR2,13,12,223007,9544,213463,17788.58333,734.1538462,22.36619866
NM_002656,PLAGL1,6,5,68106,2950,65156,13031.2,491.6666667,22.08677966
NM_001100165,PHACTR2,12,11,153222,9405,143817,13074.27273,783.75,15.29154705
NM_001100164,PHACTR2,13,12,153222,9646,143576,11964.66667,742,14.88451171
NM_003630,PEX3,12,11,39835,2784,37051,3368.272727,232,13.30854885
NM_001289037,PLAGL1,5,4,124301,2693,121608,30402,538.6,45.1570739
NM_001289038,PLAGL1,4,3,124301,2646,121655,40551.66667,661.5,45.97694633
NM_001289040,PLAGL1,6,5,124301,2720,121581,24316.2,453.3333333,44.69889706
NM_001289039,PLAGL1,5,4,124301,2750,121551,30387.75,550,44.20036364
NM_001289041,PLAGL1,6,5,68118,2930,65188,13037.6,488.3333333,22.24846416
NM_001289042,PLAGL1,5,4,124301,3081,121220,30305,616.2,39.34436871
NM_001289049,PLAGL1,6,5,68118,3351,64767,12953.4,558.5,19.32766338
NM_001289048,PLAGL1,7,6,68118,3407,64711,10785.16667,486.7142857,18.99354271
NM_001289047,PLAGL1,4,3,68118,3243,64875,21625,810.75,20.00462535
NM_001289046,PLAGL1,9,8,68118,3684,64434,8054.25,409.3333333,17.49022801
NM_001289045,PLAGL1,7,6,68118,3701,64417,10736.16667,528.7142857,17.40529587
NM_001289044,PLAGL1,6,5,124301,3156,121145,24229,526,38.3856147
NM_001289043,PLAGL1,7,6,124301,3206,121095,20182.5,458,37.77136619
NM_001278064,GRM1,8,7,408402,6715,401687,57383.85714,839.375,59.81935964
NM_001278067,GRM1,8,7,408402,6680,401722,57388.85714,835,60.13802395
NM_001278066,GRM1,9,8,408402,6766,401636,50204.5,751.7777778,59.36092226
NM_001042683,SHPRH,30,29,79290,7363,71927,2480.241379,245.4333333,9.768708407
NM_173082,SHPRH,30,29,79290,7028,72262,2491.793103,234.2666667,10.2820148
NM_001278065,GRM1,10,9,409818,6849,402969,44774.33333,684.9,58.83618046
NM_001018041,EPM2A,5,4,110553,1707,108846,27211.5,341.4,63.76449912
NM_005670,EPM2A,4,3,110553,3469,107084,35694.66667,867.25,30.86883828
NM_024694,ADGB,36,35,216463,5325,211138,6032.514286,147.9166667,39.65032864
NM_001127715,STXBP5,28,27,186120,9380,176740,6545.925926,335,18.84221748
NM_139244,STXBP5,26,25,186120,9270,176850,7074,356.5384615,19.0776699
NM_015278,SASH1,20,19,209457,7729,201728,10617.26316,386.45,26.10014232
NM_015093,TAB2,9,8,93313,4404,88909,11113.625,489.3333333,20.18823797
NM_005715,UST,8,7,329857,4399,325458,46494,549.875,73.98454194
NM_030949,PPP1R14C,4,3,107342,2215,105127,35042.33333,553.75,47.46139955
NM_001243328,RAET1E,5,4,12686,2104,10582,2645.5,420.8,5.029467681
NM_001252053,PCMT1,7,6,52838,1050,51788,8631.333333,150,49.32190476
NM_001252051,PCMT1,7,6,61728,1636,60092,10015.33333,233.7142857,36.73105134
NM_001252049,PCMT1,8,7,61728,1695,60033,8576.142857,211.875,35.41769912
NM_001252052,PCMT1,7,6,61728,1589,60139,10023.16667,227,37.84707363
NM_001252050,PCMT1,7,6,61728,1636,60092,10015.33333,233.7142857,36.73105134
NM_005389,PCMT1,8,7,61728,1742,59986,8569.428571,217.75,34.43513203
NM_025059,CCDC170,11,10,127155,5294,121861,12186.1,481.2727273,23.01870042
NM_015440,MTHFD1L,28,27,236210,3502,232708,8618.814815,125.0714286,66.45002856
NM_144497,AKAP12,3,2,33030,8233,24797,12398.5,2744.333333,3.011903316
NM_001286562,C6orf211,4,3,17843,2501,15342,5114,625.25,6.134346261
NM_001242768,MTHFD1L,28,27,235556,3189,232367,8606.185185,113.8928571,72.86516149
NM_001242767,MTHFD1L,28,27,236210,3505,232705,8618.703704,125.1785714,66.39229672
NM_005100,AKAP12,5,4,118562,8439,110123,27530.75,1687.8,13.04929494
NM_024573,C6orf211,5,4,17843,2608,15235,3808.75,521.6,5.841641104
NM_001122740,ESR1,9,8,295956,6365,289591,36198.875,707.2222222,45.4974077
NM_000125,ESR1,8,7,295596,6337,289259,41322.71429,792.125,45.64604703
NM_001122741,ESR1,9,8,297602,6322,291280,36410,702.4444444,46.07402721
NM_033071,SYNE1,146,145,515169,27585,487584,3362.648276,188.9383562,17.67569331
NM_182961,SYNE1,146,145,515717,27894,487823,3364.296552,191.0547945,17.4884563
NM_012419,RGS17,5,4,120359,1471,118888,29722,294.2,80.82121006
NM_001130699,IPCEF1,13,12,175599,6871,168728,14060.66667,528.5384615,24.55654199
NM_000914,OPRM1,4,3,93254,15283,77971,25990.33333,3820.75,5.101812471
NM_001008505,OPRM1,4,3,54111,1553,52558,17519.33333,388.25,33.84288474
NM_001008504,OPRM1,3,2,52838,2076,50762,25381,692,24.45183044
NM_001008503,OPRM1,4,3,207457,1477,205980,68660,369.25,139.4583615
NM_001145282,OPRM1,4,3,71044,1401,69643,23214.33333,350.25,49.70949322
NM_001145286,OPRM1,4,3,68243,1490,66753,22251,372.5,44.80067114
NM_001145285,OPRM1,4,3,68243,1339,66904,22301.33333,334.75,49.965646
NM_001145284,OPRM1,4,3,69609,2573,67036,22345.33333,643.25,26.05363389
NM_001145283,OPRM1,4,3,69609,2305,67304,22434.66667,576.25,29.19913232
NM_001145281,OPRM1,4,3,121860,14614,107246,35748.66667,3653.5,7.338579444
NM_001145280,OPRM1,4,3,121860,15073,106787,35595.66667,3768.25,7.084654681
NM_001285523,OPRM1,4,3,52838,1741,51097,17032.33333,435.25,29.34922458
NM_015553,IPCEF1,12,11,202284,6827,195457,17768.81818,568.9166667,28.62999854
NM_001130700,IPCEF1,12,11,202284,6830,195454,17768.54545,569.1666667,28.61698389
NM_001145279,OPRM1,6,5,121860,15644,106216,21243.2,2607.333333,6.789567885
NM_173515,CNKSR3,13,12,105322,3241,102081,8506.75,249.3076923,31.49676026
NM_001286189,SCAF8,22,21,100868,4930,95938,4568.47619,224.0909091,19.46004057
NM_001285522,OPRM1,2,1,93254,14407,78847,78847,7203.5,5.47282571
NM_001285524,OPRM1,5,4,93254,15179,78075,19518.75,3035.8,5.143619474
NM_001286188,SCAF8,21,20,100868,4965,95903,4795.15,236.4285714,19.31581067
NM_001286194,SCAF8,21,20,100868,4866,96002,4800.1,231.7142857,19.72914098
NM_001286199,SCAF8,21,20,100868,4918,95950,4797.5,234.1904762,19.5099634
NM_014892,SCAF8,20,19,100868,5208,95660,5034.736842,260.4,18.36789555
NM_016020,TFB1M,7,6,58355,2809,55546,9257.666667,401.2857143,19.7742969
NM_012454,TIAM2,26,25,167436,5942,161494,6459.76,228.5384615,27.17839111
NM_024630,ZDHHC14,9,8,292422,2796,289626,36203.25,310.6666667,103.5858369
NM_153746,ZDHHC14,9,8,292422,2751,289671,36208.875,305.6666667,105.2966194
NM_001178088,SYNJ2,26,25,82129,7357,74772,2990.88,282.9615385,10.16338181
NM_207118,GTF2H5,3,2,30999,7489,23510,11755,2496.333333,3.139270931
NM_001242395,SYTL3,16,15,114864,2708,112156,7477.066667,169.25,41.41654357
NM_001242384,SYTL3,19,18,114864,2523,112341,6241.166667,132.7894737,44.52675386
NM_001242394,SYTL3,18,17,114864,2914,111950,6585.294118,161.8888889,38.41798216
NM_020823,TMEM181,17,16,99001,5414,93587,5849.1875,318.4705882,17.28611008
NM_001009991,SYTL3,17,16,114864,2301,112563,7035.1875,135.3529412,48.91916558
NM_020245,TULP4,14,13,199166,11133,188033,14464.07692,795.2142857,16.8896973
NM_003898,SYNJ2,27,26,117321,7435,109886,4226.384615,275.3703704,14.77955615
NM_001007466,TULP4,13,12,199166,8631,190535,15877.91667,663.9230769,22.07565751
NM_032532,FNDC1,23,22,102713,6574,96139,4369.954545,285.826087,14.62412534
NM_001270533,WTAP,7,6,21923,1503,20420,3403.333333,214.7142857,13.58616101
NM_001270532,WTAP,7,6,22425,1635,20790,3465,233.5714286,12.71559633
NM_001270531,WTAP,8,7,28822,2120,26702,3814.571429,265,12.59528302
NM_152858,WTAP,6,5,22425,1854,20571,4114.2,309,11.09546926
NM_152857,WTAP,6,5,21923,1722,20201,4040.2,287,11.7311266
NM_004906,WTAP,8,7,29324,2252,27072,3867.428571,281.5,12.02131439
NM_005577,LPA,40,39,134894,6529,128365,3291.410256,163.225,19.66074437
NM_021977,SLC22A3,11,10,104208,3252,100956,10095.6,295.6363636,31.04428044
NM_153187,SLC22A1,10,9,36889,1803,35086,3898.444444,180.3,19.45978924
NM_003057,SLC22A1,11,10,36889,1917,34972,3497.2,174.2727273,18.24308816
NM_020133,AGPAT4,9,8,144052,7888,136164,17020.5,876.4444444,17.26217039
NM_206854,QKI,7,6,163955,15422,148533,24755.5,2203.142857,9.631241084
NM_006775,QKI,8,7,163955,9471,154484,22069.14286,1183.875,16.31126597
NM_206853,QKI,7,6,163955,14143,149812,24968.66667,2020.428571,10.59266068
NM_206855,QKI,6,5,163955,16368,147587,29517.4,2728,9.016801075
NM_001130690,PDE10A,22,21,334814,8217,326597,15552.2381,373.5,39.74650116
NM_001006932,RPS6KA2,22,21,452919,5757,447162,21293.42857,261.6818182,77.67274622
NM_021135,RPS6KA2,21,20,217874,5838,212036,10601.8,278,36.31997259
NM_030615,KIF25,9,8,27218,1519,25699,3212.375,168.7777778,16.91836735
NM_001040000,MLLT4,30,29,138124,7659,130465,4498.793103,255.3,17.03420812
NM_005355,KIF25,8,7,27218,1362,25856,3693.714286,170.25,18.98384728
NM_001207008,MLLT4,32,31,145031,7491,137540,4436.774194,234.09375,18.36069951
NM_001166412,SMOC2,13,12,226845,3130,223715,18642.91667,240.7692308,71.47444089
NM_022138,SMOC2,13,12,226845,3163,223682,18640.16667,243.3076923,70.71830541
NM_001286381,FAM120B,9,8,100351,3268,97083,12135.375,363.1111111,29.70716034
NM_001286380,FAM120B,11,10,111752,5218,106534,10653.4,474.3636364,20.41663473
NM_001286379,FAM120B,11,10,116370,5455,110915,11091.5,495.9090909,20.33272227
NM_032448,FAM120B,11,10,100351,5206,95145,9514.5,473.2727273,18.27602766
NM_020185,DUSP22,8,7,59300,1533,57767,8252.428571,191.625,37.68232224
NM_001286555,DUSP22,7,6,59300,3512,55788,9298,501.7142857,15.88496583
NM_148959,HUS1B,1,0,1027,1027,NA,NA,1027,NA
NM_033260,FOXQ1,1,0,2320,2320,NA,NA,2320,NA
NM_001452,FOXF2,2,1,5765,2189,3576,3576,1094.5,1.633622659
NM_001453,FOXC1,1,0,3450,3450,NA,NA,3450,NA
NM_001012418,MYLK4,13,12,87293,5773,81520,6793.333333,444.0769231,14.12090767
NM_152554,C6orf195,3,2,12328,2073,10255,5127.5,691,4.946936807
NM_030666,SERPINB1,7,6,9719,2669,7050,1175,381.2857143,2.641438741
NM_130395,WRNIP1,7,6,20315,2584,17731,2955.166667,369.1428571,6.861842105
NM_020135,WRNIP1,7,6,20315,2659,17656,2942.666667,379.8571429,6.640090259
NM_001271825,SERPINB6,7,6,14013,1564,12449,2074.833333,223.4285714,7.95971867
NM_001271824,SERPINB6,7,6,24008,1962,22046,3674.333333,280.2857143,11.23649337
NM_001271822,SERPINB6,7,6,23152,1480,21672,3612,211.4285714,14.64324324
NM_001195291,SERPINB6,8,7,24008,2056,21952,3136,257,10.6770428
NM_001271823,SERPINB6,7,6,22891,1578,21313,3552.166667,225.4285714,13.50633714
NM_004568,SERPINB6,7,6,24008,1920,22088,3681.333333,274.2857143,11.50416667
NM_004155,SERPINB9,7,6,16048,4157,11891,1981.833333,593.8571429,2.860476305
NM_003804,RIPK1,10,9,38365,3874,34491,3832.333333,387.4,8.903200826
NM_001128591,PSMG4,3,2,9140,824,8316,4158,274.6666667,10.09223301
NM_001128592,PSMG4,4,3,9140,942,8198,2732.666667,235.5,8.702760085
NM_001069,TUBB2A,4,3,3883,1623,2260,753.3333333,405.75,1.392483056
NM_001135750,PSMG4,2,1,4937,451,4486,4486,225.5,9.946784922
NM_178012,TUBB2B,4,3,3475,2023,1452,484,505.75,0.717745922
NM_183373,PXDC1,5,4,29412,2199,27213,6803.25,439.8,12.37517053
NM_012135,FAM50B,2,1,1921,1620,301,301,810,0.185802469
NM_206836,ECI2,10,9,19906,1413,18493,2054.777778,141.3,13.08775655
NM_006117,ECI2,10,9,19906,1403,18503,2055.888889,140.3,13.18816821
NM_001085401,C6orf201,6,5,51561,1657,49904,9980.8,276.1666667,30.11707906
NM_001166010,ECI2,10,9,19777,1415,18362,2040.222222,141.5,12.97667845
NM_173563,FAM217A,7,6,10866,2277,8589,1431.5,325.2857143,3.772068511
NM_001143971,CDYL,7,6,65554,3241,62313,10385.5,463,19.22647331
NM_001145115,PPP1R3G,1,0,1737,1737,NA,NA,1737,NA
NM_006638,RPP40,8,7,9019,1193,7826,1118,149.125,6.559932942
NM_001286133,RPP40,7,6,9019,1066,7953,1325.5,152.2857143,7.460600375
NM_001286132,RPP40,7,6,9019,1123,7896,1316,160.4285714,7.031166518
NM_001278710,NRN1,4,3,9607,1562,8045,2681.666667,390.5,5.150448143
NM_001278711,NRN1,4,3,6046,1801,4245,1415,450.25,2.357023876
NM_016588,NRN1,3,2,9402,2059,7343,3671.5,686.3333333,3.566294318
NM_004271,LY86,5,4,66284,884,65400,16350,176.8,73.98190045
NM_003144,SSR1,8,7,32255,9866,22389,3198.428571,1233.25,2.269308737
NM_031480,RIOK1,17,16,28210,2494,25716,1607.25,146.7058824,10.31114675
NM_153005,RIOK1,10,9,15392,1797,13595,1510.555556,179.7,7.565386756
NM_001008844,DSP,24,23,45078,7957,37121,1613.956522,331.5416667,4.665200452
NM_004415,DSP,24,23,45078,9754,35324,1535.826087,406.4166667,3.62148862
NM_030810,TXNDC5,10,9,29566,3241,26325,2925,324.1,8.122493058
NM_001145549,TXNDC5,10,9,28829,3205,25624,2847.111111,320.5,7.9950078
NM_201280,BLOC1S5,5,4,50849,2689,48160,12040,537.8,17.91000372
NM_001199322,BLOC1S5,6,5,50849,2793,48056,9611.2,465.5,17.20587182
NM_001199323,BLOC1S5,4,3,50849,2558,48291,16097,639.5,18.87842064
NM_001135650,EEF1E1,4,3,29237,613,28624,9541.333333,153.25,46.6949429
NM_004280,EEF1E1,4,3,23202,1098,22104,7368,274.5,20.13114754
NM_015948,SLC35B3,11,10,22502,2233,20269,2026.9,203,9.077026422
NM_001142541,SLC35B3,11,10,22502,1871,20631,2063.1,170.0909091,11.02672368
NM_003220,TFAP2A,7,6,18556,3307,15249,2541.5,472.4285714,4.61112791
NM_001042425,TFAP2A,7,6,22883,3157,19726,3287.666667,451,6.248337029
NM_001032280,TFAP2A,7,6,15693,3815,11878,1979.666667,545,3.113499345
NM_001165258,TMEM14C,6,5,8216,1193,7023,1404.6,198.8333333,5.886839899
NM_016462,TMEM14C,6,5,8216,1179,7037,1407.4,196.5,5.968617472
NM_017906,PAK1IP1,10,9,14784,1505,13279,1475.444444,150.5,8.823255814
NM_001145020,C6orf52,5,4,23190,626,22564,5641,125.2,36.04472843
NM_005906,MAK,14,13,75834,3897,71937,5533.615385,278.3571429,18.4595843
NM_001286489,TMEM14B,5,4,12016,1198,10818,2704.5,239.6,9.030050083
NM_001286484,TMEM14B,5,4,9224,903,8321,2080.25,180.6,9.214839424
NM_001242385,MAK,13,12,75834,3797,72037,6003.083333,292.0769231,18.97208322
NM_001242957,MAK,15,14,75834,3973,71861,5132.928571,264.8666667,18.08733954
NM_001286488,TMEM14B,6,5,12016,1301,10715,2143,216.8333333,8.235972329
NM_001127711,TMEM14B,5,4,9224,878,8346,2086.5,175.6,9.505694761
NM_030969,TMEM14B,6,5,9224,981,8243,1648.6,163.5,8.402650357
NM_001040274,SYCP2L,30,29,87479,3159,84320,2907.586207,105.3,26.69199114
NM_001135575,SMIM13,2,1,44705,4693,40012,40012,2346.5,8.525889623
NM_207582,ERVFRD-1,2,1,9351,3306,6045,6045,1653,1.828493648
NM_182966,NEDD9,3,2,32311,1303,31008,15504,434.3333333,23.79739064
NM_006403,NEDD9,7,6,49386,4543,44843,7473.833333,649,9.870790227
NM_001271033,NEDD9,6,5,49386,4095,45291,9058.2,682.5,11.06007326
NM_001100829,TMEM170B,3,2,45299,8416,36883,18441.5,2805.333333,4.382485741
NM_032744,ADTRP,6,5,65394,1810,63584,12716.8,301.6666667,35.12928177
NM_001143948,ADTRP,7,6,65394,1865,63529,10588.16667,266.4285714,34.06380697
NM_001955,EDN1,5,4,6900,2105,4795,1198.75,421,2.277909739
NM_001168319,EDN1,5,4,6900,2102,4798,1199.5,420.4,2.282588011
NM_001258457,TBC1D7,7,6,23633,1036,22597,3766.166667,148,21.81177606
NM_016495,TBC1D7,8,7,23633,1335,22298,3185.428571,166.875,16.70262172
NM_001242698,RP1-257A7.4,5,4,16293,2310,13983,3495.75,462,6.053246753
NM_001143966,TBC1D7,7,6,23633,1093,22540,3756.666667,156.1428571,20.6221409
NM_001143965,TBC1D7,8,7,23633,1175,22458,3208.285714,146.875,19.11319149
NM_001143964,TBC1D7,8,7,23633,1315,22318,3188.285714,164.375,16.97186312
NM_001242629,GFOD1,2,1,18369,2363,16006,16006,1181.5,6.77359289
NM_031244,SIRT5,10,9,31211,2420,28791,3199,242,11.89710744
NM_001242827,SIRT5,9,8,40631,4391,36240,4530,487.8888889,8.253245274
NM_016167,NOL7,8,7,5570,882,4688,669.7142857,110.25,5.315192744
NM_012241,SIRT5,10,9,40533,4548,35985,3998.333333,454.8,7.912269129
NM_001193267,SIRT5,9,8,40631,4471,36160,4520,496.7777778,8.087676135
NM_001031713,MCUR1,9,8,28013,5480,22533,2816.625,608.8888889,4.111861314
NM_152737,RNF182,3,2,55144,3416,51728,25864,1138.666667,15.14285714
NM_001165034,RNF182,3,2,55565,3386,52179,26089.5,1128.666667,15.41021855
NM_001165033,RNF182,2,1,54818,3277,51541,51541,1638.5,15.72810497
NM_001165032,RNF182,4,3,55144,3500,51644,17214.66667,875,14.75542857
NM_001040280,CD83,5,4,19285,2479,16806,4201.5,495.8,6.779346511
NM_001251901,CD83,5,4,19663,2311,17352,4338,462.2,7.508437906
NM_004233,CD83,5,4,19285,2482,16803,4200.75,496.4,6.769943594
NM_013262,MYLIP,7,6,19163,3078,16085,2680.833333,439.7142857,5.225795971
NM_001190766,STMND1,5,4,29116,1327,27789,6947.25,265.4,20.9412208
NM_001143941,RBM24,4,3,11806,2452,9354,3118,613,3.814845024
NM_153020,RBM24,3,2,11169,2399,8770,4385,799.6666667,3.655689871
NM_001143942,RBM24,4,3,12292,2468,9824,3274.666667,617,3.980551053
NM_016255,FAM8A1,5,4,11434,4750,6684,1671,950,1.407157895
NM_198586,NHLRC1,1,0,2135,2135,NA,NA,2135,NA
NM_000367,TPMT,9,8,26831,3256,23575,2946.875,361.7777778,7.240479115
NM_001134709,DEK,10,9,40401,2779,37622,4180.222222,277.9,13.5379633
NM_003472,DEK,11,10,40401,2882,37519,3751.9,262,13.01839001
NM_182757,RNF144B,8,7,81526,5044,76482,10926,630.5,15.1629659
NM_001546,ID4,3,2,4832,3879,953,476.5,1293,0.245681877
NM_003107,SOX4,1,0,4879,4879,NA,NA,4879,NA
NM_000948,PRL,5,4,10259,1366,8893,2223.25,273.2,6.510248902
NM_001163558,PRL,6,5,15611,1039,14572,2914.4,173.1666667,14.02502406
NM_138574,HDGFL1,1,0,1074,1074,NA,NA,1074,NA
NM_080723,NRSN1,4,3,21345,2412,18933,6311,603,7.849502488
NM_181337,KAAG1,1,0,1383,1383,NA,NA,1383,NA
NM_001503,GPLD1,25,24,63790,5857,57933,2413.875,234.28,9.89124125
NM_020662,MRS2,11,10,23288,3982,19306,1930.6,362,4.848317428
NM_001286266,MRS2,9,8,23288,3830,19458,2432.25,425.5555556,5.080417755
NM_001286264,MRS2,12,11,23288,3992,19296,1754.181818,332.6666667,4.833667335
NM_001286265,MRS2,10,9,20573,1799,18774,2086,179.9,10.43579767
NM_001252328,KIAA0319,17,16,39125,5332,33793,2112.0625,313.6470588,6.337771943
NM_018473,ACOT13,3,2,38034,4107,33927,16963.5,1369,8.260774288
NM_030939,C6orf62,5,4,14315,2477,11838,2959.5,495.4,4.779168349
NM_016614,TDP2,7,6,16912,1932,14980,2496.666667,276,7.753623188
NM_001160094,ACOT13,4,3,38034,4397,33637,11212.33333,1099.25,7.649988629
NM_015895,GMNN,7,6,11168,1274,9894,1649,182,7.766091052
NM_001282492,C6orf229,2,1,1577,823,754,754,411.5,0.916160389
NM_001251991,GMNN,7,6,10686,1050,9636,1606,150,9.177142857
NM_001251990,GMNN,7,6,11168,1066,10102,1683.666667,152.2857143,9.476547842
NM_001251989,GMNN,7,6,11168,1142,10026,1671,163.1428571,8.779334501
NM_001286447,FAM65B,14,13,38000,3634,34366,2643.538462,259.5714286,9.456796918
NM_015864,FAM65B,14,13,38000,2458,35542,2734,175.5714286,14.45972335
NM_005495,SLC17A4,12,11,26478,3612,22866,2078.727273,301,6.330564784
NM_170745,HIST1H2AA,1,0,501,501,NA,NA,501,NA
NM_170610,HIST1H2BA,1,0,438,438,NA,NA,438,NA
NM_001286121,SLC17A4,13,12,26478,3713,22765,1897.083333,285.6153846,6.131160786
NM_006632,SLC17A3,12,11,29145,1586,27559,2505.363636,132.1666667,17.37641866
NM_001098486,SLC17A3,13,12,29145,1821,27324,2277,140.0769231,15.00494234
NM_001286125,SLC17A2,10,9,13125,1978,11147,1238.555556,197.8,5.635490394
NM_001286123,SLC17A2,11,10,13125,2092,11033,1103.3,190.1818182,5.273900574
NM_005835,SLC17A2,11,10,17972,2394,15578,1557.8,217.6363636,6.507101086
NM_003513,HIST1H2AB,1,0,478,478,NA,NA,478,NA
NM_003537,HIST1H3B,1,0,473,473,NA,NA,473,NA
NM_003531,HIST1H3C,1,0,460,460,NA,NA,460,NA
NM_003529,HIST1H3A,1,0,470,470,NA,NA,470,NA
NM_003544,HIST1H4B,1,0,358,358,NA,NA,358,NA
NM_003538,HIST1H4A,1,0,373,373,NA,NA,373,NA
NM_021062,HIST1H2BB,1,0,432,432,NA,NA,432,NA
NM_006355,TRIM38,8,7,24642,5637,19005,2715,704.625,3.371474188
NM_005319,HIST1H1C,1,0,733,733,NA,NA,733,NA
NM_005325,HIST1H1A,1,0,782,782,NA,NA,782,NA
NM_139008,HFE,5,4,7962,1921,6041,1510.25,384.2,3.144716294
NM_003526,HIST1H2BC,1,0,439,439,NA,NA,439,NA
NM_003523,HIST1H2BE,1,0,436,436,NA,NA,436,NA
NM_003512,HIST1H2AC,1,0,547,547,NA,NA,547,NA
NM_139007,HFE,5,4,7962,1963,5999,1499.75,392.6,3.056036679
NM_139003,HFE,5,4,7962,1909,6053,1513.25,381.8,3.170770037
NM_139004,HFE,5,4,7962,1951,6011,1502.75,390.2,3.080984111
NM_000410,HFE,6,5,7962,2228,5734,1146.8,371.3333333,2.573608618
NM_003522,HIST1H2BF,1,0,431,431,NA,NA,431,NA
NM_003545,HIST1H4E,1,0,378,378,NA,NA,378,NA
NM_003542,HIST1H4C,1,0,391,391,NA,NA,391,NA
NM_003539,HIST1H4D,1,0,368,368,NA,NA,368,NA
NM_138720,HIST1H2BD,2,1,13229,815,12414,12414,407.5,15.23190184
NM_139011,HFE,3,2,7962,1409,6553,3276.5,469.6666667,4.650816182
NM_139010,HFE,4,3,7962,1686,6276,2092,421.5,3.722419929
NM_139009,HFE,6,5,7962,2159,5803,1160.6,359.8333333,2.687818434
NM_021063,HIST1H2BD,1,0,488,488,NA,NA,488,NA
NM_139006,HFE,6,5,7962,2186,5776,1155.2,364.3333333,2.642268984
NM_005323,HIST1H1T,1,0,726,726,NA,NA,726,NA
NM_005321,HIST1H1E,1,0,786,786,NA,NA,786,NA
NM_003530,HIST1H3D,2,1,2511,923,1588,1588,461.5,1.720476706
NM_021065,HIST1H2AD,1,0,511,511,NA,NA,511,NA
NM_003547,HIST1H4G,1,0,368,368,NA,NA,368,NA
NM_003525,HIST1H2BI,1,0,438,438,NA,NA,438,NA
NM_003524,HIST1H2BH,1,0,426,426,NA,NA,426,NA
NM_003518,HIST1H2BG,1,0,446,446,NA,NA,446,NA
NM_003534,HIST1H3G,1,0,468,468,NA,NA,468,NA
NM_003532,HIST1H3E,1,0,463,463,NA,NA,463,NA
NM_003543,HIST1H4H,1,0,375,375,NA,NA,375,NA
NM_003540,HIST1H4F,1,0,369,369,NA,NA,369,NA
NM_021018,HIST1H3F,1,0,467,467,NA,NA,467,NA
NM_021052,HIST1H2AE,1,0,565,565,NA,NA,565,NA
NM_005320,HIST1H1D,1,0,778,778,NA,NA,778,NA
NM_006995,BTN2A2,8,7,11773,3596,8177,1168.142857,449.5,2.273915462
NM_006994,BTN3A3,11,10,12945,3013,9932,993.2,273.9090909,3.296382343
NM_007049,BTN2A1,8,7,11751,2965,8786,1255.142857,370.625,2.963237774
NM_007048,BTN3A1,10,9,12981,3444,9537,1059.666667,344.4,2.769163763
NM_001197247,BTN3A2,11,10,13163,4126,9037,903.7,375.0909091,2.190256907
NM_001197237,BTN2A2,8,7,11663,3618,8045,1149.285714,452.25,2.223604201
NM_001145009,BTN3A1,10,9,12981,4201,8780,975.5555556,420.1,2.089978577
NM_001145008,BTN3A1,10,9,12981,3288,9693,1077,328.8,2.947992701
NM_007047,BTN3A2,11,10,13163,3834,9329,932.9,348.5454545,2.433229004
NM_001197249,BTN3A2,10,9,13163,3743,9420,1046.666667,374.3,2.516697836
NM_001197240,BTN2A2,7,6,11773,3466,8307,1384.5,495.1428571,2.396710906
NM_001197239,BTN2A2,6,5,11773,2964,8809,1761.8,494,2.971997301
NM_001197238,BTN2A2,8,7,11778,1796,9982,1426,224.5,5.557906459
NM_001197233,BTN2A1,7,6,11751,2852,8899,1483.166667,407.4285714,3.12026648
NM_197974,BTN3A3,10,9,12945,2920,10025,1113.888889,292,3.433219178
NM_194441,BTN3A1,10,9,12981,3738,9243,1027,373.8,2.472712681
NM_001242803,BTN3A3,6,5,12945,2353,10592,2118.4,392.1666667,4.501487463
NM_001197248,BTN3A2,9,8,13163,3681,9482,1185.25,409,2.575930454
NM_001197246,BTN3A2,9,8,10144,2845,7299,912.375,316.1111111,2.565553603
NM_078476,BTN2A1,8,7,11751,3194,8557,1222.428571,399.25,2.679085786
NM_181531,BTN2A2,7,6,11773,3247,8526,1421,463.8571429,2.625808439
NM_001732,BTN1A1,7,6,9159,2858,6301,1050.166667,408.2857143,2.204688593
NM_006353,HMGN4,2,1,8594,1970,6624,6624,985,3.362436548
NM_013375,ABT1,3,2,3108,2266,842,421,755.3333333,0.371579876
NM_024639,ZNF322,4,3,25371,4821,20550,6850,1205.25,4.26260112
NM_001242799,ZNF322,3,2,25371,4731,20640,10320,1577,4.362714014
NM_001242798,ZNF322,3,2,25371,4750,20621,10310.5,1583.333333,4.341263158
NM_001242797,ZNF322,5,4,25371,4897,20474,5118.5,979.4,4.180927098
NM_080596,HIST1H2AH,1,0,482,482,NA,NA,482,NA
NM_080593,HIST1H2BK,2,1,8567,841,7726,7726,420.5,9.186682521
NM_003495,HIST1H4I,1,0,371,371,NA,NA,371,NA
NM_021058,HIST1H2BJ,1,0,482,482,NA,NA,482,NA
NM_021064,HIST1H2AG,1,0,499,499,NA,NA,499,NA
NM_005865,PRSS16,12,11,8899,2877,6022,547.4545455,239.75,2.09315259
NM_033482,POM121L2,1,0,3171,3171,NA,NA,3171,NA
NM_001076781,ZNF391,3,2,12705,1599,11106,5553,533,6.945590994
NM_007149,ZNF184,6,5,22378,3108,19270,3854,518,6.2001287
NM_003521,HIST1H2BM,1,0,447,447,NA,NA,447,NA
NM_003519,HIST1H2BL,1,0,454,454,NA,NA,454,NA
NM_003509,HIST1H2AI,1,0,470,470,NA,NA,470,NA
NM_003536,HIST1H3H,1,0,474,474,NA,NA,474,NA
NM_021066,HIST1H2AJ,1,0,440,440,NA,NA,440,NA
NM_021968,HIST1H4J,1,0,357,357,NA,NA,357,NA
NM_003527,HIST1H2BO,1,0,468,468,NA,NA,468,NA
NM_003520,HIST1H2BN,1,0,450,450,NA,NA,450,NA
NM_003514,HIST1H2AM,1,0,488,488,NA,NA,488,NA
NM_003511,HIST1H2AL,1,0,471,471,NA,NA,471,NA
NM_003510,HIST1H2AK,1,0,461,461,NA,NA,461,NA
NM_033057,OR2B2,1,0,1213,1213,NA,NA,1213,NA
NM_003535,HIST1H3J,1,0,479,479,NA,NA,479,NA
NM_003533,HIST1H3I,1,0,478,478,NA,NA,478,NA
NM_003541,HIST1H4K,1,0,355,355,NA,NA,355,NA
NM_003546,HIST1H4L,1,0,365,365,NA,NA,365,NA
NM_005322,HIST1H1B,1,0,791,791,NA,NA,791,NA
NM_012367,OR2B6,1,0,943,943,NA,NA,943,NA
NM_025231,ZSCAN16,4,3,5471,1279,4192,1397.333333,319.75,3.277560594
NM_001278122,ZKSCAN8,6,5,17564,7424,10140,2028,1237.333333,1.365840517
NM_001278119,ZKSCAN8,7,6,17564,7505,10059,1676.5,1072.142857,1.340306462
NM_006298,ZKSCAN8,6,5,17564,7410,10154,2030.8,1235,1.370310391
NM_001278121,ZKSCAN8,7,6,17263,7452,9811,1635.166667,1064.571429,1.316559313
NM_001243242,ZSCAN31,4,3,11639,2675,8964,2988,668.75,3.351028037
NM_001007531,NKAPL,1,0,1663,1663,NA,NA,1663,NA
NM_032507,PGBD1,7,6,21014,3122,17892,2982,446,5.730941704
NM_030899,ZSCAN31,4,3,11639,3042,8597,2865.666667,760.5,2.826101249
NM_006299,ZSCAN9,4,3,8237,1686,6551,2183.666667,421.5,3.885527877
NM_001199480,ZSCAN9,4,3,8237,1650,6587,2195.666667,412.5,3.992121212
NM_001199479,ZSCAN9,5,4,8237,1840,6397,1599.25,368,3.476630435
NM_152736,ZSCAN26,4,3,11214,2436,8778,2926,609,3.603448276
NM_001287421,ZSCAN26,4,3,10865,2327,8538,2846,581.75,3.669101848
NM_001243244,ZSCAN31,3,2,11639,2565,9074,4537,855,3.537621832
NM_001243243,ZSCAN31,3,2,11398,2576,8822,4411,858.6666667,3.424689441
NM_001243241,ZSCAN31,4,3,11639,2978,8661,2887,744.5,2.908327737
NM_001135216,ZSCAN31,4,3,11398,3053,8345,2781.666667,763.25,2.733377006
NM_019110,ZKSCAN4,5,4,7514,2291,5223,1305.75,458.2,2.279790485
NM_001023560,ZSCAN26,4,3,11214,2840,8374,2791.333333,710,2.948591549
NM_001184743,PGBD1,7,6,21014,3142,17872,2978.666667,448.8571429,5.688096754
NM_001111039,ZSCAN26,4,3,11214,2837,8377,2792.333333,709.25,2.952767007
NM_001287422,ZSCAN26,2,1,11214,2235,8979,8979,1117.5,4.017449664
NM_001242894,ZKSCAN3,7,6,19265,4849,14416,2402.666667,692.7142857,2.97298412
NM_024493,ZKSCAN3,6,5,19265,4731,14534,2906.8,788.5,3.072077785
NM_001242895,ZKSCAN3,5,4,19265,4266,14999,3749.75,853.2,3.515939991
NM_001012455,ZSCAN23,4,3,10849,3165,7684,2561.333333,791.25,2.427804107
NM_001163391,ZSCAN12,4,3,10819,3523,7296,2432,880.75,2.070962248
NM_052923,SCAND3,4,3,15707,4881,10826,3608.666667,1220.25,2.217988117
NM_001509,GPX5,5,4,8941,1457,7484,1871,291.4,5.136582018
NM_003996,GPX5,4,3,8941,1338,7603,2534.333333,334.5,5.682361734
NM_182701,GPX6,5,4,12499,1717,10782,2695.5,343.4,6.279557368
NM_006510,TRIM27,8,7,20991,2977,18014,2573.428571,372.125,6.051058112
NM_030903,OR2W1,1,0,964,964,NA,NA,964,NA
NM_001195202,LOC100129636,6,5,40519,1068,39451,7890.2,178,36.93913858
NM_001005226,OR2B3,1,0,1107,1107,NA,NA,1107,NA
NM_001005216,OR2J3,1,0,1076,1076,NA,NA,1076,NA
NM_030905,OR2J2,1,0,1042,1042,NA,NA,1042,NA
NM_030959,OR12D3,1,0,1870,1870,NA,NA,1870,NA
NM_030876,OR5V1,1,0,1049,1049,NA,NA,1049,NA
NM_030946,OR14J1,1,0,967,967,NA,NA,967,NA
NM_013937,OR11A1,1,0,2230,2230,NA,NA,2230,NA
NM_052967,MAS1L,1,0,1138,1138,NA,NA,1138,NA
NM_030883,OR2H1,3,2,5871,2999,2872,1436,999.6666667,0.957652551
NM_013936,OR12D2,1,0,1034,1034,NA,NA,1034,NA
NM_013941,OR10C1,1,0,1040,1040,NA,NA,1040,NA
NM_007160,OR2H2,1,0,1064,1064,NA,NA,1064,NA
NM_021903,GABBR1,18,17,26002,4305,21697,1276.294118,239.1666667,5.039953542
NM_006398,UBD,2,1,4315,992,3323,3323,496,3.349798387
NM_001470,GABBR1,23,22,30959,4560,26399,1199.954545,198.2608696,5.789254386
NM_021904,GABBR1,22,21,30959,4373,26586,1266,198.7727273,6.079579236
NM_002433,MOG,8,7,15393,1918,13475,1925,239.75,7.025547445
NM_001098479,HLA-F,7,6,3958,1581,2377,396.1666667,225.8571429,1.503478811
NM_206814,MOG,7,6,15393,1819,13574,2262.333333,259.8571429,7.462341946
NM_206811,MOG,8,7,15393,1849,13544,1934.857143,231.125,7.325040562
NM_206809,MOG,8,7,15393,2168,13225,1889.285714,271,6.100092251
NM_001008229,MOG,6,5,15393,1778,13615,2723,296.3333333,7.657480315
NM_001008228,MOG,8,7,15393,2099,13294,1899.142857,262.375,6.333492139
NM_001170418,MOG,7,6,15393,1750,13643,2273.833333,250,7.796
NM_206812,MOG,7,6,15393,2050,13343,2223.833333,292.8571429,6.508780488
NM_206810,MOG,7,6,15393,1800,13593,2265.5,257.1428571,7.551666667
NM_018950,HLA-F,7,6,3188,1291,1897,316.1666667,184.4285714,1.469403563
NM_001109809,ZFP57,4,3,4764,1874,2890,963.3333333,468.5,1.542155816
NM_001098478,HLA-F,6,5,3188,1014,2174,434.8,169,2.143984221
NM_001207043,LOC554223,3,2,5903,1288,4615,2307.5,429.3333333,3.583074534
NM_002127,HLA-G,8,7,4145,1586,2559,365.5714286,198.25,1.613493064
NM_002116,HLA-A,8,7,3416,1619,1797,256.7142857,202.375,1.10994441
NM_001242758,HLA-A,8,7,3416,1619,1797,256.7142857,202.375,1.10994441
NM_021959,PPP1R11,3,2,3178,1665,1513,756.5,555,0.908708709
NM_007028,TRIM31,9,8,10195,2036,8159,1019.875,226.2222222,4.007367387
NM_025236,RNF39,4,3,5587,2174,3413,1137.666667,543.5,1.569917203
NM_001286633,TRIM40,6,5,12629,2092,10537,2107.4,348.6666667,5.036806883
NM_001278785,ZNRD1,5,4,3671,758,2913,728.25,151.6,3.843007916
NM_052828,TRIM10,8,7,8990,3014,5976,853.7142857,376.75,1.98274718
NM_006778,TRIM10,7,6,8990,3552,5438,906.3333333,507.4285714,1.530968468
NM_170769,RNF39,5,4,5585,1975,3610,902.5,395,1.827848101
NM_170783,ZNRD1,4,3,3671,882,2789,929.6666667,220.5,3.162131519
NM_014596,ZNRD1,5,4,3671,767,2904,726,153.4,3.786179922
NM_033229,TRIM15,7,6,9492,2231,7261,1210.166667,318.7142857,3.254594352
NM_001278786,ZNRD1,5,4,3671,782,2889,722.25,156.4,3.694373402
NM_138700,TRIM40,5,4,12004,1922,10082,2520.5,384.4,5.245577523
NM_003449,TRIM26,10,9,29041,3616,25425,2825,361.6,7.03125
NM_001242783,TRIM26,9,8,29041,3394,25647,3205.875,377.1111111,7.556570418
NM_024839,RPP21,5,4,1731,561,1170,292.5,112.2,2.085561497
NM_001199121,RPP21,5,4,1731,568,1163,290.75,113.6,2.047535211
NM_001199119,TRIM39-RPP21,10,9,17549,1577,15972,1774.666667,157.7,10.12809131
NM_001199120,RPP21,5,4,1731,585,1146,286.5,117,1.958974359
NM_021253,TRIM39,9,8,16887,3348,13539,1692.375,372,4.04390681
NM_172016,TRIM39,8,7,16500,3571,12929,1847,446.375,3.620554467
NM_001077497,PRR3,3,2,7989,3344,4645,2322.5,1114.666667,1.389055024
NM_005275,GNL1,12,11,16218,7921,8297,754.2727273,660.0833333,1.047468754
NM_025263,PRR3,4,3,7989,3408,4581,1527,852,1.344190141
NM_005516,HLA-E,8,7,4801,2670,2131,304.4285714,333.75,0.798127341
NM_024909,ATAT1,11,10,17837,2172,15665,1566.5,197.4545455,7.212246777
NM_001109938,C6orf136,6,5,6173,1442,4731,946.2,240.3333333,3.280859917
NM_003587,DHX16,20,19,19936,3481,16455,866.0526316,174.05,4.727089917
NM_001161376,C6orf136,6,5,6173,1985,4188,837.6,330.8333333,2.109823678
NM_007243,NRM,5,4,3375,1760,1615,403.75,352,0.917613636
NM_133471,PPP1R18,3,2,11508,4602,6906,3453,1534,1.50065189
NM_145029,C6orf136,5,4,6173,1039,5134,1283.5,207.8,4.941289702
NM_014046,MRPS18B,7,6,8690,1541,7149,1191.5,220.1428571,4.639195328
NM_002714,PPP1R10,20,19,16909,4608,12301,647.4210526,230.4,2.669487847
NM_001254952,ATAT1,10,9,17835,2100,15735,1748.333333,210,7.492857143
NM_001270708,NRM,3,2,3084,1406,1678,839,468.6666667,1.193456615
NM_001270710,NRM,2,1,3084,1186,1898,1898,593,1.600337268
NM_001270709,NRM,3,2,3084,1384,1700,850,461.3333333,1.228323699
NM_001270707,NRM,4,3,3084,1580,1504,501.3333333,395,0.951898734
NM_001134870,PPP1R18,4,3,10929,2957,7972,2657.333333,739.25,2.695975651
NM_001164239,DHX16,20,19,19936,3160,16776,882.9473684,158,5.308860759
NM_001031722,ATAT1,13,12,19937,1739,18198,1516.5,133.7692308,10.46463485
NM_005803,FLOT1,13,12,14944,1843,13101,1091.75,141.7692308,7.108518719
NM_003897,IER3,2,1,1353,1242,111,111,621,0.089371981
NM_178014,TUBB,4,3,5040,2487,2553,851,621.75,1.026537998
NM_001954,DDR1,19,18,16074,3843,12231,679.5,202.2631579,3.182669789
NM_001202523,DDR1,17,16,15178,3802,11376,711,223.6470588,2.992109416
NM_001202522,DDR1,15,14,11470,3221,8249,589.2142857,214.7333333,2.561005899
NM_020442,VARS2,30,29,12255,3637,8618,297.1724138,121.2333333,2.369535331
NM_080870,DPCR1,3,2,13223,5289,7934,3967,1763,1.500094536
NM_001202521,DDR1,15,14,11470,3303,8167,583.3571429,220.2,2.472600666
NM_001167734,VARS2,30,29,12129,3641,8488,292.6896552,121.3666667,2.331227685
NM_013994,DDR1,17,16,11470,3679,7791,486.9375,216.4117647,2.117695026
NM_013993,DDR1,19,18,15608,3880,11728,651.5555556,204.2105263,3.022680412
NM_205854,SFTA2,3,2,827,457,370,185,152.3333333,0.809628009
NM_001517,GTF2H4,14,13,5905,1730,4175,321.1538462,123.5714286,2.413294798
NM_001167733,VARS2,29,28,12255,3408,8847,315.9642857,117.5172414,2.595950704
NM_001198815,MUC22,5,4,29452,6010,23442,5860.5,1202,3.900499168
NM_001010909,MUC21,3,2,6192,3659,2533,1266.5,1219.666667,0.692265646
NM_007109,TCF19,4,3,5691,3310,2381,793.6666667,827.5,0.719335347
NM_001173531,POU5F1,5,4,2835,1584,1251,312.75,316.8,0.789772727
NM_014070,C6orf15,2,1,1334,1138,196,196,569,0.172231986
NM_001285986,POU5F1,3,2,2835,2293,542,271,764.3333333,0.236371566
NM_001285987,POU5F1,4,3,2835,2069,766,255.3333333,517.25,0.370227163
NM_014069,PSORS1C2,2,1,1818,1154,664,664,577,0.575389948
NM_014068,PSORS1C1,6,5,25263,914,24349,4869.8,152.3333333,26.64004376
NM_203289,POU5F1,4,3,2835,2069,766,255.3333333,517.25,0.370227163
NM_002701,POU5F1,5,4,6358,1425,4933,1233.25,285,3.461754386
NM_001264,CDSN,2,1,5389,2585,2804,2804,1292.5,1.084719536
NM_001105564,CCHCR1,18,17,15352,2976,12376,728,165.3333333,4.158602151
NM_019052,CCHCR1,18,17,15801,2643,13158,774,146.8333333,4.978433598
NM_001077511,TCF19,4,3,5691,3064,2627,875.6666667,766,0.857375979
NM_001105563,CCHCR1,18,17,15352,2868,12484,734.3529412,159.3333333,4.352859135
NM_005514,HLA-B,8,7,3342,1580,1762,251.7142857,197.5,1.115189873
NM_002117,HLA-C,8,7,3389,1594,1795,256.4285714,199.25,1.126097867
NM_001243042,HLA-C,8,7,3389,1594,1795,256.4285714,199.25,1.126097867
NM_001289152,MICA,6,5,15533,2268,13265,2653,378,5.848765432
NM_001289153,MICA,6,5,15533,2248,13285,2657,374.6666667,5.909697509
NM_001289154,MICA,6,5,15533,2076,13457,2691.4,346,6.482177264
NM_000247,MICA,7,6,11750,1401,10349,1724.833333,200.1428571,7.386866524
NM_001177519,MICA,6,5,11750,1404,10346,2069.2,234,7.368945869
NM_032955,AIF1,3,2,1011,506,505,252.5,168.6666667,0.998023715
NM_001159740,LTA,4,3,2226,1465,761,253.6666667,366.25,0.519453925
NM_001204078,ATP6V1G2,3,2,2399,1486,913,456.5,495.3333333,0.614401077
NM_205839,LST1,5,4,2732,769,1963,490.75,153.8,2.5526658
NM_130463,ATP6V1G2,3,2,2399,1606,793,396.5,535.3333333,0.49377335
NM_205840,LST1,3,2,1711,607,1104,552,202.3333333,1.81878089
NM_001011700,MCCD1,2,1,1271,711,560,560,355.5,0.787623066
NM_001145466,NCR3,4,3,4104,1113,2991,997,278.25,2.687331536
NM_001166538,LST1,3,2,1711,558,1153,576.5,186,2.066308244
NM_002341,LTB,4,3,1868,897,971,323.6666667,224.25,1.082497213
NM_205837,LST1,4,3,2212,738,1474,491.3333333,184.5,1.997289973
NM_007161,LST1,4,3,1711,652,1059,353,163,1.624233129
NM_138282,ATP6V1G2,3,2,2399,1452,947,473.5,484,0.652203857
NM_005931,MICB,6,5,13076,2517,10559,2111.8,419.5,4.1950735
NM_147130,NCR3,4,3,4104,1058,3046,1015.333333,264.5,2.879017013
NM_009588,LTB,3,2,1868,850,1018,509,283.3333333,1.197647059
NM_205838,LST1,4,3,2732,675,2057,685.6666667,168.75,3.047407407
NM_001623,AIF1,6,5,1767,645,1122,224.4,107.5,1.739534884
NM_004847,AIF1,3,2,1806,1494,312,156,498,0.208835341
NM_080598,DDX39B,11,10,12258,2041,10217,1021.7,185.5454545,5.005879471
NM_001144963,NFKBIL1,4,3,11980,1389,10591,3530.333333,347.25,7.624910007
NM_001144962,NFKBIL1,4,3,11980,1434,10546,3515.333333,358.5,7.354253835
NM_001144961,NFKBIL1,4,3,11255,1442,9813,3271,360.5,6.805131761
NM_001145467,NCR3,4,3,3713,879,2834,944.6666667,219.75,3.224118316
NM_000595,LTA,4,3,2031,1414,617,205.6666667,353.5,0.436350778
NM_005007,NFKBIL1,4,3,11255,1487,9768,3256,371.75,6.568930733
NM_004640,DDX39B,11,10,12258,2171,10087,1008.7,197.3636364,4.64624597
NM_000594,TNF,4,3,2770,1679,1091,363.6666667,419.75,0.649791543
NM_001289160,MICB,6,5,16245,2418,13827,2765.4,403,5.718362283
NM_001289161,MICB,6,5,13076,2388,10688,2137.6,398,4.475711893
NM_025262,LY6G5C,3,2,3691,729,2962,1481,243,4.063100137
NM_025261,LY6G6C,3,2,3088,884,2204,1102,294.6666667,2.49321267
NM_025260,C6orf25,6,5,3366,2425,941,188.2,404.1666667,0.388041237
NM_001199698,BAG6,24,23,13674,3651,10023,435.7826087,152.125,2.745275267
NM_138272,C6orf25,6,5,3366,2406,960,192,401,0.399002494
NM_138273,C6orf25,5,4,3366,2333,1033,258.25,466.6,0.44277754
NM_080703,BAG6,25,24,13674,3823,9851,410.4583333,152.92,2.576772168
NM_021160,ABHD16A,20,19,16413,2039,14374,756.5263158,101.95,7.049534085
NM_080686,PRRC2A,31,30,17106,6945,10161,338.7,224.0322581,1.463066955
NM_021221,LY6G5B,3,2,1501,777,724,362,259,0.931788932
NM_021184,C6orf47,1,0,2476,2476,NA,NA,2476,NA
NM_001199237,GPANK1,4,3,5056,2797,2259,753,699.25,0.807651055
NM_001199239,GPANK1,4,3,4635,2663,1972,657.3333333,665.75,0.740518213
NM_001287594,CLIC1,7,6,5966,1107,4859,809.8333333,158.1428571,4.38934056
NM_001282385,CSNK2B,7,6,4192,1130,3062,510.3333333,161.4285714,2.709734513
NM_021246,LY6G6D,3,2,2450,405,2045,1022.5,135,5.049382716
NM_033177,GPANK1,3,2,4175,2772,1403,701.5,924,0.506132756
NM_138277,C6orf25,5,4,3366,2549,817,204.25,509.8,0.32051785
NM_138275,C6orf25,4,3,3366,2272,1094,364.6666667,568,0.481514085
NM_138274,C6orf25,4,3,3366,2291,1075,358.3333333,572.75,0.469227412
NM_013974,DDAH2,7,6,3224,1338,1886,314.3333333,191.1428571,1.409566517
NM_001199697,BAG6,23,22,13674,3128,10546,479.3636364,136,3.371483376
NM_001199240,GPANK1,4,3,4403,2449,1954,651.3333333,612.25,0.797876684
NM_001199238,GPANK1,4,3,4635,2666,1969,656.3333333,666.5,0.73855964
NM_001288,CLIC1,6,5,5985,1257,4728,945.6,209.5,3.761336516
NM_001256169,APOM,6,5,5802,722,5080,1016,120.3333333,7.03601108
NM_080702,BAG6,25,24,13674,3799,9875,411.4583333,151.96,2.599368255
NM_019101,APOM,6,5,2318,767,1551,310.2,127.8333333,2.022164276
NM_001177515,ABHD16A,18,17,16126,2164,13962,821.2941176,120.2222222,6.45194085
NM_001098534,BAG6,25,24,13367,3669,9698,404.0833333,146.76,2.643227037
NM_001320,CSNK2B,7,6,4192,1139,3053,508.8333333,162.7142857,2.680421422
NM_004639,BAG6,25,24,13674,3841,9833,409.7083333,153.64,2.560010414
NM_004638,PRRC2A,31,30,17106,6982,10124,337.4666667,225.2258065,1.450014323
NM_001287593,CLIC1,7,6,6739,1567,5172,862,223.8571429,3.300574346
NM_001003693,LY6G6F,6,5,3690,904,2786,557.2,150.6666667,3.081858407
NM_025257,SLC44A4,21,20,15855,2654,13201,660.05,126.3809524,4.974001507
NM_001039651,SAPCD1,5,4,1853,917,936,234,183.4,1.020719738
NM_021177,LSM2,5,4,9594,885,8709,2177.25,177,9.840677966
NM_025258,VWA7,17,16,11739,2931,8808,550.5,172.4117647,3.005117707
NM_001178045,SLC44A4,21,20,14480,2657,11823,591.15,126.5238095,4.449755363
NM_001178044,SLC44A4,20,19,15855,2527,13328,701.4736842,126.35,5.274238227
NM_000434,NEU1,6,5,3882,2077,1805,361,346.1666667,0.869041887
NM_005527,HSPA1L,2,1,5441,2539,2902,2902,1269.5,1.142969673
NM_006295,VARS,30,29,18417,4322,14095,486.0344828,144.0666667,3.261221657
NM_001287485,C6orf48,5,4,4853,707,4146,1036.5,141.4,5.864214993
NM_001287487,C6orf48,4,3,4853,612,4241,1413.666667,153,6.929738562
NM_001287488,C6orf48,4,3,4853,500,4353,1451,125,8.706
NM_001287486,C6orf48,5,4,4853,704,4149,1037.25,140.8,5.893465909
NM_001040437,C6orf48,5,4,4853,850,4003,1000.75,170,4.709411765
NM_001040438,C6orf48,4,3,4853,755,4098,1366,188.75,5.42781457
NM_005346,HSPA1B,1,0,2521,2521,NA,NA,2521,NA
NM_005345,HSPA1A,1,0,2430,2430,NA,NA,2430,NA
NM_001287482,C6orf48,5,4,4853,861,3992,998,172.2,4.636469222
NM_001287484,C6orf48,4,3,4853,759,4094,1364.666667,189.75,5.393939394
NM_001287483,C6orf48,3,2,4853,713,4140,2070,237.6666667,5.806451613
NM_001710,CFB,18,17,6142,2645,3497,205.7058824,146.9444444,1.322117202
NM_006929,SKIV2L,28,27,10953,4198,6755,250.1851852,149.9285714,1.609099571
NM_001282457,C2,14,13,47891,2073,45818,3524.461538,148.0714286,22.10226725
NM_000500,CYP21A2,11,10,3355,2134,1223,122.3,194,0.573102156
NM_001242823,C4B_2,41,40,20626,5468,15158,378.95,133.3658537,2.772128749
NM_001282458,C2,18,17,18199,2898,15301,900.0588235,161,5.279848171
NM_032470,TNXB,13,12,4855,3048,1807,150.5833333,234.4615385,0.592847769
NM_032454,STK19,8,7,9579,1640,7939,1134.142857,205,4.840853659
NM_001178063,C2,14,13,44677,2016,42661,3281.615385,144,21.16121032
NM_007293,C4A,41,40,20625,5467,15158,378.95,133.3414634,2.772635815
NM_002904,NELFE,11,10,7002,1572,5430,543,142.9090909,3.454198473
NM_181842,ZBTB12,2,1,2377,1867,510,510,933.5,0.273165506
NM_001252204,C4A,40,39,20625,5328,15297,392.2307692,133.2,2.871058559
NM_001145903,C2,16,15,18199,2472,15727,1048.466667,154.5,6.362055016
NM_001128590,CYP21A2,10,9,3355,2043,1314,146,204.3,0.643171806
NM_000063,C2,18,17,18199,2870,15329,901.7058824,159.4444444,5.341114983
NM_005510,DXO,7,6,2446,1597,849,141.5,228.1428571,0.531621791
NM_004197,STK19,8,7,9579,1628,7951,1135.857143,203.5,4.883906634
NM_001282459,C2,6,5,7583,1890,5693,1138.6,315,3.012169312
NM_001002029,C4B,41,40,20626,5468,15158,378.95,133.3658537,2.772128749
NM_004381,ATF6B,18,17,12974,2634,10340,608.2352941,146.3333333,3.925588459
NM_001136153,ATF6B,18,17,12974,2625,10349,608.7647059,145.8333333,3.94247619
NM_000500,CYP21A2,10,9,3356,2141,1215,135,214.1,0.567491826
NM_001242823,C4B_2,41,40,20625,5468,15157,378.925,133.3658537,2.771945867
NM_022110,FKBPL,2,1,1585,1346,239,239,673,0.17756315
NM_032470,TNXB,13,12,4975,3138,1837,153.0833333,241.3846154,0.585404716
NM_007293,C4A,41,40,20624,5467,15157,378.925,133.3414634,2.772452899
NM_001252204,C4A,40,39,20624,5328,15296,392.2051282,133.2,2.870870871
NM_019105,TNXB,44,43,68221,13169,55052,1280.27907,299.2954545,4.180423722
NM_001128590,CYP21A2,9,8,3356,2050,1306,163.25,227.7777778,0.637073171
NM_001002029,C4B,41,40,20625,5468,15157,378.925,133.3658537,2.771945867
NM_030651,PRRT1,4,3,3582,1900,1682,560.6666667,475,0.885263158
NM_001276501,GPSM3,4,3,2151,1489,662,220.6666667,372.25,0.444593687
NM_001206934,AGER,10,9,3356,1503,1853,205.8888889,150.3,1.232867598
NM_006411,AGPAT1,7,6,7935,2264,5671,945.1666667,323.4285714,2.504858657
NM_030652,EGFL8,9,8,3682,1301,2381,297.625,144.5555556,1.830130669
NM_001206966,AGER,10,9,3356,1357,1999,222.1111111,135.7,1.473102432
NM_022107,GPSM3,8,7,4759,1464,3295,470.7142857,183,2.25068306
NM_032741,AGPAT1,7,6,9907,2049,7858,1309.666667,292.7142857,3.835041484
NM_138717,PPT2,9,8,10231,1842,8389,1048.625,204.6666667,4.554288817
NM_001206940,AGER,10,9,3356,1455,1901,211.2222222,145.5,1.30652921
NM_001206929,AGER,11,10,3356,1549,1807,180.7,140.8181818,1.16655907
NM_005155,PPT2,9,8,9684,2063,7621,952.625,229.2222222,3.694134755
NM_006913,RNF5,6,5,2410,1143,1267,253.4,190.5,1.108486439
NM_172197,AGER,10,9,3356,1345,2011,223.4444444,134.5,1.495167286
NM_002586,PBX2,9,8,5455,3222,2233,279.125,358,0.693047796
NM_001136,AGER,11,10,3356,1501,1855,185.5,136.4545455,1.235842771
NM_001204103,PPT2,9,8,9684,2053,7631,953.875,228.1111111,3.716999513
NM_001206954,AGER,9,8,3356,1312,2044,255.5,145.7777778,1.557926829
NM_001206932,AGER,11,10,3356,1459,1897,189.7,132.6363636,1.30020562
NM_001206936,AGER,10,9,3356,1403,1953,217,140.3,1.392017106
NM_004557,NOTCH4,30,29,29226,6775,22451,774.1724138,225.8333333,3.313800738
NM_006781,C6orf10,23,22,79216,2204,77012,3500.545455,95.82608696,34.94192377
NM_001286474,C6orf10,26,25,79216,2201,77015,3080.6,84.65384615,34.99091322
NM_001286475,C6orf10,24,23,79216,2157,77059,3350.391304,89.875,35.72508113
NM_002125,HLA-DRB5,6,5,12854,1174,11680,2336,195.6666667,9.948892675
NM_019111,HLA-DRA,5,4,5209,1288,3921,980.25,257.6,3.044254658
NM_002124,HLA-DRB1,6,5,11068,1222,9846,1969.2,203.6666667,8.057283142
NM_002123,HLA-DQB1,5,4,7227,1645,5582,1395.5,329,3.39331307
NM_002122,HLA-DQA1,5,4,6248,1547,4701,1175.25,309.4,3.038784745
NM_001243961,HLA-DQB1,6,5,7227,1670,5557,1111.4,278.3333333,3.32754491
NM_001243965,HLA-DRB1,7,6,11068,1196,9874,1645.666667,170.8571429,8.255852843
NM_001198858,HLA-DQB2,5,4,7457,1127,6330,1582.5,225.4,5.616681455
NM_020056,HLA-DQA2,5,4,5503,1157,4346,1086.5,231.4,3.756266206
NM_148919,PSMB8,6,5,3324,1122,2202,440.4,187,1.962566845
NM_002800,PSMB9,6,5,5692,1054,4638,927.6,175.6666667,4.400379507
NM_018833,TAP2,12,11,16939,2552,14387,1307.909091,212.6666667,5.637539185
NM_000544,TAP2,12,11,13362,5691,7671,697.3636364,474.25,1.347917765
NM_000593,TAP1,11,10,8764,2963,5801,580.1,269.3636364,1.957813027
NM_004159,PSMB8,6,5,4220,1589,2631,526.2,264.8333333,1.655758339
NM_002120,HLA-DOB,6,5,4287,1378,2909,581.8,229.6666667,2.111030479
NM_002119,HLA-DOA,5,4,5431,3489,1942,485.5,697.8,0.556606478
NM_002118,HLA-DMB,6,5,6443,1403,5040,1008,233.8333333,3.59230221
NM_006120,HLA-DMA,5,4,4510,1127,3383,845.75,225.4,3.001774623
NM_001199456,BRD2,12,11,8423,3222,5201,472.8181818,268.5,1.614214773
NM_005104,BRD2,13,12,12847,4907,7940,661.6666667,377.4615385,1.618096597
NM_001113182,BRD2,13,12,10619,4820,5799,483.25,370.7692308,1.203112033
NM_001199455,BRD2,13,12,9912,4615,5297,441.4166667,355,1.147778982
NM_001163771,COL11A2,5,4,6025,1213,4812,1203,242.6,3.967023908
NM_080681,COL11A2,64,63,29778,6231,23547,373.7619048,97.359375,3.779008185
NM_080679,COL11A2,63,62,29778,6167,23611,380.8225806,97.88888889,3.828603859
NM_080680,COL11A2,66,65,29778,6491,23287,358.2615385,98.34848485,3.587582807
NM_033554,HLA-DPA1,5,4,9110,1686,7424,1856,337.2,4.403321471
NM_001242525,HLA-DPA1,6,5,16211,1702,14509,2901.8,283.6666667,8.524676851
NM_002121,HLA-DPB1,6,5,13772,4061,9711,1942.2,676.8333333,2.391282935
NM_001242524,HLA-DPA1,6,5,16211,1778,14433,2886.6,296.3333333,8.117547807
NM_001164267,WDR46,15,14,10426,2216,8210,586.4285714,147.7333333,3.704873646
NM_022551,RPS18,6,5,4431,548,3883,776.6,91.33333333,7.085766423
NM_021976,RXRB,10,9,7113,2929,4184,464.8888889,292.9,1.428473882
NM_001145338,ZBTB22,2,1,3539,2648,891,891,1324,0.336480363
NM_001185181,PFDN6,4,3,1301,705,596,198.6666667,176.25,0.845390071
NM_014234,HSD17B8,9,8,2196,1004,1192,149,111.5555556,1.187250996
NM_001270401,RXRB,10,9,7113,2941,4172,463.5555556,294.1,1.418565114
NM_001265595,PFDN6,5,4,1339,598,741,185.25,119.6,1.239130435
NM_003190,TAPBP,8,7,14694,3766,10928,1561.142857,470.75,2.901752523
NM_002931,RING1,7,6,4215,1745,2470,411.6666667,249.2857143,1.415472779
NM_005453,ZBTB22,2,1,3332,2666,666,666,1333,0.249812453
NM_005452,WDR46,15,14,10426,2378,8048,574.8571429,158.5333333,3.384356602
NM_001243738,RGL2,17,16,7736,3162,4574,285.875,186,1.446552815
NM_001350,DAXX,8,7,4460,2620,1840,262.8571429,327.5,0.702290076
NM_001254717,DAXX,7,6,4460,2363,2097,349.5,337.5714286,0.887431231
NM_001265596,PFDN6,5,4,1339,595,744,186,119,1.250420168
NM_001141969,DAXX,8,7,4460,2623,1837,262.4285714,327.875,0.700343119
NM_001141970,DAXX,8,7,4460,2554,1906,272.2857143,319.25,0.746280345
NM_014260,PFDN6,5,4,1339,603,736,184,120.6,1.220563847
NM_001077516,SLC39A7,8,7,3613,2159,1454,207.7142857,269.875,0.673459935
NM_004761,RGL2,18,17,7736,3360,4376,257.4117647,186.6666667,1.302380952
NM_003782,B3GALT4,1,0,1687,1687,NA,NA,1687,NA
NM_006979,SLC39A7,7,6,3613,2461,1152,192,351.5714286,0.468102397
NM_172209,TAPBP,7,6,14694,3504,11190,1865,500.5714286,3.193493151
NM_172208,TAPBP,7,6,10756,2010,8746,1457.666667,287.1428571,4.351243781
NM_001288777,SLC39A7,8,7,3613,1875,1738,248.2857143,234.375,0.926933333
NM_001289174,VPS52,19,18,21695,3446,18249,1013.833333,181.3684211,5.295705165
NM_001289175,VPS52,20,19,21695,2732,18963,998.0526316,136.6,6.941068814
NM_001289176,VPS52,18,17,21695,2538,19157,1126.882353,141,7.548069346
NM_022553,VPS52,20,19,21695,3051,18644,981.2631579,152.55,6.11078335
NM_015921,CUTA,5,4,1748,1204,544,136,240.8,0.451827243
NM_002263,KIFC1,11,10,18388,2715,15673,1567.3,246.8181818,5.772744015
NM_024165,PHF1,15,14,5459,2310,3149,224.9285714,154,1.363203463
NM_006772,SYNGAP1,19,18,33621,6029,27592,1532.888889,317.3157895,4.576546691
NM_002636,PHF1,14,13,5459,2203,3256,250.4615385,157.3571429,1.477984567
NM_001014433,CUTA,6,5,1748,814,934,186.8,135.6666667,1.147420147
NM_001014840,CUTA,6,5,1748,942,806,161.2,157,0.855626327
NM_001014838,CUTA,6,5,1748,1032,716,143.2,172,0.69379845
NM_001014837,CUTA,6,5,1748,1063,685,137,177.1666667,0.644402634
NM_001188,BAK1,6,5,7749,2199,5550,1110,366.5,2.523874488
NM_002224,ITPR3,58,57,75194,9089,66105,1159.736842,156.7068966,7.273077346
NM_032340,UQCC2,4,3,14992,1342,13650,4550,335.5,10.17138599
NM_002418,MLN,5,4,9346,577,8769,2192.25,115.4,15.19757366
NM_001142883,IP6K3,7,6,25321,2830,22491,3748.5,404.2857143,7.947349823
NM_001184698,MLN,5,4,9346,556,8790,2197.5,111.2,15.80935252
NM_001143944,LEMD2,8,7,15731,2367,13364,1909.142857,295.875,5.645965357
NM_181336,LEMD2,9,8,17918,2949,14969,1871.125,327.6666667,5.075957952
NM_001040109,MLN,5,4,9346,574,8772,2193,114.8,15.28222997
NM_054111,IP6K3,6,5,25321,2700,22621,4524.2,450,8.378148148
NM_001256813,GRM4,11,10,87341,6737,80604,8060.4,612.4545455,11.96437583
NM_001256812,GRM4,10,9,92122,6512,85610,9512.222222,651.2,13.14649877
NM_001008703,C6orf1,5,4,2730,940,1790,447.5,188,1.904255319
NM_001287398,C6orf1,4,3,2730,913,1817,605.6666667,228.25,1.990142388
NM_001287397,C6orf1,4,3,2730,1165,1565,521.6666667,291.25,1.343347639
NM_001287396,C6orf1,5,4,2730,1132,1598,399.5,226.4,1.411660777
NM_178508,C6orf1,5,4,2730,1192,1538,384.5,238.4,1.290268456
NM_001008704,C6orf1,5,4,2730,880,1850,462.5,176,2.102272727
NM_001204091,RPS10,6,5,8673,654,8019,1603.8,109,12.26146789
NM_001203245,RPS10,6,5,8589,802,7787,1557.4,133.6666667,9.709476309
NM_001014,RPS10,6,5,8673,650,8023,1604.6,108.3333333,12.34307692
NM_001199583,PACSIN1,10,9,20353,4298,16055,1783.888889,429.8,3.735458353
NM_012391,SPDEF,6,5,18533,1920,16613,3322.6,320,8.652604167
NM_001252294,SPDEF,5,4,18533,1871,16662,4165.5,374.2,8.905398183
NM_005643,TAF11,5,4,10295,1567,8728,2182,313.4,5.569878749
NM_017754,UHRF1BP1,21,20,85499,9654,75845,3792.25,459.7142857,7.856328983
NM_001270488,TAF11,4,3,10295,1469,8826,2942,367.25,6.008168822
NM_001261821,TCP11,11,10,23340,2131,21209,2120.9,193.7272727,9.952604411
NM_001261820,TCP11,11,10,23340,2146,21194,2119.4,195.0909091,9.876048462
NM_001261819,TCP11,9,8,23340,1785,21555,2694.375,198.3333333,12.07563025
NM_001261818,TCP11,9,8,23340,1800,21540,2692.5,200,11.96666667
NM_001261817,TCP11,10,9,23340,1924,21416,2379.555556,192.4,11.13097713
NM_018679,TCP11,10,9,23340,2033,21307,2367.444444,203.3,10.48057059
NM_001093728,TCP11,10,9,23340,1939,21401,2377.888889,193.9,11.03713254
NM_152753,SCUBE3,22,21,36421,5137,31284,1489.714286,233.5,6.08993576
NM_022047,DEF6,11,10,23955,2307,21648,2164.8,209.7272727,9.383615085
NM_007104,RPL10A,6,5,2382,725,1657,331.4,120.8333333,2.285517241
NM_003322,TULP1,15,14,15030,2141,12889,920.6428571,142.7333333,6.020084073
NM_003214,TEAD3,13,12,23489,3004,20485,1707.083333,231.0769231,6.819241012
NM_021922,FANCE,10,9,14745,2565,12180,1353.333333,256.5,4.748538012
NM_001289395,TULP1,14,13,15030,1981,13049,1003.769231,141.5,6.587077234
NM_001010886,CLPSL1,3,2,7012,480,6532,3266,160,13.60833333
NM_001252598,CLPS,2,1,2364,438,1926,1926,219,4.397260274
NM_001252597,CLPS,4,3,2364,661,1703,567.6666667,165.25,2.576399395
NM_207409,CLPSL2,3,2,2960,433,2527,1263.5,144.3333333,5.836027714
NM_001832,CLPS,3,2,2364,562,1802,901,187.3333333,3.206405694
NM_001286550,CLPSL2,4,3,2960,513,2447,815.6666667,128.25,4.769980507
NM_001286576,ARMC12,6,5,11883,1119,10764,2152.8,186.5,9.619302949
NM_001286574,ARMC12,6,5,11883,1149,10734,2146.8,191.5,9.342036554
NM_145028,ARMC12,6,5,11883,1230,10653,2130.6,205,8.66097561
NM_003137,SRPK1,16,15,88148,4378,83770,5584.666667,273.625,19.1343079
NM_002754,MAPK13,12,11,14042,6360,7682,698.3636364,530,1.207861635
NM_001010903,C6orf222,12,11,21129,3747,17382,1580.181818,312.25,4.638911129
NM_173676,PNPLA1,8,7,65429,2375,63054,9007.714286,296.875,26.54905263
NM_001145717,PNPLA1,8,7,38137,2486,35651,5093,310.75,14.34070796
NM_001145716,PNPLA1,8,7,65429,2402,63027,9003.857143,300.25,26.23938385
NM_016135,ETV7,8,7,21608,1744,19864,2837.714286,218,11.38990826
NM_001207041,ETV7,6,5,21608,1441,20167,4033.4,240.1666667,13.99514226
NM_001207040,ETV7,7,6,21608,1607,20001,3333.5,229.5714286,12.44617299
NM_001207039,ETV7,7,6,33581,1476,32105,5350.833333,210.8571429,21.75135501
NM_001207038,ETV7,7,6,21599,1503,20096,3349.333333,214.7142857,13.37059215
NM_001207037,ETV7,8,7,21608,1785,19823,2831.857143,223.125,11.10532213
NM_001207036,ETV7,7,6,21608,1578,20030,3338.333333,225.4285714,12.69328264
NM_001207035,ETV7,8,7,33581,1642,31939,4562.714286,205.25,19.45127893
NM_152990,PXT1,5,4,52339,2112,50227,12556.75,422.4,23.78172348
NM_007271,STK38,14,13,53580,3590,49990,3845.384615,256.4285714,13.92479109
NM_001220778,CDKN1A,3,2,8631,2272,6359,3179.5,757.3333333,2.798855634
NM_000389,CDKN1A,3,2,8662,2162,6500,3250,720.6666667,3.006475486
NM_078467,CDKN1A,4,3,10851,2110,8741,2913.666667,527.5,4.142654028
NM_001220777,CDKN1A,3,2,10881,2107,8774,4387,702.3333333,4.164214523
NM_020939,CPNE5,21,20,98667,3360,95307,4765.35,160,28.36517857
NM_001286635,C6orf89,9,8,43102,6860,36242,4530.25,762.2222222,5.283090379
NM_001199159,PI16,8,7,16576,2093,14483,2069,261.625,6.919732441
NM_152734,C6orf89,8,7,43102,6759,36343,5191.857143,844.875,5.376978843
NM_014341,MTCH1,12,11,18418,2277,16141,1467.363636,189.75,7.088713219
NM_001271641,MTCH1,12,11,18418,2328,16090,1462.727273,194,6.911512027
NM_153370,PI16,7,6,10406,2197,8209,1368.166667,313.8571429,3.736458807
NM_001286637,C6orf89,9,8,43102,6801,36301,4537.625,755.6666667,5.337597412
NM_001286636,C6orf89,10,9,57096,6925,50171,5574.555556,692.5,7.244909747
NM_173558,FGD2,16,15,23424,3061,20363,1357.533333,191.3125,6.652401176
NM_001243186,PIM1,6,5,5284,2715,2569,513.8,452.5,0.946224678
NM_002648,PIM1,6,5,5284,2715,2569,513.8,452.5,0.946224678
NM_017772,TBC1D22B,13,12,75200,3475,71725,5977.083333,267.3076923,20.64028777
NM_138493,CCDC167,4,3,17005,624,16381,5460.333333,156,26.25160256
NM_015050,CMTR1,24,23,48379,4148,44231,1923.086957,172.8333333,10.66321119
NM_002062,GLP1R,13,12,38965,3136,35829,2985.75,241.2307692,11.42506378
NM_018322,SAYSD1,2,1,11027,1922,9105,9105,961,4.737252862
NM_032115,KCNK16,6,5,7858,1254,6604,1320.8,209,5.266347687
NM_031460,KCNK17,5,4,15461,1570,13891,3472.75,314,8.847770701
NM_001135111,KCNK17,6,5,15462,1723,13739,2747.8,287.1666667,7.973882763
NM_001135107,KCNK16,5,4,7858,1112,6746,1686.5,222.4,6.066546763
NM_001135106,KCNK16,5,4,6385,952,5433,1358.25,190.4,5.706932773
NM_001135105,KCNK16,5,4,7858,1414,6444,1611,282.8,4.5572843
NM_005943,MOCS1,10,9,23423,4173,19250,2138.888889,417.3,4.612988258
NM_001075098,MOCS1,11,10,30258,4170,26088,2608.8,379.0909091,6.256115108
NM_001159726,TSPO2,4,3,1621,828,793,264.3333333,207,0.957729469
NM_173561,UNC5CL,9,8,12300,3137,9163,1145.375,348.5555556,2.920943577
NM_001010873,TSPO2,4,3,1841,1018,823,274.3333333,254.5,0.808447937
NM_002505,NFYA,10,9,29441,6229,23212,2579.111111,622.9,3.726440841
NM_178174,TREML1,6,5,5090,1346,3744,748.8,224.3333333,2.781575037
NM_018965,TREM2,5,4,4682,1060,3622,905.5,212,3.416981132
NM_021705,NFYA,9,8,29441,6141,23300,2912.5,682.3333333,3.794170331
NM_001271821,TREM2,4,3,4682,865,3817,1272.333333,216.25,4.412716763
NM_001271808,TREML1,5,4,5090,1012,4078,1019.5,202.4,4.029644269
NM_001271807,TREML1,5,4,5090,1292,3798,949.5,258.4,2.939628483
NM_145063,OARD1,6,5,5659,1180,4479,895.8,196.6666667,3.795762712
NM_024807,TREML2,5,4,11440,3828,7612,1903,765.6,1.988505747
NM_018643,TREM1,4,3,11460,1637,9823,3274.333333,409.25,6.000610874
NM_001242589,TREM1,3,2,7182,2088,5094,2547,696,2.439655172
NM_001242590,TREM1,3,2,11460,1443,10017,5008.5,481,6.941787942
NM_198153,TREML4,6,5,10060,2076,7984,1596.8,346,3.845857418
NM_001199510,NCR2,6,5,15099,1054,14045,2809,175.6666667,13.32542694
NM_001199509,NCR2,6,5,15099,1090,14009,2801.8,181.6666667,12.85229358
NM_004828,NCR2,5,4,15099,946,14153,3538.25,189.2,14.96088795
NM_005586,MDFI,5,4,15789,1622,14167,3541.75,324.4,8.734278668
NM_006653,FRS3,7,6,9731,2186,7545,1257.5,312.2857143,3.451509607
NM_013397,PRICKLE4,8,7,6612,1654,4958,708.2857143,206.75,2.99758162
NM_002630,PGC,9,8,10692,1384,9308,1163.5,153.7777778,6.725433526
NM_001134493,TOMM6,3,2,2455,857,1598,799,285.6666667,1.864644107
NM_001166424,PGC,7,6,6565,1159,5406,901,165.5714286,4.664365833
NM_001760,CCND3,5,4,6917,2090,4827,1206.75,418,2.309569378
NM_001136125,CCND3,4,3,6917,1873,5044,1681.333333,468.25,2.693005873
NM_001287427,CCND3,5,4,6917,2590,4327,1081.75,518,1.670656371
NM_004053,BYSL,7,6,11821,1997,9824,1637.333333,285.2857143,4.919379069
NM_004275,MED20,4,3,15787,2482,13305,4435,620.5,5.360596293
NM_138572,TAF8,9,8,30395,4332,26063,3257.875,481.3333333,6.016389658
NM_002098,GUCA1B,4,3,11674,2274,9400,3133.333333,568.5,4.133685136
NM_018141,MRPS10,7,6,11096,2147,8949,1491.5,306.7142857,4.168141593
NM_000409,GUCA1A,6,5,24652,1910,22742,4548.4,318.3333333,11.90680628
NM_001184801,UBR2,12,11,56331,2475,53856,4896,206.25,21.76
NM_000322,PRPH2,3,2,26027,3030,22997,11498.5,1010,7.589768977
NM_003192,TBCC,1,0,1652,1652,NA,NA,1652,NA
NM_198486,RPL7L1,6,5,7062,1281,5781,1156.2,213.5,4.512880562
NM_015349,GLTSCR1L,12,11,47504,6527,40977,3725.181818,543.9166667,6.278075686
NM_001008739,C6orf226,1,0,553,553,NA,NA,553,NA
NM_001243170,PTCRA,3,2,9850,764,9086,4543,254.6666667,11.89267016
NM_001243169,PTCRA,5,4,9850,1012,8838,2209.5,202.4,8.733201581
NM_138296,PTCRA,4,3,9850,1086,8764,2921.333333,271.5,8.069981584
NM_006586,CNPY3,6,5,10150,1771,8379,1675.8,295.1666667,4.731225296
NM_000287,PEX6,17,16,15372,3515,11857,741.0625,206.7647059,3.373257468
NM_006245,PPP2R5D,16,15,27848,3063,24785,1652.333333,191.4375,8.091740124
NM_014623,MEA1,4,3,1653,870,783,261,217.5,0.9
NM_001243168,PTCRA,4,3,9850,1131,8719,2906.333333,282.75,7.709106985
NM_001270476,PPP2R5D,16,15,27848,3080,24768,1651.2,192.5,8.041558442
NM_018960,GNMT,6,5,3120,1074,2046,409.2,179,1.905027933
NM_057161,KLHDC3,11,10,7197,2030,5167,516.7,184.5454545,2.545320197
NM_180977,PPP2R5D,14,13,27848,2743,25105,1931.153846,195.9285714,9.152387896
NM_180976,PPP2R5D,16,15,27848,2967,24881,1658.733333,185.4375,8.385911695
NM_015950,MRPL2,7,6,5477,1293,4184,697.3333333,184.7142857,3.235885538
NM_014780,CUL7,26,25,16330,5526,10804,432.16,212.5384615,1.955121245
NM_001168370,CUL7,26,25,16330,5533,10797,431.88,212.8076923,1.951382613
NM_138343,KLC4,6,5,7803,1314,6489,1297.8,219,4.938356164
NM_001289035,KLC4,15,14,15507,2188,13319,951.3571429,145.8666667,6.087294333
NM_201521,KLC4,16,15,15507,2420,13087,872.4666667,151.25,5.40785124
NM_001289034,KLC4,16,15,15244,2654,12590,839.3333333,165.875,4.743782969
NM_201522,KLC4,17,16,15244,2837,12407,775.4375,166.8823529,4.373281636
NM_201523,KLC4,16,15,15244,2710,12534,835.6,169.375,4.625092251
NM_003131,SRF,7,6,10326,4325,6001,1000.166667,617.8571429,1.387514451
NM_199184,DNPH1,3,2,3846,800,3046,1523,266.6666667,3.8075
NM_015089,CUL9,41,40,42405,7812,34593,864.825,190.5365854,4.428187404
NM_006443,DNPH1,4,3,3846,650,3196,1065.333333,162.5,4.916923077
NM_006672,SLC22A7,10,9,7280,2563,4717,524.1111111,256.3,1.840421381
NM_014345,ZNF318,10,9,33375,8016,25359,2817.666667,801.6,3.163547904
NM_153320,SLC22A7,10,9,7280,2569,4711,523.4444444,256.9,1.833787466
NM_206922,CRIP3,8,7,3321,964,2357,336.7142857,120.5,2.445020747
NM_015388,YIPF3,9,8,5165,1585,3580,447.5,176.1111111,2.258675079
NM_203290,POLR1C,9,8,4471,1329,3142,392.75,147.6666667,2.364183597
NM_001146020,TJAP1,9,8,29035,2581,26454,3306.75,286.7777778,10.24951569
NM_001146019,TJAP1,10,9,29035,2731,26304,2922.666667,273.1,9.631636763
NM_001146018,TJAP1,11,10,29035,2789,26246,2624.6,253.5454545,9.410541413
NM_001146017,TJAP1,10,9,16974,2726,14248,1583.111111,272.6,5.226705796
NM_001198934,ABCC10,22,21,22873,5050,17823,848.7142857,229.5454545,3.529306931
NM_001012974,LRRC73,6,5,3380,1788,1592,318.4,298,0.890380313
NM_023932,DLK2,6,5,5274,1630,3644,728.8,271.6666667,2.235582822
NM_001286656,DLK2,6,5,5274,1612,3662,732.4,268.6666667,2.271712159
NM_033450,ABCC10,20,19,18676,5108,13568,714.1052632,255.4,2.656225529
NM_080604,TJAP1,10,9,29035,2783,26252,2916.888889,278.3,9.432985986
NM_001271882,LRRC73,6,5,3380,1096,2284,456.8,182.6666667,2.083941606
NM_001146016,TJAP1,11,10,29035,2762,26273,2627.3,251.0909091,9.51230992
NM_001286655,DLK2,6,5,6282,1935,4347,869.4,322.5,2.246511628
NM_206539,DLK2,6,5,6282,2046,4236,847.2,341,2.070381232
NM_006502,POLH,11,10,44384,8423,35961,3596.1,765.7272727,4.269381456
NM_152732,RSPH9,5,4,25983,967,25016,6254,193.4,25.8697001
NM_014628,MAD2L1BP,3,2,5113,1282,3831,1915.5,427.3333333,2.988299532
NM_001286216,GTPBP2,12,11,6874,2843,4031,366.4545455,236.9166667,1.417868449
NM_019096,GTPBP2,12,11,8767,3038,5729,520.8181818,253.1666667,1.885780118
NM_001193341,RSPH9,6,5,25983,1020,24963,4992.6,170,24.47352941
NM_001003690,MAD2L1BP,4,3,11411,1551,9860,3286.666667,387.75,6.35718891
NM_003376,VEGFA,8,7,16279,3618,12661,1808.714286,452.25,3.499447208
NM_001033756,VEGFA,7,6,16279,3479,12800,2133.333333,497,3.679218166
NM_001171629,VEGFA,7,6,16279,3479,12800,2133.333333,497,3.679218166
NM_001025367,VEGFA,8,7,16279,3600,12679,1811.285714,450,3.521944444
NM_001025369,VEGFA,7,6,16279,3510,12769,2128.166667,501.4285714,3.637891738
NM_001171630,VEGFA,5,4,16279,3381,12898,3224.5,676.2,3.814847678
NM_001171627,VEGFA,7,6,16279,3510,12769,2128.166667,501.4285714,3.637891738
NM_001171625,VEGFA,8,7,16279,3600,12679,1811.285714,450,3.521944444
NM_001171622,VEGFA,5,4,16279,3381,12898,3224.5,676.2,3.814847678
NM_001171628,VEGFA,6,5,16279,3412,12867,2573.4,568.6666667,3.771101993
NM_001171626,VEGFA,7,6,16279,3545,12734,2122.333333,506.4285714,3.592101551
NM_001171624,VEGFA,8,7,16279,3618,12661,1808.714286,452.25,3.499447208
NM_001171623,VEGFA,8,7,16279,3669,12610,1801.428571,458.625,3.436903788
NM_001025370,VEGFA,6,5,16279,3412,12867,2573.4,568.6666667,3.771101993
NM_001025368,VEGFA,7,6,16279,3545,12734,2122.333333,506.4285714,3.592101551
NM_001025366,VEGFA,8,7,16279,3669,12610,1801.428571,458.625,3.436903788
NM_001204385,VEGFA,7,6,16279,3485,12794,2132.333333,497.8571429,3.671162123
NM_001204384,VEGFA,7,6,16279,3485,12794,2132.333333,497.8571429,3.671162123
NM_001287044,VEGFA,7,6,14503,2558,11945,1990.833333,365.4285714,4.6696638
NM_001171992,C6orf223,4,3,5359,3627,1732,577.3333333,906.75,0.477529639
NM_153246,C6orf223,4,3,5359,3584,1775,591.6666667,896,0.495256696
NM_032111,MRPL14,3,2,13820,777,13043,6521.5,259,16.78635779
NM_007058,CAPN11,23,22,25593,2751,22842,1038.272727,119.6086957,8.303162486
NM_018426,TMEM63B,24,23,27882,3223,24659,1072.130435,134.2916667,7.650946323
NM_007355,HSP90AB1,12,11,6932,2715,4217,383.3636364,226.25,1.553222836
NM_020745,AARS2,22,21,14602,4804,9798,466.5714286,218.3636364,2.039550375
NM_178148,SLC35B2,4,3,3472,2069,1403,467.6666667,517.25,0.678105365
NM_001271972,HSP90AB1,12,11,6932,2685,4247,386.0909091,223.75,1.581750466
NM_001271971,HSP90AB1,12,11,6932,2571,4361,396.4545455,214.25,1.696227149
NM_001137560,TMEM151B,3,2,8704,4622,4082,2041,1540.666667,0.88316746
NM_001271969,HSP90AB1,12,11,6932,2728,4204,382.1818182,227.3333333,1.541055718
NM_001271970,HSP90AB1,12,11,7724,2656,5068,460.7272727,221.3333333,1.90813253
NM_001078177,SLC29A1,14,13,10527,2499,8028,617.5384615,178.5,3.212484994
NM_001078175,SLC29A1,14,13,10649,2304,8345,641.9230769,164.5714286,3.621961806
NM_001078174,SLC29A1,13,12,14648,2339,12309,1025.75,179.9230769,5.262505344
NM_004955,SLC29A1,13,12,14648,2336,12312,1026,179.6923077,5.270547945
NM_004556,NFKBIE,6,5,7624,2587,5037,1007.4,431.1666667,1.947042907
NM_182539,TCTE1,5,4,17563,1688,15875,3968.75,337.6,9.404620853
NM_001286510,SLC35B2,4,3,3253,2064,1189,396.3333333,516,0.576065891
NM_001286509,SLC35B2,4,3,3472,2065,1407,469,516.25,0.681355932
NM_001286517,SLC35B2,3,2,3472,1874,1598,799,624.6666667,0.852721451
NM_001286519,SLC35B2,2,1,3472,1718,1754,1754,859,1.020954598
NM_001286511,SLC35B2,4,3,3791,2019,1772,590.6666667,504.75,0.877662209
NM_001078176,SLC29A1,13,12,10649,2196,8453,704.4166667,168.9230769,3.849271403
NM_001286513,SLC35B2,3,2,3472,1913,1559,779.5,637.6666667,0.81495034
NM_001286512,SLC35B2,4,3,3253,2068,1185,395,517,0.573017408
NM_001286520,SLC35B2,4,3,3472,2073,1399,466.3333333,518.25,0.674867342
NM_001253,CDC5L,16,15,62912,6448,56464,3764.266667,403,8.756823821
NM_145026,SPATS1,9,8,34509,1117,33392,4174,124.1111111,29.89435989
NM_001256023,CLIC5,6,5,104268,2058,102210,20442,343,49.66472303
NM_014936,ENPP4,4,3,16737,4684,12053,4017.666667,1171,2.57322801
NM_001204052,SLC25A27,7,6,25277,2533,22744,3790.666667,361.8571429,8.979076194
NM_001204051,SLC25A27,9,8,25277,2731,22546,2818.25,303.4444444,8.255584035
NM_004277,SLC25A27,9,8,25277,2995,22282,2785.25,332.7777778,7.439732888
NM_001162435,ANKRD66,5,4,12302,1062,11240,2810,212.4,10.58380414
NM_001168357,PLA2G7,12,11,31379,1760,29619,2692.636364,146.6666667,16.82897727
NM_005084,PLA2G7,12,11,31100,1851,29249,2659,154.25,15.8017288
NM_001098518,GPR116,21,20,69474,5838,63636,3181.8,278,10.90030832
NM_015234,GPR116,21,20,102435,5778,96657,4832.85,275.1428571,16.72845275
NM_025048,GPR110,8,7,22462,1430,21032,3004.571429,178.75,14.70769231
NM_153840,GPR110,15,14,42271,3093,39178,2798.428571,206.2,12.66666667
NM_014452,TNFRSF21,6,5,78422,3648,74774,14954.8,608,20.49725877
NM_153839,GPR111,11,10,41209,5137,36072,3607.2,467,7.021997275
NM_153838,GPR115,10,9,23470,3172,20298,2255.333333,317.2,6.399117276
NM_181744,OPN5,7,6,44343,3489,40854,6809,498.4285714,11.70937231
NM_001145652,C6orf141,1,0,1697,1697,NA,NA,1697,NA
NM_018132,CENPQ,9,8,29726,1737,27989,3498.625,193,16.11341393
NM_001010904,GLYATL3,6,5,28108,2136,25972,5194.4,356,12.15917603
NM_000324,RHAG,10,9,31699,1938,29761,3306.777778,193.8,15.35655315
NM_001190986,CRISP3,8,7,17060,2236,14824,2117.714286,279.5,6.629695886
NM_138733,PGK2,1,0,1691,1691,NA,NA,1691,NA
NM_006061,CRISP3,8,7,17078,2224,14854,2122,278,6.678956835
NM_001037729,DEFB113,2,1,950,251,699,699,125.5,2.784860558
NM_001166478,DEFB133,2,1,3345,188,3157,3157,94,16.79255319
NM_001037499,DEFB114,2,1,3815,212,3603,3603,106,16.99528302
NM_001037497,DEFB110,2,1,3140,386,2754,2754,193,7.134715026
NM_001037728,DEFB110,2,1,12845,237,12608,12608,118.5,53.19831224
NM_001037498,DEFB112,2,1,5078,344,4734,4734,172,13.76162791
NM_003221,TFAP2B,7,6,28889,5777,23112,3852,825.2857143,4.000692401
NM_002388,MCM3,17,16,20869,3225,17644,1102.75,189.7058824,5.471007752
NM_002190,IL17A,3,2,4253,1862,2391,1195.5,620.6666667,1.284103115
NM_001270472,MCM3,16,15,20869,3111,17758,1183.866667,194.4375,5.708132433
NM_052872,IL17F,3,2,7816,811,7005,3502.5,270.3333333,8.637484587
NM_133367,PAQR8,2,1,45651,4740,40911,40911,2370,8.631012658
NM_014051,TMEM14A,5,4,15503,1019,14484,3621,203.8,14.21393523
NM_145740,GSTA1,7,6,12488,1266,11222,1870.333333,180.8571429,8.864139021
NM_000846,GSTA2,7,6,13478,1316,12162,2027,188,9.241641337
NM_153699,GSTA5,7,6,14354,851,13503,2250.5,121.5714286,15.86721504
NM_000847,GSTA3,7,6,13059,920,12139,2023.166667,131.4285714,13.19456522
NM_014920,ICK,14,13,60504,6141,54363,4181.769231,438.6428571,8.852467025
NM_016513,ICK,15,14,60504,6253,54251,3875.071429,416.8666667,8.675995522
NM_001512,GSTA4,7,6,17434,1348,16086,2681,192.5714286,11.93323442
NM_003643,GCM1,6,5,21866,2770,19096,3819.2,461.6666667,6.893862816
NM_001242828,ELOVL5,9,8,81783,3090,78693,9836.625,343.3333333,25.46699029
NM_001242831,ELOVL5,3,2,55091,834,54257,27128.5,278,65.05635492
NM_001242830,ELOVL5,7,6,81783,2882,78901,13150.16667,411.7142857,27.37716863
NM_021814,ELOVL5,8,7,81783,3008,78775,11253.57143,376,26.18849734
NM_001197115,GCLC,15,14,47789,3713,44076,3148.285714,247.5333333,11.87072448
NM_001498,GCLC,16,15,47789,3828,43961,2930.733333,239.25,11.48406479
NM_001003760,KLHL31,3,2,17809,5746,12063,6031.5,1915.333333,2.099373477
NM_014464,TINAG,11,10,81749,1815,79934,7993.4,165,44.04077135
NM_207410,GFRAL,9,8,75026,1920,73106,9138.25,213.3333333,38.07604167
NM_001257273,ZNF451,4,3,19706,9546,10160,3386.666667,2386.5,1.064320134
NM_020931,KIAA1586,4,3,8709,2968,5741,1913.666667,742,1.934299191
NM_001286276,KIAA1586,4,3,8494,2898,5596,1865.333333,724.5,1.930986888
NM_001286275,KIAA1586,4,3,8709,2946,5763,1921,736.5,1.956211813
NM_001286274,KIAA1586,3,2,8709,2886,5823,2911.5,962,2.017671518
NM_016277,RAB23,7,6,35323,4843,30480,5080,691.8571429,6.293619657
NM_001278668,RAB23,7,6,34470,4373,30097,5016.166667,624.7142857,6.882460553
NM_001278666,RAB23,7,6,35323,4374,30949,5158.166667,624.8571429,7.07567444
NM_183227,RAB23,7,6,34470,4397,30073,5012.166667,628.1428571,6.839435979
NM_001278667,RAB23,7,6,35323,4546,30777,5129.5,649.4285714,6.770127585
NM_004282,BAG2,3,2,12910,2055,10855,5427.5,685,5.282238443
NM_001282487,PRIM2,5,4,8748,876,7872,1968,175.2,8.98630137
NM_001282488,PRIM2,5,4,11560,907,10653,2663.25,181.4,11.74531422
NM_001190706,MTRNR2L9,1,0,528,528,NA,NA,528,NA
NM_001143940,LGSN,5,4,44028,5218,38810,9702.5,1043.6,7.4377156
NM_016571,LGSN,4,3,44028,5638,38390,12796.66667,1409.5,6.809152182
NM_003463,PTP4A1,6,5,11578,5095,6483,1296.6,849.1666667,1.272423945
NM_015153,PHF3,15,14,67976,6962,61014,4358.142857,464.1333333,8.763860959
NM_001271675,LOC441155,2,1,4195,3826,369,369,1913,0.096445374
NM_078485,COL9A1,32,31,67170,3082,64088,2067.354839,96.3125,20.79428942
NM_001851,COL9A1,38,37,87045,3820,83225,2249.324324,100.5263158,21.78664921
NM_145267,C6orf57,3,2,21983,528,21455,10727.5,176,40.6344697
NM_080742,B3GAT2,4,3,95721,1929,93792,31264,482.25,48.62208398
NM_024576,OGFRL1,7,6,13498,1747,11751,1958.5,249.5714286,6.726388094
NM_001168411,RIMS1,6,5,36415,3285,33130,6626,547.5,10.08523592
NM_030568,KHDC1,4,3,21871,1137,20734,6911.333333,284.25,18.235708
NM_001251874,KHDC1,5,4,68902,1434,67468,16867,286.8,47.0488145
NM_001126063,KHDC1L,3,2,1909,637,1272,636,212.3333333,1.996860283
NM_001025290,DPPA5,3,2,1216,663,553,276.5,221,0.834087481
NM_001080507,OOEP,3,2,1237,680,557,278.5,226.6666667,0.819117647
NM_018665,DDX43,17,16,23006,2713,20293,1268.3125,159.5882353,7.479911537
NM_138441,MB21D1,5,4,27189,1807,25382,6345.5,361.4,14.04648589
NM_001017361,KHDC3L,3,2,1500,1025,475,237.5,341.6666667,0.463414634
NM_001402,EEF1A1,8,7,5284,3520,1764,252,440,0.501136364
NM_001865,COX7A2,4,3,6255,705,5550,1850,176.25,7.872340426
NM_018247,TMEM30A,7,6,31996,4551,27445,4574.166667,650.1428571,6.030542738
NM_001143958,TMEM30A,6,5,31996,4442,27554,5510.8,740.3333333,6.203061684
NM_000863,HTR1B,1,0,1174,1174,NA,NA,1174,NA
NM_001010844,IRAK1BP1,4,3,33424,3452,29972,9990.666667,863,8.682502897
NM_001201363,HMGN3,7,6,33495,1021,32474,5412.333333,145.8571429,31.80607248
NM_001201362,HMGN3,5,4,33495,1475,32020,8005,295,21.70847458
NM_138730,HMGN3,6,5,33495,886,32609,6521.8,147.6666667,36.80474041
NM_004242,HMGN3,6,5,33495,927,32568,6513.6,154.5,35.13268608
NM_001243308,C6orf7,4,3,66835,754,66081,22027,188.5,87.64058355
NM_022726,ELOVL4,6,5,32788,3066,29722,5944.4,511,9.694063927
NM_017633,FAM46A,3,2,6983,5615,1368,684,1871.666667,0.243633126
NM_015525,IBTK,29,28,77494,5804,71690,2560.357143,200.137931,12.35182633
NM_006670,TPBG,3,2,4212,3394,818,409,1131.333333,0.241013553
NM_001166392,TPBG,2,1,3174,2882,292,292,1441,0.101318529
NM_001199942,DOPEY1,40,39,100807,8035,92772,2378.769231,200.875,11.54598631
NM_015018,DOPEY1,39,38,100807,8001,92806,2442.263158,205.1538462,11.59930009
NM_033411,RWDD2A,3,2,3226,1418,1808,904,472.6666667,1.275035261
NM_001170423,PRSS35,3,2,13229,2609,10620,5310,869.6666667,4.070525105
NM_153362,PRSS35,2,1,13229,2503,10726,10726,1251.5,4.285257691
NM_016230,CYB5R4,16,15,100778,2263,98515,6567.666667,141.4375,43.5329209
NM_001009994,RIPPLY2,4,3,4251,668,3583,1194.333333,167,5.363772455
NM_138409,MRAP2,4,3,57187,2217,54970,18323.33333,554.25,24.7947677
NM_002526,NT5E,9,8,46209,4077,42132,5266.5,453,10.33406917
NM_001204813,NT5E,8,7,46209,3926,42283,6040.428571,490.75,10.76999491
NM_001159674,SYNCRIP,12,11,35108,6800,28308,2573.454545,566.6666667,4.162941176
NM_001159676,SYNCRIP,11,10,33669,6807,26862,2686.2,618.8181818,3.94623182
NM_001159677,SYNCRIP,12,11,35543,7340,28203,2563.909091,611.6666667,3.842370572
NM_006372,SYNCRIP,11,10,29352,3205,26147,2614.7,291.3636364,8.158190328
NM_001253771,SYNCRIP,11,10,35108,6718,28390,2839,610.7272727,4.225960107
NM_001159675,SYNCRIP,10,9,27478,2570,24908,2767.555556,257,9.691828794
NM_001159673,SYNCRIP,11,10,35140,6776,28364,2836.4,616,4.185950413
NM_000735,CGA,4,3,9651,755,8896,2965.333333,188.75,11.78278146
NM_001252383,CGA,5,4,9651,849,8802,2200.5,169.8,10.36749117
NM_198568,GJB7,3,2,46301,2283,44018,22009,761,19.28077092
NM_001042493,SMIM8,4,3,19742,2441,17301,5767,610.25,7.087668988
NM_001287445,SMIM8,3,2,19742,1309,18433,9216.5,436.3333333,14.08174179
NM_020425,SMIM8,3,2,19742,2419,17323,8661.5,806.3333333,7.161223646
NM_001010868,C6orf163,5,4,20612,1309,19303,4825.75,261.8,14.74637128
NM_001031743,C6orf165,13,12,56503,2228,54275,4522.916667,171.3846154,24.36041293
NM_020320,RARS2,20,19,75641,1852,73789,3883.631579,92.6,39.84287257
NM_018064,AKIRIN2,5,4,27409,1937,25472,6368,387.4,13.15023232
NM_033181,CNR1,2,1,5473,5375,98,98,2687.5,0.018232558
NM_030960,SPACA1,7,6,19045,1506,17539,2923.166667,215.1428571,11.64608234
NM_001010853,PM20D2,7,6,19521,4719,14802,2467,674.1428571,3.1366815
NM_080743,SRSF12,5,4,22124,3604,18520,4630,720.8,5.138734739
NM_006813,PNRC1,2,1,4452,2135,2317,2317,1067.5,1.085245902
NM_002043,GABRR2,9,8,58180,2090,56090,7011.25,232.2222222,26.83732057
NM_021244,RRAGD,7,6,47662,4933,42729,7121.5,704.7142857,8.661869045
NM_020466,LYRM2,3,2,6533,5358,1175,587.5,1786,0.219298246
NM_032602,GJA10,1,0,1633,1633,NA,NA,1633,NA
NM_001288630,EPHA7,3,2,9930,1923,8007,4003.5,641,4.163806552
NM_024641,MANEA,5,4,31957,4621,27336,6834,924.2,5.915602683
NM_020482,FHL5,7,6,54090,2142,51948,8658,306,24.25210084
NM_001170807,FHL5,6,5,54090,1910,52180,10436,318.3333333,27.31937173
NM_014165,NDUFAF4,3,2,8582,2414,6168,3084,804.6666667,2.555095278
NM_005604,POU3F2,1,0,4088,4088,NA,NA,4088,NA
NM_015491,PNISR,11,10,25368,3152,22216,2221.6,286.5454545,7.04822335
NM_032870,PNISR,12,11,25368,3233,22135,2012.272727,269.4166667,6.846582122
NM_017421,COQ3,7,6,24736,1272,23464,3910.666667,181.7142857,18.44654088
NM_001080481,USP45,18,17,83070,6404,76666,4509.764706,355.7777778,11.97158026
NM_001195131,TSTD3,4,3,12191,1930,10261,3420.333333,482.5,5.316580311
NM_021620,PRDM13,4,3,8806,3208,5598,1866,802,1.745012469
NM_005068,SIM1,11,10,74803,4006,70797,7079.7,364.1818182,17.67274089
NM_007073,BVES,8,7,39846,5443,34403,4914.714286,680.375,6.32059526
NM_001199563,BVES,8,7,40352,5573,34779,4968.428571,696.625,6.240624439
NM_147147,BVES,8,7,39524,5513,34011,4858.714286,689.125,6.16923635
NM_022361,POPDC3,4,3,22085,1852,20233,6744.333333,463,10.924946
NM_182907,PRDM1,5,4,11079,4758,6321,1580.25,951.6,1.328499369
NM_001198,PRDM1,7,6,23621,5172,18449,3074.833333,738.8571429,3.567092034
NM_032730,RTN4IP1,9,8,58472,2645,55827,6978.375,293.8888889,21.10661626
NM_001624,AIM1,20,19,58606,7572,51034,2686,378.6,6.739830956
NM_001142470,C6orf203,5,4,23416,1799,21617,5404.25,359.8,12.01612007
NM_001142468,C6orf203,4,3,23416,1715,21701,7233.666667,428.75,12.65364431
NM_001080450,BEND3,5,4,49253,6665,42588,10647,1333,6.389797449
NM_016487,C6orf203,4,3,23416,1189,22227,7409,297.25,18.69386039
NM_001286409,SCML4,4,3,30241,4033,26208,8736,1008.25,6.498388297
NM_014028,OSTM1,6,5,33330,4473,28857,5771.4,745.5,6.451374916
NM_003269,NR2E1,9,8,22753,3221,19532,2441.5,357.8888889,6.063955293
NM_001286102,NR2E1,9,8,20788,2628,18160,2270,292,6.910197869
NM_152827,SNX3,3,2,49749,1371,48378,24189,457,35.28665208
NM_003795,SNX3,4,3,49749,1468,48281,16093.66667,367,32.88896458
NM_173830,CEP57L1,11,10,34610,2528,32082,3208.2,229.8181818,12.69066456
NM_001142401,CD164,5,4,16047,3078,12969,3242.25,615.6,4.213450292
NM_006016,CD164,6,5,16047,3118,12929,2585.8,519.6666667,4.146568313
NM_001142404,CD164,6,5,16047,2426,13621,2724.2,404.3333333,5.614591921
NM_001142403,CD164,7,6,16047,2523,13524,2254,360.4285714,5.360285375
NM_001142402,CD164,5,4,16047,3060,12987,3246.75,612,4.244117647
NM_001159291,MICAL1,24,23,11926,3410,8516,370.2608696,142.0833333,2.497360704
NM_003080,SMPD2,10,9,3193,1690,1503,167,169,0.889349112
NM_001286613,MICAL1,25,24,21907,3705,18202,758.4166667,148.2,4.912820513
NM_022765,MICAL1,25,24,11926,3669,8257,344.0416667,146.76,2.250476969
NM_001286361,PPIL6,6,5,50958,3902,47056,9411.2,650.3333333,12.05945669
NM_001286360,PPIL6,7,6,50958,4039,46919,7819.833333,577,11.61648923
NM_001111298,PPIL6,9,8,50958,4215,46743,5842.875,468.3333333,11.08967972
NM_014797,ZBTB24,7,6,20723,5604,15119,2519.833333,800.5714286,2.697894361
NM_001164313,ZBTB24,2,1,2290,1248,1042,1042,624,0.834935897
NM_173672,PPIL6,8,7,50958,4136,46822,6688.857143,517,11.32059961
NM_001286099,GPR6,3,2,2466,1950,516,258,650,0.264615385
NM_005284,GPR6,2,1,2466,1840,626,626,920,0.340217391
NM_015891,CDC40,15,14,51800,3867,47933,3423.785714,257.8,12.39539695
NM_004032,DDO,4,3,23372,1536,21836,7278.666667,384,14.21614583
NM_003649,DDO,5,4,23372,1714,21658,5414.5,342.8,12.63593932
NM_001634,AMD1,9,8,20930,3432,17498,2187.25,381.3333333,5.098484848
NM_001287216,AMD1,5,4,20930,3068,17862,4465.5,613.6,5.822033898
NM_001287214,AMD1,8,7,20930,3344,17586,2512.285714,418,5.258971292
NM_001289111,RPF2,9,8,46248,3663,42585,5323.125,407,11.62571663
NM_032194,RPF2,10,9,46248,3702,42546,4727.333333,370.2,11.49270665
NM_153369,KIAA1919,4,3,9781,3922,5859,1953,980.5,1.493880673
NM_147686,TRAF3IP2,9,8,50898,6241,44657,5582.125,693.4444444,7.15542381
NM_001164281,TRAF3IP2,9,8,50898,6238,44660,5582.5,693.1111111,7.159345944
NM_001164283,TRAF3IP2,4,3,11984,4515,7469,2489.666667,1128.75,1.654263566
NM_153047,FYN,11,10,59732,3034,56698,5669.8,275.8181818,18.6875412
NM_003880,WISP3,6,5,15611,1245,14366,2873.2,207.5,11.53895582
NM_001033564,FAM229B,4,3,15321,2675,12646,4215.333333,668.75,4.727476636
NM_016262,TUBE1,12,11,16893,2309,14584,1325.818182,192.4166667,6.316154179
NM_198239,WISP3,5,4,15518,1324,14194,3548.5,264.8,10.72054381
NM_001105208,LAMA4,2,1,935,769,166,166,384.5,0.215864759
NM_001105209,LAMA4,2,1,935,786,149,149,393,0.18956743
NM_001013734,RFPL4B,3,2,3968,1903,2065,1032.5,634.3333333,1.085128744
NM_002356,MARCKS,2,1,6127,4293,1834,1834,2146.5,0.427207081
NM_001527,HDAC2,14,13,35041,6670,28371,2182.384615,476.4285714,4.253523238
NM_153612,HS3ST5,2,1,7293,2746,4547,4547,1373,1.655863074
NM_002031,FRK,8,7,119230,2857,116373,16624.71429,357.125,40.73258663
NM_000493,COL10A1,3,2,7213,3293,3920,1960,1097.666667,1.190403887
NM_021648,TSPYL4,1,0,4132,4132,NA,NA,4132,NA
NM_003309,TSPYL1,1,0,5260,5260,NA,NA,5260,NA
NM_001276460,FAM26F,2,1,2403,551,1852,1852,275.5,3.361161525
NM_001010919,FAM26F,3,2,2403,1135,1268,634,378.3333333,1.117180617
NM_013352,DSE,6,5,67334,4045,63289,12657.8,674.1666667,15.64622991
NM_015952,RWDD1,7,6,22236,1455,20781,3463.5,207.8571429,14.28247423
NM_001256887,FAM26D,4,3,29857,1495,28362,9454,373.75,18.97123746
NM_001256888,FAM26D,4,3,29857,1401,28456,9485.333333,350.25,20.31120628
NM_001256889,FAM26D,3,2,29857,1278,28579,14289.5,426,22.36228482
NM_153711,FAM26E,2,1,6903,3541,3362,3362,1770.5,0.949449308
NM_153036,FAM26D,3,2,29857,1333,28524,14262,444.3333333,21.39834959
NM_001139444,TRAPPC3L,5,4,49124,1113,48011,12002.75,222.6,43.13656783
NM_001007464,RWDD1,8,7,22236,1570,20666,2952.285714,196.25,13.16305732
NM_016104,RWDD1,9,8,22236,1699,20537,2567.125,188.7777778,12.08769865
NM_001161664,RSPH4A,5,4,16508,2709,13799,3449.75,541.8,5.093761536
NM_001010892,RSPH4A,6,5,16508,2846,13662,2732.4,474.3333333,4.800421644
NM_145062,ZUFSP,10,9,33194,2221,30973,3441.444444,222.1,13.94552004
NM_001286355,GPRC6A,5,4,36974,2674,34300,8575,534.8,12.82722513
NM_148963,GPRC6A,6,5,36974,2888,34086,6817.2,481.3333333,11.80263158
NM_001085480,FAM162B,4,3,13528,1040,12488,4162.666667,260,12.00769231
NM_001286354,GPRC6A,6,5,36974,2363,34611,6922.2,393.8333333,14.64705882
NM_173560,RFX6,19,18,54952,3526,51426,2857,185.5789474,14.58479864
NM_182645,VGLL2,4,3,8009,2235,5774,1924.666667,558.75,2.58344519
NM_153453,VGLL2,3,2,8009,1712,6297,3148.5,570.6666667,3.678154206
NM_020399,GOPC,9,8,42274,4636,37638,4704.75,515.1111111,8.118636756
NM_001017408,GOPC,8,7,42274,4611,37663,5380.428571,576.375,8.168076339
NM_138459,NUS1,5,4,35271,4812,30459,7614.75,962.4,6.329800499
NM_002667,PLN,2,1,12147,1716,10431,10431,858,6.078671329
NM_014034,ASF1A,4,3,15096,2512,12584,4194.666667,628,5.00955414
NM_153255,MCM9,7,6,24567,2497,22070,3678.333333,356.7142857,8.838606328
NM_024581,FAM184A,18,17,118820,4063,114757,6750.411765,225.7222222,28.24440069
NM_001243094,HSF2,7,6,20861,1063,19798,3299.666667,151.8571429,18.62464722
NM_001135564,HSF2,12,11,33570,2655,30915,2810.454545,221.25,11.6440678
NM_020755,SERINC1,10,9,28461,3138,25323,2813.666667,313.8,8.069789675
NM_004506,HSF2,13,12,33570,2710,30860,2571.666667,208.4615385,11.38745387
NM_001270395,PKIB,5,4,73646,1603,72043,18010.75,320.6,44.94260761
NM_001286138,SMPDL3A,7,6,20672,1764,18908,3151.333333,252,10.71882086
NM_001446,FABP7,4,3,4574,1003,3571,1190.333333,250.75,3.560319043
NM_006714,SMPDL3A,8,7,20672,1979,18693,2670.428571,247.375,9.445679636
NM_016063,HDDC2,6,5,26788,1621,25167,5033.4,270.1666667,15.52560148
NM_012259,HEY2,5,4,11685,2677,9008,2252,535.4,3.364960777
NM_138571,HINT3,5,4,23530,3384,20146,5036.5,676.8,5.953309693
NM_001199622,NCOA7,6,5,12808,4058,8750,1750,676.3333333,2.156234598
NM_001286524,CENPW,3,2,9088,1183,7905,3952.5,394.3333333,6.68216399
NM_001286525,CENPW,3,2,9088,1098,7990,3995,366,7.276867031
NM_001012507,CENPW,3,2,9088,1138,7950,3975,379.3333333,6.985940246
NM_032784,RSPO3,5,4,80580,4588,75992,18998,917.6,16.56320837
NM_001242851,RNF146,3,2,21880,2086,19794,9897,695.3333333,9.488974113
NM_030963,RNF146,5,4,21724,2385,19339,4834.75,477,8.108595388
NM_001242852,RNF146,5,4,21824,2635,19189,4797.25,527,7.282352941
NM_001242850,RNF146,3,2,21724,2146,19578,9789,715.3333333,9.123019571
NM_001242849,RNF146,3,2,21824,2416,19408,9704,805.3333333,8.033112583
NM_001242846,RNF146,5,4,21724,2417,19307,4826.75,483.4,7.988001655
NM_001242845,RNF146,5,4,21724,2504,19220,4805,500.8,7.67571885
NM_001242844,RNF146,5,4,21824,2655,19169,4792.25,531,7.219962335
NM_001139510,ECHDC1,6,5,53697,2123,51574,10314.8,353.8333333,24.29298163
NM_014702,KIAA0408,6,5,20986,8130,12856,2571.2,1355,1.581303813
NM_001010905,C6orf58,6,5,14646,1207,13439,2687.8,201.1666667,11.13421707
NM_001277185,SAMD3,11,10,71585,1902,69683,6968.3,172.9090909,36.63669821
NM_001017373,SAMD3,12,11,78654,2121,76533,6957.545455,176.75,36.0834512
NM_001258278,TMEM200A,2,1,21971,2924,19047,19047,1462,6.514021888
NM_001258277,TMEM200A,3,2,76786,2970,73816,36908,990,24.85387205
NM_001258276,TMEM200A,2,1,76786,2905,73881,73881,1452.5,25.432358
NM_052913,TMEM200A,2,1,5950,5023,927,927,2511.5,0.184551065
NM_001195597,SMLR1,2,1,9733,2516,7217,7217,1258,2.868441971
NM_015979,MED23,31,30,54275,4646,49629,1654.3,149.8709677,10.68209212
NM_001270522,MED23,30,29,41503,4497,37006,1276.068966,149.9,8.229041583
NM_000045,ARG1,8,7,11130,1480,9650,1378.571429,185,6.52027027
NM_001244438,ARG1,8,7,11130,1504,9626,1375.142857,188,6.400265957
NM_001270521,MED23,30,29,54275,4627,49648,1712,154.2333333,10.73006268
NM_004830,MED23,29,28,41503,5267,36236,1294.142857,181.6206897,6.879817733
NM_030908,OR2A4,1,0,934,934,NA,NA,934,NA
NM_001145659,CTAGE9,1,0,2578,2578,NA,NA,2578,NA
NM_006208,ENPP1,25,24,87141,7467,79674,3319.75,298.68,10.67014865
NM_001901,CTGF,5,4,3203,2348,855,213.75,469.6,0.364139693
NM_003569,STX7,10,9,55676,4280,51396,5710.666667,428,12.00841121
NM_053278,TAAR8,1,0,1030,1030,NA,NA,1030,NA
NM_175067,TAAR6,1,0,1039,1039,NA,NA,1039,NA
NM_175057,TAAR9,1,0,1050,1050,NA,NA,1050,NA
NM_001033080,TAAR2,2,1,7127,1058,6069,6069,529,5.736294896
NM_014626,TAAR2,1,0,945,945,NA,NA,945,NA
NM_138327,TAAR1,1,0,1021,1021,NA,NA,1021,NA
NM_004666,VNN1,7,6,33199,3851,29348,4891.333333,550.1428571,7.620877694
NM_003967,TAAR5,1,0,1148,1148,NA,NA,1148,NA
NM_001242350,VNN2,5,4,14140,1460,12680,3170,292,8.684931507
NM_052831,SLC18B1,14,13,29242,2439,26803,2061.769231,174.2142857,10.98933989
NM_078488,VNN2,8,7,19591,1954,17637,2519.571429,244.25,9.026100307
NM_001016,RPS12,6,5,2997,509,2488,497.6,84.83333333,4.888015717
NM_004665,VNN2,7,6,14140,2125,12015,2002.5,303.5714286,5.654117647
NM_003206,TCF21,2,1,3135,1271,1864,1864,635.5,1.466561762
NM_198392,TCF21,3,2,6418,3211,3207,1603.5,1070.333333,0.998754282
NM_001253676,TBPL1,7,6,35332,1633,33699,5616.5,233.2857143,20.6362523
NM_004865,TBPL1,7,6,34339,1335,33004,5500.666667,190.7142857,24.72209738
NM_005627,SGK1,12,11,5652,2419,3233,293.9090909,201.5833333,1.336502687
NM_001143678,SGK1,12,11,6688,2643,4045,367.7272727,220.25,1.530457813
NM_001143677,SGK1,12,11,8628,2464,6164,560.3636364,205.3333333,2.501623377
NM_006620,HBS1L,18,17,94521,7180,87341,5137.705882,398.8888889,12.16448468
NM_001145207,HBS1L,5,4,19043,2812,16231,4057.75,562.4,5.772048364
NM_001145158,HBS1L,17,16,94521,7053,87468,5466.75,414.8823529,12.40153126
NM_138419,MTFR2,8,7,19283,1513,17770,2538.571429,189.125,11.74487773
NM_001099286,MTFR2,8,7,19283,1801,17482,2497.428571,225.125,9.706829539
NM_001077440,BCLAF1,12,11,32990,7122,25868,2351.636364,593.5,3.632125807
NM_001077441,BCLAF1,13,12,32990,6757,26233,2186.083333,519.7692308,3.882344236
NM_014739,BCLAF1,13,12,32990,7276,25714,2142.833333,559.6923077,3.534084662
NM_001008783,SLC35D3,2,1,3376,2360,1016,1016,1180,0.430508475
NM_000416,IFNGR1,7,6,21948,2127,19821,3303.5,303.8571429,9.318758815
NM_175747,OLIG3,1,0,2197,2197,NA,NA,2197,NA
NM_006290,TNFAIP3,9,8,16128,4699,11429,1428.625,522.1111111,2.432219621
NM_001270508,TNFAIP3,9,8,16128,4747,11381,1422.625,527.4444444,2.39751422
NM_001270507,TNFAIP3,9,8,16128,4723,11405,1425.625,524.7777778,2.414778742
NM_021635,PBOV1,1,0,2502,2502,NA,NA,2502,NA
NM_014320,HEBP2,4,3,9248,1286,7962,2654,321.5,6.191290824
NM_015439,CCDC28A,6,5,19801,1502,18299,3659.8,250.3333333,12.18308921
NM_001286611,REPS1,20,19,84248,4039,80209,4221.526316,201.95,19.85862837
NM_031922,REPS1,20,19,84248,4036,80212,4221.684211,201.8,19.8741328
NM_001286612,REPS1,17,16,84248,3763,80485,5030.3125,221.3529412,21.3885198
NM_001128617,REPS1,19,18,84248,3957,80291,4460.611111,208.2631579,20.29087693
NM_021243,ABRACL,3,2,14622,848,13774,6887,282.6666667,16.24292453
NM_001168389,CITED2,2,1,1960,1782,178,178,891,0.099887767
NM_001168388,CITED2,2,1,2109,1799,310,310,899.5,0.172317954
NM_006079,CITED2,2,1,2397,1938,459,459,969,0.236842105
NM_002511,NMBR,3,2,13193,1357,11836,5918,452.3333333,8.722181282
NM_182503,ADAT2,6,5,27874,6259,21615,4323,1043.166667,3.453427065
NM_001286259,ADAT2,6,5,19847,7357,12490,2498,1226.166667,1.697702868
NM_032020,FUCA2,7,6,17073,2555,14518,2419.666667,365,5.682191781
NM_001013623,ZC2HC1B,8,7,73912,1000,72912,10416,125,72.912
NM_031287,SF3B5,1,0,738,738,NA,NA,738,NA
NM_003764,STX11,2,1,41424,5506,35918,35918,2753,6.523428987
NM_032145,FBXO30,3,2,16651,4410,12241,6120.5,1470,2.775736961
NM_006834,RAB32,3,2,11260,1206,10054,5027,402,8.336650083
NM_207360,ZC3H12D,6,5,37384,4913,32471,6494.2,818.8333333,6.609200081
NM_001002255,SUMO4,1,0,689,689,NA,NA,689,NA
NM_138785,GINM1,8,7,24541,1117,23424,3346.285714,139.625,20.97045658
NM_139126,PPIL4,13,12,41609,2547,39062,3255.166667,195.9230769,15.33647428
NM_198887,NUP43,8,7,22258,3881,18377,2625.285714,485.125,4.735119814
NM_001270519,LATS1,4,3,35339,2722,32617,10872.33333,680.5,11.98273328
NM_004690,LATS1,8,7,60105,7525,52580,7511.428571,940.625,6.987375415
NM_032832,LRP11,7,6,45588,3625,41963,6993.833333,517.8571429,11.576
NM_025218,ULBP1,5,4,9705,3147,6558,1639.5,629.4,2.083889418
NM_001243327,RAET1E,3,2,1940,1010,930,465,336.6666667,0.920792079
NM_001243325,RAET1E,4,3,2571,854,1717,572.3333333,213.5,2.010538642
NM_139165,RAET1E,4,3,2571,962,1609,536.3333333,240.5,1.672557173
NM_025217,ULBP2,5,4,7234,1351,5883,1470.75,270.2,4.354552184
NM_001001788,RAET1G,5,4,6202,1112,5090,1272.5,222.4,4.577338129
NM_130900,RAET1L,4,3,5404,806,4598,1532.666667,201.5,5.70471464
NM_024518,ULBP3,4,3,4461,739,3722,1240.666667,184.75,5.036535859
NM_001164695,IYD,6,5,35739,7469,28270,5654,1244.833333,3.784977909
NM_001164694,IYD,6,5,35739,7520,28219,5643.8,1253.333333,3.752526596
NM_203395,IYD,5,4,35739,7407,28332,7083,1481.4,3.825030377
NM_001242769,MTHFD1L,8,7,33323,1073,32250,4607.142857,134.125,30.05591799
NM_001271937,RMND1,11,10,47421,1496,45925,4592.5,136,30.69852941
NM_020861,ZBTB2,3,2,27429,3089,24340,12170,1029.666667,7.879572677
NM_017909,RMND1,12,11,47421,2015,45406,4127.818182,167.9166667,22.53399504
NM_025107,MYCT1,2,1,26687,3045,23642,23642,1522.5,7.764203612
NM_194435,VIP,7,6,8972,1591,7381,1230.166667,227.2857143,4.639220616
NM_003381,VIP,7,6,8972,1594,7378,1229.666667,227.7142857,4.628607277
NM_012177,FBXO5,5,4,12547,2098,10449,2612.25,419.6,4.980457579
NM_019041,MTRF1L,7,6,15527,3885,11642,1940.333333,555,2.996653797
NM_001142522,FBXO5,5,4,13084,2258,10826,2706.5,451.6,4.794508415
NM_001114184,MTRF1L,6,5,15527,3747,11780,2356,624.5,3.143848412
NM_001145287,OPRM1,4,3,45849,15848,30001,10000.33333,3962,1.893046441
NM_001285528,OPRM1,3,2,2178,1071,1107,553.5,357,1.033613445
NM_001285527,OPRM1,2,1,2178,1406,772,772,703,0.549075391
NM_001285526,OPRM1,4,3,45849,15829,30020,10006.66667,3957.25,1.896519047
NM_001010927,TIAM2,13,12,40762,2681,38081,3173.416667,206.2307692,14.20402835
NM_001001346,CLDN20,2,1,12537,1211,11326,11326,605.5,9.352601156
NM_015718,NOX3,14,13,60537,2058,58479,4498.384615,147,28.4154519
NM_018452,TMEM242,4,3,35201,5031,30170,10056.66667,1257.75,5.996819718
NM_032861,SERAC1,17,16,58778,3986,54792,3424.5,234.4705882,13.74611139
NM_006519,DYNLT1,5,4,8299,763,7536,1884,152.6,9.876802097
NM_003379,EZR,13,12,52569,3162,49407,4117.25,243.2307692,15.62523719
NM_001111077,EZR,14,13,53685,3129,50556,3888.923077,223.5,16.15723873
NM_001195032,C6orf99,3,2,21768,641,21127,10563.5,213.6666667,32.95943838
NM_001278733,TAGAP,6,5,7886,3521,4365,873,586.8333333,1.239704629
NM_031924,RSPH3,8,7,22934,2185,20749,2964.142857,273.125,9.49610984
NM_152133,TAGAP,9,8,10685,3728,6957,869.625,414.2222222,1.866148069
NM_138810,TAGAP,8,7,6242,1325,4917,702.4285714,165.625,3.710943396
NM_054114,TAGAP,10,9,10685,3896,6789,754.3333333,389.6,1.742556468
NM_000636,SOD2,5,4,11600,1598,10002,2500.5,319.6,6.259073842
NM_001024466,SOD2,5,4,14206,912,13294,3323.5,182.4,14.57675439
NM_001024465,SOD2,6,5,14206,1030,13176,2635.2,171.6666667,12.79223301
NM_001271862,PNLDC1,19,18,20457,1861,18596,1033.111111,97.94736842,9.992477163
NM_005891,ACAT2,9,8,17100,1560,15540,1942.5,173.3333333,9.961538462
NM_030752,TCP1,12,11,11207,2465,8742,794.7272727,205.4166667,3.546450304
NM_001008897,TCP1,11,10,11207,2378,8829,882.9,216.1818182,3.712783852
NM_014161,MRPL18,4,3,7971,981,6990,2330,245.25,7.125382263
NM_173516,PNLDC1,19,18,20457,1960,18497,1027.611111,103.1578947,9.437244898
NM_002377,MAS1,1,0,1135,1135,NA,NA,1135,NA
NM_003058,SLC22A2,11,10,42171,2523,39648,3964.8,229.3636364,15.71462545
NM_000301,PLG,19,18,51862,3556,48306,2683.666667,187.1578947,13.58436445
NM_001168338,PLG,4,3,9681,1204,8477,2825.666667,301,7.040697674
NM_144980,C6orf118,9,8,29960,1848,28112,3514,205.3333333,15.21212121
NM_003181,T,9,8,11013,2493,8520,1065,277,3.417569194
NM_001270484,T,8,7,11013,2225,8788,1255.428571,278.125,3.949662921
NM_175922,PRR18,1,0,2705,2705,NA,NA,2705,NA
NM_145169,SFT2D1,8,7,22476,698,21778,3111.142857,87.25,31.20057307
NM_016098,MPC1,4,3,18095,979,17116,5705.333333,244.75,17.48314607
NM_001270879,MPC1,5,4,18095,1196,16899,4224.75,239.2,14.12959866
NM_003730,RNASET2,9,8,27075,1259,25816,3227,139.8888889,20.50516283
NM_001278690,FGFR1OP,11,10,43103,3462,39641,3964.1,314.7272727,11.45031774
NM_194429,FGFR1OP,12,11,43103,3688,39415,3583.181818,307.3333333,10.68736443
NM_007045,FGFR1OP,13,12,43103,3749,39354,3279.5,288.3846154,10.49719925
NM_001145121,TCP10L2,8,7,12317,2193,10124,1446.285714,274.125,4.616507068
NM_031409,CCR6,3,2,16390,3482,12908,6454,1160.666667,3.707064905
NM_005299,GPR31,1,0,961,961,NA,NA,961,NA
NM_004367,CCR6,3,2,27336,3219,24117,12058.5,1073,7.492078285
NM_031949,TTLL2,3,2,17605,2880,14725,7362.5,960,5.112847222
NM_001143947,UNC93A,7,6,24701,1992,22709,3784.833333,284.5714286,11.4001004
NM_018974,UNC93A,8,7,24701,2119,22582,3226,264.875,10.65691364
NM_004610,TCP10,8,7,11423,1281,10142,1448.857143,160.125,7.917252147
NM_001129895,HGC6.3,1,0,1017,1017,NA,NA,1017,NA
NM_001122841,FRMD1,11,10,20084,2889,17195,1719.5,262.6363636,5.951886466
NM_024919,FRMD1,11,10,23377,3039,20338,2033.8,276.2727273,6.692333004
NM_214462,DACT2,4,3,12852,2978,9874,3291.333333,744.5,3.315648086
NM_001286351,DACT2,6,5,26926,2034,24892,4978.4,339,12.23795477
NM_001286350,DACT2,3,2,12852,2454,10398,5199,818,4.237163814
NM_003247,THBS2,23,22,38336,5904,32432,1474.181818,256.6956522,5.493224932
NM_133325,PHF10,12,11,20106,1679,18427,1675.181818,139.9166667,10.97498511
NM_001029863,C6orf120,1,0,4147,4147,NA,NA,4147,NA
NM_018288,PHF10,12,11,20106,1685,18421,1674.636364,140.4166667,10.93234421
NM_001278533,ERMARD,17,16,29964,1942,28022,1751.375,114.2352941,14.42945417
NM_001278532,ERMARD,17,16,29964,1992,27972,1748.25,117.1764706,14.04216867
NM_001278531,ERMARD,18,17,29964,2021,27943,1643.705882,112.2777778,13.8263236
NM_018341,ERMARD,18,17,29964,2162,27802,1635.411765,120.1111111,12.85938945
NM_174910,TCTE3,4,3,11425,751,10674,3558,187.75,14.21304927
NM_005618,DLL1,11,10,8405,3321,5084,508.4,301.9090909,1.530864198
NM_001172085,TBP,7,6,18539,1709,16830,2805,244.1428571,9.847864248
NM_001199464,PDCD2,5,4,2909,1156,1753,438.25,231.2,1.516435986
NM_001199463,PDCD2,4,3,2909,1946,963,321,486.5,0.494861254
NM_001199462,PDCD2,7,6,9084,3003,6081,1013.5,429,2.024975025
NM_001199461,PDCD2,4,3,2947,1292,1655,551.6666667,323,1.280959752
NM_003194,TBP,8,7,18539,1912,16627,2375.285714,239,8.696129707
NM_002598,PDCD2,6,5,9122,3139,5983,1196.6,523.1666667,1.906021026
NM_002793,PSMB1,6,5,18215,923,17292,3458.4,153.8333333,18.73456121
NM_144781,PDCD2,3,2,2947,2082,865,432.5,694,0.415465898
NM_020299,AKR1B10,10,9,13824,1606,12218,1357.555556,160.6,7.607721046
NM_198428,BBS9,23,22,476530,4042,472488,21476.72727,175.7391304,116.8946066
NM_014451,BBS9,21,20,476530,3920,472610,23630.5,186.6666667,120.5637755
NM_001033605,BBS9,22,21,476530,4026,472504,22500.19048,183,117.3631396
NM_001033604,BBS9,22,21,476530,3936,472594,22504.47619,178.9090909,120.0696138
NM_001145306,CDK6,8,7,231708,11725,219983,31426.14286,1465.625,18.76187633
NM_001259,CDK6,8,7,228998,11620,217378,31054,1452.5,18.70722892
NM_033427,CTTNBP2,23,22,162857,5992,156865,7130.227273,260.5217391,26.1790721
NM_019841,TRPV5,15,14,25174,2501,22673,1619.5,166.7333333,9.06557377
NM_001033519,WIPI2,12,11,43653,4414,39239,3567.181818,367.8333333,8.889669234
NM_015610,WIPI2,13,12,43653,4502,39151,3262.583333,346.3076923,8.696357175
NM_001278299,WIPI2,13,12,43653,4676,38977,3248.083333,359.6923077,8.335543199
NM_001134395,C7orf50,5,4,141272,1288,139984,34996,257.6,108.6832298
NM_001033518,WIPI2,13,12,43653,4469,39184,3265.333333,343.7692308,8.767957037
NM_032350,C7orf50,5,4,141272,1298,139974,34993.5,259.6,107.8382126
NM_001134396,C7orf50,5,4,141272,1269,140003,35000.75,253.8,110.3254531
NM_001013837,MAD1L1,19,18,417157,2717,414440,23024.44444,143,152.5358852
NM_016003,WIPI2,12,11,43653,4447,39206,3564.181818,370.5833333,8.816280639
NM_001079653,SDK1,20,19,139316,3132,136184,7167.578947,156.6,43.48148148
NM_001013836,MAD1L1,19,18,417157,2720,414437,23024.27778,143.1578947,152.3665441
NM_152744,SDK1,45,44,967553,10441,957112,21752.54545,232.0222222,91.66861412
NM_004227,CYTH3,13,12,110832,4480,106352,8862.666667,344.6153846,23.73928571
NM_003550,MAD1L1,19,18,417157,2757,414400,23022.22222,145.1052632,150.3083061
NM_015204,THSD7A,27,26,461764,10612,451152,17352,393.037037,42.51338108
NM_145695,DGKB,24,23,665471,3376,662095,28786.73913,140.6666667,196.1181872
NM_004080,DGKB,25,24,696403,6709,689694,28737.25,268.36,102.8013117
NM_178425,HDAC9,25,24,501109,4583,496526,20688.58333,183.32,108.3408248
NM_178423,HDAC9,26,25,501625,4684,496941,19877.64,180.1538462,106.0932963
NM_058176,HDAC9,23,22,458056,3163,454893,20676.95455,137.5217391,143.8169459
NM_004067,CHN2,13,12,319825,3450,316375,26364.58333,265.3846154,91.70289855
NM_004289,NFE2L3,4,3,34911,3714,31197,10399,928.5,8.399838449
NM_024728,SUGCT,15,14,725793,1632,724161,51725.78571,108.8,443.7261029
NM_001177507,AOAH,20,19,211607,2362,209245,11012.89474,118.1,88.58806097
NM_001177506,AOAH,22,21,211607,2579,209028,9953.714286,117.2272727,81.05001939
NM_080631,VPS41,28,27,185259,4847,180412,6681.925926,173.1071429,37.22137405
NM_001193312,SUGCT,13,12,725793,1519,724274,60356.16667,116.8461538,476.8097433
NM_001193311,SUGCT,15,14,725793,1743,724050,51717.85714,116.2,415.404475
NM_001637,AOAH,21,20,211607,2459,209148,10457.4,117.0952381,85.05408703
NM_014396,VPS41,29,28,185259,4923,180336,6440.571429,169.7586207,36.63132236
NM_001193313,SUGCT,14,13,725793,1664,724129,55702.23077,118.8571429,435.1736779
NM_031443,CCM2,10,9,76284,1904,74380,8264.444444,190.4,39.06512605
NM_001029835,CCM2,10,9,48838,1892,46946,5216.222222,189.2,24.81289641
NM_001167934,CCM2,9,8,76284,1729,74555,9319.375,192.1111111,43.12030075
NM_152701,ABCA13,62,61,476036,17246,458790,7521.147541,278.1612903,26.60269048
NM_001167935,CCM2,8,7,76284,1629,74655,10665,203.625,45.82872928
NM_030796,VOPP1,5,4,101896,2949,98947,24736.75,589.8,33.55272974
NM_001287438,COBL,8,7,245991,3846,242145,34592.14286,480.75,62.96021841
NM_001287436,COBL,14,13,300608,5354,295254,22711.84615,382.4285714,55.14643257
NM_015198,COBL,13,12,300608,5323,295285,24607.08333,409.4615385,55.47341725
NM_001284283,VOPP1,5,4,68061,2772,65289,16322.25,554.4,23.5530303
NM_001284282,VOPP1,5,4,82167,2838,79329,19832.25,567.6,27.95243129
NM_001284284,VOPP1,5,4,67110,2933,64177,16044.25,586.6,21.88100921
NM_015570,AUTS2,19,18,1193981,6436,1187545,65974.72222,338.7368421,184.5160037
NM_148842,WBSCR16,11,10,48495,2432,46063,4606.3,221.0909091,18.94037829
NM_031468,CALN1,7,6,632886,9468,623418,103903,1352.571429,65.84474018
NM_001257190,POM121,16,15,72075,7057,65018,4334.533333,441.0625,9.213263426
NM_001127232,AUTS2,5,4,691703,1653,690050,172512.5,330.6,417.4531155
NM_001127231,AUTS2,18,17,1193572,5954,1187618,69859.88235,330.7777778,199.4655694
NM_001017440,CALN1,6,5,557734,9477,548257,109651.4,1579.5,57.85132426
NM_012301,MAGI2,22,21,1436518,6902,1429616,68076.95238,313.7272727,207.1306868
NM_000722,CACNA2D1,39,38,493615,3861,489754,12888.26316,99,126.8464128
NM_000443,ABCB4,28,27,73660,3995,69665,2580.185185,142.6785714,17.43804756
NM_018850,ABCB4,27,26,73660,3853,69807,2684.884615,142.7037037,18.11757072
NM_018849,ABCB4,28,27,73660,4016,69644,2579.407407,143.4285714,17.34163347
NM_001135557,DYNC1I1,16,15,325920,2951,322969,21531.26667,184.4375,109.4439173
NM_001135556,DYNC1I1,17,16,325920,3012,322908,20181.75,177.1764706,107.2071713
NM_003439,ZKSCAN1,6,5,26119,9433,16686,3337.2,1572.166667,1.768896427
NM_001278422,DYNC1I1,16,15,337818,2353,335465,22364.33333,147.0625,142.5690608
NM_001278421,DYNC1I1,16,15,325920,3002,322918,21527.86667,187.625,107.5676216
NM_003496,TRRAP,71,70,134755,12661,122094,1744.2,178.3239437,9.643314114
NM_001244580,TRRAP,72,71,134755,12749,122006,1718.394366,177.0694444,9.569848616
NM_001287055,ZKSCAN1,4,3,26119,8763,17356,5785.333333,2190.75,1.980600251
NM_004411,DYNC1I1,17,16,325920,3063,322857,20178.5625,180.1764706,105.4054848
NM_001287054,ZKSCAN1,8,7,26119,9464,16655,2379.285714,1183,1.759826712
NM_006348,COG5,22,21,362772,4902,357870,17041.42857,222.8181818,73.00489596
NM_182691,SRPK2,15,14,152705,3780,148925,10637.5,252,39.39814815
NM_182692,SRPK2,16,15,272558,3704,268854,17923.6,231.5,72.58477322
NM_001193584,NRCAM,29,28,308772,6342,302430,10801.07143,218.6896552,47.68684957
NM_001193583,NRCAM,30,29,308772,6379,302393,10427.34483,212.6333333,47.40445211
NM_001193582,NRCAM,31,30,308772,6437,302335,10077.83333,207.6451613,46.96830822
NM_001161520,COG5,21,20,356663,5687,350976,17548.8,270.8095238,61.71549147
NM_005746,NAMPT,11,10,36908,4592,32316,3231.6,417.4545455,7.037456446
NM_002553,ORC5,14,13,81709,1972,79737,6133.615385,140.8571429,40.43458418
NM_198990,NAPEPLD,6,5,49548,5068,44480,8896,844.6666667,8.776637727
NM_181747,ORC5,9,8,39873,1326,38547,4818.375,147.3333333,29.07013575
NM_001122838,NAPEPLD,5,4,49548,5368,44180,11045,1073.6,8.230253353
NM_001278273,SRPK2,17,16,182407,3729,178678,11167.375,219.3529412,47.91579512
NM_001202543,CUX1,24,23,442331,13893,428438,18627.73913,578.875,30.83840783
NM_005010,NRCAM,28,27,308772,6350,302422,11200.81481,226.7857143,47.62551181
NM_181552,CUX1,24,23,440633,13771,426862,18559.21739,573.7916667,30.99716796
NM_181733,COG5,21,20,362772,4838,357934,17896.7,230.3809524,73.98387764
NM_001202544,CUX1,22,21,468068,3006,465062,22145.80952,136.6363636,154.7112442
NM_001202545,CUX1,22,21,468068,2916,465152,22150.09524,132.5454545,159.5171468
NM_001913,CUX1,23,22,468068,3055,465013,21136.95455,132.826087,152.213748
NM_181500,CUX1,23,22,468068,3049,465019,21137.22727,132.5652174,152.5152509
NM_001202546,CUX1,22,21,467964,2833,465131,22149.09524,128.7727273,164.183198
NM_001172766,FOXP2,17,16,278777,6382,272395,17024.6875,375.4117647,42.6817612
NM_001127500,MET,21,20,125983,6697,119286,5964.3,318.9047619,17.81185605
NM_000245,MET,21,20,125983,6643,119340,5967,316.3333333,17.96477495
NM_032549,IMMP2L,6,5,899243,1529,897714,179542.8,254.8333333,587.1249182
NM_148898,FOXP2,18,17,278777,6461,272316,16018.58824,358.9444444,42.14765516
NM_148900,FOXP2,18,17,278777,6437,272340,16020,357.6111111,42.30852882
NM_014491,FOXP2,17,16,278777,6385,272392,17024.5,375.5882353,42.66123727
NM_001244606,IMMP2L,7,6,899469,1216,898253,149708.8333,173.7142857,738.6949013
NM_001206839,PTPRZ1,29,28,188933,5587,183346,6548.071429,192.6551724,32.81653839
NM_001206838,PTPRZ1,30,29,188933,5609,183324,6321.517241,186.9666667,32.68390087
NM_002851,PTPRZ1,30,29,188933,8189,180744,6232.551724,272.9666667,22.07155941
NM_001868,CPA1,10,9,7661,1439,6222,691.3333333,143.9,4.323835997
NM_001130720,AHCYL2,17,16,205199,5079,200120,12507.5,298.7647059,39.40145698
NM_001127323,GRM8,11,10,813778,3871,809907,80990.7,351.9090909,209.2242315
NM_020911,PLXNA4,32,31,453234,13093,440141,14198.09677,409.15625,33.61651264
NM_021807,EXOC4,18,17,812692,4210,808482,47557.76471,233.8888889,192.0384798
NM_013255,MKLN1,18,17,168805,11201,157604,9270.823529,622.2777778,14.07052942
NM_000845,GRM8,10,9,804919,3569,801350,89038.88889,356.9,224.5306809
NM_001145354,MKLN1,19,18,386545,11274,375271,20848.38889,593.3684211,33.28641121
NM_001105543,PLXNA4,4,3,193078,3412,189666,63222,853,55.58792497
NM_015328,AHCYL2,17,16,205199,5082,200117,12507.3125,298.9411765,39.37760724
NM_022740,HIPK2,15,14,231379,15240,216139,15438.5,1016,14.18234908
NM_130840,ATP6V0A4,21,20,91904,3054,88850,4442.5,145.4285714,29.0929928
NM_015135,NUP205,43,42,90839,6308,84531,2012.642857,146.6976744,13.40060241
NM_130841,ATP6V0A4,21,20,67745,3112,64633,3231.65,148.1904762,20.76895887
NM_020632,ATP6V0A4,22,21,91904,3158,88746,4226,143.5454545,28.10196327
NM_001113239,HIPK2,15,14,231379,15159,216220,15444.28571,1010.6,14.26347384
NM_004717,DGKI,34,33,457226,4814,452412,13709.45455,141.5882353,93.97839634
NM_004333,BRAF,18,17,190753,2964,187789,11046.41176,164.6666667,63.35661269
NM_001164459,ACTR3C,8,7,55770,1227,54543,7791.857143,153.375,44.45232274
NM_003575,ZNF282,8,7,30764,3729,27035,3862.142857,466.125,7.249932958
NM_014141,CNTNAP2,24,23,2304637,9916,2294721,99770.47826,413.1666667,231.4159944
NM_001164458,ACTR3C,8,7,76459,1289,75170,10738.57143,161.125,58.31652444
NM_002847,PTPRN2,23,22,1048734,4850,1043884,47449.27273,210.8695652,215.2338144
NM_001936,DPP6,26,25,683650,4476,679174,27166.96,172.1538462,151.7368186
NM_130843,PTPRN2,22,21,1048734,4762,1043972,49712.95238,216.4545455,219.2297354
NM_130842,PTPRN2,22,21,1048734,4798,1043936,49711.2381,218.0909091,217.5773239
NM_001039350,DPP6,26,25,1101578,4587,1096991,43879.64,176.4230769,239.1521692
NM_170606,KMT2C,59,58,301082,16921,284161,4899.327586,286.7966102,16.79339283
NM_130797,DPP6,26,25,936220,4558,931662,37266.48,175.3076923,204.4014919
NM_001164762,PRKAR1B,11,10,163745,2505,161240,16124,227.7272727,64.36726547
NM_001164761,PRKAR1B,11,10,164012,2565,161447,16144.7,233.1818182,62.94230019
NM_001164759,PRKAR1B,11,10,178481,2434,176047,17604.7,221.2727273,72.32826623
NM_001164760,PRKAR1B,11,10,178146,2544,175602,17560.2,231.2727273,69.0259434
NM_001164758,PRKAR1B,11,10,178481,2499,175982,17598.2,227.1818182,70.42096839
NM_015949,GET4,9,8,19882,2097,17785,2223.125,233,8.481163567
NM_002735,PRKAR1B,11,10,163329,2523,160806,16080.6,229.3636364,63.73602854
NM_017802,HEATR2,13,12,59780,3427,56353,4696.083333,263.6153846,16.44382842
NM_020223,FAM20C,10,9,107773,2790,104983,11664.77778,279,37.62831541
NM_002360,MAFK,3,2,12313,3353,8960,4480,1117.666667,2.67223382
NM_032415,CARD11,25,24,137871,4456,133415,5558.958333,178.24,29.94052962
NM_133463,AMZ1,7,6,35916,4430,31486,5247.666667,632.8571429,7.10744921
NM_007353,GNA12,4,3,116220,4388,111832,37277.33333,1097,25.48587056
NM_001287500,IQCE,20,19,48592,2486,46106,2426.631579,124.3,18.54625905
NM_001287499,IQCE,21,20,48592,2535,46057,2302.85,120.7142857,18.16844181
NM_001287502,IQCE,19,18,48592,2439,46153,2564.055556,128.3684211,18.92291923
NM_001287501,IQCE,20,19,55764,6796,48968,2577.263158,339.8,7.20541495
NM_152558,IQCE,22,21,55764,6892,48872,2327.238095,313.2727273,7.091120139
NM_001284355,AMZ1,6,5,27236,4204,23032,4606.4,700.6666667,5.478591817
NM_001270375,MMD2,8,7,53226,2402,50824,7260.571429,300.25,21.15903414
NM_001204513,RBAK-RBAKDN,6,5,27404,864,26540,5308,144,30.71759259
NM_018059,RADIL,15,14,84597,3685,80912,5779.428571,245.6666667,21.95712347
NM_001100600,MMD2,7,6,53226,2423,50803,8467.166667,346.1428571,20.96698308
NM_198403,MMD2,7,6,53226,2351,50875,8479.166667,335.8571429,21.63972778
NM_032172,USP42,18,17,56647,5138,51509,3029.941176,285.4444444,10.02510705
NM_000535,PMS2,15,14,35869,2851,33018,2358.428571,190.0666667,11.58119958
NM_003088,FSCN1,5,4,13853,2801,11052,2763,560.2,3.945733667
NM_001080495,TNRC18,30,29,116756,10600,106156,3660.551724,353.3333333,10.01471698
NM_207116,RNF216,17,16,161691,5696,155995,9749.6875,335.0588235,27.38676264
NM_207111,RNF216,17,16,161691,5867,155824,9739,345.1176471,26.55940003
NM_001278559,ZNF316,9,8,20959,7248,13711,1713.875,805.3333333,1.89169426
NM_006908,RAC1,6,5,29474,2347,27127,5425.4,391.1666667,11.55815935
NM_018890,RAC1,7,6,29474,2405,27069,4511.5,343.5714286,11.25530146
NM_001145118,GRID2IP,22,21,54660,4654,50006,2381.238095,211.5454545,10.74473571
NM_001099697,RSPH10B2,21,20,44658,3127,41531,2076.55,148.9047619,13.28141989
NM_173565,RSPH10B,21,20,44658,3127,41531,2076.55,148.9047619,13.28141989
NM_001276478,ICA1,14,13,149429,2453,146976,11305.84615,175.2142857,59.91683653
NM_001037763,COL28A1,35,34,177218,3550,173668,5107.882353,101.4285714,48.92056338
NM_138426,GLCCI1,8,7,120337,4801,115536,16505.14286,600.125,24.06498646
NM_002947,RPA3,8,7,81665,1602,80063,11437.57143,200.25,49.97690387
NM_022307,ICA1,14,13,148869,2271,146598,11276.76923,162.2142857,64.55217966
NM_001136020,ICA1,14,13,149098,2471,146627,11279,176.5,59.33913395
NM_004968,ICA1,14,13,149429,2456,146973,11305.61538,175.4285714,59.84242671
NM_152745,NXPH1,3,2,319010,2924,316086,158043,974.6666667,108.1005472
NM_014660,PHF14,17,16,133879,8387,125492,7843.25,493.3529412,14.96268034
NM_001163152,ETV1,9,8,95285,6107,89178,11147.25,678.5555556,14.6025872
NM_001163151,ETV1,9,8,95285,6242,89043,11130.375,693.5555556,14.26513938
NM_001163150,ETV1,10,9,95285,6297,88988,9887.555556,629.7,14.1318088
NM_001163149,ETV1,12,11,100011,6233,93778,8525.272727,519.4166667,15.0454035
NM_001163148,ETV1,13,12,100196,6363,93833,7819.416667,489.4615385,14.74666038
NM_001163147,ETV1,12,11,98788,6554,92234,8384.909091,546.1666667,14.07293256
NM_004956,ETV1,14,13,98788,6822,91966,7074.307692,487.2857143,13.48079742
NM_001004320,AGMO,13,12,361699,2488,359211,29934.25,191.3846154,144.3774116
NM_001101426,ISPD,10,9,333797,5534,328263,36473.66667,553.4,59.31749187
NM_001101417,ISPD,9,8,333797,5383,328414,41051.75,598.1111111,61.00947427
NM_020319,ANKMY2,10,9,46043,2565,43478,4830.888889,256.5,16.95048733
NM_176813,AGR3,8,7,22585,758,21827,3118.142857,94.75,28.79551451
NM_001204145,HDAC9,11,10,173099,4118,168981,16898.1,374.3636364,41.03472559
NM_001204148,HDAC9,11,10,159568,4257,155311,15531.1,387,36.48367395
NM_015132,SNX13,26,25,149748,6397,143351,5734.04,246.0384615,22.40909801
NM_001204146,HDAC9,11,10,173099,4296,168803,16880.3,390.5454545,39.29306331
NM_001204144,HDAC9,13,12,581896,4457,577439,48119.91667,342.8461538,129.5577743
NM_014707,HDAC9,12,11,173098,4250,168848,15349.81818,354.1666667,39.72894118
NM_001204147,HDAC9,10,9,159568,4109,155459,17273.22222,410.9,37.83377951
NM_152774,TMEM196,4,3,53468,3368,50100,16700,842,14.87529691
NM_182762,MACC1,7,6,82736,9165,73571,12261.83333,1309.285714,8.027386798
NM_178559,ABCB5,19,18,109673,4394,105279,5848.833333,231.2631579,23.9597178
NM_002214,ITGB8,14,13,84659,8791,75868,5836,627.9285714,8.630189967
NM_001163941,ABCB5,28,27,141394,5429,135965,5035.740741,193.8928571,25.04420704
NM_001277115,DNAH11,82,81,358355,13978,344377,4251.567901,170.4634146,24.63707254
NM_003112,SP4,6,5,86464,5806,80658,16131.6,967.6666667,13.8921805
NM_012294,RAPGEF5,26,25,238627,6648,231979,9279.16,255.6923077,34.89455475
NM_199136,FAM221A,7,6,22522,1479,21043,3507.166667,211.2857143,14.22785666
NM_001127364,FAM221A,6,5,22522,1370,21152,4230.4,228.3333333,15.43941606
NM_001127365,FAM221A,5,4,22522,1195,21327,5331.75,239,17.84686192
NM_001031710,KLHL7,11,10,69687,3186,66501,6650.1,289.6363636,20.87288136
NM_032944,STK31,24,23,122187,3592,118595,5156.304348,149.6666667,33.01642539
NM_001260505,STK31,23,22,122346,3278,119068,5412.181818,142.5217391,36.32336791
NM_006547,IGF2BP3,15,14,160169,4174,155995,11142.5,278.2666667,37.37302348
NM_001260504,STK31,24,23,122187,3624,118563,5154.913043,151,32.7160596
NM_018846,KLHL7,11,10,69123,3270,65853,6585.3,297.2727273,20.13853211
NM_031414,STK31,24,23,122346,3348,118998,5173.826087,139.5,35.54301075
NM_001127454,DFNA5,9,8,59667,2274,57393,7174.125,252.6666667,25.23878628
NM_001127453,DFNA5,10,9,59111,2260,56851,6316.777778,226,25.15530973
NM_145322,OSBPL3,20,19,96086,6278,89808,4726.736842,313.9,14.30519274
NM_145321,OSBPL3,21,20,96086,6372,89714,4485.7,303.4285714,14.07940992
NM_145320,OSBPL3,21,20,96086,6387,89699,4484.95,304.1428571,14.04399562
NM_015550,OSBPL3,23,22,183677,6809,176868,8039.454545,296.0434783,25.9756205
NM_016447,MPP6,13,12,114415,2200,112215,9351.25,169.2307692,51.00681818
NM_004403,DFNA5,10,9,59667,2505,57162,6351.333333,250.5,22.81916168
NM_001199835,SNX10,7,6,82436,2632,79804,13300.66667,376,30.32066869
NM_013322,SNX10,7,6,82436,2585,79851,13308.5,369.2857143,30.8901354
NM_003930,SKAP2,13,12,197655,3983,193672,16139.33333,306.3846154,48.62465478
NM_006024,TAX1BP1,17,16,89674,3507,86167,5385.4375,206.2941176,24.57000285
NM_001206902,TAX1BP1,16,15,89674,3192,86482,5765.466667,199.5,27.0933584
NM_152740,HIBADH,8,7,137563,2006,135557,19365.28571,250.75,67.57577268
NM_001206901,TAX1BP1,17,16,90396,3384,87012,5438.25,199.0588235,25.71276596
NM_001079864,TAX1BP1,17,16,89674,3381,86293,5393.3125,198.8823529,25.52292221
NM_175061,JAZF1,5,4,350246,3204,347042,86760.5,640.8,108.315231
NM_001011666,CREB5,7,6,139792,7779,132013,22002.16667,1111.285714,16.97043322
NM_031311,CPVL,13,12,150908,1704,149204,12433.66667,131.0769231,87.56103286
NM_019029,CPVL,13,12,150908,1792,149116,12426.33333,137.8461538,83.21205357
NM_004904,CREB5,11,10,390279,8224,382055,38205.5,747.6363636,46.45610409
NM_182899,CREB5,10,9,526573,8198,518375,57597.22222,819.8,63.23188583
NM_182898,CREB5,11,10,413369,8543,404826,40482.6,776.6363636,47.38686644
NM_001080529,WIPF3,9,8,110514,4193,106321,13290.125,465.8888889,25.35678512
NM_001197027,PLEKHA8,14,13,89986,2154,87832,6756.307692,153.8571429,40.77623027
NM_001145515,SCRN1,7,6,69708,5115,64593,10765.5,730.7142857,12.62815249
NM_001145514,SCRN1,8,7,70188,5216,64972,9281.714286,652,12.45628834
NM_001145513,SCRN1,8,7,70017,5284,64733,9247.571429,660.5,12.250757
NM_014766,SCRN1,8,7,69708,5276,64432,9204.571429,659.5,12.21228203
NM_024051,GGCT,4,3,8222,1174,7048,2349.333333,293.5,6.003407155
NM_001199817,GGCT,2,1,8222,890,7332,7332,445,8.238202247
NM_001199816,GGCT,3,2,8222,1037,7185,3592.5,345.6666667,6.928640309
NM_001199815,GGCT,4,3,8222,1194,7028,2342.666667,298.5,5.886097152
NM_002047,GARS,17,16,39469,2766,36703,2293.9375,162.7058824,13.26934201
NM_001191059,PDE1C,19,18,318350,2907,315443,17524.61111,153,108.5115239
NM_001191058,PDE1C,19,18,545753,2731,543022,30167.88889,143.7368421,198.8363237
NM_001191057,PDE1C,18,17,317836,2975,314861,18521.23529,165.2777778,105.8356303
NM_001191056,PDE1C,17,16,281221,2996,278225,17389.0625,176.2352941,92.86548732
NM_001257968,CCDC129,15,14,129047,3626,125421,8958.642857,241.7333333,34.58935466
NM_001257967,CCDC129,15,14,139620,4157,135463,9675.928571,277.1333333,32.58672119
NM_005020,PDE1C,18,17,281800,2766,279034,16413.76471,153.6666667,100.8799711
NM_007270,FKBP9,10,9,49529,3473,46056,5117.333333,347.3,13.2611575
NM_001284341,FKBP9,11,10,49529,3633,45896,4589.6,330.2727273,12.6330856
NM_001284343,FKBP9,7,6,27459,2707,24752,4125.333333,386.7142857,9.143701515
NM_133468,BMPER,16,15,250963,5047,245916,16394.4,315.4375,48.72518328
NM_207173,NPSR1,9,8,220049,1419,218630,27328.75,157.6666667,154.0732911
NM_207172,NPSR1,9,8,191695,1576,190119,23764.875,175.1111111,120.6338832
NM_015283,DPY19L1,22,21,109162,4887,104275,4965.47619,222.1363636,21.3372212
NM_001077653,TBX20,8,7,51671,1832,49839,7119.857143,229,27.20469432
NM_001284302,ANLN,23,22,63988,4697,59291,2695.045455,204.2173913,12.62316372
NM_030636,EEPD1,8,7,148318,4695,143623,20517.57143,586.875,30.59062833
NM_001788,Sep-07,13,12,106121,4361,101760,8480,335.4615385,23.33409768
NM_018685,ANLN,24,23,63988,4812,59176,2572.869565,200.5,12.29758936
NM_001242956,Sep-07,12,11,106121,4254,101867,9260.636364,354.5,23.94616831
NM_001284301,ANLN,23,22,63988,4700,59288,2694.909091,204.3478261,12.61446809
NM_001011553,Sep-07,13,12,106121,4360,101761,8480.083333,335.3846154,23.3396789
NM_001039459,ELMO1,7,6,132208,3597,128611,21435.16667,513.8571429,35.75507367
NM_001206480,ELMO1,22,21,596420,5391,591029,28144.2381,245.0454545,109.6325357
NM_001206482,ELMO1,22,21,500763,5561,495202,23581.04762,252.7727273,89.04909189
NM_014800,ELMO1,22,21,596046,5202,590844,28135.42857,236.4545455,113.5801615
NM_130442,ELMO1,7,6,133362,3743,129619,21603.16667,534.7142857,34.62970879
NM_139316,AMPH,20,19,247872,3320,244552,12871.15789,166,73.66024096
NM_001635,AMPH,21,20,247872,3447,244425,12221.25,164.1428571,70.90948651
NM_007252,POU6F2,11,10,486783,2335,484448,48444.8,212.2727273,207.4723769
NM_001166018,POU6F2,11,10,486783,2227,484556,48455.6,202.4545455,217.5823978
NM_005402,RALA,5,4,84573,2815,81758,20439.5,563,29.04369449
NM_031267,CDK13,14,13,146776,6809,139967,10766.69231,486.3571429,20.55617565
NM_003718,CDK13,14,13,146776,6989,139787,10752.84615,499.2142857,20.00100157
NM_000168,GLI3,15,14,276072,8229,267843,19131.64286,548.6,32.54866934
NM_032014,MRPS24,4,3,2990,700,2290,763.3333333,175,3.271428571
NM_001204871,URGCP-MRPS24,7,6,40076,845,39231,6538.5,120.7142857,46.42721893
NM_004760,STK17A,7,6,44288,3940,40348,6724.666667,562.8571429,10.24060914
NM_015052,HECW1,30,29,450742,6869,443873,15305.96552,228.9666667,64.61974086
NM_001287059,HECW1,28,27,450742,6530,444212,16452.2963,233.2142857,68.02633997
NM_001165036,OGDH,23,22,102550,4313,98237,4465.318182,187.5217391,22.7769534
NM_002541,OGDH,23,22,102550,4325,98225,4464.772727,188.0434783,22.71098266
NM_001101648,NPC1L1,19,18,28781,4985,23796,1322,262.3684211,4.773520562
NM_172082,CAMK2B,20,19,108483,4084,104399,5494.684211,204.2,25.5629285
NM_013389,NPC1L1,20,19,28781,5067,23714,1248.105263,253.35,4.680086836
NM_001220,CAMK2B,24,23,108483,4610,103873,4516.217391,192.0833333,22.53210412
NM_015332,NUDCD3,6,5,108422,4923,103499,20699.8,820.5,21.02356287
NM_001003941,OGDH,9,8,70076,1821,68255,8531.875,202.3333333,37.48215266
NM_172080,CAMK2B,20,19,108483,4159,104324,5490.736842,207.95,25.0839144
NM_172083,CAMK2B,18,17,108483,4043,104440,6143.529412,224.6111111,25.83230275
NM_172084,CAMK2B,16,15,108483,3951,104532,6968.8,246.9375,26.45709947
NM_172081,CAMK2B,19,18,108483,4116,104367,5798.166667,216.6315789,25.35641399
NM_172079,CAMK2B,20,19,108483,4162,104321,5490.578947,208.1,25.06511293
NM_172078,CAMK2B,21,20,108483,4235,104248,5212.4,201.6666667,24.61582054
NM_005856,RAMP3,3,2,26485,1350,25135,12567.5,450,18.61851852
NM_021116,ADCY1,20,19,148591,12518,136073,7161.736842,625.9,10.87018693
NM_138295,PKD1L1,57,56,173823,9132,164691,2940.910714,160.2105263,18.03449409
NM_025031,C7orf69,3,2,24557,666,23891,11945.5,222,35.87237237
NM_022748,TNS3,31,30,306992,7649,299343,9978.1,246.7419355,39.1349196
NM_001159878,ZPBP,8,7,155838,1231,154607,22086.71429,153.875,125.5946385
NM_007009,ZPBP,8,7,155838,1234,154604,22086.28571,154.25,125.286872
NM_198570,VWC2,4,3,138883,1895,136988,45662.66667,473.75,72.28918206
NM_005311,GRB10,16,15,142292,4721,137571,9171.4,295.0625,29.14022453
NM_001082971,DDC,15,14,107022,2085,104937,7495.5,139,50.3294964
NM_001220776,IKZF1,4,3,128422,5487,122935,40978.33333,1371.75,22.40477492
NM_001220775,IKZF1,4,3,128422,5517,122905,40968.33333,1379.25,22.27750589
NM_001220774,IKZF1,5,4,128422,5614,122808,30702,1122.8,21.87531172
NM_001220773,IKZF1,5,4,128422,5644,122778,30694.5,1128.8,21.75372077
NM_001220772,IKZF1,3,2,128422,5381,123041,61520.5,1793.666667,22.8658242
NM_001220771,IKZF1,5,4,128422,5764,122658,30664.5,1152.8,21.28001388
NM_001220770,IKZF1,6,5,128422,5777,122645,24529,962.8333333,21.2298771
NM_001220769,IKZF1,6,5,128422,5807,122615,24523,967.8333333,21.11503358
NM_001220768,IKZF1,6,5,128422,5933,122489,24497.8,988.8333333,20.64537334
NM_001220767,IKZF1,7,6,128422,5904,122518,20419.66667,843.4285714,20.75169377
NM_001220766,IKZF1,7,6,128422,5934,122488,20414.66667,847.7142857,20.64172565
NM_001220765,IKZF1,7,6,128422,6069,122353,20392.16667,867,20.16032295
NM_001242889,DDC,13,12,102636,1689,100947,8412.25,129.9230769,59.76731794
NM_001242888,DDC,13,12,102636,1734,100902,8408.5,133.3846154,58.19031142
NM_001242887,DDC,14,13,102636,1825,100811,7754.692308,130.3571429,55.23890411
NM_001242886,DDC,14,13,102636,1855,100781,7752.384615,132.5,54.32938005
NM_001242890,DDC,10,9,68425,1399,67026,7447.333333,139.9,47.90993567
NM_000790,DDC,15,14,102636,1970,100666,7190.428571,131.3333333,51.09949239
NM_006060,IKZF1,8,7,128422,6196,122226,17460.85714,774.5,19.72659781
NM_001001555,GRB10,17,16,203401,5049,198352,12397,297,39.28540305
NM_001001550,GRB10,16,15,115240,4801,110439,7362.6,300.0625,23.00333264
NM_001001549,GRB10,15,14,142292,4582,137710,9836.428571,305.4666667,30.05456133
NM_201284,EGFR,16,15,152015,2881,149134,9942.266667,180.0625,51.76466505
NM_018697,LANCL2,9,8,68296,4362,63934,7991.75,484.6666667,14.65703806
NM_005228,EGFR,28,27,188308,5628,182680,6765.925926,201,32.45913291
NM_201283,EGFR,10,9,137921,1582,136339,15148.77778,158.2,86.18141593
NM_201282,EGFR,16,15,149605,2255,147350,9823.333333,140.9375,65.34368071
NM_004577,PSPH,8,7,40526,2126,38400,5485.714286,265.75,18.06208843
NM_153363,ZNF679,5,4,38459,1572,36887,9221.75,314.4,23.46501272
NM_001284342,VKORC1L1,2,1,86295,5788,80507,80507,2894,13.90929509
NM_003596,TPST1,6,5,155181,2057,153124,30624.8,342.8333333,74.44044725
NM_173517,VKORC1L1,3,2,86295,5899,80396,40198,1966.333333,13.62875064
NM_016038,SBDS,5,4,7900,1610,6290,1572.5,322,3.906832298
NM_018264,TYW1,16,15,242717,3380,239337,15955.8,211.25,70.80976331
NM_001287060,RABGEF1,10,9,129372,4536,124836,13870.66667,453.6,27.52116402
NM_022479,WBSCR17,11,10,581065,3529,577536,57753.6,320.8181818,163.654293
NM_001145440,TYW1B,15,14,259323,3172,256153,18296.64286,211.4666667,80.75441362
NM_001145441,TYW1B,13,12,275086,1616,273472,22789.33333,124.3076923,169.2277228
NM_001281304,FKBP6,8,7,30413,1558,28855,4122.142857,194.75,18.52053915
NM_032408,BAZ1B,20,19,81889,6135,75754,3987.052632,306.75,12.34784026
NM_001135211,FKBP6,9,8,30493,1558,28935,3616.875,173.1111111,18.57188703
NM_003602,FKBP6,9,8,30413,1649,28764,3595.5,183.2222222,17.44329897
NM_002314,LIMK1,16,15,38750,3398,35352,2356.8,212.375,10.40376692
NM_005685,GTF2IRD1,27,26,148802,3415,145387,5591.807692,126.4814815,42.57306003
NM_001278791,RFC2,11,10,22958,1857,21101,2110.1,168.8181818,11.362951
NM_001278792,RFC2,10,9,22958,1647,21311,2367.888889,164.7,12.93928355
NM_003388,CLIP2,17,16,116470,5580,110890,6930.625,328.2352941,19.87275986
NM_001199207,GTF2IRD1,27,26,148802,3511,145291,5588.115385,130.037037,41.38165765
NM_001204426,LIMK1,15,14,29371,3175,26196,1871.142857,211.6666667,8.250708661
NM_032421,CLIP2,16,15,116470,5474,110996,7399.733333,342.125,20.27694556
NM_002914,RFC2,10,9,22958,1652,21306,2367.333333,165.2,12.89709443
NM_016328,GTF2IRD1,27,26,148802,3460,145342,5590.076923,128.1481481,42.00635838
NM_181471,RFC2,11,10,22958,1755,21203,2120.3,159.5454545,12.08148148
NM_001278793,RFC2,10,9,22958,1754,21204,2356,175.4,12.08893957
NM_001243198,HIP1,29,28,205673,7916,197757,7062.75,272.9655172,24.98193532
NM_001145064,GATSL2,9,8,59738,999,58739,7342.375,111,58.7977978
NM_001145063,GATSL1,9,8,60012,1273,58739,7342.375,141.4444444,46.14218382
NM_001099415,POM121C,15,14,69507,5880,63627,4544.785714,392,10.82091837
NM_005338,HIP1,31,30,205673,8071,197602,6586.733333,260.3548387,24.4829637
NM_016086,STYXL1,9,8,51668,1425,50243,6280.375,158.3333333,35.25824561
NM_182684,UPK3B,7,6,17456,1531,15925,2654.166667,218.7142857,10.40169824
NM_030570,UPK3B,5,4,17456,1614,15842,3960.5,322.8,9.815365551
NM_080744,SRCRB4D,11,10,20368,2817,17551,1755.1,256.0909091,6.230386936
NM_182683,UPK3B,6,5,17456,1450,16006,3201.2,241.6666667,11.03862069
NM_001110199,SRRM3,15,14,85391,3630,81761,5840.071429,242,22.52369146
NM_198467,RSBN1L,8,7,83379,3228,80151,11450.14286,403.5,24.82992565
NM_001131008,PTPN12,18,17,102038,3125,98913,5818.411765,173.6111111,31.65216
NM_001131009,PTPN12,17,16,102038,3028,99010,6188.125,178.1176471,32.69815059
NM_001127358,PHTF2,18,17,158714,5103,153611,9035.941176,283.5,30.10209681
NM_020879,CCDC146,19,18,172589,3352,169237,9402.055556,176.4210526,50.48836516
NM_001127360,PHTF2,9,8,125393,2634,122759,15344.875,292.6666667,46.6055429
NM_002835,PTPN12,18,17,102617,3243,99374,5845.529412,180.1666667,30.64261486
NM_006379,SEMA3C,18,17,176815,5192,171623,10095.47059,288.4444444,33.05527735
NM_001256414,GNAI1,8,7,83656,3189,80467,11495.28571,398.625,25.23267482
NM_002069,GNAI1,8,7,84587,3326,81261,11608.71429,415.75,24.43205051
NM_001010934,HGF,5,4,19238,2015,17223,4305.75,403,8.547394541
NM_001010932,HGF,18,17,68010,2808,65202,3835.411765,156,23.22008547
NM_001010931,HGF,8,7,27447,1297,26150,3735.714286,162.125,20.1619121
NM_001010933,HGF,8,7,27447,1282,26165,3737.857143,160.25,20.40951638
NM_000601,HGF,18,17,68010,2823,65187,3834.529412,156.8333333,23.09139214
NM_033026,PCLO,25,24,408878,20313,388565,16190.20833,812.52,19.12888298
NM_014510,PCLO,20,19,342403,17115,325288,17120.42105,855.75,19.00601811
NM_006080,SEMA3A,17,16,236560,5676,230884,14430.25,333.8823529,40.67723749
NM_012431,SEMA3E,17,16,285259,6646,278613,17413.3125,390.9411765,41.92190791
NM_001178129,SEMA3E,17,16,277527,6010,271517,16969.8125,353.5294118,45.17753744
NM_152754,SEMA3D,17,16,126377,6275,120102,7506.375,369.1176471,19.13976096
NM_001142749,KIAA1324L,22,21,182793,6861,175932,8377.714286,311.8636364,25.64232619
NM_152748,KIAA1324L,21,20,89070,6457,82613,4130.65,307.4761905,12.79433173
NM_000840,GRM3,6,5,220964,4266,216698,43339.6,711,50.79653071
NM_138290,RUNDC3B,12,11,203886,4113,199773,18161.18182,342.75,48.57111597
NM_001134406,RUNDC3B,10,9,203886,3913,199973,22219.22222,391.3,51.10477894
NM_001134405,RUNDC3B,11,10,203886,4061,199825,19982.5,369.1818182,49.20586063
NM_000927,ABCB1,29,28,209462,4745,204717,7311.321429,163.6206897,43.14373024
NM_016351,ADAM22,30,29,268640,9256,259384,8944.275862,308.5333333,28.02333621
NM_021722,ADAM22,31,30,268640,9344,259296,8643.2,301.4193548,27.75
NM_021721,ADAM22,28,27,247864,2800,245064,9076.444444,100,87.52285714
NM_004194,ADAM22,29,28,247864,2909,244955,8748.392857,100.3103448,84.20591268
NM_021723,ADAM22,31,30,268640,9365,259275,8642.5,302.0967742,27.68553123
NM_181646,ZNF804B,4,3,577595,4592,573003,191001,1148,124.7828833
NM_001039706,C7orf63,23,22,65891,3925,61966,2816.636364,170.6521739,15.78751592
NM_001160138,C7orf63,23,22,65891,3871,62020,2819.090909,168.3043478,16.02169982
NM_012449,STEAP1,5,4,10454,1318,9136,2284,263.6,6.931714719
NM_001287137,CDK14,13,12,500777,4801,495976,41331.33333,369.3076923,103.3068111
NM_001287135,CDK14,15,14,614231,5145,609086,43506.14286,343,118.3840622
NM_012395,CDK14,14,13,501195,4968,496227,38171.30769,354.8571429,99.88466184
NM_001287136,CDK14,14,13,500777,4897,495880,38144.61538,349.7857143,101.2619971
NM_147185,AKAP9,50,49,169800,12489,157311,3210.428571,249.78,12.59596445
NM_001146152,CYP51A1,10,9,22598,2944,19654,2183.777778,294.4,6.675951087
NM_000466,PEX1,24,23,41510,4406,37104,1613.217391,183.5833333,8.421243759
NM_001282677,PEX1,23,22,41510,4234,37276,1694.363636,184.0869565,8.803967879
NM_005751,AKAP9,50,49,169800,12513,157287,3209.938776,250.26,12.56988732
NM_000786,CYP51A1,10,9,22379,3218,19161,2129,321.8,5.954319453
NM_019004,ANKIB1,20,19,155152,6101,149051,7844.789474,305.05,24.43058515
NM_001282678,PEX1,24,23,41510,4441,37069,1611.695652,185.0416667,8.34699392
NM_001164738,CALCR,13,12,135325,3623,131702,10975.16667,278.6923077,36.35164229
NM_001164737,CALCR,16,15,150245,3712,146533,9768.866667,232,39.47548491
NM_001742,CALCR,14,13,150245,3591,146654,11281.07692,256.5,40.83932052
NM_017667,CCDC132,28,27,128784,5738,123046,4557.259259,204.9285714,21.44405716
NM_001257998,CCDC132,29,28,128784,5767,123017,4393.464286,198.862069,21.33119473
NM_001099401,SGCE,12,11,70987,1787,69200,6290.909091,148.9166667,38.72411863
NM_001099400,SGCE,11,10,70987,1719,69268,6926.8,156.2727273,40.29552065
NM_003919,SGCE,11,10,70987,1711,69276,6927.6,155.5454545,40.48860316
NM_001166160,PPP1R9A,20,19,388780,10539,378241,19907.42105,526.95,35.88964797
NM_016116,ASB4,5,4,54332,3829,50503,12625.75,765.8,13.18960564
NM_017650,PPP1R9A,16,15,388780,9707,379073,25271.53333,606.6875,39.05150922
NM_001166163,PPP1R9A,14,13,386519,9615,376904,28992.61538,686.7857143,39.19958398
NM_001166162,PPP1R9A,17,16,386519,10107,376412,23525.75,594.5294118,37.24270308
NM_001166161,PPP1R9A,18,17,386519,10237,376282,22134.23529,568.7222222,36.75705773
NM_001160210,SLC25A13,18,17,201929,3211,198718,11689.29412,178.3888889,61.88663968
NM_006304,SHFM1,3,2,21126,501,20625,10312.5,167,41.16766467
NM_014251,SLC25A13,18,17,201929,3208,198721,11689.47059,178.2222222,61.94544888
NM_014916,LMTK2,14,13,102749,8959,93790,7214.615385,639.9285714,10.46880232
NM_001190996,ARPC1A,10,9,40391,1615,38776,4308.444444,161.5,24.00990712
NM_145115,ZSCAN25,8,7,15461,4357,11104,1586.285714,544.625,2.548542575
NM_001199847,SMURF1,18,17,116687,5694,110993,6529,316.3333333,19.49297506
NM_006409,ARPC1A,10,9,40391,1617,38774,4308.222222,161.7,23.97897341
NM_181349,SMURF1,18,17,116687,5703,110984,6528.470588,316.8333333,19.46063475
NM_020429,SMURF1,19,18,116687,5782,110905,6161.388889,304.3157895,19.18107921
NM_006076,AGFG2,12,11,29011,4823,24188,2198.909091,401.9166667,5.015135808
NM_017984,ZCWPW1,18,17,27938,2484,25454,1497.294118,138,10.24718196
NM_001258008,ZCWPW1,16,15,27938,2271,25667,1711.133333,141.9375,11.30206957
NM_004444,EPHB4,17,16,24958,4368,20590,1286.875,256.9411765,4.713827839
NM_001278563,COL26A1,13,12,196205,3045,193160,16096.66667,234.2307692,63.43513957
NM_133457,COL26A1,13,12,196205,3039,193166,16097.16667,233.7692308,63.56235604
NM_006989,RASA4,21,20,37114,5627,31487,1574.35,267.952381,5.595699307
NM_001277335,RASA4B,20,19,34440,2814,31626,1664.526316,140.7,11.23880597
NM_001079877,RASA4,20,19,37114,5488,31626,1664.526316,274.4,5.762755102
NM_145032,FBXL13,20,19,261709,3136,258573,13609.10526,156.8,82.453125
NM_017621,ALKBH4,3,2,8656,2124,6532,3266,708,3.075329567
NM_001111038,FBXL13,19,18,261982,2823,259159,14397.72222,148.5789474,91.80269217
NM_001287150,FBXL13,19,18,261982,2874,259108,14394.88889,151.2631579,90.15588031
NM_173054,RELN,64,63,517734,11629,506105,8033.412698,181.703125,43.52093903
NM_198999,SLC26A5,20,19,71971,2708,69263,3645.421053,135.4,25.57717873
NM_206883,SLC26A5,20,19,93449,2520,90929,4785.736842,126,36.08293651
NM_001167962,SLC26A5,19,18,71971,2611,69360,3853.333333,137.4210526,26.56453466
NM_005045,RELN,65,64,517734,11636,506098,7907.78125,179.0153846,43.49415607
NM_206885,SLC26A5,10,9,93449,1440,92009,10223.22222,144,63.89513889
NM_206884,SLC26A5,15,14,93449,1988,91461,6532.928571,132.5333333,46.00653924
NM_199000,LHFPL3,3,2,579901,3179,576722,288361,1059.666667,181.4161686
NM_182931,KMT2E,27,26,99897,6890,93007,3577.192308,255.1851852,13.4988389
NM_018682,KMT2E,26,25,99897,6741,93156,3726.24,259.2692308,13.81931464
NM_020725,ATXN7L1,12,11,271812,5703,266109,24191.72727,475.25,46.66123093
NM_019042,PUS7,16,15,65727,3498,62229,4148.6,218.625,17.78987993
NM_138495,ATXN7L1,10,9,74390,5433,68957,7661.888889,543.3,12.69225106
NM_152750,CDHR3,19,18,73222,6519,66703,3705.722222,343.1052632,10.23209081
NM_152749,ATXN7L1,4,3,116397,1660,114737,38245.66667,415,69.1186747
NM_012257,HBP1,11,10,33516,2840,30676,3067.6,258.1818182,10.80140845
NM_002736,PRKAR2B,11,10,117080,3672,113408,11340.8,333.8181818,30.88453159
NM_001244262,HBP1,11,10,33570,2736,30834,3083.4,248.7272727,11.26973684
NM_175884,CCDC71L,1,0,4425,4425,NA,NA,4425,NA
NM_002291,LAMB1,34,33,79560,5880,73680,2232.727273,172.9411765,12.53061224
NM_007356,LAMB4,34,33,106807,5892,100915,3058.030303,173.2941176,17.12746096
NM_000441,SLC26A4,21,20,57174,4949,52225,2611.25,235.6666667,10.5526369
NM_181581,DUS4L,8,7,14568,2288,12280,1754.285714,286,5.367132867
NM_001270419,DUS4L,8,7,14568,2138,12430,1775.714286,267.25,5.813844715
NM_001037132,NRCAM,30,29,92545,6335,86210,2972.758621,211.1666667,13.60852407
NM_001256011,PNPLA8,11,10,57741,4446,53295,5329.5,404.1818182,11.98717949
NM_001256010,PNPLA8,10,9,55898,4584,51314,5701.555556,458.4,11.19415358
NM_001256009,PNPLA8,10,9,55898,4525,51373,5708.111111,452.5,11.35314917
NM_015723,PNPLA8,12,11,55898,4871,51027,4638.818182,405.9166667,10.47567235
NM_001256008,PNPLA8,10,9,55898,4711,51187,5687.444444,471.1,10.86542135
NM_001256007,PNPLA8,11,10,55898,4758,51140,5114,432.5454545,10.74821354
NM_018334,LRRN3,2,1,34449,3540,30909,30909,1770,8.731355932
NM_001099660,LRRN3,4,3,34449,3731,30718,10239.33333,932.75,8.233181453
NM_001099658,LRRN3,3,2,34449,3623,30826,15413,1207.666667,8.508418438
NM_001007245,IFRD1,13,12,54061,3523,50538,4211.5,271,14.34516037
NM_001197080,IFRD1,12,11,54061,3247,50814,4619.454545,270.5833333,15.64952264
NM_021994,ZNF277,12,11,137348,2699,134649,12240.81818,224.9166667,49.88847721
NM_014705,DOCK4,52,51,480300,8388,471912,9253.176471,161.3076923,56.26037196
NM_001146267,GPR85,3,2,6076,4766,1310,655,1588.666667,0.274863617
NM_001146266,GPR85,2,1,5927,4828,1099,1099,2414,0.227630489
NM_001146265,GPR85,3,2,7367,4939,2428,1214,1646.333333,0.491597489
NM_152556,C7orf60,5,4,120732,3947,116785,29196.25,789.4,29.58829491
NM_018970,GPR85,3,2,7367,4936,2431,1215.5,1645.333333,0.492504052
NM_001172767,FOXP2,10,9,227643,1495,226148,25127.55556,149.5,151.2695652
NM_148899,FOXP2,9,8,227643,1419,226224,28278,157.6666667,159.4249471
NM_015641,TES,7,6,48292,2789,45503,7583.833333,398.4285714,16.31516673
NM_012252,TFEC,8,7,95667,6708,88959,12708.42857,838.5,13.26162791
NM_001244583,TFEC,6,5,33167,6315,26852,5370.4,1052.5,4.252098179
NM_001018058,TFEC,7,6,95667,6620,89047,14841.16667,945.7142857,13.45120846
NM_152829,TES,7,6,35834,2623,33211,5535.166667,374.7142857,12.66145635
NM_006136,CAPZA2,10,9,56752,2366,54386,6042.888889,236.6,22.98647506
NM_130768,ASZ1,13,12,64303,1878,62425,5202.083333,144.4615385,33.24014909
NM_000492,CFTR,27,26,188703,6158,182545,7020.961538,228.0740741,29.6435531
NM_018412,ST7,15,14,276696,2058,274638,19617,137.2,133.4489796
NM_021908,ST7,16,15,270582,2915,267667,17844.46667,182.1875,91.82401372
NM_016200,LSM8,4,3,20009,12524,7485,2495,3131,0.597652507
NM_012281,KCND2,6,5,476667,5339,471328,94265.6,889.8333333,88.28020229
NM_012338,TSPAN12,8,7,70805,2572,68233,9747.571429,321.5,26.52916019
NM_024913,CPED1,23,22,308749,5343,303406,13791.18182,232.3043478,56.78570092
NM_016087,WNT16,4,3,15739,2880,12859,4286.333333,720,4.464930556
NM_001105533,CPED1,18,17,272529,2846,269683,15863.70588,158.1111111,94.75860857
NM_057168,WNT16,4,3,12070,3118,8952,2984,779.5,2.871071199
NM_017954,CADPS2,30,29,568337,6084,562253,19388.03448,202.8,92.41502301
NM_005763,AASS,24,23,70748,5895,64853,2819.695652,245.625,11.00135708
NM_001009571,CADPS2,28,27,568337,5959,562378,20828.81481,212.8214286,94.37455949
NM_001167940,CADPS2,30,29,568337,6096,562241,19387.62069,203.2,92.23113517
NM_003117,SPAM1,7,6,46177,2431,43746,7291,347.2857143,17.99506376
NM_022444,SLC13A1,15,14,86439,3812,82627,5901.928571,254.1333333,21.67549843
NM_003941,WASL,11,10,67146,4458,62688,6268.8,405.2727273,14.06191117
NM_001042594,POT1,18,17,107599,3969,103630,6095.882353,220.5,26.10985135
NM_015450,POT1,19,18,107599,4101,103498,5749.888889,215.8421053,25.23725921
NM_005302,GPR37,2,1,20426,3817,16609,16609,1908.5,4.351323029
NM_014390,SND1,24,23,440459,3532,436927,18996.82609,147.1666667,123.7052661
NM_001201372,CCDC136,10,9,30725,1739,28986,3220.666667,173.9,16.66820012
NM_001242452,IRF5,8,7,12096,2584,9512,1358.857143,323,3.681114551
NM_001128926,FAM71F2,5,4,10991,1136,9855,2463.75,227.2,8.675176056
NM_001098627,IRF5,9,8,9318,2891,6427,803.375,321.2222222,2.223106192
NM_032643,IRF5,9,8,11819,2762,9057,1132.125,306.8888889,3.279145547
NM_022742,CCDC136,18,17,30139,4239,25900,1523.529412,235.5,6.109931588
NM_001012454,FAM71F2,5,4,11059,1231,9828,2457,246.2,7.983753046
NM_001098630,IRF5,9,8,12096,2843,9253,1156.625,315.8888889,3.25466057
NM_001098629,IRF5,9,8,12096,2891,9205,1150.625,321.2222222,3.18401937
NM_005631,SMO,12,11,24674,3749,20925,1902.272727,312.4166667,5.581488397
NM_020704,STRIP2,21,20,53967,5135,48832,2441.6,244.5238095,9.509639727
NM_182697,UBE2H,5,4,122229,5073,117156,29289,1014.6,23.0940272
NM_001202498,UBE2H,7,6,122212,4772,117440,19573.33333,681.7142857,24.61022632
NM_014997,KLHDC10,10,9,65213,6448,58765,6529.444444,644.8,9.11367866
NM_001134336,STRIP2,20,19,49203,2902,46301,2436.894737,145.1,15.95485872
NM_003344,UBE2H,7,6,122229,5168,117061,19510.16667,738.2857143,22.65112229
NM_001040110,NRF1,11,10,127005,3524,123481,12348.1,320.3636364,35.04001135
NM_005011,NRF1,11,10,145369,3541,141828,14182.8,321.9090909,40.05309235
NM_012133,COPG2,13,12,207520,1747,205773,17147.75,134.3846154,117.7864911
NM_005397,PODXL,8,7,56357,5896,50461,7208.714286,737,8.558514247
NM_001018111,PODXL,9,8,56357,5993,50364,6295.5,665.8888889,8.403804439
NM_017812,CHCHD3,8,7,297207,1598,295609,42229.85714,199.75,184.9868586
NM_181775,PLXNA4,5,4,163928,2005,161923,40480.75,401,80.759601
NM_001037126,EXOC4,10,9,231125,1615,229510,25501.11111,161.5,142.1114551
NM_144648,LRGUK,20,19,136830,2720,134110,7058.421053,136,49.30514706
NM_001190849,CNOT4,12,11,148330,3566,144764,13160.36364,297.1666667,40.59562535
NM_001190848,CNOT4,11,10,123055,3794,119261,11926.1,344.9090909,31.43410648
NM_001190847,CNOT4,11,10,148330,3361,144969,14496.9,305.5454545,43.1326986
NM_001008225,CNOT4,11,10,123055,3785,119270,11927,344.0909091,31.51122853
NM_199186,BPGM,4,3,33038,2109,30929,10309.66667,527.25,14.66524419
NM_013316,CNOT4,11,10,148330,3352,144978,14497.8,304.7272727,43.25119332
NM_001724,BPGM,3,2,33038,1787,31251,15625.5,595.6666667,17.48796866
NM_033157,CALD1,15,14,191318,4557,186761,13340.07143,303.8,40.98332236
NM_033139,CALD1,13,12,79331,4295,75036,6253,330.3846154,17.47054715
NM_033138,CALD1,15,14,191318,5247,186071,13290.78571,349.8,35.46235944
NM_033140,CALD1,12,11,79331,4216,75115,6828.636364,351.3333333,17.81665085
NM_001190850,CNOT4,12,11,148330,3575,144755,13159.54545,297.9166667,40.49090909
NM_004342,CALD1,14,13,191318,4481,186837,14372.07692,320.0714286,41.6953805
NM_178563,AGBL3,17,16,149273,3550,145723,9107.6875,208.8235294,41.04873239
NM_014149,WDR91,15,14,27728,4634,23094,1649.571429,308.9333333,4.983599482
NM_001128619,LUZP6,4,3,50703,3888,46815,15605,972,12.04089506
NM_145808,MTPN,4,3,50703,3888,46815,15605,972,12.04089506
NM_012450,SLC13A4,16,15,46948,2910,44038,2935.866667,181.875,15.13333333
NM_001006630,CHRM2,4,3,148374,2786,145588,48529.33333,696.5,52.25699928
NM_001006631,CHRM2,4,3,147941,2478,145463,48487.66667,619.5,58.70177563
NM_001006632,CHRM2,3,2,147941,2455,145486,72743,818.3333333,59.2610998
NM_001006627,CHRM2,3,2,148374,2707,145667,72833.5,902.3333333,53.81123014
NM_001006626,CHRM2,5,4,147904,2576,145328,36332,515.2,56.41614907
NM_002825,PTN,5,4,116456,1550,114906,28726.5,310,74.13290323
NM_001006629,CHRM2,2,1,147789,2389,145400,145400,1194.5,60.86228548
NM_001006628,CHRM2,3,2,147780,2459,145321,72660.5,819.6666667,59.09760065
NM_000739,CHRM2,4,3,147941,2534,145407,48469,633.5,57.38239937
NM_194071,CREB3L2,12,11,127124,7468,119656,10877.81818,622.3333333,16.02249598
NM_015905,TRIM24,19,18,125255,4023,121232,6735.111111,211.7368421,30.13472533
NM_001253775,CREB3L2,4,3,89292,1163,88129,29376.33333,290.75,75.77730009
NM_001139456,SVOPL,15,14,84762,1819,82943,5924.5,121.2666667,45.59813084
NM_003852,TRIM24,19,18,125255,3921,121334,6740.777778,206.3684211,30.94465698
NM_174959,SVOPL,12,11,69941,1433,68508,6228,119.4166667,47.80739707
NM_001244585,LUC7L2,11,10,83100,2482,80618,8061.8,225.6363636,32.48106366
NM_016019,LUC7L2,10,9,63613,2722,60891,6765.666667,272.2,22.36994857
NM_001244584,C7orf55-LUC7L2,11,10,82327,2758,79569,7956.9,250.7272727,28.85025381
NM_020910,KIAA1549,20,19,149939,12398,137541,7239,619.9,11.09380545
NM_001270643,LUC7L2,11,10,63613,2794,60819,6081.9,254,21.76771654
NM_001164665,KIAA1549,20,19,149939,12446,137493,7236.473684,622.3,11.04716375
NM_173569,UBN2,18,17,76753,14462,62291,3664.176471,803.4444444,4.307218919
NM_015689,DENND2A,18,17,84124,3480,80644,4743.764706,193.3333333,23.17356322
NM_001008749,RAB19,4,3,22209,956,21253,7084.333333,239,22.23117155
NM_001130966,TBXAS1,17,16,242080,2386,239694,14980.875,140.3529412,100.458508
NM_052853,ADCK2,8,7,21957,2372,19585,2797.857143,296.5,8.256745363
NM_030984,TBXAS1,12,11,191175,1915,189260,17205.45455,159.5833333,98.83028721
NM_001166253,TBXAS1,14,13,191175,2218,188957,14535.15385,158.4285714,85.19251578
NM_001061,TBXAS1,13,12,191175,2079,189096,15758,159.9230769,90.95526696
NM_001166254,TBXAS1,15,14,242080,2131,239949,17139.21429,142.0666667,112.5992492
NM_030647,KDM7A,20,19,92197,9198,82999,4368.368421,459.9,9.023592085
NM_018238,AGK,16,15,103133,2941,100192,6679.466667,183.8125,34.06732404
NM_001195278,TMEM178B,4,3,406149,10561,395588,131862.6667,2640.25,37.45743774
NM_001105558,WEE2,12,11,22920,3073,19847,1804.272727,256.0833333,6.4585096
NM_032983,CASP2,10,9,19483,4017,15466,1718.444444,401.7,3.850136918
NM_001130025,FAM115C,7,6,104133,2981,101152,16858.66667,425.8571429,33.9322375
NM_001224,CASP2,12,11,18110,4052,14058,1278,337.6666667,3.469397828
NM_032982,CASP2,11,10,19483,4236,15247,1524.7,385.0909091,3.599386213
NM_173678,FAM115C,7,6,103636,2967,100669,16778.16667,423.8571429,33.92955848
NM_022445,TPK1,9,8,384114,2448,381666,47708.25,272,155.9093137
NM_001042482,TPK1,8,7,384114,2300,381814,54544.85714,287.5,166.006087
NM_001203248,EZH2,20,19,76979,2701,74278,3909.368421,135.05,27.50018512
NM_152998,EZH2,19,18,76979,2610,74369,4131.611111,137.3684211,28.49386973
NM_001203249,EZH2,19,18,76139,2701,73438,4079.888889,142.1578947,27.18918919
NM_001203247,EZH2,20,19,76979,2728,74251,3907.947368,136.4,27.2181085
NM_004456,EZH2,20,19,76979,2743,74236,3907.157895,137.15,27.06379876
NM_032534,KRBA1,17,16,19518,4036,15482,967.625,237.4117647,3.835976214
NM_001099220,ZNF862,8,7,29061,6905,22156,3165.142857,863.125,3.208689356
NM_001282291,ABCB8,17,16,19362,4752,14610,913.125,279.5294118,3.074494949
NM_001282292,ABCB8,16,15,19362,4625,14737,982.4666667,289.0625,3.186378378
NM_007188,ABCB8,16,15,19362,4700,14662,977.4666667,293.75,3.119574468
NM_001282293,ABCB8,15,14,19362,4386,14976,1069.714286,292.4,3.414500684
NM_001098834,GBX1,2,1,18961,1094,17867,17867,547,16.33180987
NM_173680,ZNF775,3,2,19315,2278,17037,8518.5,759.3333333,7.478928885
NM_016203,PRKAG2,16,15,321117,3423,317694,21179.6,213.9375,92.8115688
NM_022087,GALNT11,12,11,96651,2734,93917,8537.909091,227.8333333,34.35149963
NM_024429,PRKAG2,12,11,76145,2244,73901,6718.272727,187,32.93270945
NM_001040633,PRKAG2,16,15,258758,3154,255604,17040.26667,197.125,81.0412175
NM_053043,RBM33,18,17,136978,10343,126635,7449.117647,574.6111111,12.24354636
NM_001103176,CNPY1,4,3,32588,2238,30350,10116.66667,559.5,13.56121537
NM_058246,DNAJB6,10,9,80424,2486,77938,8659.777778,248.6,31.35076428
NM_138400,NOM1,11,10,23461,6088,17373,1737.3,553.4545455,2.853646518
NM_014671,UBE3C,23,22,130413,5204,125209,5691.318182,226.2608696,24.06014604
NM_022458,LMBR1,17,16,212334,4907,207427,12964.1875,288.6470588,42.27165274
NM_005494,DNAJB6,8,7,49310,1567,47743,6820.428571,195.875,30.46777281
NM_001281932,NCAPG2,29,28,73663,4158,69505,2482.321429,143.3793103,16.71596922
NM_020728,ESYT2,22,21,98632,5979,92653,4412.047619,271.7727273,15.49640408
NM_003382,VIPR2,13,12,116785,3957,112828,9402.333333,304.3846154,28.51352034
NM_001281933,NCAPG2,28,27,65036,5314,59722,2211.925926,189.7857143,11.23861498
NM_018051,WDR60,25,24,89616,3797,85819,3575.791667,151.88,22.60179089
NM_017760,NCAPG2,28,27,73663,4104,69559,2576.259259,146.5714286,16.94907407
NM_001195127,WI2-2373I1.2,3,2,1320,705,615,307.5,235,0.872340426
NM_033023,PDGFA,6,5,22586,2744,19842,3968.4,457.3333333,7.231049563
NM_002607,PDGFA,7,6,22586,2814,19772,3295.333333,402,7.026297086
NM_025154,SUN1,18,17,58307,3848,54459,3203.470588,213.7777778,14.15254678
NM_001171946,SUN1,6,5,28317,1083,27234,5446.8,180.5,25.1468144
NM_001171945,SUN1,7,6,27259,1316,25943,4323.833333,188,19.71352584
NM_001171944,SUN1,17,16,58307,3734,54573,3410.8125,219.6470588,14.61515801
NM_001130965,SUN1,19,18,42417,3986,38431,2135.055556,209.7894737,9.641495233
NM_006869,ADAP1,11,10,56784,2363,54421,5442.1,214.8181818,23.03046974
NM_001284308,ADAP1,11,10,57508,2190,55318,5531.8,199.0909091,25.25936073
NM_001284311,ADAP1,9,8,22991,1956,21035,2629.375,217.3333333,10.75408998
NM_001284310,ADAP1,10,9,29317,2104,27213,3023.666667,210.4,12.93393536
NM_001284309,ADAP1,11,10,47917,2130,45787,4578.7,193.6363636,21.49624413
NM_017781,CYP2W1,9,8,6443,2313,4130,516.25,257,1.785559879
NM_001031617,COX19,3,2,10751,4894,5857,2928.5,1631.333333,1.196771557
NM_001098201,GPER1,2,1,5730,2646,3084,3084,1323,1.16553288
NM_001039966,GPER1,3,2,7010,2974,4036,2018,991.3333333,1.357094822
NM_001505,GPER1,2,1,7010,2849,4161,4161,1424.5,1.460512461
NM_138445,GPR146,1,0,1758,1758,NA,NA,1758,NA
NM_001080461,UNCX,3,2,3961,1599,2362,1181,533,1.477173233
NM_182491,ZFAND2A,5,4,7314,906,6408,1602,181.2,7.072847682
NM_001080453,INTS1,48,47,34107,7022,27085,576.2765957,146.2916667,3.857163201
NM_182924,MICALL2,17,16,25116,3116,22000,1375,183.2941176,7.060333761
NM_032302,PSMG3,2,1,2661,1389,1272,1272,694.5,0.915766739
NM_001134340,PSMG3,3,2,2700,781,1919,959.5,260.3333333,2.457106274
NM_001097620,TMEM184A,9,8,14197,6285,7912,989,698.3333333,1.258870326
NM_001128636,ELFN1,2,1,38794,3744,35050,35050,1872,9.361645299
NM_198954,NUDT1,4,3,8242,775,7467,2489,193.75,9.63483871
NM_198953,NUDT1,4,3,8242,702,7540,2513.333333,175.5,10.74074074
NM_198952,NUDT1,5,4,8886,788,8098,2024.5,157.6,10.27664975
NM_198949,NUDT1,5,4,8925,791,8134,2033.5,158.2,10.28318584
NM_198950,NUDT1,5,4,8886,715,8171,2042.75,143,11.42797203
NM_198948,NUDT1,5,4,8925,718,8207,2051.75,143.6,11.43036212
NM_013393,FTSJ2,3,2,7909,1604,6305,3152.5,534.6666667,3.930798005
NM_013321,SNX8,11,10,62696,4738,57958,5795.8,430.7272727,12.23258759
NM_002452,NUDT1,4,3,8925,666,8259,2753,166.5,12.4009009
NM_003751,EIF3B,19,18,25905,3025,22880,1271.111111,159.2105263,7.563636364
NM_018641,CHST12,2,1,31023,2135,28888,28888,1067.5,13.53067916
NM_001037283,EIF3B,19,18,25905,3100,22805,1266.944444,163.1578947,7.356451613
NM_001243795,CHST12,2,1,31023,2121,28902,28902,1060.5,13.62659123
NM_001243794,CHST12,2,1,31023,2107,28916,28916,1053.5,13.72377788
NM_001040167,LFNG,8,7,8586,2382,6204,886.2857143,297.75,2.604534005
NM_152743,BRAT1,14,13,17950,3027,14923,1147.923077,216.2142857,4.92996366
NM_002304,LFNG,9,8,10568,2067,8501,1062.625,229.6666667,4.112723754
NM_001166355,LFNG,9,8,15902,2279,13623,1702.875,253.2222222,5.977621764
NM_001040168,LFNG,8,7,9333,1401,7932,1133.142857,175.125,5.661670236
NM_025250,TTYH3,14,13,32835,4836,27999,2153.769231,345.4285714,5.789702233
NM_001282441,GNA12,5,4,87154,4377,82777,20694.25,875.4,18.91181174
NM_001282440,GNA12,3,2,35035,4247,30788,15394,1415.666667,7.249352484
NM_001037165,FOXK1,9,8,89146,11200,77946,9743.25,1244.444444,6.959464286
NM_014855,AP5Z1,17,16,18766,5536,13230,826.875,325.6470588,2.389812139
NM_020144,PAPOLB,1,0,4258,4258,NA,NA,4258,NA
NM_021163,RBAK,5,4,23568,6556,17012,4253,1311.2,2.594874924
NM_001204456,RBAK,6,5,23669,6362,17307,3461.4,1060.333333,2.720370953
NM_001033520,WIPI2,10,9,19588,4305,15283,1698.111111,430.5,3.550058072
NM_001040661,SLC29A4,11,10,21145,2902,18243,1824.3,263.8181818,6.286354238
NM_153247,SLC29A4,11,10,21145,2899,18246,1824.6,263.5454545,6.293894446
NM_024963,FBXL18,5,4,37973,8234,29739,7434.75,1646.8,3.611731844
NM_001101,ACTB,6,5,3455,1818,1637,327.4,303,0.900440044
NM_001097622,OCM,4,3,5567,700,4867,1622.333333,175,6.952857143
NM_015622,CCZ1,15,14,27264,1839,25425,1816.071429,122.6,13.82544861
NM_001099697,RSPH10B2,21,20,44539,3127,41412,2070.6,148.9047619,13.24336425
NM_173565,RSPH10B,21,20,44539,3127,41412,2070.6,148.9047619,13.24336425
NM_001134335,EIF2AK1,15,14,36984,4477,32507,2321.928571,298.4666667,7.260888988
NM_014413,EIF2AK1,15,14,36984,4480,32504,2321.714286,298.6666667,7.255357143
NM_001271700,ANKRD61,3,2,5178,1426,3752,1876,475.3333333,2.631136045
NM_006303,AIMP2,4,3,14585,1223,13362,4454,305.75,10.9255928
NM_001037163,FAM220A,2,1,19552,2216,17336,17336,1108,7.823104693
NM_006854,KDELR2,5,4,23139,2865,20274,5068.5,573,7.076439791
NM_001100603,KDELR2,4,3,23139,2611,20528,6842.666667,652.75,7.862121792
NM_001142936,DAGLB,13,12,38898,2536,36362,3030.166667,195.0769231,14.33832808
NM_139179,DAGLB,15,14,38898,2925,35973,2569.5,195,12.29846154
NM_017560,ZNF853,3,2,8396,3581,4815,2407.5,1193.666667,1.344596481
NM_001134389,ZDHHC4,8,7,11547,1339,10208,1458.285714,167.375,7.623599701
NM_001134388,ZDHHC4,9,8,11547,1471,10076,1259.5,163.4444444,6.849762067
NM_001134387,ZDHHC4,8,7,11547,1561,9986,1426.571429,195.125,6.397181294
NM_024067,C7orf26,6,5,18442,1919,16523,3304.6,319.8333333,8.610213653
NM_018106,ZDHHC4,8,7,11547,1404,10143,1449,175.5,7.224358974
NM_006956,ZNF12,6,5,18504,4955,13549,2709.8,825.8333333,2.734409687
NM_016265,ZNF12,5,4,18504,5068,13436,3359,1013.6,2.651144436
NM_198097,CCZ1B,15,14,27362,1851,25511,1822.214286,123.4,13.78227985
NM_020156,C1GALT1,4,3,66036,6241,59795,19931.66667,1560.25,9.580996635
NM_019005,MIOS,13,12,40496,3336,37160,3096.666667,256.6153846,11.13908873
NM_002489,NDUFA4,4,3,8235,2062,6173,2057.666667,515.5,2.993695441
NM_018374,TMEM106B,9,8,26044,6523,19521,2440.125,724.7777778,2.992641423
NM_001134232,TMEM106B,8,7,26044,6328,19716,2816.571429,791,3.115676359
NM_001135924,VWDE,29,28,73345,5612,67733,2419.035714,193.5172414,12.06931575
NM_033128,SCIN,14,13,64082,2585,61497,4730.538462,184.6428571,23.78994197
NM_001112706,SCIN,16,15,83027,3262,79765,5317.666667,203.875,24.4527897
NM_212460,ARL4A,2,1,4108,2984,1124,1124,1492,0.376675603
NM_001037164,ARL4A,2,1,4108,2987,1121,1121,1493.5,0.375292936
NM_001195396,ARL4A,2,1,3649,3210,439,439,1605,0.136760125
NM_005738,ARL4A,2,1,3649,3213,436,436,1606.5,0.135698724
NM_005924,MEOX2,3,2,75473,2374,73099,36549.5,791.3333333,30.79149115
NM_015464,SOSTDC1,2,1,4370,1871,2499,2499,935.5,1.335649385
NM_001195280,LRRC72,9,8,54611,946,53665,6708.125,105.1111111,56.72832981
NM_001159767,BZW2,12,11,60391,1885,58506,5318.727273,157.0833333,31.03766578
NM_014038,BZW2,12,11,60391,1869,58522,5320.181818,155.75,31.31193151
NM_006408,AGR2,8,7,12476,991,11485,1640.714286,123.875,11.58930373
NM_014399,TSPAN13,6,5,30812,1908,28904,5780.8,318,15.14884696
NM_001621,AHR,11,10,47501,6258,41243,4124.3,568.9090909,6.590444231
NM_175886,PRPS1L1,1,0,1088,1088,NA,NA,1088,NA
NM_152898,FERD3L,1,0,641,641,NA,NA,641,NA
NM_000474,TWIST1,2,1,2206,1668,538,538,834,0.322541966
NM_001002926,TWISTNB,4,3,13577,3896,9681,3227,974,2.484856263
NM_001163942,ABCB5,6,5,13053,2253,10800,2160,375.5,4.793608522
NM_001163993,ABCB5,6,5,20223,1730,18493,3698.6,288.3333333,10.68959538
NM_182700,SP8,2,1,4616,3635,981,981,1817.5,0.269876204
NM_198956,SP8,3,2,4616,3732,884,442,1244,0.236870311
NM_001127370,CDCA7L,11,10,45027,2973,42054,4205.4,270.2727273,14.14530777
NM_001127371,CDCA7L,9,8,45027,2779,42248,5281,308.7777778,15.20259086
NM_018719,CDCA7L,10,9,45027,2918,42109,4678.777778,291.8,14.4307745
NM_207342,STEAP1B,5,4,80840,1303,79537,19884.25,260.6,61.04144282
NM_001164460,STEAP1B,5,4,61865,1304,60561,15140.25,260.8,46.44248466
NM_000600,IL6,5,4,4857,1189,3668,917,237.8,3.084945332
NM_019059,TOMM7,3,2,10222,782,9440,4720,260.6666667,12.07161125
NM_032581,FAM126A,11,10,72894,6162,66732,6673.2,560.1818182,10.82960078
NM_001172428,KLHL7,5,4,20318,1030,19288,4822,206,18.72621359
NM_002510,GPNMB,11,10,28415,2741,25674,2567.4,249.1818182,9.366654506
NM_007342,NUPL2,7,6,19186,1804,17382,2897,257.7142857,9.635254989
NM_001005340,GPNMB,11,10,28415,2777,25638,2563.8,252.4545455,9.232265034
NM_138446,MALSU1,4,3,10242,759,9483,3161,189.75,12.49407115
NM_013293,TRA2A,8,7,27261,1851,25410,3630,231.375,13.72771475
NM_001282758,TRA2A,9,8,27261,1942,25319,3164.875,215.7777778,13.03759011
NM_001282757,TRA2A,9,8,27261,2153,25108,3138.5,239.2222222,11.66186716
NM_001282759,TRA2A,10,9,27261,2241,25020,2780,224.1,11.16465863
NM_138771,CCDC126,4,3,47331,2477,44854,14951.33333,619.25,18.1081954
NM_000905,NPY,4,3,7679,564,7115,2371.666667,141,12.61524823
NM_018947,CYCS,3,2,6712,5541,1171,585.5,1847,0.211333694
NM_022150,NPVF,3,2,3916,1191,2725,1362.5,397,2.287993283
NM_138811,C7orf31,10,9,45503,3619,41884,4653.777778,361.9,11.57336281
NM_007276,CBX3,6,5,12398,2336,10062,2012.4,389.3333333,4.307363014
NM_002137,HNRNPA2B1,11,10,10859,3677,7182,718.2,334.2727273,1.953222736
NM_031243,HNRNPA2B1,12,11,10859,3714,7145,649.5454545,309.5,1.923801831
NM_016587,CBX3,6,5,11905,2108,9797,1959.4,351.3333333,4.647533207
NM_001199838,SNX10,4,3,10006,2333,7673,2557.666667,583.25,3.288898414
NM_001199837,SNX10,5,4,13447,2435,11012,2753,487,4.52238193
NM_001145531,C7orf71,4,3,9436,1995,7441,2480.333333,498.75,3.729824561
NM_002141,HOXA4,2,1,2275,1730,545,545,865,0.315028902
NM_006735,HOXA2,2,1,2423,1780,643,643,890,0.361235955
NM_006896,HOXA7,2,1,2960,2017,943,943,1008.5,0.467526029
NM_030661,HOXA3,3,2,13407,3260,10147,5073.5,1086.666667,3.112576687
NM_024014,HOXA6,2,1,2193,804,1389,1389,402,1.72761194
NM_000522,HOXA13,2,1,3228,2516,712,712,1258,0.282988871
NM_005523,HOXA11,2,1,4061,2655,1406,1406,1327.5,0.529566855
NM_005522,HOXA1,2,1,3013,2549,464,464,1274.5,0.182032169
NM_152739,HOXA9,2,1,3094,2059,1035,1035,1029.5,0.5026712
NM_018951,HOXA10,2,1,3747,2573,1174,1174,1286.5,0.45627672
NM_019102,HOXA5,2,1,2618,1659,959,959,829.5,0.578059072
NM_153631,HOXA3,4,3,20832,3400,17432,5810.666667,850,5.127058824
NM_153620,HOXA1,3,2,3013,2347,666,333,782.3333333,0.28376651
NM_001989,EVX1,3,2,4030,1861,2169,1084.5,620.3333333,1.165502418
NM_014817,TRIL,2,1,5057,5057,2,2,2528.5,0.000395491
NM_001039936,CHN2,7,6,34460,2840,31620,5270,405.7142857,11.13380282
NM_175887,PRR15,2,1,3486,1680,1806,1806,840,1.075
NM_032639,PLEKHA8,13,12,62384,2306,60078,5006.5,177.3846154,26.05290546
NM_001197026,PLEKHA8,14,13,56303,7851,48452,3727.076923,560.7857143,6.171443128
NM_017946,FKBP14,4,3,16220,5085,11135,3711.666667,1271.25,2.189773845
NM_152793,MTURN,3,2,27831,5817,22014,11007,1939,3.784424961
NM_147128,ZNRF2,5,4,83387,3465,79922,19980.5,693,23.06551227
NM_006092,NOD1,14,13,54252,4510,49742,3826.307692,322.1428571,11.02926829
NM_001202481,CRHR2,14,13,48162,3145,45017,3462.846154,224.6428571,14.31383148
NM_001202475,CRHR2,13,12,48162,2917,45245,3770.416667,224.3846154,15.51079877
NM_001199219,INMT,3,2,5469,2559,2910,1455,853,1.137162954
NM_001202482,CRHR2,12,11,30584,3007,27577,2507,250.5833333,9.170934486
NM_001883,CRHR2,12,11,30584,3010,27574,2506.727273,250.8333333,9.160797342
NM_006774,INMT,3,2,5469,2562,2907,1453.5,854,1.134660422
NM_001202483,CRHR2,13,12,30584,3122,27462,2288.5,240.1538462,8.796284433
NM_032222,FAM188B,18,17,120971,2751,118220,6954.117647,152.8333333,42.97346419
NM_198098,AQP1,4,3,13718,2811,10907,3635.666667,702.75,3.880113838
NM_001185062,AQP1,4,3,4014,2438,1576,525.3333333,609.5,0.646431501
NM_001185061,AQP1,4,3,4028,2666,1362,454,666.5,0.510877719
NM_001185060,AQP1,5,4,4218,2492,1726,431.5,498.4,0.692616372
NM_000823,GHRHR,13,12,15512,1620,13892,1157.666667,124.6153846,8.575308642
NM_001199637,ADCYAP1R1,14,13,59019,6442,52577,4044.384615,460.1428571,8.161595778
NM_001199636,ADCYAP1R1,17,16,59019,6589,52430,3276.875,387.5882353,7.957201396
NM_001199635,ADCYAP1R1,17,16,59019,6592,52427,3276.6875,387.7647059,7.953125
NM_001118,ADCYAP1R1,16,15,59019,6507,52512,3500.8,406.6875,8.070078377
NM_022728,NEUROD6,2,1,3465,2163,1302,1302,1081.5,0.601941748
NM_194300,CCDC129,13,12,100689,4031,96658,8054.833333,310.0769231,23.97866534
NM_006658,PPP1R17,5,4,21440,1971,19469,4867.25,394.2,9.877727042
NM_001145123,PPP1R17,4,3,21440,1817,19623,6541,454.25,10.79966979
NM_015060,AVL9,16,15,88605,2369,86236,5749.066667,148.0625,36.40185732
NM_001130710,LSM5,5,4,9927,2192,7735,1933.75,438.4,3.528740876
NM_012322,LSM5,5,4,5080,2255,2825,706.25,451,1.252771619
NM_001139499,LSM5,5,4,9927,2431,7496,1874,486.2,3.083504731
NM_015483,KBTBD2,4,3,23692,3714,19978,6659.333333,928.5,5.379106085
NM_016489,NT5C3A,10,9,27054,1834,25220,2802.222222,183.4,13.75136314
NM_203288,RP9,6,5,14594,1126,13468,2693.6,187.6666667,11.96092362
NM_001002009,NT5C3A,10,9,48686,1770,46916,5212.888889,177,26.50621469
NM_001166118,NT5C3A,11,10,27054,1921,25133,2513.3,174.6363636,13.08328995
NM_001002010,NT5C3A,9,8,48686,1714,46972,5871.5,190.4444444,27.40490082
NM_001166220,TBX20,6,5,22601,1380,21221,4244.2,230,15.37753623
NM_022373,HERPUD2,9,8,62504,2919,59585,7448.125,324.3333333,20.41281261
NM_001100425,KIAA0895,7,6,65977,4231,61746,10291,604.4285714,14.59371307
NM_001199707,KIAA0895,6,5,43025,4471,38554,7710.8,745.1666667,8.623126817
NM_001199708,KIAA0895,7,6,43121,4305,38816,6469.333333,615,9.016492451
NM_001199706,KIAA0895,7,6,43085,4464,38621,6436.833333,637.7142857,8.651657706
NM_015314,KIAA0895,6,5,43093,4327,38766,7753.2,721.1666667,8.959094061
NM_181791,GPR141,1,0,919,919,NA,NA,919,NA
NM_017549,EPDR1,3,2,31381,2601,28780,14390,867,11.06497501
NM_003014,SFRP4,6,5,10992,2979,8013,1602.6,496.5,2.689828802
NM_001242948,EPDR1,3,2,30623,2086,28537,14268.5,695.3333333,13.68024928
NM_001242946,EPDR1,2,1,31381,2391,28990,28990,1195.5,12.12463404
NM_016616,NME8,18,17,51805,2329,49476,2910.352941,129.3888889,21.24345213
NM_032016,STARD3NL,9,8,52466,1753,50713,6339.125,194.7777778,28.92926412
NM_001003799,TARP,4,3,14006,1031,12975,4325,257.75,12.58486906
NM_001003806,TARP,4,3,14006,1031,12975,4325,257.75,12.58486906
NM_020192,YAE1D1,3,2,6507,902,5605,2802.5,300.6666667,6.213968958
NM_001282446,YAE1D1,3,2,45715,2770,42945,21472.5,923.3333333,15.50361011
NM_138701,MPLKIP,2,1,1911,943,968,968,471.5,1.026511135
NM_002192,INHBA,3,2,14107,2178,11929,5964.5,726,5.477043159
NM_031903,MRPL32,3,2,5516,895,4621,2310.5,298.3333333,5.163128492
NM_024054,C7orf25,2,1,2819,1822,997,997,911,0.547200878
NM_001099858,C7orf25,2,1,2819,1827,992,992,913.5,0.542966612
NM_002787,PSMA2,8,7,15345,1472,13873,1981.857143,184,9.424592391
NM_018224,COA1,6,5,90296,933,89363,17872.6,155.5,95.78027867
NM_000712,BLVRA,8,7,48671,1089,47582,6797.428571,136.125,43.6932966
NM_001253823,BLVRA,9,8,48671,1184,47487,5935.875,131.5555556,40.10726351
NM_015983,UBE2D4,7,6,29702,3989,25713,4285.5,569.8571429,6.445976435
NM_017920,URGCP,5,4,30732,3596,27136,6784,719.2,7.546162403
NM_001077664,URGCP,6,5,50497,3819,46678,9335.6,636.5,12.22257135
NM_001077663,URGCP,6,5,30732,3624,27108,5421.6,604,7.48013245
NM_001284331,POLM,10,9,10480,2715,7765,862.7777778,271.5,2.860036832
NM_001284315,DBNL,11,10,17079,2018,15061,1506.1,183.4545455,7.46333003
NM_001122956,DBNL,13,12,17078,2231,14847,1237.25,171.6153846,6.65486329
NM_001284330,POLM,9,8,10480,2638,7842,980.25,293.1111111,2.972706596
NM_000290,PGAM2,3,2,2862,860,2002,1001,286.6666667,2.327906977
NM_001284313,DBNL,11,10,17079,2034,15045,1504.5,184.9090909,7.396755162
NM_001256879,POLD2,12,11,8830,2177,6653,604.8181818,181.4166667,3.056040423
NM_006230,POLD2,11,10,8892,1642,7250,725,149.2727273,4.415347138
NM_013284,POLM,11,10,10480,2827,7653,765.3,257,2.707110011
NM_014063,DBNL,13,12,17078,2207,14871,1239.25,169.7692308,6.738106026
NM_001014436,DBNL,13,12,17078,2204,14874,1239.5,169.5384615,6.748638838
NM_001129,AEBP1,21,20,10206,4107,6099,304.95,195.5714286,1.485025566
NM_001127218,POLD2,11,10,8892,1815,7077,707.7,165,3.899173554
NM_175064,SPDYE1,7,6,9236,2657,6579,1096.5,379.5714286,2.476100866
NM_021223,MYL7,7,6,2455,604,1851,308.5,86.28571429,3.064569536
NM_000162,GCK,10,9,45154,2743,42411,4712.333333,274.3,15.46153846
NM_006555,YKT6,7,6,13317,2773,10544,1757.333333,396.1428571,3.802380094
NM_033508,GCK,11,10,15019,2569,12450,1245,233.5454545,4.846243675
NM_033507,GCK,10,9,15019,2444,12575,1397.222222,244.4,5.145253682
NM_019082,DDX56,14,13,9123,2886,6237,479.7692308,206.1428571,2.161122661
NM_001257189,DDX56,13,12,9123,2765,6358,529.8333333,212.6923077,2.299457505
NM_182547,TMED4,5,4,3067,1027,2040,510,205.4,1.986368062
NM_031449,ZMIZ2,19,18,20951,5162,15789,877.1666667,271.6842105,3.058698179
NM_174929,ZMIZ2,17,16,13694,5021,8673,542.0625,295.3529412,1.72734515
NM_201516,H2AFV,4,3,14514,1303,13211,4403.666667,325.75,10.13891021
NM_201436,H2AFV,4,3,14514,1355,13159,4386.333333,338.75,9.711439114
NM_033224,PURB,1,0,9094,9094,NA,NA,9094,NA
NM_012412,H2AFV,5,4,14514,1434,13080,3270,286.8,9.121338912
NM_201517,H2AFV,4,3,14514,1319,13195,4398.333333,329.75,10.00379075
NM_021130,PPIA,5,4,6477,2281,4196,1049,456.2,1.83954406
NM_138635,H2AFV,5,4,21239,3760,17479,4369.75,752,4.648670213
NM_033054,MYO1G,22,21,16446,3301,13145,625.952381,150.0454545,3.982126628
NM_001146334,NACAD,8,7,8459,4769,3690,527.1428571,596.125,0.773747117
NM_199122,TBRG4,9,8,11649,1934,9715,1214.375,214.8888889,5.023267839
NM_030900,TBRG4,9,8,11649,1955,9694,1211.75,217.2222222,4.958567775
NM_001261834,TBRG4,11,10,11649,2243,9406,940.6,203.9090909,4.19349086
NM_004749,TBRG4,11,10,11649,2287,9362,936.2,207.9090909,4.093572366
NM_001281768,ADCY1,10,9,90534,1703,88831,9870.111111,170.3,52.16147974
NM_000598,IGFBP3,5,4,9029,2618,6411,1602.75,523.6,2.44881589
NM_001013398,IGFBP3,5,4,9029,2636,6393,1598.25,527.2,2.425265554
NM_000596,IGFBP1,4,3,5310,1654,3656,1218.666667,413.5,2.210399033
NM_001123065,C7orf65,3,2,6406,2914,3492,1746,971.3333333,1.19835278
NM_001030019,SUN3,10,9,41972,1446,40526,4502.888889,144.6,28.02627939
NM_152782,SUN3,11,10,41972,1363,40609,4060.9,123.9090909,29.79383712
NM_001267866,C7orf57,7,6,25788,1925,23863,3977.166667,275,12.39636364
NM_001267865,C7orf57,8,7,25788,1938,23850,3407.142857,242.25,12.30650155
NM_001100159,C7orf57,9,8,25788,2143,23645,2955.625,238.1111111,11.03359776
NM_004507,HUS1,8,7,16339,3025,13314,1902,378.125,4.401322314
NM_001284350,SUN3,11,10,41972,1545,40427,4042.7,140.4545455,26.16634304
NM_001287430,UPP1,6,5,19481,1224,18257,3651.4,204,14.91584967
NM_001287426,UPP1,10,9,20132,1983,18149,2016.555556,198.3,9.152294503
NM_001287428,UPP1,7,6,20132,1575,18557,3092.833333,225,11.78222222
NM_001287429,UPP1,6,5,19595,1400,18195,3639,233.3333333,12.99642857
NM_003364,UPP1,9,8,19523,1723,17800,2225,191.4444444,10.33081834
NM_001161834,C7orf72,9,8,63172,1413,61759,7719.875,157,43.70771408
NM_001042762,FIGNL1,4,3,6263,3540,2723,907.6666667,885,0.76920904
NM_001287493,FIGNL1,3,2,6263,3371,2892,1446,1123.666667,0.857905666
NM_001287494,FIGNL1,3,2,6263,3366,2897,1448.5,1122,0.860665478
NM_001287495,FIGNL1,2,1,6263,3261,3002,3002,1630.5,0.92057651
NM_001287496,FIGNL1,4,3,6263,3257,3006,1002,814.25,0.922935216
NM_022116,FIGNL1,4,3,6263,3533,2730,910,883.25,0.772714407
NM_001287492,FIGNL1,4,3,6263,3978,2285,761.6666667,994.5,0.574409251
NM_182595,POM121L12,1,0,1271,1271,NA,NA,1271,NA
NM_182546,VSTM2A,5,4,26931,1291,25640,6410,258.2,19.8605732
NM_001012456,SEC61G,4,3,7001,466,6535,2178.333333,116.5,14.02360515
NM_014302,SEC61G,4,3,7001,470,6531,2177,117.5,13.89574468
NM_207366,Sep-14,10,9,69247,3795,65452,7272.444444,379.5,17.24690382
NM_001483,GBAS,10,9,35607,2014,33593,3732.555556,201.4,16.67974181
NM_015969,MRPS17,3,2,3424,588,2836,1418,196,4.823129252
NM_001202469,GBAS,8,7,35607,1895,33712,4816,236.875,17.78997361
NM_182633,ZNF713,4,3,28104,2069,26035,8678.333333,517.25,12.58337361
NM_001146333,SUMF2,8,7,16450,1905,14545,2077.857143,238.125,7.635170604
NM_001009186,CCT6A,13,12,12306,2542,9764,813.6666667,195.5384615,3.841070024
NM_015411,SUMF2,9,8,16450,2063,14387,1798.375,229.2222222,6.973824527
NM_001042470,SUMF2,6,5,16450,1808,14642,2928.4,301.3333333,8.098451327
NM_001130069,SUMF2,8,7,16450,1917,14533,2076.142857,239.625,7.581116328
NM_001042469,SUMF2,8,7,16450,2017,14433,2061.857143,252.125,7.155676748
NM_001258460,PHKG1,10,9,12715,2113,10602,1178,211.3,5.017510648
NM_001258459,PHKG1,11,10,12715,2237,10478,1047.8,203.3636364,4.683951721
NM_016139,CHCHD2,4,3,4923,819,4104,1368,204.75,5.010989011
NM_006213,PHKG1,10,9,12715,2140,10575,1175,214,4.941588785
NM_001762,CCT6A,14,13,12306,2678,9628,740.6153846,191.2857143,3.595220314
NM_001145712,NUPR1L,2,1,1718,602,1116,1116,301,1.853820598
NM_033273,ZNF479,5,4,20247,2072,18175,4543.75,414.4,8.771718147
NM_001159279,ZNF716,4,3,23384,5214,18170,6056.666667,1303.5,3.484848485
NM_001159522,ZNF727,4,3,33108,1683,31425,10475,420.75,18.67201426
NM_001159524,ZNF735,4,3,13089,1243,11846,3948.666667,310.75,9.530168946
NM_001170905,ZNF736,5,4,36833,2103,34730,8682.5,420.6,16.51450309
NM_001130022,ZNF680,4,3,38473,2292,36181,12060.33333,573,15.78577661
NM_178558,ZNF680,4,3,43252,3054,40198,13399.33333,763.5,13.16240995
NM_001282360,ZNF107,3,2,45501,5592,39909,19954.5,1864,7.136802575
NM_001282359,ZNF107,4,3,45501,5689,39812,13270.66667,1422.25,6.998066444
NM_001013746,ZNF107,5,4,45501,5850,39651,9912.75,1170,6.777948718
NM_016220,ZNF107,7,6,45501,6121,39380,6563.333333,874.4285714,6.433589283
NM_001160183,ZNF138,5,4,39295,2762,36533,9133.25,552.4,13.22700941
NM_006524,ZNF138,3,2,39295,2545,36750,18375,848.3333333,14.44007859
NM_001271649,ZNF138,2,1,39295,2417,36878,36878,1208.5,15.25775755
NM_001271640,ZNF138,4,3,39295,2683,36612,12204,670.75,13.64591875
NM_001271638,ZNF138,4,3,39295,2635,36660,12220,658.75,13.91271347
NM_001271637,ZNF138,4,3,39295,2628,36667,12222.33333,657,13.95243531
NM_001271639,ZNF138,4,3,39295,2624,36671,12223.66667,656,13.97522866
NM_015852,ZNF117,4,3,16586,6408,10178,3392.666667,1602,1.588327091
NM_021148,ZNF273,4,3,28337,4329,24008,8002.666667,1082.25,5.545853546
NM_001007253,ERV3-1,2,1,16393,3268,13125,13125,1634,4.01621787
NM_001287532,ZNF92,3,2,27338,3127,24211,12105.5,1042.333333,7.742564759
NM_007139,ZNF92,3,2,27338,3096,24242,12121,1032,7.830103359
NM_152626,ZNF92,4,3,27338,3224,24114,8038,806,7.479528536
NM_001287533,ZNF92,5,4,27338,3347,23991,5997.75,669.4,7.167911563
NM_001287534,ZNF92,2,1,27338,2999,24339,24339,1499.5,8.115705235
NM_000181,GUSB,12,11,21630,2310,19320,1756.363636,192.5,8.363636364
NM_001284290,GUSB,10,9,21631,1871,19760,2195.555556,187.1,10.56119722
NM_001024946,ASL,15,14,17497,1997,15500,1107.142857,133.1333333,7.761642464
NM_001024944,ASL,15,14,17497,2015,15482,1105.857143,134.3333333,7.68337469
NM_001024943,ASL,16,15,17497,2076,15421,1028.066667,129.75,7.42822736
NM_001040648,CRCP,3,2,39750,2573,37177,18588.5,857.6666667,14.44889234
NM_001040647,CRCP,5,4,39750,2707,37043,9260.75,541.4,13.6841522
NM_001142414,CRCP,5,4,39750,2651,37099,9274.75,530.2,13.99434176
NM_000048,ASL,17,16,17555,1953,15602,975.125,114.8823529,7.988735279
NM_014478,CRCP,6,5,39750,2807,36943,7388.6,467.8333333,13.16102601
NM_001167961,KCTD7,5,4,14350,3891,10459,2614.75,778.2,2.687997944
NM_153033,KCTD7,4,3,14350,5055,9295,3098.333333,1263.75,1.838773492
NM_014504,RABGEF1,9,8,70807,3816,66991,8373.875,424,17.5552935
NM_001287062,RABGEF1,10,9,70807,4012,66795,7421.666667,401.2,16.64880359
NM_001287061,RABGEF1,9,8,55581,3875,51706,6463.25,430.5555556,13.34348387
NM_017994,TMEM248,7,6,37337,4245,33092,5515.333333,606.4285714,7.795524146
NM_172020,POM121,14,13,57679,5495,52184,4014.153846,392.5,9.496633303
NM_001281451,TRIM50,7,6,13049,1985,11064,1844,283.5714286,5.573803526
NM_001281450,TRIM50,7,6,15555,2054,13501,2250.166667,293.4285714,6.573028238
NM_001168348,NSUN5,9,8,6353,2342,4011,501.375,260.2222222,1.71263877
NM_148956,NSUN5,10,9,6353,2387,3966,440.6666667,238.7,1.661499791
NM_178125,TRIM50,7,6,15555,2057,13498,2249.666667,293.8571429,6.561983471
NM_018044,NSUN5,9,8,6353,2456,3897,487.125,272.8888889,1.586726384
NM_001168347,NSUN5,10,9,6353,2382,3971,441.2222222,238.2,1.667086482
NM_003508,FZD9,1,0,2343,2343,NA,NA,2343,NA
NM_012453,TBL2,7,6,9738,3045,6693,1115.5,435,2.198029557
NM_001707,BCL7B,6,5,21384,1717,19667,3933.4,286.1666667,11.45428072
NM_001197244,BCL7B,5,4,21384,1545,19839,4959.75,309,12.8407767
NM_032317,DNAJC30,1,0,2535,2535,NA,NA,2535,NA
NM_032954,MLXIPL,17,16,31348,3232,28116,1757.25,190.1176471,8.699257426
NM_032953,MLXIPL,17,16,31348,3289,28059,1753.6875,193.4705882,8.531164488
NM_032952,MLXIPL,17,16,31348,3238,28110,1756.875,190.4705882,8.681284744
NM_032951,MLXIPL,17,16,31348,3295,28053,1753.3125,193.8235294,8.513808801
NM_001202560,WBSCR22,13,12,14655,1303,13352,1112.666667,100.2307692,10.24712203
NM_017528,WBSCR22,12,11,14655,1251,13404,1218.545455,104.25,10.7146283
NM_001165903,STX1A,10,9,20484,2089,18395,2043.888889,208.9,8.805648636
NM_001077621,VPS37D,4,3,4268,1609,2659,886.3333333,402.25,1.652579242
NM_004603,STX1A,10,9,20484,2135,18349,2038.777778,213.5,8.594379391
NM_152559,WBSCR27,6,5,7936,936,7000,1400,156,7.478632479
NM_148913,ABHD11,6,5,2759,1452,1307,261.4,242,0.900137741
NM_001306,CLDN3,1,0,1275,1275,NA,NA,1275,NA
NM_001305,CLDN4,1,0,1832,1832,NA,NA,1832,NA
NM_001145364,ABHD11,5,4,2761,1303,1458,364.5,260.6,1.118956255
NM_148912,ABHD11,6,5,2759,1473,1286,257.2,245.5,0.873048201
NM_182504,WBSCR28,3,2,4736,857,3879,1939.5,285.6666667,4.526254376
NM_001278915,ELN,33,32,42119,3831,38288,1196.5,116.0909091,9.994257374
NM_001278914,ELN,31,30,42119,3739,38380,1279.333333,120.6129032,10.26477668
NM_001081754,ELN,32,31,42119,3773,38346,1236.967742,117.90625,10.16326531
NM_001081753,ELN,31,30,42119,3715,38404,1280.133333,119.8387097,10.33755047
NM_001081752,ELN,30,29,42119,3669,38450,1325.862069,122.3,10.47969474
NM_001278939,ELN,34,33,42119,4000,38119,1155.121212,117.6470588,9.52975
NM_001278912,ELN,32,31,42119,3758,38361,1237.451613,117.4375,10.20782331
NM_001278916,ELN,29,28,42119,3611,38508,1375.285714,124.5172414,10.66408197
NM_001278917,ELN,32,31,42119,3782,38337,1236.677419,118.1875,10.13670016
NM_001081755,ELN,32,31,42119,3755,38364,1237.548387,117.34375,10.21677763
NM_000501,ELN,33,32,42119,3813,38306,1197.0625,115.5454545,10.04615788
NM_001278918,ELN,28,27,42119,3487,38632,1430.814815,124.5357143,11.07886435
NM_001278913,ELN,29,28,42119,3566,38553,1376.892857,122.9655172,10.81127314
NM_031992,EIF4H,6,5,22725,2492,20233,4046.6,415.3333333,8.11918138
NM_022170,EIF4H,7,6,22725,2553,20172,3362,364.7142857,7.901292597
NM_032464,LAT2,14,13,20079,2205,17874,1374.923077,157.5,8.106122449
NM_032463,LAT2,14,13,20079,2135,17944,1380.307692,152.5,8.404683841
NM_014146,LAT2,13,12,20079,2015,18064,1505.333333,155,8.964764268
NM_001163636,GTF2I,34,33,103033,4536,98497,2984.757576,133.4117647,21.71450617
NM_001280800,GTF2I,10,9,59397,1355,58042,6449.111111,135.5,42.83542435
NM_032999,GTF2I,35,34,103033,4603,98430,2895,131.5142857,21.38388008
NM_033000,GTF2I,34,33,103033,4542,98491,2984.575758,133.5882353,21.68450022
NM_033001,GTF2I,34,33,103033,4539,98494,2984.666667,133.5,21.69949328
NM_001518,GTF2I,33,32,103033,4478,98555,3079.84375,135.6969697,22.00870925
NM_001281447,GTF2IRD2,3,2,20118,628,19490,9745,209.3333333,31.03503185
NM_000265,NCF1,11,10,15413,1470,13943,1394.3,133.6363636,9.485034014
NM_173537,GTF2IRD2,16,15,57391,3599,53792,3586.133333,224.9375,14.94637399
NM_030798,WBSCR16,11,10,33449,2420,31029,3102.9,220,12.82190083
NM_001281441,WBSCR16,9,8,19097,1420,17677,2209.625,157.7777778,12.44859155
NM_173537,GTF2IRD2,16,15,57278,3601,53677,3578.466667,225.0625,14.90613718
NM_001003795,GTF2IRD2B,16,15,57278,3601,53677,3578.466667,225.0625,14.90613718
NM_198924,TRIM73,5,4,9995,1363,8632,2158,272.6,6.333088775
NM_198853,TRIM74,5,4,9987,1355,8632,2158,271,6.370479705
NM_001099435,SPDYE5,8,7,9331,2675,6656,950.8571429,334.375,2.488224299
NM_006072,CCL26,4,3,20224,566,19658,6552.666667,141.5,34.73144876
NM_002991,CCL24,3,2,1921,363,1558,779,121,4.292011019
NM_031925,TMEM120A,12,11,7839,1483,6356,577.8181818,123.5833333,4.285906945
NM_001040457,RHBDD2,5,4,9929,1883,8046,2011.5,376.6,4.272968667
NM_001040456,RHBDD2,4,3,9929,1760,8169,2723,440,4.641477273
NM_000941,POR,16,15,71755,2515,69240,4616,157.1875,27.53081511
NM_005918,MDH2,9,8,19492,2267,17225,2153.125,251.8888889,7.598147331
NM_001282403,MDH2,8,7,19492,2140,17352,2478.857143,267.5,8.108411215
NM_001282404,MDH2,8,7,19492,2097,17395,2485,262.125,8.295183596
NM_012479,YWHAG,2,1,32236,3749,28487,28487,1874.5,7.598559616
NM_001540,HSPB1,3,2,1741,900,841,420.5,300,0.934444444
NM_020892,DTX2,12,11,44342,2831,41511,3773.727273,235.9166667,14.6630166
NM_001102596,DTX2,8,7,25487,2130,23357,3336.714286,266.25,10.9657277
NM_001102595,DTX2,10,9,44342,2544,41798,4644.222222,254.4,16.43003145
NM_007155,ZP3,9,8,44549,1486,43063,5382.875,165.1111111,28.97913863
NM_001110354,ZP3,8,7,17118,1308,15810,2258.571429,163.5,12.08715596
NM_001102594,DTX2,11,10,44342,2710,41632,4163.2,246.3636364,15.36236162
NM_012230,POMZP3,7,6,17319,1559,15760,2626.666667,222.7142857,10.10904426
NM_152992,POMZP3,5,4,17319,1327,15992,3998,265.4,12.05124341
NM_006682,FGL2,2,1,6464,4270,2194,2194,2135,0.51381733
NM_017439,GSAP,31,30,105651,3282,102369,3412.3,105.8709677,31.19104205
NM_032936,TMEM60,2,1,4704,875,3829,3829,437.5,4.376
NM_001127357,PHTF2,18,17,117376,5026,112350,6608.823529,279.2222222,22.35376045
NM_001127359,PHTF2,9,8,84055,2557,81498,10187.25,284.1111111,31.87250684
NM_020432,PHTF2,17,16,117376,5013,112363,7022.6875,294.8823529,22.41432276
NM_001102386,GNAT3,8,7,53257,1073,52184,7454.857143,134.125,48.63373719
NM_001001547,CD36,14,13,72232,2079,70153,5396.384615,148.5,33.74362674
NM_001001548,CD36,15,14,40763,4742,36021,2572.928571,316.1333333,7.596161957
NM_001127444,CD36,12,11,27974,1997,25977,2361.545455,166.4166667,13.00801202
NM_001127443,CD36,13,12,28091,1823,26268,2189,140.2307692,14.40921558
NM_000072,CD36,14,13,35904,2118,33786,2598.923077,151.2857143,15.95184136
NM_001289911,CD36,12,11,72213,1755,70458,6405.272727,146.25,40.14700855
NM_001289909,CD36,12,11,28328,1701,26627,2420.636364,141.75,15.6537331
NM_001289908,CD36,10,9,27767,1671,26096,2899.555556,167.1,15.61699581
NM_001142327,DMTF1,18,17,43973,3819,40154,2362,212.1666667,10.51427075
NM_024315,TMEM243,4,3,23555,1047,22508,7502.666667,261.75,21.49761223
NM_021145,DMTF1,20,19,43780,4058,39722,2090.631579,202.9,9.788565796
NM_001142326,DMTF1,17,16,43973,3701,40272,2517,217.7058824,10.88138341
NM_021151,CROT,18,17,54163,3254,50909,2994.647059,180.7777778,15.64505224
NM_001243745,CROT,4,3,14476,1268,13208,4402.666667,317,10.41640379
NM_001143935,CROT,19,18,54163,3339,50824,2823.555556,175.7368421,15.22132375
NM_006716,DBF4,12,11,33314,3919,29395,2672.272727,326.5833333,7.500637918
NM_018843,SLC25A40,12,11,41880,3154,38726,3520.545455,262.8333333,12.27837666
NM_024636,STEAP4,5,4,30486,4478,26008,6502,895.6,5.807949978
NM_001256892,SRI,7,6,18792,915,17877,2979.5,130.7142857,19.53770492
NM_198901,SRI,8,7,21878,2000,19878,2839.714286,250,9.939
NM_003130,SRI,8,7,14969,2024,12945,1849.285714,253,6.395750988
NM_001205316,STEAP4,4,3,30486,3949,26537,8845.666667,987.25,6.719929096
NM_001205315,STEAP4,6,5,30486,4578,25908,5181.6,763,5.659239843
NM_001256891,SRI,7,6,11883,939,10944,1824,134.1428571,11.65495208
NM_152706,C7orf62,2,1,1613,1021,592,592,510.5,0.579823702
NM_001040666,STEAP2,7,6,23860,2315,21545,3590.833333,330.7142857,9.306695464
NM_001040665,STEAP2,6,5,25820,6702,19118,3823.6,1117,2.852581319
NM_152999,STEAP2,5,4,25994,6925,19069,4767.25,1385,2.753646209
NM_001244946,STEAP2,6,5,25820,2148,23672,4734.4,358,11.02048417
NM_001244945,STEAP2,6,5,25994,2520,23474,4694.8,420,9.315079365
NM_001244944,STEAP2,6,5,25994,7039,18955,3791,1173.166667,2.692854099
NM_001042717,GTPBP10,8,7,44792,7313,37479,5354.142857,914.125,5.124982907
NM_033107,GTPBP10,10,9,44792,7552,37240,4137.777778,755.2,4.931144068
NM_012129,CLDN12,3,2,12622,3620,9002,4501,1206.666667,2.486740331
NM_001185073,CLDN12,3,2,12622,3624,8998,4499,1208,2.482891832
NM_001185072,CLDN12,4,3,12622,3664,8958,2986,916,2.444868996
NM_003505,FZD1,1,0,4351,4351,NA,NA,4351,NA
NM_006980,MTERF,3,2,7997,2166,5831,2915.5,722,2.692059095
NM_001161528,LRRD1,5,4,20394,2666,17728,4432,533.2,6.649662416
NM_194454,KRIT1,19,18,46947,4542,42405,2355.833333,239.0526316,9.336195509
NM_194455,KRIT1,19,18,47133,5016,42117,2339.833333,264,8.3965311
NM_001013406,KRIT1,17,16,46947,4248,42699,2668.6875,249.8823529,10.05155367
NM_004912,KRIT1,19,18,46931,4889,42042,2335.666667,257.3157895,8.599304561
NM_194456,KRIT1,20,19,47133,4782,42351,2229,239.1,8.856336261
NM_021167,GATAD1,5,4,12621,4602,8019,2004.75,920.4,1.742503259
NM_032120,RBM48,5,4,8738,1722,7016,1754,344.4,4.074332172
NM_001288584,FAM133B,11,10,29314,2466,26848,2684.8,224.1818182,10.88726683
NM_001040057,FAM133B,12,11,29638,2482,27156,2468.727273,206.8333333,10.94117647
NM_152789,FAM133B,11,10,29638,2382,27256,2725.6,216.5454545,11.44248531
NM_152703,SAMD9L,5,4,18314,7138,11176,2794,1427.6,1.565704679
NM_017654,SAMD9,3,2,18512,6858,11654,5827,2286,1.699329251
NM_001193307,SAMD9,2,1,18512,6756,11756,11756,3378,1.740082889
NM_024553,CCDC132,12,11,44086,1202,42884,3898.545455,100.1666667,35.67720466
NM_001288810,HEPACAM2,8,7,31011,2118,28893,4127.571429,264.75,13.64164306
NM_198151,HEPACAM2,9,8,31011,2144,28867,3608.375,238.2222222,13.46408582
NM_001039372,HEPACAM2,10,9,37935,2153,35782,3975.777778,215.3,16.61960056
NM_001288804,HEPACAM2,11,10,37935,2223,35712,3571.2,202.0909091,16.06477733
NM_021955,GNGT1,3,2,4667,631,4036,2018,210.3333333,6.396196513
NM_006528,TFPI2,5,4,5596,2449,3147,786.75,489.8,1.285014292
NM_001271004,TFPI2,5,4,5596,2373,3223,805.75,474.6,1.358196376
NM_001271003,TFPI2,5,4,5596,2416,3180,795,483.2,1.316225166
NM_004126,GNG11,2,1,4812,956,3856,3856,478,4.033472803
NM_005868,BET1,4,3,12692,3065,9627,3209,766.25,3.140946166
NM_000089,COL1A2,52,51,36673,5463,31210,611.9607843,105.0576923,5.712978217
NM_022900,CASD1,18,17,47160,3897,43263,2544.882353,216.5,11.10161663
NM_001184961,PEG10,2,1,13371,6619,6752,6752,3309.5,1.02009367
NM_001184962,PEG10,2,1,13371,6619,6752,6752,3309.5,1.02009367
NM_001040152,PEG10,2,1,13371,6619,6752,6752,3309.5,1.02009367
NM_001172437,PEG10,2,1,13326,6585,6741,6741,3292.5,1.023690205
NM_015068,PEG10,2,1,13371,6619,6752,6752,3309.5,1.02009367
NM_001172438,PEG10,2,1,13326,6585,6741,6741,3292.5,1.023690205
NM_000940,PON3,9,8,36505,1200,35305,4413.125,133.3333333,29.42083333
NM_000446,PON1,9,8,26217,1761,24456,3057,195.6666667,13.88756388
NM_001018161,PON2,9,8,30212,1627,28585,3573.125,180.7777778,17.56914567
NM_145872,ASB4,3,2,42902,1550,41352,20676,516.6666667,26.67870968
NM_000305,PON2,9,8,30212,1663,28549,3568.625,184.7777778,17.16716777
NM_002612,PDK4,11,10,13118,3711,9407,940.7,337.3636364,2.534896254
NM_001201451,C7orf76,4,3,21899,2681,19218,6406,670.25,7.168220813
NM_001201450,C7orf76,5,4,21899,2712,19187,4796.75,542.4,7.074852507
NM_005222,DLX6,3,2,5064,1878,3186,1593,626,1.696485623
NM_005221,DLX5,3,2,4443,1427,3016,1508,475.6666667,2.113524877
NM_020186,ACN9,2,1,65172,2059,63113,63113,1029.5,30.65225838
NM_013998,TAC1,5,4,8515,1094,7421,1855.25,218.8,6.783363803
NM_013997,TAC1,6,5,8515,1149,7366,1473.2,191.5,6.410791993
NM_013996,TAC1,6,5,8515,1140,7375,1475,190,6.469298246
NM_003182,TAC1,7,6,8515,1195,7320,1220,170.7142857,6.125523013
NM_001673,ASNS,13,12,20427,2092,18335,1527.916667,160.9230769,8.764340344
NM_133436,ASNS,13,12,20050,2347,17703,1475.25,180.5384615,7.542820622
NM_183356,ASNS,14,13,20427,2371,18056,1388.923077,169.3571429,7.615352172
NM_001178077,ASNS,11,10,20050,1715,18335,1833.5,155.9090909,10.6909621
NM_001178076,ASNS,11,10,20427,1782,18645,1864.5,162,10.46296296
NM_001178075,ASNS,13,12,20427,2018,18409,1534.083333,155.2307692,9.122398414
NM_006188,OCM2,4,3,5405,591,4814,1604.666667,147.75,8.145516074
NM_015395,TECPR1,26,25,36810,5771,31039,1241.56,221.9615385,5.378443944
NM_177455,BHLHA15,1,0,707,707,NA,NA,707,NA
NM_015379,BRI3,3,2,9862,794,9068,4534,264.6666667,11.42065491
NM_001159491,BRI3,3,2,11298,702,10596,5298,234,15.09401709
NM_018842,BAIAP2L1,14,13,109467,3684,105783,8137.153846,263.1428571,28.71416938
NM_002523,NPTX2,5,4,12586,2718,9868,2467,543.6,3.630610743
NM_001134451,TMEM130,7,6,23564,2730,20834,3472.333333,390,7.631501832
NM_001134450,TMEM130,8,7,23564,3073,20491,2927.285714,384.125,6.668076798
NM_152913,TMEM130,8,7,23564,3037,20527,2932.428571,379.625,6.75897267
NM_001145715,KPNA7,10,9,33894,1695,32199,3577.666667,169.5,18.99646018
NM_213603,ZNF789,5,4,14704,1608,13096,3274,321.6,8.144278607
NM_014891,PDAP1,6,5,14009,2693,11316,2263.2,448.8333333,4.202005199
NM_001198879,ATP5J2-PTCD1,9,8,49464,5547,43917,5489.625,616.3333333,7.917252569
NM_001081559,CPSF4,8,7,18435,1759,16676,2382.285714,219.875,9.480386583
NM_006693,CPSF4,8,7,18435,1834,16601,2371.571429,229.25,9.051799346
NM_015545,PTCD1,8,7,22102,5513,16589,2369.857143,689.125,3.009069472
NM_001013258,ZNF789,4,3,9435,537,8898,2966,134.25,16.5698324
NM_001039178,ATP5J2,3,2,8042,379,7663,3831.5,126.3333333,20.21899736
NM_005720,ARPC1B,10,9,20108,1541,18567,2063,154.1,12.0486697
NM_004889,ATP5J2,4,3,8042,515,7527,2509,128.75,14.61553398
NM_003910,BUD31,6,5,10640,1049,9591,1918.2,174.8333333,9.142993327
NM_001003714,ATP5J2,3,2,8042,397,7645,3822.5,132.3333333,19.25692695
NM_001003713,ATP5J2,4,3,8042,497,7545,2515,124.25,15.18108652
NM_032164,ZNF394,3,2,7025,2148,4877,2438.5,716,2.270484171
NM_001009958,ZNF655,3,2,5882,1202,4680,2340,400.6666667,3.893510815
NM_145111,FAM200A,2,1,5836,2490,3346,3346,1245,1.3437751
NM_024061,ZNF655,5,4,6285,1590,4695,1173.75,318,2.952830189
NM_001009960,ZNF655,3,2,17630,4568,13062,6531,1522.666667,2.859457093
NM_145102,ZKSCAN5,7,6,29174,4224,24950,4158.333333,603.4285714,5.906723485
NM_001195543,GS1-259H13.2,6,5,12556,1118,11438,2287.6,186.3333333,10.23076923
NM_001195542,GS1-259H13.2,6,5,12556,1124,11432,2286.4,187.3333333,10.17081851
NM_001195541,GS1-259H13.2,6,5,12556,1127,11429,2285.8,187.8333333,10.14108252
NM_014569,ZKSCAN5,7,6,28874,4351,24523,4087.166667,621.5714286,5.636175592
NM_001085368,ZNF655,4,3,17630,4674,12956,4318.666667,1168.5,2.771929825
NM_001085367,ZNF655,5,4,5882,1417,4465,1116.25,283.4,3.151023289
NM_001083956,ZNF655,4,3,18033,4847,13186,4395.333333,1211.75,2.720445636
NM_138494,ZNF655,3,2,18033,4741,13292,6646,1580.333333,2.803627927
NM_001085366,ZNF655,3,2,6285,1375,4910,2455,458.3333333,3.570909091
NM_001190484,CYP3A5,5,4,8778,1082,7696,1924,216.4,7.112754159
NM_001256497,CYP3A7-CYP3AP1,15,14,50519,2273,48246,3446.142857,151.5333333,21.22569292
NM_000765,CYP3A7,13,12,30161,2091,28070,2339.166667,160.8461538,13.42419895
NM_000777,CYP3A5,13,12,31810,1739,30071,2505.916667,133.7692308,17.29212191
NM_001202855,CYP3A4,13,12,27230,2802,24428,2035.666667,215.5384615,8.71805853
NM_017460,CYP3A4,13,12,27230,2805,24425,2035.416667,215.7692308,8.707664884
NM_001005276,OR2AE1,1,0,973,973,NA,NA,973,NA
NM_057095,CYP3A43,13,12,38093,1731,36362,3030.166667,133.1538462,21.00635471
NM_001278921,CYP3A43,10,9,38093,1398,36695,4077.222222,139.8,26.24821173
NM_022820,CYP3A43,13,12,38093,1734,36359,3029.916667,133.3846154,20.96828143
NM_057096,CYP3A43,12,11,38093,1567,36526,3320.545455,130.5833333,23.30950862
NM_033091,TRIM4,6,5,29195,3386,25809,5161.8,564.3333333,7.622268163
NM_033017,TRIM4,7,6,29195,3465,25730,4288.333333,495,7.425685426
NM_001185,AZGP1,4,3,9387,1269,8118,2706,317.25,6.397163121
NM_181538,GJC3,2,1,6353,1118,5235,5235,559,4.682468694
NM_203397,MBLAC1,2,1,1803,1501,302,302,750.5,0.201199201
NM_001278595,MCM7,14,13,9214,3099,6115,470.3846154,221.3571429,1.973217167
NM_001278292,ZNF3,5,4,11795,2714,9081,2270.25,542.8,3.345983788
NM_001278291,ZNF3,4,3,11795,2592,9203,3067.666667,648,3.550540123
NM_001278290,ZNF3,5,4,11795,2724,9071,2267.75,544.8,3.330029369
NM_001278287,ZNF3,6,5,12579,2880,9699,1939.8,480,3.367708333
NM_001278284,ZNF3,6,5,12579,2964,9615,1923,494,3.243927126
NM_001190415,TAF6,15,14,12790,2448,10342,738.7142857,163.2,4.224673203
NM_005641,TAF6,15,14,12304,2777,9527,680.5,185.1333333,3.430680591
NM_032924,ZNF3,6,5,11795,2846,8949,1789.8,474.3333333,3.144413212
NM_005916,MCM7,15,14,9214,3025,6189,442.0714286,201.6666667,2.045950413
NM_006833,COPS6,10,9,3241,1435,1806,200.6666667,143.5,1.258536585
NM_145914,ZSCAN21,4,3,15248,1993,13255,4418.333333,498.25,6.650777722
NM_152755,CNPY4,6,5,5865,1473,4392,878.4,245.5,2.981670061
NM_017715,ZNF3,6,5,17919,1670,16249,3249.8,278.3333333,9.72994012
NM_139315,TAF6,15,14,12330,2479,9851,703.6428571,165.2666667,3.97377975
NM_182776,MCM7,14,13,8054,2990,5064,389.5384615,213.5714286,1.693645485
NM_004722,AP4M1,15,14,5675,1883,3792,270.8571429,125.5333333,2.013807754
NM_024637,GAL3ST4,4,3,9510,2544,6966,2322,636,2.738207547
NM_001282718,STAG3,32,31,36646,4202,32444,1046.580645,131.3125,7.721085198
NM_024070,PVRIG,6,5,2242,1575,667,133.4,262.5,0.423492063
NM_001008395,LAMTOR4,4,3,5305,616,4689,1563,154,7.612012987
NM_152742,GPC2,10,9,7763,2542,5221,580.1111111,254.2,2.053894571
NM_012447,STAG3,34,33,36646,4411,32235,976.8181818,129.7352941,7.307866697
NM_178831,GATS,5,4,71579,2743,68836,17209,548.6,25.09515129
NM_018275,C7orf43,11,10,4261,2525,1736,173.6,229.5454545,0.687524752
NM_001282716,STAG3,34,33,36665,4330,32335,979.8484848,127.3529412,7.467667436
NM_001282717,STAG3,34,33,36646,4414,32232,976.7272727,129.8235294,7.302220208
NM_013439,PILRA,7,6,26656,1323,25333,4222.166667,189,19.14814815
NM_178273,PILRA,5,4,26656,1068,25588,6397,213.6,23.9588015
NM_178272,PILRA,6,5,26656,1103,25553,5110.6,183.8333333,23.16681777
NM_178238,PILRB,4,3,9830,1442,8388,2796,360.5,5.816920943
NM_001004351,SPDYE3,11,10,14496,3196,11300,1130,290.5454545,3.535669587
NM_030935,TSC22D4,5,4,12762,2388,10374,2593.5,477.6,4.344221106
NM_001194991,MEPCE,5,4,5338,1887,3451,862.75,377.4,1.828828829
NM_001194990,MEPCE,5,4,5338,2302,3036,759,460.4,1.318853171
NM_145030,PPP1R35,4,3,1184,934,250,83.33333333,233.5,0.267665953
NM_019606,MEPCE,4,3,4497,3034,1463,487.6666667,758.5,0.482201714
NM_001194992,MEPCE,5,4,5338,1752,3586,896.5,350.4,2.046803653
NM_001004323,C7orf61,3,2,7658,1007,6651,3325.5,335.6666667,6.604766634
NM_173564,NYAP1,7,6,10876,3590,7286,1214.333333,512.8571429,2.029526462
NM_001163499,FBXO24,10,9,11546,2003,9543,1060.333333,200.3,4.76435347
NM_016188,ACTL6B,14,13,13360,1545,11815,908.8461538,110.3571429,7.647249191
NM_001206855,TFR2,15,14,13236,2483,10753,768.0714286,165.5333333,4.330648409
NM_001040099,MOSPD3,5,4,2888,1178,1710,427.5,235.6,1.451612903
NM_023948,MOSPD3,5,4,2888,1208,1680,420,241.6,1.390728477
NM_001168682,SAP25,6,5,1419,841,578,115.6,140.1666667,0.687277051
NM_012172,FBXO24,10,9,11546,2153,9393,1043.666667,215.3,4.362749652
NM_003227,TFR2,18,17,21136,2906,18230,1072.352941,161.4444444,6.273227805
NM_002593,PCOLCE,9,8,5918,1629,4289,536.125,181,2.632903622
NM_033506,FBXO24,10,9,14786,2264,12522,1391.333333,226.4,5.530918728
NM_001040098,MOSPD3,6,5,2949,1026,1923,384.6,171,1.874269006
NM_001040097,MOSPD3,6,5,3277,1110,2167,433.4,185,1.952252252
NM_001289934,LRCH4,18,17,12179,2306,9873,580.7647059,128.1111111,4.281439722
NM_002319,LRCH4,18,17,12179,3254,8925,525,180.7777778,2.742778119
NM_001289933,ZASP,1,0,700,700,NA,NA,700,NA
NM_005837,POP7,2,1,1449,934,515,515,467,0.551391863
NM_003386,ZAN,48,47,64172,8716,55456,1179.914894,181.5833333,6.362551629
NM_022574,GIGYF1,24,23,9742,6353,3389,147.3478261,264.7083333,0.533448764
NM_173059,ZAN,46,45,64172,8441,55731,1238.466667,183.5,6.602416775
NM_000799,EPO,5,4,2902,1335,1567,391.75,267,1.173782772
NM_005273,GNB2,10,9,5431,1674,3757,417.4444444,167.4,2.24432497
NM_001282449,ACHE,5,4,5979,1996,3983,995.75,399.2,1.995490982
NM_001128853,SRRT,20,19,13586,3021,10565,556.0526316,151.05,3.497186362
NM_015831,ACHE,5,4,5928,2962,2966,741.5,592.4,1.001350439
NM_003302,TRIP6,9,8,6128,1761,4367,545.875,195.6666667,2.479840999
NM_020246,SLC12A9,14,13,14295,3325,10970,843.8461538,237.5,3.29924812
NM_015908,SRRT,20,19,13586,3033,10553,555.4210526,151.65,3.47939334
NM_001267814,SLC12A9,12,11,12821,1945,10876,988.7272727,162.0833333,5.591773779
NM_001267812,SLC12A9,14,13,12821,2283,10538,810.6153846,163.0714286,4.615856329
NM_001128854,SRRT,20,19,13586,3018,10568,556.2105263,150.9,3.501656726
NM_001128852,SRRT,20,19,13586,3030,10556,555.5789474,151.5,3.483828383
NM_001015072,UFSP1,1,0,997,997,NA,NA,997,NA
NM_000665,ACHE,5,4,5928,2209,3719,929.75,441.8,1.683567225
NM_001164462,MUC12,12,11,49328,16333,32995,2999.545455,1361.083333,2.020143268
NM_030961,TRIM56,3,2,5105,3530,1575,787.5,1176.666667,0.446175637
NM_001040105,MUC17,13,12,38778,14363,24415,2034.583333,1104.846154,1.699853791
NM_000602,SERPINE1,9,8,12179,3199,8980,1122.5,355.4444444,2.807127227
NM_198571,NAT16,4,3,9785,2939,6846,2282,734.75,2.329363729
NM_003378,VGF,2,1,3064,2555,509,509,1277.5,0.199217221
NM_014343,CLDN15,5,4,5856,1375,4481,1120.25,275,3.258909091
NM_016068,FIS1,5,4,5480,744,4736,1184,148.8,6.365591398
NM_178176,MOGAT3,7,6,5292,1415,3877,646.1666667,202.1428571,2.739929329
NM_001283,AP1S1,5,4,6873,1302,5571,1392.75,260.4,4.278801843
NM_001084,PLOD3,19,18,11755,2996,8759,486.6111111,157.6842105,2.923564753
NM_001185080,CLDN15,6,5,6730,2137,4593,918.6,356.1666667,2.149274684
NM_006349,ZNHIT1,5,4,6488,1194,5294,1323.5,238.8,4.433835846
NM_001287147,MOGAT3,6,5,5292,1211,4081,816.2,201.8333333,3.369942197
NM_001287525,RABL5,6,5,8458,2518,5940,1188,419.6666667,2.359015091
NM_001287526,RABL5,3,2,8458,2275,6183,3091.5,758.3333333,2.717802198
NM_022777,RABL5,5,4,8458,2444,6014,1503.5,488.8,2.460720131
NM_001130820,RABL5,4,3,8458,2353,6105,2035,588.25,2.594560136
NM_001130822,RABL5,4,3,8458,2366,6092,2030.666667,591.5,2.574809806
NM_001130821,RABL5,5,4,8458,2475,5983,1495.75,495,2.417373737
NM_138403,MYL10,8,7,15973,1017,14956,2136.571429,127.125,14.70599803
NM_020979,SH2B2,7,6,33775,1901,31874,5312.333333,271.5714286,16.76696476
NM_024653,PRKRIP1,6,5,30327,2187,28140,5628,364.5,12.86694102
NM_001146210,SPDYE6,8,7,10699,3153,7546,1078,394.125,2.393276245
NM_032831,ORAI2,3,2,23293,10682,12611,6305.5,3560.666667,1.18058416
NM_001242713,LOC100289561,5,4,16774,1046,15728,3932,209.2,15.03632887
NM_001271819,ORAI2,3,2,23293,10553,12740,6370,3517.666667,1.207239647
NM_001271818,ORAI2,4,3,23293,10815,12478,4159.333333,2703.75,1.153767915
NM_001126340,ORAI2,4,3,23293,10792,12501,4167,2698,1.158358043
NM_001031618,SPDYE2,9,8,11080,1992,9088,1136,221.3333333,4.562248996
NM_001277335,RASA4B,20,19,34640,2814,31826,1675.052632,140.7,11.30987918
NM_006234,POLR2J,4,3,5835,980,4855,1618.333333,245,4.954081633
NM_001097615,POLR2J3,9,8,34704,1689,33015,4126.875,187.6666667,19.54706927
NM_001166339,SPDYE2B,9,8,11080,1992,9088,1136,221.3333333,4.562248996
NM_152892,LRWD1,15,14,8224,2213,6011,429.3571429,147.5333333,2.716222323
NM_001031618,SPDYE2,9,8,11077,1992,9085,1135.625,221.3333333,4.560742972
NM_001114403,UPK3BL,6,5,5768,1348,4420,884,224.6666667,3.278931751
NM_032959,POLR2J2,9,8,34983,1996,32987,4123.375,221.7777778,16.52655311
NM_001166339,SPDYE2B,9,8,11077,1992,9085,1135.625,221.3333333,4.560742972
NM_001145268,FAM185A,8,7,60275,2266,58009,8287,283.25,25.59973522
NM_001145269,FAM185A,7,6,60275,1914,58361,9726.833333,273.4285714,30.49164054
NM_005824,LRRC17,5,4,32214,2275,29939,7484.75,455,13.16
NM_001031692,LRRC17,4,3,32214,2221,29993,9997.666667,555.25,13.50427735
NM_031905,ARMC10,7,6,24884,2641,22243,3707.166667,377.2857143,8.422188565
NM_001161013,ARMC10,4,3,24884,2284,22600,7533.333333,571,9.894921191
NM_001161011,ARMC10,5,4,24884,2462,22422,5605.5,492.4,9.107229894
NM_001161012,ARMC10,5,4,24884,2357,22527,5631.75,471.4,9.557488333
NM_001161010,ARMC10,6,5,24884,2463,22421,4484.2,410.5,9.103126269
NM_001161009,ARMC10,6,5,24884,2535,22349,4469.8,422.5,8.81617357
NM_002803,PSMC2,12,11,21873,2843,19030,1730,236.9166667,6.693633486
NM_014377,DNAJC2,17,16,32401,2229,30172,1885.75,131.1176471,13.53611485
NM_001204453,PSMC2,5,4,14945,994,13951,3487.75,198.8,14.03521127
NM_001129887,DNAJC2,15,14,32401,2068,30333,2166.642857,137.8666667,14.66779497
NM_004279,PMPCB,13,12,17262,3932,13330,1110.833333,302.4615385,3.390132248
NM_021930,RINT1,15,14,35594,2991,32603,2328.785714,199.4,10.90036777
NM_182715,SYPL1,5,4,21979,2305,19674,4918.5,461,8.535357918
NM_006754,SYPL1,6,5,22281,2341,19940,3988,390.1666667,8.517727467
NM_002649,PIK3CG,11,10,43501,7221,36280,3628,656.4545455,5.024234871
NM_001282427,PIK3CG,11,10,43702,6996,36706,3670.6,636,5.246712407
NM_001282426,PIK3CG,11,10,43702,7072,36630,3663,642.9090909,5.179581448
NM_005295,GPR22,3,2,5625,2969,2656,1328,989.6666667,0.894577299
NM_001008405,BCAP29,8,7,42560,5781,36779,5254.142857,722.625,6.362048089
NM_018844,BCAP29,8,7,43342,6027,37315,5330.714286,753.375,6.191305791
NM_024814,CBLL1,6,5,17972,4438,13534,2706.8,739.6666667,3.049571879
NM_000111,SLC26A3,21,20,37768,2915,34853,1742.65,138.8095238,11.95643225
NM_001284291,CBLL1,6,5,17972,4435,13537,2707.4,739.1666667,3.052311161
NM_000108,DLD,14,13,30093,3627,26466,2035.846154,259.0714286,7.29693962
NM_001289750,DLD,12,11,30093,3476,26617,2419.727273,289.6666667,7.657364787
NM_001289751,DLD,13,12,30093,3557,26536,2211.333333,273.6153846,7.460219286
NM_001289752,DLD,13,12,30093,3482,26611,2217.583333,267.8461538,7.64244687
NM_012328,DNAJB9,3,2,5107,2541,2566,1283,847,1.009838646
NM_001287598,THAP5,3,2,7311,3391,3920,1960,1130.333333,1.15600118
NM_001287599,THAP5,3,2,7626,3315,4311,2155.5,1105,1.300452489
NM_001287601,THAP5,2,1,7626,3243,4383,4383,1621.5,1.351526364
NM_001130475,THAP5,3,2,7626,3437,4189,2094.5,1145.666667,1.218795461
NM_182529,THAP5,3,2,7311,3513,3798,1899,1171,1.081127242
NM_001024607,C7orf66,2,1,601,424,177,177,212,0.41745283
NM_001197079,IFRD1,12,11,25147,3412,21735,1975.909091,284.3333333,6.370164127
NM_001550,IFRD1,12,11,26777,3313,23464,2133.090909,276.0833333,7.082402656
NM_001134468,LSMEM1,4,3,10037,1474,8563,2854.333333,368.5,5.80936228
NM_182597,LSMEM1,4,3,9879,1680,8199,2733,420,4.880357143
NM_022484,TMEM168,5,4,28043,7306,20737,5184.25,1461.2,2.838352039
NM_001287497,TMEM168,6,5,28043,7398,20645,4129,1233,2.790619086
NM_002711,PPP1R3A,4,3,42202,4300,37902,12634,1075,8.814418605
NM_001166346,MDFIC,3,2,1513,894,619,309.5,298,0.692393736
NM_001166345,MDFIC,5,4,97763,5317,92446,23111.5,1063.4,17.3868723
NM_199072,MDFIC,5,4,97763,5317,92446,23111.5,1063.4,17.3868723
NM_001172897,CAV1,3,2,34829,2439,32390,16195,813,13.2800328
NM_001172896,CAV1,2,1,34894,2639,32255,32255,1319.5,12.22243274
NM_001172895,CAV1,3,2,36178,3205,32973,16486.5,1068.333333,10.28798752
NM_198212,CAV2,2,1,8942,2904,6038,6038,1452,2.079201102
NM_001753,CAV1,3,2,36402,2716,33686,16843,905.3333333,12.40279823
NM_001206748,CAV2,2,1,8499,2977,5522,5522,1488.5,1.854887471
NM_001206747,CAV2,3,2,8942,3093,5849,2924.5,1031,1.891044294
NM_001233,CAV2,3,2,8942,3093,5849,2924.5,1031,1.891044294
NM_003391,WNT2,5,4,46659,2911,43748,10937,582.2,15.02851254
NM_019644,ANKRD7,7,6,18074,1364,16710,2785,194.8571429,12.25073314
NM_198267,ING3,5,4,6219,1227,4992,1248,245.4,4.068459658
NM_019071,ING3,12,11,24896,2216,22680,2061.818182,184.6666667,10.23465704
NM_001040020,FAM3C,10,9,47519,2512,45007,5000.777778,251.2,17.91679936
NM_014888,FAM3C,10,9,47519,2552,44967,4996.333333,255.2,17.62029781
NM_001160264,FEZF1,5,4,3119,1960,1159,289.75,392,0.591326531
NM_001024613,FEZF1,4,3,3119,2109,1010,336.6666667,527.25,0.478899953
NM_139175,RNF133,1,0,1444,1444,NA,NA,1444,NA
NM_198085,RNF148,1,0,1303,1303,NA,NA,1303,NA
NM_016945,TAS2R16,1,0,997,997,NA,NA,997,NA
NM_001282420,NDUFA5,5,4,16744,1572,15172,3793,314.4,9.651399491
NM_001282855,IQUB,13,12,80768,3527,77241,6436.75,271.3076923,21.89991494
NM_001282422,NDUFA5,4,3,16877,1437,15440,5146.666667,359.25,10.74460682
NM_001282421,NDUFA5,5,4,16744,1563,15181,3795.25,312.6,9.712731926
NM_001282419,NDUFA5,4,3,16877,1509,15368,5122.666667,377.25,10.18422797
NM_178827,IQUB,13,12,82484,3127,79357,6613.083333,240.5384615,25.37799808
NM_005000,NDUFA5,5,4,16877,1555,15322,3830.5,311,9.853376206
NM_080928,ASB15,10,9,28822,2716,26106,2900.666667,271.6,9.611929308
NM_207163,LMOD2,3,2,8288,2152,6136,3068,717.3333333,2.851301115
NM_012269,HYAL4,5,4,32310,2411,29899,7474.75,482.2,12.40107839
NM_153189,SPAM1,5,4,34816,2051,32765,8191.25,410.2,15.97513408
NM_001174046,SPAM1,5,4,34193,2140,32053,8013.25,428,14.97803738
NM_001174045,SPAM1,6,5,34193,2226,31967,6393.4,371,14.36073675
NM_001174044,SPAM1,5,4,34816,2230,32586,8146.5,446,14.61255605
NM_001136002,TMEM229A,1,0,2555,2555,NA,NA,2555,NA
NM_001024603,LOC154872,4,3,13520,673,12847,4282.333333,168.25,19.08915305
NM_176814,ZNF800,6,5,22415,4227,18188,3637.6,704.5,4.302815235
NM_020369,FSCN3,7,6,8164,1898,6266,1044.333333,271.1428571,3.301369863
NM_006193,PAX4,9,8,5436,2019,3417,427.125,224.3333333,1.692421991
NM_001662,ARF5,6,5,3355,1102,2253,450.6,183.6666667,2.04446461
NM_024523,GCC1,2,1,4974,4134,840,840,2067,0.203193033
NM_022143,LRRC4,2,1,3880,3709,171,171,1854.5,0.046104071
NM_000230,LEP,3,2,16353,3430,12923,6461.5,1143.333333,3.767638484
NM_001174164,PRRT4,6,5,11362,3551,7811,1562.2,591.8333333,2.199662067
NM_001102605,IMPDH1,16,15,17707,2597,15110,1007.333333,162.3125,5.818251829
NM_001142575,IMPDH1,13,12,13695,2319,11376,948,178.3846154,4.905562743
NM_001142574,IMPDH1,14,13,13695,2380,11315,870.3846154,170,4.754201681
NM_183243,IMPDH1,15,14,17707,2518,15189,1084.928571,167.8666667,6.032168388
NM_001142576,IMPDH1,16,15,17707,2528,15179,1011.933333,158,6.004351266
NM_001142573,IMPDH1,14,13,13695,2395,11300,869.2307692,171.0714286,4.718162839
NM_018077,RBM28,19,18,33528,2828,30700,1705.555556,148.8421053,10.85572843
NM_000883,IMPDH1,17,16,17707,2628,15079,942.4375,154.5882353,5.73782344
NM_001114726,PRRT4,6,5,11362,2400,8962,1792.4,400,3.734166667
NM_001166135,RBM28,15,14,33528,2401,31127,2223.357143,160.0666667,12.96418159
NM_013332,HILPDA,2,1,2590,1414,1176,1176,707,0.831683168
NM_018396,METTL2B,9,8,26197,2191,24006,3000.75,243.4444444,10.9566408
NM_001098786,HILPDA,2,1,2590,1300,1290,1290,650,0.992307692
NM_001282789,FAM71F1,8,7,22684,1714,20970,2995.714286,214.25,12.23453909
NM_001282788,FAM71F1,7,6,16403,1766,14637,2439.5,252.2857143,8.288221971
NM_032599,FAM71F1,7,6,16403,1772,14631,2438.5,253.1428571,8.256772009
NM_001199673,CALU,6,5,34133,5162,28971,5794.2,860.3333333,5.612359551
NM_001199672,CALU,8,7,34133,6179,27954,3993.428571,772.375,4.524033015
NM_001199671,CALU,8,7,34133,6179,27954,3993.428571,772.375,4.524033015
NM_001708,OPN1SW,5,4,3303,1103,2200,550,220.6,1.99456029
NM_001219,CALU,7,6,34133,5363,28770,4795,766.1428571,5.364534775
NM_001130674,CALU,7,6,34133,5363,28770,4795,766.1428571,5.364534775
NM_001127487,FLNC,47,46,28847,9086,19761,429.5869565,193.3191489,2.174884438
NM_001195150,LOC100130705,2,1,5639,3805,1834,1834,1902.5,0.481997372
NM_199349,KCP,22,21,20774,2795,17981,856.2380952,127.0454545,6.433273703
NM_001198909,ATP6V1F,3,2,3048,820,2228,1114,273.3333333,2.717073171
NM_001458,FLNC,48,47,28847,9186,19661,418.3191489,191.375,2.140322229
NM_001135914,KCP,37,36,33856,4769,29089,808.0277778,128.8918919,6.099601594
NM_004231,ATP6V1F,2,1,3048,735,2313,2313,367.5,3.146938776
NM_012470,TNPO3,23,22,100995,4435,96560,4389.090909,192.826087,21.77226607
NM_001191028,TNPO3,22,21,100995,4242,96753,4607.285714,192.8181818,22.80834512
NM_178562,TSPAN33,8,7,24824,2788,22036,3148,348.5,7.903873745
NM_001130722,AHCYL2,17,16,54570,4937,49633,3102.0625,290.4117647,10.05327122
NM_001130723,AHCYL2,17,16,62090,5082,57008,3563,298.9411765,11.21763085
NM_001195243,SMKR1,2,1,10455,1037,9418,9418,518.5,9.081967213
NM_001282191,ZC3HC1,9,8,33167,1768,31399,3924.875,196.4444444,17.75961538
NM_001282190,ZC3HC1,11,10,33167,2029,31138,3113.8,184.4545455,15.3464761
NM_016478,ZC3HC1,10,9,33167,1982,31185,3465,198.2,15.73410696
NM_032842,TMEM209,15,14,40785,3560,37225,2658.928571,237.3333333,10.45646067
NM_145268,SSMEM1,3,2,8982,1159,7823,3911.5,386.3333333,6.749784297
NM_001127442,CPA5,11,10,23943,1879,22064,2206.4,170.8181818,11.74241618
NM_001127441,CPA5,14,13,23941,2076,21865,1681.923077,148.2857143,10.5322736
NM_016352,CPA4,11,10,31048,2828,28220,2822,257.0909091,9.978783593
NM_001869,CPA2,11,10,22936,1340,21596,2159.6,121.8181818,16.11641791
NM_080385,CPA5,13,12,23943,2024,21919,1826.583333,155.6923077,10.82954545
NM_001163446,CPA4,10,9,31048,2728,28320,3146.666667,272.8,10.38123167
NM_002402,MEST,12,11,14241,2517,11724,1065.818182,209.75,4.657926103
NM_001257158,CEP41,10,9,47441,6280,41161,4573.444444,628,6.554299363
NM_001253901,MEST,11,10,20124,2353,17771,1777.1,213.9090909,7.552486188
NM_001253900,MEST,12,11,14241,2475,11766,1069.636364,206.25,4.753939394
NM_018718,CEP41,11,10,47441,6497,40944,4094.4,590.6363636,6.301985532
NM_001257159,CEP41,9,8,47441,6231,41210,5151.25,692.3333333,6.613705665
NM_001257160,CEP41,3,2,22178,3318,18860,9430,1106,5.684147077
NM_177524,MEST,12,11,20124,2456,17668,1606.181818,204.6666667,7.193811075
NM_177525,MEST,12,11,14970,2393,12577,1143.363636,199.4166667,5.255745926
NM_001253902,MEST,11,10,19952,2305,17647,1764.7,209.5454545,7.655965293
NM_052933,TSGA13,8,7,17922,1661,16261,2323,207.625,9.789885611
NM_138693,KLF14,1,0,1480,1480,NA,NA,1480,NA
NM_032826,SLC35B4,10,9,27739,6825,20914,2323.777778,682.5,3.064322344
NM_001628,AKR1B1,10,9,16783,1408,15375,1708.333333,140.8,10.91974432
NM_001080538,AKR1B15,12,11,30745,1637,29108,2646.181818,136.4166667,17.78130727
NM_024033,C7orf49,4,3,5048,1622,3426,1142,405.5,2.112207152
NM_001243755,C7orf49,4,3,3696,1355,2341,780.3333333,338.75,1.727675277
NM_001243754,C7orf49,4,3,5048,1439,3609,1203,359.75,2.507991661
NM_001243753,C7orf49,4,3,3696,1537,2159,719.6666667,384.25,1.40468445
NM_001243752,C7orf49,4,3,4746,1733,3013,1004.333333,433.25,1.738603578
NM_001243751,C7orf49,4,3,5048,1659,3389,1129.666667,414.75,2.042796866
NM_001243749,C7orf49,4,3,5048,1912,3136,1045.333333,478,1.640167364
NM_018295,TMEM140,2,1,18203,2057,16146,16146,1028.5,7.84929509
NM_182489,STRA8,9,8,26515,1002,25513,3189.125,111.3333333,25.46207585
NM_001130929,C7orf73,3,2,13941,2501,11440,5720,833.6666667,4.574170332
NM_205855,FAM180A,4,3,19250,1805,17445,5815,451.25,9.664819945
NM_001243523,AC022173.2,4,3,4620,581,4039,1346.333333,145.25,6.951807229
NM_001190906,AKR1D1,8,7,41874,2595,39279,5611.285714,324.375,15.13641618
NM_005989,AKR1D1,9,8,41874,2719,39155,4894.375,302.1111111,14.4005149
NM_001190907,AKR1D1,8,7,41874,2635,39239,5605.571429,329.375,14.8914611
NM_001085429,TMEM213,3,2,8032,3393,4639,2319.5,1131,1.367226643
NM_024625,ZC3HAV1,9,8,49383,3191,46192,5774,354.5555556,14.47571294
NM_080660,ZC3HAV1L,5,4,10325,1758,8567,2141.75,351.6,4.873151308
NM_020119,ZC3HAV1,13,12,66201,7184,59017,4918.083333,552.6153846,8.215061247
NM_001144923,TTC26,17,16,58244,4257,53987,3374.1875,250.4117647,12.68193564
NM_001287513,TTC26,18,17,58244,4280,53964,3174.352941,237.7777778,12.60841121
NM_001287512,TTC26,15,14,58244,3955,54289,3877.785714,263.6666667,13.72667509
NM_001144920,TTC26,17,16,58244,4216,54028,3376.75,248,12.81499051
NM_024926,TTC26,18,17,58244,4351,53893,3170.176471,241.7222222,12.38634797
NM_197964,C7orf55,2,1,5189,1212,3977,3977,606,3.281353135
NM_198508,KLRG2,5,4,30371,1549,28822,7205.5,309.8,18.60684312
NM_001080511,CLEC2L,5,4,21059,1293,19766,4941.5,258.6,15.28692962
NM_022750,PARP12,12,11,39974,3803,36171,3288.272727,316.9166667,9.511175388
NM_032295,SLC37A3,12,11,64800,3060,61740,5612.727273,255,20.17647059
NM_001287498,SLC37A3,14,13,64800,3316,61484,4729.538462,236.8571429,18.54161641
NM_207113,SLC37A3,15,14,64800,3365,61435,4388.214286,224.3333333,18.25705795
NM_013446,MKRN1,8,7,26531,3159,23372,3338.857143,394.875,7.398543843
NM_001145125,MKRN1,5,4,23388,1685,21703,5425.75,337,12.88011869
NM_004546,NDUFB2,4,3,9967,499,9468,3156,124.75,18.9739479
NM_016071,MRPS33,3,2,8520,749,7771,3885.5,249.6666667,10.37516689
NM_053035,MRPS33,3,2,8822,691,8131,4065.5,230.3333333,11.76700434
NM_001080392,KIAA1147,9,8,45427,7305,38122,4765.25,811.6666667,5.218617385
NM_016944,TAS2R4,1,0,901,901,NA,NA,901,NA
NM_016943,TAS2R3,1,0,1102,1102,NA,NA,1102,NA
NM_001171951,PRSS37,5,4,5145,1199,3946,986.5,239.8,3.291075897
NM_001256510,SSBP1,7,6,11883,1023,10860,1810,146.1428571,10.61583578
NM_003143,SSBP1,7,6,12169,721,11448,1908,103,15.8779473
NM_001256513,SSBP1,7,6,12169,814,11355,1892.5,116.2857143,13.94963145
NM_001256512,SSBP1,7,6,12169,886,11283,1880.5,126.5714286,12.73476298
NM_001256511,SSBP1,7,6,12169,904,11265,1877.5,129.1428571,12.46128319
NM_018980,TAS2R5,1,0,1151,1151,NA,NA,1151,NA
NM_001008270,PRSS37,5,4,5145,1202,3943,985.75,240.4,3.280366057
NM_013252,CLEC5A,7,6,19628,3518,16110,2685,502.5714286,4.579306424
NM_176817,TAS2R38,1,0,1144,1144,NA,NA,1144,NA
NM_001001656,OR9A4,1,0,946,946,NA,NA,946,NA
NM_004668,MGAM,48,47,110870,6532,104338,2219.957447,136.0833333,15.97336191
NM_001001317,PRSS58,6,5,5922,924,4998,999.6,154,5.409090909
NM_002769,PRSS1,5,4,3610,822,2788,697,164.4,3.391727494
NM_001190487,MTRNR2L6,1,0,1396,1396,NA,NA,1396,NA
NM_001280794,EPHB6,19,18,16073,4013,12060,670,211.2105263,3.005232993
NM_001280795,EPHB6,16,15,8335,3382,4953,330.2,211.375,1.464518037
NM_002770,PRSS2,2,1,1472,410,1062,1062,205,2.590243902
NM_018646,TRPV6,15,14,14536,2926,11610,829.2857143,195.0666667,3.967874231
NM_004445,EPHB6,17,16,8335,3452,4883,305.1875,203.0588235,1.414542294
NM_000420,KEL,19,18,21304,2566,18738,1041,135.0526316,7.302416212
NM_178829,C7orf34,2,1,1356,770,586,586,385,0.761038961
NM_001001658,OR9A2,1,0,934,934,NA,NA,934,NA
NM_002652,PIP,4,3,7662,580,7082,2360.666667,145,12.21034483
NM_001001667,OR6V1,1,0,943,943,NA,NA,943,NA
NM_001282876,TMEM139,3,2,3101,2387,714,357,795.6666667,0.299120235
NM_001282877,TMEM139,4,3,3152,2069,1083,361,517.25,0.523441276
NM_153345,TMEM139,3,2,3152,1967,1185,592.5,655.6666667,0.602440264
NM_015917,GSTK1,8,7,5702,1066,4636,662.2857143,133.25,4.348968105
NM_001242775,TMEM139,4,3,3152,2090,1062,354,522.5,0.508133971
NM_001242774,TMEM139,5,4,3152,2178,974,243.5,435.6,0.447199265
NM_001242773,TMEM139,4,3,3152,2066,1086,362,516.5,0.525653437
NM_001143680,GSTK1,7,6,5702,1029,4673,778.8333333,147,4.541302235
NM_001143679,GSTK1,7,6,5702,1233,4469,744.8333333,176.1428571,3.624493106
NM_001143681,GSTK1,7,6,5702,936,4766,794.3333333,133.7142857,5.091880342
NM_176882,TAS2R40,1,0,973,973,NA,NA,973,NA
NM_176881,TAS2R39,1,0,1018,1018,NA,NA,1018,NA
NM_001278297,FAM131B,6,5,9349,4289,5060,1012,714.8333333,1.179762182
NM_001010972,ZYX,10,9,9848,2315,7533,837,231.5,3.25399568
NM_014690,FAM131B,7,6,8682,4277,4405,734.1666667,611,1.029927519
NM_005232,EPHA1,18,17,17782,3381,14401,847.1176471,187.8333333,4.259390713
NM_003461,ZYX,10,9,9848,2318,7530,836.6666667,231.8,3.248490078
NM_000083,CLCN1,23,22,35880,3116,32764,1489.272727,135.4782609,10.51476252
NM_001031690,FAM131B,7,6,9349,4384,4965,827.5,626.2857143,1.132527372
NM_177437,TAS2R60,1,0,958,958,NA,NA,958,NA
NM_176883,TAS2R41,1,0,925,925,NA,NA,925,NA
NM_001008747,CTAGE15,1,0,2588,2588,NA,NA,2588,NA
NM_001130026,FAM115C,8,7,14236,4893,9343,1334.714286,611.625,1.909462497
NM_178561,CTAGE6,1,0,2663,2663,NA,NA,2663,NA
NM_001206938,FAM115A,9,8,50819,5739,45080,5635,637.6666667,7.855027008
NM_001206941,FAM115A,8,7,34007,5083,28924,4132,635.375,5.69034035
NM_014719,FAM115A,9,8,50713,5673,45040,5630,630.3333333,7.93936189
NM_001004685,OR2F2,1,0,955,955,NA,NA,955,NA
NM_012365,OR2A5,1,0,937,937,NA,NA,937,NA
NM_012369,OR2F1,1,0,1090,1090,NA,NA,1090,NA
NM_001004488,OR2A25,1,0,934,934,NA,NA,934,NA
NM_001005281,OR6B1,1,0,937,937,NA,NA,937,NA
NM_198495,CTAGE4,1,0,2627,2627,NA,NA,2627,NA
NM_001005480,OR2A2,1,0,958,958,NA,NA,958,NA
NM_001003702,ARHGEF35,2,1,9617,2476,7141,7141,1238,2.884087237
NM_001004135,OR2A12,1,0,934,934,NA,NA,934,NA
NM_001001659,OR2A14,1,0,934,934,NA,NA,934,NA
NM_001005328,OR2A7,1,0,934,934,NA,NA,934,NA
NM_001005287,OR2A1,1,0,934,934,NA,NA,934,NA
NM_001005287,OR2A1,1,0,934,934,NA,NA,934,NA
NM_198495,CTAGE4,1,0,2627,2627,NA,NA,2627,NA
NM_001278507,CTAGE8,1,0,3112,3112,NA,NA,3112,NA
NM_001001802,OR2A42,1,0,934,934,NA,NA,934,NA
NM_001001802,OR2A42,1,0,934,934,NA,NA,934,NA
NM_001080413,NOBOX,10,9,12989,2086,10903,1211.444444,208.6,5.22674976
NM_005435,ARHGEF5,15,14,25238,5503,19735,1409.642857,366.8666667,3.586225695
NM_145304,C7orf33,3,2,25297,1357,23940,11970,452.3333333,17.64185704
NM_003592,CUL1,22,21,102271,3231,99040,4716.190476,146.8636364,30.65304859
NM_004911,PDIA4,10,9,25630,2962,22668,2518.666667,296.2,7.652937205
NM_020781,ZNF398,7,6,56612,5499,51113,8518.833333,785.5714286,9.29496272
NM_152411,ZNF786,4,3,21138,3272,17866,5955.333333,818,5.460268949
NM_170686,ZNF398,6,5,35560,5435,30125,6025,905.8333333,5.542778289
NM_001001661,ZNF425,4,3,23562,3222,20340,6780,805.5,6.312849162
NM_001195220,ZNF783,6,5,22825,4461,18364,3672.8,743.5,4.116565792
NM_012256,ZNF212,5,4,15960,2815,13145,3286.25,563,4.669626998
NM_015694,ZNF777,6,5,29601,3078,26523,5304.6,513,8.616959064
NM_152557,ZNF746,7,6,25016,3804,21212,3535.333333,543.4285714,5.576235542
NM_001163474,ZNF746,7,6,25016,3807,21209,3534.833333,543.8571429,5.571053323
NM_198455,SSPO,110,109,57924,15689,42237,387.4954128,142.6272727,2.692140991
NM_207336,ZNF467,5,4,8844,2284,6560,1640,456.8,2.872154116
NM_145230,ATP6V0E2,4,3,7732,2731,5001,1667,682.75,1.831197364
NM_001100592,ATP6V0E2,3,2,7683,2568,5115,2557.5,856,1.99182243
NM_001142928,LRRC61,3,2,14951,1966,12985,6492.5,655.3333333,6.604781282
NM_023942,LRRC61,2,1,14951,1795,13156,13156,897.5,7.329247911
NM_014374,REPIN1,1,0,2877,2877,NA,NA,2877,NA
NM_013400,REPIN1,4,3,5256,3296,1960,653.3333333,824,0.594660194
NM_002889,RARRES2,6,5,3358,747,2611,522.2,124.5,3.495314592
NM_138434,ZBED6CL,1,0,2875,2875,NA,NA,2875,NA
NM_001099696,REPIN1,2,1,5256,2971,2285,2285,1485.5,0.769101313
NM_001099695,REPIN1,3,2,5256,3170,2086,1043,1056.666667,0.658044164
NM_175571,GIMAP8,5,4,28523,3948,24575,6143.75,789.6,6.224670719
NM_024711,GIMAP6,3,2,7274,3705,3569,1784.5,1235,0.963292848
NM_153236,GIMAP7,2,1,6218,1231,4987,4987,615.5,4.051177904
NM_018326,GIMAP4,3,2,6585,1968,4617,2308.5,656,2.346036585
NM_001244072,GIMAP6,3,2,7274,3915,3359,1679.5,1305,0.85798212
NM_001244071,GIMAP6,3,2,7274,3481,3793,1896.5,1160.333333,1.089629417
NM_001199577,GIMAP1-GIMAP5,6,5,27094,2268,24826,4965.2,378,10.94620811
NM_015660,GIMAP2,3,2,7936,1445,6491,3245.5,481.6666667,4.492041522
NM_130759,GIMAP1,3,2,7725,4419,3306,1653,1473,0.748133062
NM_018384,GIMAP5,3,2,6303,1880,4423,2211.5,626.6666667,2.352659574
NM_001272072,AOC1,5,4,8816,2498,6318,1579.5,499.6,2.529223379
NM_001101314,TMEM176B,6,5,9247,1192,8055,1611,198.6666667,6.757550336
NM_001101312,TMEM176B,7,6,9247,1304,7943,1323.833333,186.2857143,6.091257669
NM_001101311,TMEM176B,7,6,9247,1312,7935,1322.5,187.4285714,6.048018293
NM_001091,AOC1,5,4,8816,2441,6375,1593.75,488.2,2.611634576
NM_014020,TMEM176B,7,6,10074,1436,8638,1439.666667,205.1428571,6.015320334
NM_018487,TMEM176A,7,6,4356,1045,3311,551.8333333,149.2857143,3.168421053
NM_001160111,NOS3,14,13,10133,2551,7582,583.2307692,182.2142857,2.972167777
NM_001160110,NOS3,14,13,10133,2391,7742,595.5384615,170.7857143,3.237975742
NM_001204798,KCNH2,5,4,6403,2449,3954,988.5,489.8,1.614536546
NM_172056,KCNH2,9,8,28888,3548,25340,3167.5,394.2222222,7.14205186
NM_000603,NOS3,27,26,23545,4365,19180,737.6923077,161.6666667,4.394043528
NM_000238,KCNH2,15,14,33360,4305,29055,2075.357143,287,6.74912892
NM_001160109,NOS3,14,13,10133,2045,8088,622.1538462,146.0714286,3.955012225
NM_173681,ATG9B,17,16,12291,4593,7698,481.125,270.1764706,1.676028739
NM_172057,KCNH2,11,10,10875,3206,7669,766.9,291.4545455,2.392077355
NM_001164410,CDK5,11,10,4152,1105,3047,304.7,100.4545455,2.757466063
NM_006712,FASTK,10,9,4264,1881,2383,264.7777778,188.1,1.26687932
NM_001042535,AGAP3,9,8,36928,2081,34847,4355.875,231.2222222,16.74531475
NM_004935,CDK5,12,11,4155,1205,2950,268.1818182,100.4166667,2.44813278
NM_001258461,FASTK,10,9,4264,1800,2464,273.7777778,180,1.368888889
NM_031434,TMUB1,3,2,2243,1801,442,221,600.3333333,0.245419212
NM_031946,AGAP3,18,17,57726,3277,54449,3202.882353,182.0555556,16.61550198
NM_033015,FASTK,9,8,4264,1457,2807,350.875,161.8888889,1.926561428
NM_001136044,TMUB1,3,2,2450,1338,1112,556,446,0.831091181
NM_001199694,SLC4A2,22,21,13877,4395,9482,451.5238095,199.7727273,2.15745165
NM_001199692,SLC4A2,23,22,18317,4949,13368,607.6363636,215.173913,2.701151748
NM_020321,ASIC3,11,10,4466,2325,2141,214.1,211.3636364,0.920860215
NM_001281300,AGAP3,16,15,58607,2784,55823,3721.533333,174,20.05136494
NM_001199693,SLC4A2,22,21,13982,3974,10008,476.5714286,180.6363636,2.518369401
NM_020322,ASIC3,10,9,4466,2245,2221,246.7777778,224.5,0.989309577
NM_003040,SLC4A2,23,22,16959,4165,12794,581.5454545,181.0869565,3.071788715
NM_004769,ASIC3,11,10,4466,2305,2161,216.1,209.5454545,0.937527115
NM_003078,SMARCD3,14,13,38174,1725,36449,2803.769231,123.2142857,21.12985507
NM_007189,ABCF2,15,14,15892,4711,11181,798.6428571,314.0666667,2.373381448
NM_080871,ASB10,6,5,12136,1744,10392,2078.4,290.6666667,5.958715596
NM_005692,ABCF2,16,15,19539,2409,17130,1142,150.5625,7.110834371
NM_019015,CHPF2,4,3,6340,3992,2348,782.6666667,998,0.588176353
NM_001142459,ASB10,6,5,11695,1940,9755,1951,323.3333333,5.028350515
NM_001142460,ASB10,5,4,11695,1825,9870,2467.5,365,5.408219178
NM_001284295,CHPF2,5,4,6340,2722,3618,904.5,544.4,1.329169728
NM_001003802,SMARCD3,14,13,37763,1686,36077,2775.153846,120.4285714,21.39798339
NM_001003801,SMARCD3,13,12,9692,1696,7996,666.3333333,130.4615385,4.714622642
NM_016118,NUB1,15,14,36703,3146,33557,2396.928571,209.7333333,10.66656071
NM_198285,WDR86,6,5,28919,2047,26872,5374.4,341.1666667,13.12750366
NM_001243351,NUB1,15,14,36703,3188,33515,2393.928571,212.5333333,10.51286073
NM_001284260,WDR86,6,5,28919,2111,26808,5361.6,351.8333333,12.69919469
NM_001284262,WDR86,6,5,29586,1548,28038,5607.6,258,18.1124031
NM_001284261,WDR86,5,4,29586,1411,28175,7043.75,282.2,19.96810773
NM_005614,RHEB,8,7,53914,2083,51831,7404.428571,260.375,24.88286126
NM_144727,CRYGN,4,3,10045,727,9318,3106,181.75,12.8170564
NM_145292,GALNTL5,9,8,63557,1744,61813,7726.625,193.7777778,35.44323394
NM_005431,XRCC2,3,2,29665,3072,26593,13296.5,1024,8.656575521
NM_001040135,ACTR3B,10,9,95632,2017,93615,10401.66667,201.7,46.41298959
NM_020445,ACTR3B,12,11,95632,2229,93403,8491.181818,185.75,41.90354419
NM_007349,PAXIP1,21,20,59284,3733,55551,2777.55,177.7619048,14.88106081
NM_024012,HTR5A,2,1,17070,4557,12513,12513,2278.5,2.745885451
NM_198336,INSIG1,6,5,12461,2631,9830,1966,438.5,3.736221969
NM_198337,INSIG1,4,3,12461,2722,9739,3246.333333,680.5,3.577883909
NM_005542,INSIG1,6,5,12461,3016,9445,1889,502.6666667,3.1316313
NM_001427,EN2,2,1,6704,3397,3307,3307,1698.5,0.973506035
NM_000193,SHH,3,2,9411,1579,7832,3916,526.3333333,4.96010133
NM_001184997,RNF32,9,8,34151,1757,32394,4049.25,195.2222222,18.43710871
NM_001184996,RNF32,9,8,36381,1904,34477,4309.625,211.5555556,18.10766807
NM_030936,RNF32,9,8,36469,1799,34670,4333.75,199.8888889,19.27181768
NM_001165255,MNX1,3,2,4584,1623,2961,1480.5,541,1.824399261
NM_005515,MNX1,3,2,5802,2179,3623,1811.5,726.3333333,1.662689307
NM_001204869,WISP1,3,2,40652,4737,35915,17957.5,1579,7.581802829
NM_080838,WISP1,4,3,40652,4932,35720,11906.66667,1233,7.242497972
NM_001204870,WISP1,2,1,40652,4456,36196,36196,2228,8.122980251
NM_003882,WISP1,5,4,40652,5194,35458,8864.5,1038.8,6.826723142
NM_024940,DOCK5,52,51,228334,7607,220727,4327.980392,146.2884615,29.01630078
NM_001282357,SLC26A7,19,18,188662,5162,183500,10194.44444,271.6842105,35.54823712
NM_134266,SLC26A7,19,18,145432,2694,142738,7929.888889,141.7894737,52.98366741
NM_001282356,SLC26A7,20,19,188662,5326,183336,9649.263158,266.3,34.42283139
NM_052832,SLC26A7,19,18,148868,5286,143582,7976.777778,278.2105263,27.16269391
NM_152564,VPS13B,62,61,864322,14087,850235,13938.27869,227.2096774,60.35600199
NM_017890,VPS13B,62,61,864322,14162,850160,13937.04918,228.4193548,60.03106906
NM_178565,RSPO2,6,5,184371,3155,181216,36243.2,525.8333333,57.43771791
NM_001282863,RSPO2,5,4,183889,2753,181136,45284,550.6,65.79585906
NM_001040704,DEFB106B,2,1,3885,305,3580,3580,152.5,11.73770492
NM_033225,CSMD1,70,69,2059455,14387,2045068,29638.66667,205.5285714,142.1469382
NM_024596,MCPH1,14,13,237029,3168,233861,17989.30769,226.2857143,73.8197601
NM_152251,DEFB106A,2,1,3885,305,3580,3580,152.5,11.73770492
NM_001172575,MCPH1,7,6,40829,3636,37193,6198.833333,519.4285714,10.22909791
NM_001172574,MCPH1,8,7,40829,3781,37048,5292.571429,472.625,9.798466014
NM_152271,LONRF1,12,11,33588,3596,29992,2726.545455,299.6666667,8.340378198
NM_178857,RP1L1,4,3,48759,7981,40778,13592.66667,1995.25,5.109384789
NM_139167,SGCZ,8,7,1148421,2186,1146235,163747.8571,273.25,524.352699
NM_003747,TNKS,27,26,226413,9626,216787,8337.961538,356.5185185,22.52098483
NM_001172410,SFTPC,6,5,2809,981,1828,365.6,163.5,1.863404689
NM_001172357,SFTPC,5,4,2809,1176,1633,408.25,235.2,1.388605442
NM_003018,SFTPC,6,5,2809,989,1820,364,164.8333333,1.840242669
NM_006197,PCM1,39,38,107093,8822,98271,2586.078947,226.2051282,11.13931081
NM_003844,TNFRSF10A,10,9,33712,1760,31952,3550.222222,176,18.15454545
NM_001160008,NRG1,11,10,212781,2370,210411,21041.1,215.4545455,88.78101266
NM_001160005,NRG1,5,4,195044,1630,193414,48353.5,326,118.6588957
NM_001159995,NRG1,11,10,169216,2438,166778,16677.8,221.6363636,68.40771124
NM_001160007,NRG1,4,3,180410,1591,178819,59606.33333,397.75,112.3940918
NM_001160004,NRG1,13,12,216832,3224,213608,17800.66667,248,66.25558313
NM_004495,NRG1,6,5,180410,1695,178715,35743,282.5,105.4365782
NM_002717,PPP2R2A,10,9,81190,3949,77241,8582.333333,394.9,19.55963535
NM_013962,NRG1,5,4,1103504,1991,1101513,275378.25,398.2,553.2461075
NM_001177591,PPP2R2A,10,9,79465,3681,75784,8420.444444,368.1,20.58788373
NM_001008711,RBPMS,10,9,187763,3015,184748,20527.55556,301.5,61.27628524
NM_006867,RBPMS,10,9,187763,3135,184628,20514.22222,313.5,58.89250399
NM_173175,PTK2B,30,29,133829,3971,129858,4477.862069,132.3666667,32.7015865
NM_173174,PTK2B,36,35,147911,4756,143155,4090.142857,132.1111111,30.09987384
NM_013958,NRG1,7,6,195044,1734,193310,32218.33333,247.7142857,111.4821223
NM_013957,NRG1,12,11,216832,3081,213751,19431.90909,256.75,69.37715028
NM_013956,NRG1,13,12,216832,3106,213726,17810.5,238.9230769,68.81068899
NM_013964,NRG1,12,11,216832,3090,213742,19431.09091,257.5,69.17216828
NM_013959,NRG1,3,2,96521,2364,94157,47078.5,788,39.82952623
NM_013960,NRG1,13,12,216832,3233,213599,17799.91667,248.6923077,66.06835756
NM_004103,PTK2B,32,31,136991,4197,132794,4283.677419,131.15625,31.6402192
NM_001159999,NRG1,12,11,169216,2490,166726,15156.90909,207.5,66.95823293
NM_001160002,NRG1,5,4,180410,1643,178767,44691.75,328.6,108.8052343
NM_001160001,NRG1,10,9,169216,2386,166830,18536.66667,238.6,69.92036882
NM_001258211,FBXO16,8,7,61911,1318,60593,8656.142857,164.75,45.97344461
NM_173176,PTK2B,31,30,133914,4183,129731,4324.366667,134.9354839,31.01386565
NM_172366,FBXO16,9,8,61911,1355,60556,7569.5,150.5555556,44.69077491
NM_001008710,RBPMS,9,8,187763,2928,184835,23104.375,325.3333333,63.12670765
NM_025151,RAB11FIP1,5,4,40552,5959,34593,8648.25,1191.8,5.805168652
NM_080872,UNC5D,17,16,559208,7307,551901,34493.8125,429.8235294,75.53045025
NM_021623,PLEKHA2,13,12,72679,5653,67028,5585.666667,434.8461538,11.85706704
NM_194294,IDO2,11,10,81438,2305,79133,7913.3,209.5454545,34.33101952
NM_001031836,KCNU1,27,26,151803,3769,148034,5693.615385,139.5925926,39.27673123
NM_001002814,RAB11FIP1,6,5,40552,7862,32690,6538,1310.333333,4.15797507
NM_001282919,SPIDR,19,18,475095,3363,471732,26207.33333,177,140.2711864
NM_001282916,SPIDR,19,18,475095,3332,471763,26209.05556,175.3684211,141.5855342
NM_001080394,SPIDR,20,19,475095,3400,471695,24826.05263,170,138.7338235
NM_018967,SNTG1,19,18,882341,3417,878924,48829.11111,179.8421053,257.2209541
NM_144651,PXDNL,23,22,489870,4830,485040,22047.27273,210,100.4223602
NM_207413,FAM150A,5,4,31426,1176,30250,7562.5,235.2,25.72278912
NM_001287813,SNTG1,20,19,884331,3234,881097,46373.52632,161.7,272.4480519
NM_001287814,SNTG1,17,16,882341,3229,879112,54944.5,189.9411765,272.2551874
NM_014729,TOX,9,8,313792,4140,309652,38706.5,460,74.79516908
NM_001164383,STAU2,10,9,326560,2461,324099,36011,246.1,131.6940268
NM_001164382,STAU2,14,13,326560,2894,323666,24897.38462,206.7142857,111.8403594
NM_001164381,STAU2,14,13,326560,2940,323620,24893.84615,210,110.0748299
NM_001164380,STAU2,15,14,326560,3072,323488,23106.28571,204.8,105.3020833
NM_006540,NCOA2,23,22,291755,6180,285575,12980.68182,268.6956522,46.20954693
NM_006421,ARFGEF1,39,38,146030,7264,138766,3651.736842,186.2564103,19.1032489
NM_024721,ZFHX4,11,10,186008,13969,172039,17203.9,1269.909091,12.31577063
NM_001199888,IL7,4,3,72753,1894,70859,23619.66667,473.5,37.4123548
NM_001199887,IL7,5,4,72753,2027,70726,17681.5,405.4,34.89195856
NM_001199886,IL7,5,4,72753,1949,70804,17701,389.8,36.32837352
NM_000880,IL7,6,5,72753,2082,70671,14134.2,347,33.94380403
NM_005941,MMP16,10,9,290259,6345,283914,31546,634.5,44.74609929
NM_173538,CNBD1,11,10,516281,1470,514811,51481.1,133.6363636,350.2115646
NM_006281,STK3,11,10,371052,2839,368213,36821.3,258.0909091,129.6981331
NM_012415,RAD54B,15,14,103157,3089,100068,7147.714286,205.9333333,32.39494982
NM_002998,SDC2,5,4,118157,3490,114667,28666.75,698,32.85587393
NM_001205263,RAD54B,13,12,64994,3110,61884,5157,239.2307692,19.89839228
NM_001256313,STK3,9,8,371042,2494,368548,46068.5,277.1111111,147.7738573
NM_001256312,STK3,13,12,487942,3184,484758,40396.5,244.9230769,152.2481156
NM_001040630,NCALD,6,5,438367,3815,434552,86910.4,635.8333333,113.9061599
NM_001040627,NCALD,6,5,437794,3575,434219,86843.8,595.8333333,121.4598601
NM_001040626,NCALD,7,6,437794,3663,434131,72355.16667,523.2857143,118.5178815
NM_001040625,NCALD,7,6,437794,3663,434131,72355.16667,523.2857143,118.5178815
NM_001040629,NCALD,7,6,437794,3632,434162,72360.33333,518.8571429,119.5379956
NM_001040628,NCALD,8,7,437794,3720,434074,62010.57143,465,116.6865591
NM_001040624,NCALD,8,7,437794,3751,434043,62006.14286,468.875,115.7139429
NM_032041,NCALD,4,3,104671,3722,100949,33649.66667,930.5,27.1222461
NM_014677,RIMS2,22,21,435242,6442,428800,20419.04762,292.8181818,66.56317914
NM_001282881,RIMS2,21,20,435242,6516,428726,21436.3,310.2857143,65.79588705
NM_001100117,RIMS2,24,23,753682,6821,746861,32472.21739,284.2083333,109.4943557
NM_052900,CSMD3,69,68,1214085,12686,1201399,17667.63235,183.8550725,94.70274318
NM_003301,TRHR,2,1,32161,1416,30745,30745,708,21.71257062
NM_198124,CSMD3,72,71,1154225,13088,1141137,16072.35211,181.7777778,87.18956296
NM_198123,CSMD3,71,70,1214085,13195,1200890,17155.57143,185.8450704,91.01098901
NM_021021,SNTB1,7,6,276326,4982,271344,45224,711.7142857,54.46487354
NM_001040092,ENPP2,25,24,81791,3147,78644,3276.833333,125.88,24.99014935
NM_006209,ENPP2,26,25,81791,3304,78487,3139.48,127.0769231,23.75514528
NM_001101676,SAMD12,5,4,432491,8874,423617,105904.25,1774.8,47.73687176
NM_001130863,ENPP2,26,25,81791,3223,78568,3142.72,123.9615385,24.37728824
NM_207506,SAMD12,4,3,243959,2168,241791,80597,542,111.527214
NM_001204824,KCNQ3,15,14,326406,10714,315692,22549.42857,714.2666667,29.46537241
NM_001247996,ASAP1,31,30,391557,6377,385180,12839.33333,205.7096774,60.40144268
NM_018482,ASAP1,30,29,391557,6274,385283,13285.62069,209.1333333,61.40946764
NM_004519,KCNQ3,15,14,359901,11263,348638,24902.71429,750.8666667,30.95427506
NM_015912,FAM135B,20,19,366801,6982,359819,18937.84211,349.1,51.53523346
NM_012154,AGO2,19,18,104384,3519,100865,5603.611111,185.2105263,28.66297244
NM_001164623,AGO2,18,17,104384,3416,100968,5939.294118,189.7777778,29.55737705
NM_001024678,LRRC24,5,4,4657,1777,2880,720,355.4,1.62070906
NM_001001795,C8orf82,3,2,2857,1935,922,461,645,0.476485788
NM_183421,FBXO25,11,10,63069,2452,60617,6061.7,222.9090909,24.72145188
NM_183420,FBXO25,10,9,63069,2424,60645,6738.333333,242.4,25.01856436
NM_012173,FBXO25,9,8,63069,2373,60696,7587,263.6666667,25.57774968
NM_207332,ERICH1,6,5,67028,1806,65222,13044.4,301,36.11406423
NM_001277161,DLGAP2,11,10,207112,10101,197011,19701.1,918.2727273,19.5041085
NM_014629,ARHGEF10,29,28,134660,5620,129040,4608.571429,193.7931034,22.96085409
NM_004745,DLGAP2,12,11,207112,10144,196968,17906.18182,845.3333333,19.41719243
NM_207411,XKR5,8,7,27127,4898,22231,3175.857143,612.25,4.538791343
NM_004225,MFHAS1,3,2,109134,5258,103876,51938,1752.666667,19.75580068
NM_012331,MSRA,6,5,374573,1490,373083,74616.6,248.3333333,250.3912752
NM_001199729,MSRA,7,6,333337,1715,331622,55270.33333,245,193.3655977
NM_001135670,MSRA,5,4,374573,1369,373204,93301,273.8,272.6106647
NM_001135671,MSRA,6,5,333337,1639,331698,66339.6,273.1666667,202.3782794
NM_001715,BLK,13,12,70589,2603,67986,5665.5,200.2307692,26.11832501
NM_173683,XKR6,3,2,305220,3761,301459,150729.5,1253.666667,80.15394842
NM_001195257,LOC100133267,2,1,7360,242,7118,7118,121,29.41322314
NM_001287756,FDFT1,5,4,36700,1694,35006,8751.5,338.8,20.66469894
NM_001287747,FDFT1,8,7,36267,2338,33929,4847,292.25,14.51197605
NM_001287745,FDFT1,9,8,36700,2382,34318,4289.75,264.6666667,14.40722082
NM_001287748,FDFT1,8,7,36222,2000,34222,4888.857143,250,17.111
NM_001037804,DEFB130,2,1,7360,242,7118,7118,121,29.41322314
NM_001287744,FDFT1,8,7,43738,2302,41436,5919.428571,287.75,18
NM_001287742,FDFT1,10,9,43738,2675,41063,4562.555556,267.5,15.35065421
NM_001287743,FDFT1,9,8,43738,2476,41262,5157.75,275.1111111,16.66478191
NM_004462,FDFT1,8,7,36700,2184,34516,4930.857143,273,15.8040293
NM_182643,DLC1,18,17,431559,7497,424062,24944.82353,416.5,56.56422569
NM_024767,DLC1,5,4,210315,2459,207856,51964,491.8,84.52867019
NM_006094,DLC1,14,13,49939,6058,43881,3375.461538,432.7142857,7.243479696
NM_020844,KIAA1456,5,4,84103,9593,74510,18627.5,1918.6,7.76712186
NM_006765,TUSC3,11,10,226564,3895,222669,22266.9,354.0909091,57.16790757
NM_178234,TUSC3,10,9,226564,3829,222735,24748.33333,382.9,58.17054061
NM_138715,MSR1,10,9,84915,3771,81144,9016,377.1,21.51789976
NM_138716,MSR1,9,8,84915,3581,81334,10166.75,397.8888889,22.7126501
NM_001166393,MTUS1,12,11,78783,3663,75120,6829.090909,305.25,20.50778051
NM_016353,ZDHHC2,13,12,66407,4025,62382,5198.5,309.6153846,15.49863354
NM_181723,MICU3,15,14,95403,4002,91401,6528.642857,266.8,22.83883058
NM_004686,MTMR7,14,13,116736,5301,111435,8571.923077,378.6428571,21.02150538
NM_001001931,MTUS1,12,11,78429,4018,74411,6764.636364,334.8333333,18.51941264
NM_001001925,MTUS1,14,13,157125,6271,150854,11604.15385,447.9285714,24.05581247
NM_001001924,MTUS1,15,14,157125,6434,150691,10763.64286,428.9333333,23.42104445
NM_015310,PSD3,16,15,486385,11703,474682,31645.46667,731.4375,40.56071093
NM_206909,PSD3,13,12,281594,10104,271490,22624.16667,777.2307692,26.86955661
NM_018371,CSGALNACT1,10,9,278424,3882,274542,30504.66667,388.2,70.72179289
NM_001130518,CSGALNACT1,10,9,198386,4292,194094,21566,429.2,45.222274
NM_001165039,GFRA2,7,6,96818,2938,93880,15646.66667,419.7142857,31.95371001
NM_001165038,GFRA2,8,7,96818,3023,93795,13399.28571,377.875,31.02712537
NM_182795,NPM2,9,8,12056,1109,10947,1368.375,123.2222222,9.871055005
NM_001495,GFRA2,9,8,96818,3339,93479,11684.875,371,27.99610662
NM_001286681,NPM2,8,7,12056,941,11115,1587.857143,117.625,11.81190223
NM_001286680,NPM2,10,9,12789,1524,11265,1251.666667,152.4,7.391732283
NM_001135721,PIWIL2,23,22,80506,4020,76486,3476.636364,174.7826087,19.02636816
NM_018068,PIWIL2,23,22,80776,3659,77117,3505.318182,159.0869565,21.07597704
NM_005775,SORBS3,21,20,23759,3144,20615,1030.75,149.7142857,6.556933842
NM_001135154,SLC39A14,9,8,66880,1753,65127,8140.875,194.7777778,37.15173987
NM_144962,PEBP4,7,6,214658,901,213757,35626.16667,128.7142857,237.2441731
NM_002318,LOXL2,14,13,107314,3824,103490,7960.769231,273.1428571,27.06328452
NM_014479,ADAMDEC1,14,13,21730,2362,19368,1489.846154,168.7142857,8.199830652
NM_001145272,ADAMDEC1,13,12,21730,2242,19488,1624,172.4615385,8.692239072
NM_001105541,NEFM,3,2,4153,2517,1636,818,839,0.649980135
NM_001145271,ADAMDEC1,15,14,21730,2453,19277,1376.928571,163.5333333,7.858540563
NM_005382,NEFM,3,2,5334,3274,2060,1030,1091.333333,0.629199756
NM_017634,KCTD9,12,11,30622,3413,27209,2473.545455,284.4166667,7.972165251
NM_022659,EBF2,16,15,203396,4888,198508,13233.86667,305.5,40.61129296
NM_001197293,DPYSL2,14,13,143986,4652,139334,10718,332.2857143,29.95141874
NM_001244604,DPYSL2,14,13,79774,4294,75480,5806.153846,306.7142857,17.57801584
NM_033303,ADRA1A,3,2,117257,2307,114950,57475,769,49.82661465
NM_001386,DPYSL2,14,13,80355,4635,75720,5824.615385,331.0714286,16.33656958
NM_182826,SCARA3,6,5,42711,1717,40994,8198.8,286.1666667,23.87536401
NM_001010906,NUGGC,19,18,61909,3906,58003,3222.388889,205.5789474,14.84971838
NM_173833,SCARA5,9,8,122972,4160,118812,14851.5,462.2222222,28.56057692
NM_001256483,EPHX2,18,17,53922,2208,51714,3042,122.6666667,23.42119565
NM_006228,PNOC,4,3,26224,1203,25021,8340.333333,300.75,20.79883624
NM_001256484,EPHX2,19,18,53756,2126,51630,2868.333333,111.8947368,24.28504233
NM_001256482,EPHX2,19,18,53922,2256,51666,2870.333333,118.7368421,22.90159574
NM_001979,EPHX2,19,18,53922,2294,51628,2868.222222,120.7368421,22.50566696
NM_016240,SCARA3,6,5,38962,3637,35325,7065,606.1666667,9.712675282
NM_001017420,ESCO2,11,10,30368,3369,26999,2699.9,306.2727273,8.013950727
NM_001135726,HMBOX1,10,9,162333,3185,159148,17683.11111,318.5,49.96797488
NM_001172562,INTS9,17,16,122259,2547,119712,7482,149.8235294,47.00117786
NM_001440,EXTL3,7,6,52219,6347,45872,7645.333333,906.7142857,7.227351505
NM_018250,INTS9,17,16,122525,2781,119744,7484,163.5882353,43.05789284
NM_015254,KIF13B,40,39,195817,8806,187011,4795.153846,220.15,21.23677038
NM_001145159,INTS9,16,15,122525,2717,119808,7987.2,169.8125,44.09569378
NM_024567,HMBOX1,11,10,162019,3244,158775,15877.5,294.9090909,48.94420469
NM_001008712,RBPMS,7,6,163026,1360,161666,26944.33333,194.2857143,118.8720588
NM_006571,DCTN6,7,6,27344,1133,26211,4368.5,161.8571429,23.13415711
NM_001195103,GSR,12,11,49908,3013,46895,4263.181818,251.0833333,15.56422171
NM_001195102,GSR,12,11,49908,3085,46823,4256.636364,257.0833333,15.17763371
NM_001195104,GSR,11,10,49908,2925,46983,4698.3,265.9090909,16.0625641
NM_000553,WRN,35,34,140501,5781,134720,3962.352941,165.1714286,23.30392666
NM_000637,GSR,13,12,49908,3173,46735,3894.583333,244.0769231,14.72896313
NM_024787,RNF122,6,5,19376,1878,17498,3499.6,313,9.317358892
NM_032664,FUT10,5,4,102322,3552,98770,24692.5,710.4,27.80686937
NM_001174063,FGFR1,18,17,57698,5913,51785,3046.176471,328.5,8.757821749
NM_023110,FGFR1,18,17,57698,5919,51779,3045.823529,328.8333333,8.747930394
NM_023106,FGFR1,17,16,57698,5645,52053,3253.3125,332.0588235,9.221080602
NM_006283,TACC1,13,12,65826,7815,58011,4834.25,601.1538462,7.42303263
NM_001174067,FGFR1,19,18,56709,5394,51315,2850.833333,283.8947368,9.513348165
NM_001174066,FGFR1,17,16,56709,4971,51738,3233.625,292.4117647,10.4079662
NM_001174065,FGFR1,18,17,56709,5233,51476,3028,290.7222222,9.836804892
NM_023105,FGFR1,17,16,57698,5651,52047,3252.9375,332.4117647,9.210228278
NM_023034,WHSC1L1,24,23,107231,5454,101777,4425.086957,227.25,18.66098276
NM_015850,FGFR1,18,17,57698,5913,51785,3046.176471,328.5,8.757821749
NM_001122824,TACC1,11,10,65826,6583,59243,5924.3,598.4545455,8.999392374
NM_001146216,TACC1,13,12,124844,7761,117083,9756.916667,597,15.08607138
NM_001174064,FGFR1,19,18,57698,5982,51716,2873.111111,314.8421053,8.645269141
NM_001190956,ADAM18,6,5,27009,1452,25557,5111.4,242,17.60123967
NM_014237,ADAM18,20,19,145498,2419,143079,7530.473684,120.95,59.14799504
NM_003816,ADAM9,22,21,108276,4120,104156,4959.809524,187.2727273,25.28058252
NM_145004,ADAM32,25,24,177388,2752,174636,7276.5,110.08,63.45784884
NM_001135731,ZMAT4,6,5,367234,2245,364989,72997.8,374.1666667,162.5786192
NM_024645,ZMAT4,7,6,367234,2474,364760,60793.33333,353.4285714,147.4373484
NM_003012,SFRP1,3,2,47516,4470,43046,21523,1490,9.629977629
NM_001099412,KAT6A,18,17,122510,9303,113207,6659.235294,516.8333333,12.16887026
NM_020475,ANK1,42,41,144398,8199,136199,3321.926829,195.2142857,16.61165996
NM_006766,KAT6A,17,16,122510,9170,113340,7083.75,539.4117647,12.35986914
NM_020477,ANK1,42,41,144398,7788,136610,3331.95122,185.4285714,17.54108885
NM_020476,ANK1,42,41,144398,8274,136124,3320.097561,197,16.45201837
NM_001099413,KAT6A,18,17,122510,9259,113251,6661.823529,514.3888889,12.23145048
NM_000037,ANK1,43,42,144398,8335,136063,3239.595238,193.8372093,16.32429514
NM_001142446,ANK1,43,42,243538,8521,235017,5595.642857,198.1627907,27.58091773
NM_006749,SLC20A2,11,10,123378,3968,119410,11941,360.7272727,30.09324597
NM_030954,RNF170,7,6,43430,3895,39535,6589.166667,556.4285714,10.15019255
NM_001160223,RNF170,7,6,43430,4125,39305,6550.833333,589.2857143,9.528484848
NM_032410,HOOK3,22,21,133651,14462,119189,5675.666667,657.3636364,8.241529526
NM_001160224,RNF170,6,5,47088,2010,45078,9015.6,335,22.42686567
NM_001257181,SLC20A2,11,10,122677,3636,119041,11904.1,330.5454545,32.73954895
NM_001257180,SLC20A2,11,10,85000,4005,80995,8099.5,364.0909091,20.22347066
NM_002690,POLB,14,13,33360,1348,32012,2462.461538,96.28571429,23.74777448
NM_001160225,RNF170,7,6,43430,3774,39656,6609.333333,539.1428571,10.50768415
NM_182746,MCM4,17,16,17958,4816,13142,821.375,283.2941176,2.728820598
NM_005914,MCM4,16,15,17958,4931,13027,868.4666667,308.1875,2.641857635
NM_001081640,PRKDC,85,84,187076,13500,173576,2066.380952,158.8235294,12.85748148
NM_006904,PRKDC,86,85,187076,13594,173482,2040.964706,158.0697674,12.76165956
NM_014682,ST18,26,25,299049,6356,292693,11707.72,244.4615385,46.04987413
NM_001083617,RB1CC1,24,23,92010,6682,85328,3709.913043,278.4166667,12.76982939
NM_014781,RB1CC1,24,23,92010,6691,85319,3709.521739,278.7916667,12.75130773
NM_006756,TCEA1,10,9,55904,2797,53107,5900.777778,279.7,18.98712907
NM_201437,TCEA1,9,8,55904,2733,53171,6646.375,303.6666667,19.45517746
NM_213619,ATP6V1H,13,12,127770,2145,125625,10468.75,165,58.56643357
NM_213620,ATP6V1H,14,13,127501,2094,125407,9646.692308,149.5714286,59.8887297
NM_014175,MRPL15,5,4,13295,1754,11541,2885.25,350.8,6.57981756
NM_001286673,RGS20,5,4,107498,1765,105733,26433.25,353,59.90538244
NM_015941,ATP6V1H,14,13,127770,2200,125570,9659.230769,157.1428571,57.07727273
NM_001286674,RGS20,3,2,107498,1530,105968,52984,510,69.26013072
NM_001286675,RGS20,4,3,107498,1615,105883,35294.33333,403.75,65.5622291
NM_170587,RGS20,6,5,107498,2111,105387,21077.4,351.8333333,49.92278541
NM_052898,XKR4,3,2,423695,3912,419783,209891.5,1304,107.3064928
NM_002350,LYN,13,12,132622,4171,128451,10704.25,320.8461538,30.79621194
NM_001111097,LYN,13,12,132622,4108,128514,10709.5,316,31.28383642
NM_003580,NSMAF,31,30,76342,3600,72742,2424.733333,116.1290323,20.20611111
NM_147189,FAM110B,5,4,155166,4373,150793,37698.25,874.6,34.48273496
NM_001144772,NSMAF,31,30,75904,3540,72364,2412.133333,114.1935484,20.44180791
NM_017780,CHD7,38,37,189264,11618,177646,4801.243243,305.7368421,15.29058358
NM_002865,RAB2A,8,7,106736,3820,102916,14702.28571,477.5,26.94136126
NM_001242644,RAB2A,7,6,106736,3747,102989,17164.83333,535.2857143,27.48572191
NM_001164750,ASPH,25,24,189295,5179,184116,7671.5,207.16,35.55049237
NM_004318,ASPH,25,24,214086,5374,208712,8696.333333,214.96,38.83736509
NM_173519,CLVS1,6,5,213681,3498,210183,42036.6,583,60.08662093
NM_173688,NKAIN3,6,5,742129,1572,740557,148111.4,262,471.0922392
NM_152758,YTHDF3,5,4,44236,5169,39067,9766.75,1033.8,7.557941575
NM_001277818,YTHDF3,5,4,43786,4929,38857,9714.25,985.8,7.883343477
NM_001277815,YTHDF3,6,5,44236,5201,39035,7807,866.8333333,7.505287445
NM_001277814,YTHDF3,6,5,43786,5070,38716,7743.2,845,7.636291913
NM_001277817,YTHDF3,5,4,44162,5008,39154,9788.5,1001.6,7.818290735
NM_001277816,YTHDF3,4,3,44236,5082,39154,13051.33333,1270.5,7.704447068
NM_001277813,YTHDF3,6,5,44236,5316,38920,7784,886,7.321294206
NM_004820,CYP7B1,6,5,202821,2401,200420,40084,400.1666667,83.47355269
NM_033105,DNAJC5B,6,5,78966,1386,77580,15516,231,55.97402597
NM_001145839,MTFR1,7,6,63687,1479,62208,10368,211.2857143,42.06085193
NM_001145838,MTFR1,6,5,40692,2508,38184,7636.8,418,15.22488038
NM_001242318,PDE7A,13,12,127402,6644,120758,10063.16667,511.0769231,18.17549669
NM_014637,MTFR1,8,7,65912,2741,63171,9024.428571,342.625,23.04669829
NM_024790,CSPP1,29,28,132248,4747,127501,4553.607143,163.6896552,26.85927954
NM_001144755,MYBL1,15,14,51072,5023,46049,3289.214286,334.8666667,9.167628907
NM_001080416,MYBL1,16,15,51072,5204,45868,3057.866667,325.25,8.813989239
NM_013257,SGK3,17,16,86843,4209,82634,5164.625,247.5882353,19.63269185
NM_001033578,SGK3,17,16,149606,4486,145120,9070,263.8823529,32.34953188
NM_001204173,C8orf44-SGK3,19,18,194472,4582,189890,10549.44444,241.1578947,41.44260148
NM_144650,ADHFE1,14,13,36328,1909,34419,2647.615385,136.3571429,18.02985856
NM_170709,SGK3,16,15,86843,4112,82731,5515.4,257,20.11940661
NM_020361,CPA6,11,10,324217,1915,322302,32230.2,174.0909091,168.3039164
NM_024870,PREX2,40,39,279296,5172,274124,7028.820513,129.3,53.00154679
NM_025170,PREX2,24,23,153053,3048,150005,6521.956522,127,49.21423885
NM_052958,C8orf34,14,13,488303,2699,485604,37354.15385,192.7857143,179.9199704
NM_001195639,C8orf34,7,6,205107,4081,201026,33504.33333,583,49.25900515
NM_001128205,SULF1,23,22,168121,5739,162382,7381,249.5217391,28.29447639
NM_001128204,SULF1,22,21,194290,5570,188720,8986.666667,253.1818182,33.88150808
NM_001146009,SLCO5A1,8,7,160838,3422,157416,22488,427.75,46.00116891
NM_001128206,SULF1,22,21,168121,5576,162545,7740.238095,253.4545455,29.15082496
NM_030958,SLCO5A1,10,9,162733,3800,158933,17659.22222,380,41.82447368
NM_001146008,SLCO5A1,8,7,161059,3743,157316,22473.71429,467.875,42.02938819
NM_015170,SULF1,23,22,194290,5733,188557,8570.772727,249.2608696,32.88976103
NM_016027,LACTB2,7,6,31948,1560,30388,5064.666667,222.8571429,19.47948718
NM_000503,EYA1,18,17,164801,4344,160457,9438.647059,241.3333333,36.9376151
NM_001288575,EYA1,18,17,164801,4262,160539,9443.470588,236.7777778,37.66752698
NM_001288574,EYA1,18,17,164801,4326,160475,9439.705882,240.3333333,37.09546926
NM_172059,EYA1,16,15,159080,3651,155429,10361.93333,228.1875,42.57162421
NM_172060,EYA1,16,15,159258,3806,155452,10363.46667,237.875,40.84393064
NM_172058,EYA1,17,16,159258,3935,155323,9707.6875,231.4705882,39.47217281
NM_003218,TERF1,9,8,38892,2909,35983,4497.875,323.2222222,12.3695428
NM_017489,TERF1,10,9,38892,2970,35922,3991.333333,297,12.09494949
NM_004770,KCNB2,3,2,400960,3585,397375,198687.5,1195,110.8437936
NM_001164385,STAU2,10,9,197327,3981,193346,21482.88889,398.1,48.56719417
NM_001164384,STAU2,11,10,198108,4225,193883,19388.3,384.0909091,45.88946746
NM_018299,UBE2W,6,5,92692,8432,84260,16852,1405.333333,9.99288425
NM_014393,STAU2,12,11,197327,4162,193165,17560.45455,346.8333333,46.41158097
NM_001271015,UBE2W,6,5,98815,957,97858,19571.6,159.5,102.2549634
NM_001001481,UBE2W,7,6,92692,8466,84226,14037.66667,1209.428571,9.948736121
NM_015886,PI15,6,5,30494,6738,23756,4751.2,1123,3.525675275
NM_006823,PKIA,4,3,89168,4205,84963,28321,1051.25,20.20523187
NM_181839,PKIA,3,2,89168,4075,85093,42546.5,1358.333333,20.88171779
NM_001025253,TPD52,8,7,136793,4096,132697,18956.71429,512,32.39672852
NM_014018,MRPS28,3,2,111413,710,110703,55351.5,236.6666667,155.9197183
NM_001033723,ZNF704,9,8,246332,14395,231937,28992.125,1599.444444,16.11233067
NM_001287144,TPD52,6,5,136793,4018,132775,26555,669.6666667,33.04504729
NM_005079,TPD52,6,5,136793,4025,132768,26553.6,670.8333333,32.98583851
NM_005536,IMPA1,9,8,29440,3405,26035,3254.375,378.3333333,7.646108664
NM_018440,PAG1,9,8,144259,10752,133507,16688.375,1194.666667,12.41694568
NM_001144879,IMPA1,8,7,29440,3295,26145,3735,411.875,7.934749621
NM_001144878,IMPA1,10,9,29440,3607,25833,2870.333333,360.7,7.161907402
NM_001100392,RALYL,10,9,738627,2234,736393,81821.44444,223.4,329.629812
NM_173848,RALYL,9,8,738494,2914,735580,91947.5,323.7777778,252.42965
NM_001100393,RALYL,9,8,738627,2201,736426,92053.25,244.5555556,334.5870059
NM_001100391,RALYL,9,8,736980,1990,734990,91873.75,221.1111111,369.3417085
NM_001287243,RALYL,8,7,738494,2880,735614,105087.7143,360,255.4215278
NM_001287244,RALYL,8,7,215918,1694,214224,30603.42857,211.75,126.4604486
NM_001164830,CA1,7,6,13487,1203,12284,2047.333333,171.8571429,10.21113882
NM_001951,E2F5,8,7,37136,1742,35394,5056.285714,217.75,20.31802526
NM_001128831,CA1,8,7,49886,1217,48669,6952.714286,152.125,39.99096138
NM_001128830,CA1,9,8,49886,1295,48591,6073.875,143.8888889,37.52200772
NM_001128829,CA1,9,8,49886,1293,48593,6074.125,143.6666667,37.58159319
NM_001738,CA1,9,8,49886,1272,48614,6076.75,141.3333333,38.21855346
NM_000067,CA2,7,6,17592,1673,15919,2653.166667,239,9.51524208
NM_001083589,E2F5,8,7,26845,1593,25252,3607.428571,199.125,15.85185185
NM_001083588,E2F5,8,7,37136,1739,35397,5056.714286,217.375,20.35480161
NM_007013,WWP1,25,24,125186,4130,121056,5044,165.2,29.31138015
NM_152565,ATP6V0D2,8,7,55317,2378,52939,7562.714286,297.25,22.26198486
NM_019098,CNGB3,18,17,169742,4365,165377,9728.058824,242.5,37.88705613
NM_003909,CPNE3,17,16,47072,4881,42191,2636.9375,287.1176471,8.643925425
NM_002485,NBN,16,15,51337,4637,46700,3113.333333,289.8125,10.0711667
NM_004929,CALB1,11,10,24271,2542,21729,2172.9,231.0909091,8.547993706
NM_018710,TMEM55A,7,6,46703,2410,44293,7382.166667,344.2857143,18.37883817
NM_022351,NECAB1,13,12,167711,5153,162558,13546.5,396.3846154,31.54628372
NM_001129890,LRRC69,8,7,116619,1331,115288,16469.71429,166.375,86.61758077
NM_001198633,RUNX1T1,11,10,148261,7383,140878,14087.8,671.1818182,19.08140322
NM_001198627,RUNX1T1,14,13,140689,7701,132988,10229.84615,550.0714286,17.26892611
NM_001198626,RUNX1T1,13,12,140689,7640,133049,11087.41667,587.6923077,17.41479058
NM_001198625,RUNX1T1,15,14,140689,7784,132905,9493.214286,518.9333333,17.07412641
NM_001198628,RUNX1T1,12,11,144723,7296,137427,12493.36364,608,18.8359375
NM_001198629,RUNX1T1,12,11,140297,7422,132875,12079.54545,618.5,17.90285637
NM_001198632,RUNX1T1,12,11,140297,7413,132884,12080.36364,617.75,17.92580602
NM_001198631,RUNX1T1,12,11,140689,7495,133194,12108.54545,624.5833333,17.77104736
NM_001198630,RUNX1T1,13,12,140297,7483,132814,11067.83333,575.6153846,17.74876386
NM_001198634,RUNX1T1,11,10,140689,7321,133368,13336.8,665.5454545,18.21718344
NM_001198679,RUNX1T1,12,11,140689,7466,133223,12111.18182,622.1666667,17.84395928
NM_004349,RUNX1T1,11,10,107998,7431,100567,10056.7,675.5454545,13.53344099
NM_175635,RUNX1T1,11,10,140297,7248,133049,13304.9,658.9090909,18.35665011
NM_175634,RUNX1T1,12,11,148261,7557,140704,12791.27273,629.75,18.61902872
NM_001144663,CDH17,18,17,90139,3717,86422,5083.647059,206.5,23.25047081
NM_004063,CDH17,18,17,81423,3716,77707,4571,206.4444444,20.91146394
NM_015496,KIAA1429,24,23,65743,6463,59280,2577.391304,269.2916667,9.172211048
NM_001135733,TP53INP1,5,4,23417,5657,17760,4440,1131.4,3.139473219
NM_001122827,ESRP1,14,13,66332,3547,62785,4829.615385,253.3571429,17.70087398
NM_001122826,ESRP1,15,14,66332,3699,62633,4473.785714,246.6,16.93241417
NM_017697,ESRP1,16,15,66332,3822,62510,4167.333333,238.875,16.35531136
NM_033285,TP53INP1,4,3,23417,5618,17799,5933,1404.5,3.168209327
NM_001122825,ESRP1,14,13,66332,3559,62773,4828.692308,254.2142857,17.63781961
NM_183009,KIAA1429,13,12,42542,3681,38861,3238.416667,283.1538462,10.55718555
NM_001034915,ESRP1,16,15,66332,3810,62522,4168.133333,238.125,16.40997375
NM_015942,MTERFD1,8,7,22217,1478,20739,2962.714286,184.75,14.03179973
NM_001286643,MTERFD1,9,8,22217,1541,20676,2584.5,171.2222222,13.41726152
NM_016134,CPQ,8,7,498278,1957,496321,70903,244.625,253.6131834
NM_024759,NIPAL2,12,11,102236,2267,99969,9088.090909,188.9166667,44.09748566
NM_001170806,C8orf47,2,1,29090,598,28492,28492,299,47.64548495
NM_002380,MATN2,19,18,167637,4127,163510,9083.888889,217.2105263,39.61957839
NM_018407,LAPTM4B,7,6,77023,2245,74778,12463,320.7142857,33.30868597
NM_030583,MATN2,19,18,167637,4070,163567,9087.055556,214.2105263,40.18845209
NM_178812,MTDH,12,11,86083,7679,78404,7127.636364,639.9166667,10.21018362
NM_173549,C8orf47,3,2,29090,1553,27537,13768.5,517.6666667,17.73148744
NM_015243,VPS13B,18,17,196523,2840,193683,11393.11765,157.7777778,68.19823944
NM_001286693,RGS22,26,25,144690,4179,140511,5620.44,160.7307692,33.62311558
NM_183419,RNF19A,10,9,53109,4417,48692,5410.222222,441.7,11.02377179
NM_001280539,RNF19A,11,10,79161,4311,74850,7485,391.9090909,17.36256089
NM_003114,SPAG1,19,18,83571,3966,79605,4422.5,208.7368421,20.07186082
NM_001286692,RGS22,28,27,145180,4286,140894,5218.296296,153.0714286,32.87307513
NM_172218,SPAG1,19,18,83871,3768,80103,4450.166667,198.3157895,21.25875796
NM_015668,RGS22,28,27,145180,4322,140858,5216.962963,154.3571429,32.59093012
NM_024915,GRHL2,16,15,177286,5245,172041,11469.4,327.8125,32.80095329
NM_015902,UBR5,59,58,160417,10942,149475,2577.155172,185.4576271,13.66066533
NM_001282873,UBR5,59,58,160417,10939,149478,2577.206897,185.4067797,13.66468599
NM_001164616,FZD6,8,7,34037,3688,30349,4335.571429,461,8.229121475
NM_001024372,BAALC,2,1,89614,2684,86930,86930,1342,32.38822653
NM_024812,BAALC,3,2,89614,2852,86762,43381,950.6666667,30.42145863
NM_001164615,FZD6,7,6,34435,3775,30660,5110,539.2857143,8.121854305
NM_003506,FZD6,7,6,34037,3802,30235,5039.166667,543.1428571,7.952393477
NM_001695,ATP6V1C1,13,12,52039,5717,46322,3860.166667,439.7692308,8.102501312
NM_013437,LRP12,7,6,99795,4156,95639,15939.83333,593.7142857,23.01227141
NM_001282882,RIMS2,6,5,31092,3786,27306,5461.2,631,7.212361331
NM_001135703,LRP12,6,5,99795,4098,95697,19139.4,683,23.35212299
NM_012082,ZFPM2,8,7,485622,4488,481134,68733.42857,561,107.2045455
NM_001198534,OXR1,7,6,26588,2628,23960,3993.333333,375.4285714,9.117199391
NM_018002,OXR1,16,15,482517,4637,477880,31858.66667,289.8125,103.0580116
NM_001198535,OXR1,6,5,26588,2546,24042,4808.4,424.3333333,9.443047918
NM_001198533,OXR1,17,16,482517,4719,477798,29862.375,277.5882353,101.2498411
NM_001198532,OXR1,16,15,304771,4492,300279,20018.6,280.75,66.84750668
NM_181354,OXR1,14,13,94887,4465,90422,6955.538462,318.9285714,20.25128779
NM_001146,ANGPT1,9,8,248546,4347,244199,30524.875,483,56.17644352
NM_001199859,ANGPT1,9,8,248546,4344,244202,30525.25,482.6666667,56.21593002
NM_001099756,SYBU,6,5,69016,2962,66054,13210.8,493.6666667,22.30047265
NM_001099755,SYBU,6,5,70648,2686,67962,13592.4,447.6666667,25.30230827
NM_001099754,SYBU,7,6,70648,2892,67756,11292.66667,413.1428571,23.42876902
NM_001099753,SYBU,7,6,70648,2889,67759,11293.16667,412.7142857,23.45413638
NM_001099746,SYBU,6,5,106831,2794,104037,20807.4,465.6666667,37.23586256
NM_001099745,SYBU,8,7,106831,3082,103749,14821.28571,385.25,33.66288125
NM_001099744,SYBU,8,7,117617,3246,114371,16338.71429,405.75,35.23444239
NM_001099743,SYBU,8,7,117617,3243,114374,16339.14286,405.375,35.26796176
NM_017786,SYBU,9,8,74729,3122,71607,8950.875,346.8888889,22.93625881
NM_001099752,SYBU,8,7,71419,3092,68327,9761,386.5,22.09799483
NM_001099751,SYBU,8,7,71419,3089,68330,9761.428571,386.125,22.12042732
NM_001099750,SYBU,9,8,74729,3125,71604,8950.5,347.2222222,22.91328
NM_001099749,SYBU,6,5,74729,2715,72014,14402.8,452.5,26.52449355
NM_001099748,SYBU,8,7,74729,3003,71726,10246.57143,375.375,23.88478188
NM_001099747,SYBU,8,7,74729,3000,71729,10247,375,23.90966667
NM_177531,PKHD1L1,78,77,168796,14095,154701,2009.103896,180.7051282,10.97559418
NM_001282903,TRPS1,7,6,260533,10010,250523,41753.83333,1430,25.02727273
NM_001282902,TRPS1,6,5,259517,9520,249997,49999.4,1586.666667,26.26018908
NM_014112,TRPS1,7,6,260533,10024,250509,41751.5,1432,24.99092179
NM_001172815,SLC30A8,11,10,225765,5441,220324,22032.4,494.6363636,40.49329167
NM_001172813,SLC30A8,11,10,225765,5572,220193,22019.3,506.5454545,39.51776741
NM_001172811,SLC30A8,10,9,226443,5326,221117,24568.55556,532.6,41.51652272
NM_003756,EIF3H,8,7,111009,1283,109726,15675.14286,160.375,85.52299299
NM_000127,EXT1,11,10,312458,3374,309084,30908.4,306.7272727,91.60758743
NM_021110,COL14A1,48,47,246928,6512,240416,5115.234043,135.6666667,36.91891892
NM_022045,MTBP,22,21,78239,3109,75130,3577.619048,141.3181818,24.16532647
NM_024094,DSCC1,9,8,21991,2278,19713,2464.125,253.1111111,8.653643547
NM_022783,DEPTOR,9,8,177264,2645,174619,21827.375,293.8888889,66.01852552
NM_001283012,DEPTOR,7,6,177264,2340,174924,29154,334.2857143,74.75384615
NM_001204180,ZHX1-C8ORF76,6,5,48300,1533,46767,9353.4,255.5,30.50684932
NM_001242463,FBXO32,7,6,43368,6521,36847,6141.166667,931.5714286,5.650513725
NM_148177,FBXO32,6,5,34258,6434,27824,5564.8,1072.333333,4.324525956
NM_145647,TBC1D31,22,21,79474,3526,75948,3616.571429,160.2727273,21.53942144
NM_014109,ATAD2,28,27,76616,5592,71024,2630.518519,199.7142857,12.70100143
NM_014943,ZHX2,4,3,192856,4363,188493,62831,1090.75,43.20261288
NM_058229,FBXO32,9,8,43368,6802,36566,4570.75,755.7777778,5.375771832
NM_001145088,TBC1D31,20,19,79474,3236,76238,4012.526316,161.8,23.55933251
NM_001282974,MTSS1,14,13,177739,4981,172758,13289.07692,355.7857143,34.68339691
NM_001282971,MTSS1,15,14,177739,5069,172670,12333.57143,337.9333333,34.06391793
NM_001039112,FER1L6,41,40,268077,6092,261985,6549.625,148.5853659,43.00476034
NM_014751,MTSS1,14,13,177739,5056,172683,13283.30769,361.1428571,34.15407437
NM_014846,KIAA0196,29,28,67560,4194,63366,2263.071429,144.6206897,15.10872675
NM_173685,NSMCE2,8,7,275286,1220,274066,39152.28571,152.5,224.6442623
NM_016623,FAM49B,12,11,100281,3850,96431,8766.454545,320.8333333,25.04701299
NM_001256763,FAM49B,13,12,100281,3938,96343,8028.583333,302.9230769,24.46495683
NM_001115,ADCY8,18,17,260290,4119,256171,15068.88235,228.8333333,62.19252246
NM_001080399,OC90,14,13,35162,1796,33366,2566.615385,128.2857143,18.577951
NM_001045557,SLA,8,7,66339,3189,63150,9021.428571,398.625,19.80244591
NM_016018,PHF20L1,21,20,73450,6284,67166,3358.3,299.2380952,10.68841502
NM_001277196,PHF20L1,20,19,73450,6205,67245,3539.210526,310.25,10.83722804
NM_198513,PHF20L1,8,7,37837,3247,34590,4941.428571,405.875,10.65291038
NM_001045556,SLA,9,8,66339,3468,62871,7858.875,385.3333333,18.12889273
NM_001282965,SLA,7,6,66339,3087,63252,10542,441,20.48979592
NM_001282964,SLA,7,6,66339,3056,63283,10547.16667,436.5714286,20.70778796
NM_003235,TG,48,47,267940,8501,259439,5519.978723,177.1041667,30.51864487
NM_003033,ST3GAL1,9,8,117094,6980,110114,13764.25,775.5555556,15.7756447
NM_173344,ST3GAL1,10,9,117094,6778,110316,12257.33333,677.8,16.27559752
NM_001029939,ZFAT,17,16,218772,4711,214061,13378.8125,277.1176471,45.43854808
NM_001167583,ZFAT,16,15,218772,4551,214221,14281.4,284.4375,47.07119314
NM_001174158,ZFAT,14,13,218772,4291,214481,16498.53846,306.5,49.98391983
NM_001174157,ZFAT,15,14,235263,4441,230822,16487.28571,296.0666667,51.9752308
NM_020863,ZFAT,16,15,235263,4628,230635,15375.66667,289.25,49.83470182
NM_001289394,ZFAT,17,16,235263,4788,230475,14404.6875,281.6470588,48.13596491
NM_006558,KHDRBS3,9,8,190134,1965,188169,23521.125,218.3333333,95.76030534
NM_152888,COL22A1,65,64,325760,6411,319349,4989.828125,98.63076923,49.81266573
NM_001282534,KCNK9,2,1,85936,2327,83609,83609,1163.5,35.92995273
NM_001160372,TRAPPC9,23,22,725277,4322,720955,32770.68182,187.9130435,166.8105044
NM_031466,TRAPPC9,23,22,726094,4497,721597,32799.86364,195.5217391,160.4618635
NM_153831,PTK2,32,31,342933,4585,338348,10914.45161,143.28125,73.79454744
NM_207414,MROH5,30,29,73403,4197,69206,2386.413793,139.9,16.48939719
NM_001199649,PTK2,33,32,342933,4625,338308,10572.125,140.1515152,73.14767568
NM_005607,PTK2,32,31,342933,4574,338359,10914.80645,142.9375,73.97442064
NM_145003,TSNARE1,14,13,191104,1919,189185,14552.69231,137.0714286,98.58520063
NM_001258447,TOP1MT,14,13,50652,1915,48737,3749,136.7857143,25.45013055
NM_001258446,TOP1MT,15,14,50652,2057,48595,3471.071429,137.1333333,23.62421001
NM_002066,GML,4,3,12047,727,11320,3773.333333,181.75,15.57083906
NM_015117,ZC3H3,12,11,103797,3289,100508,9137.090909,274.0833333,30.55883247
NM_032450,MROH1,44,43,113926,5407,108519,2523.697674,122.8863636,20.07009432
NM_198572,SPATC1,5,4,15435,2041,13394,3348.5,408.2,6.562469378
NM_013291,CPSF1,38,37,16289,4532,11757,317.7567568,119.2631579,2.594218888
NM_001099281,MROH1,12,11,65451,1742,63709,5791.727273,145.1666667,36.57233065
NM_015201,BOP1,16,15,29066,2389,26677,1778.466667,149.3125,11.1665969
NM_001134374,SPATC1,4,3,15435,1900,13535,4511.666667,475,7.123684211
NM_001099280,MROH1,13,12,65451,1863,63588,5299,143.3076923,34.13204509
NM_001288814,MROH1,42,41,113297,5265,108032,2634.926829,125.3571429,20.51889839
NM_001005504,OR4F21,1,0,940,940,NA,NA,940,NA
NM_001042415,ZNF596,6,5,14882,2736,12146,2429.2,456,4.439327485
NM_001042416,ZNF596,6,5,14945,2869,12076,2415.2,478.1666667,4.209132102
NM_173539,ZNF596,6,5,15142,2787,12355,2471,464.5,4.433082167
NM_001287254,ZNF596,6,5,14792,2727,12065,2413,454.5,4.424275761
NM_001287399,ZNF596,6,5,15142,2785,12357,2471.4,464.1666667,4.436983842
NM_001287256,ZNF596,6,5,15205,2698,12507,2501.4,449.6666667,4.635656042
NM_001287255,ZNF596,6,5,15205,2702,12503,2500.6,450.3333333,4.627313101
NM_001256113,TDRP,4,3,55057,2471,52586,17528.66667,617.75,21.28126265
NM_175075,TDRP,4,3,55993,3427,52566,17522,856.75,15.33878027
NM_018941,CLN8,3,2,22868,7172,15696,7848,2390.666667,2.188510876
NM_014867,KBTBD11,2,1,33067,6719,26348,26348,3359.5,3.921416878
NM_003970,MYOM2,37,36,100224,5048,95176,2643.777778,136.4324324,18.85419968
NM_001147,ANGPT2,9,8,63611,5276,58335,7291.875,586.2222222,11.05667172
NM_001118887,ANGPT2,9,8,63611,5273,58338,7292.25,585.8888889,11.0635312
NM_001118888,ANGPT2,8,7,63611,5119,58492,8356,639.875,11.42645048
NM_018361,AGPAT5,8,7,53145,5527,47618,6802.571429,690.875,8.615523792
NM_001926,DEFA6,2,1,1384,470,914,914,235,1.944680851
NM_001925,DEFA4,3,2,2443,545,1898,949,181.6666667,3.482568807
NM_005218,DEFB1,2,1,7434,465,6969,6969,232.5,14.98709677
NM_004084,DEFA1,3,2,2445,501,1944,972,167,3.880239521
NM_021010,DEFA5,2,1,1432,451,981,981,225.5,2.175166297
NM_004084,DEFA1,3,2,2438,501,1937,968.5,167,3.866267465
NM_004084,DEFA1,3,2,2434,501,1933,966.5,167,3.858283433
NM_001042500,DEFA1B,3,2,2445,501,1944,972,167,3.880239521
NM_001042500,DEFA1B,3,2,2438,501,1937,968.5,167,3.866267465
NM_001042500,DEFA1B,3,2,2434,501,1933,966.5,167,3.858283433
NM_005217,DEFA3,3,2,2427,494,1933,966.5,164.6666667,3.912955466
NM_001256874,USP17L4,1,0,1594,1594,NA,NA,1594,NA
NM_001256873,USP17L1P,1,0,1594,1594,NA,NA,1594,NA
NM_001081551,DEFB103A,2,1,1381,439,942,942,219.5,2.145785877
NM_001040702,DEFB104B,2,1,4776,283,4493,4493,141.5,15.87632509
NM_058207,SPAG11B,2,1,1803,446,1357,1357,223,3.042600897
NM_058200,SPAG11B,4,3,15918,759,15159,5053,189.75,19.97233202
NM_016512,SPAG11B,4,3,13108,798,12310,4103.333333,199.5,15.42606516
NM_018661,DEFB103B,2,1,1268,326,942,942,163,2.889570552
NM_058203,SPAG11B,3,2,2407,654,1753,876.5,218,2.680428135
NM_058202,SPAG11B,3,2,15918,680,15238,7619,226.6666667,22.40882353
NM_080389,DEFB104A,2,1,4776,283,4493,4493,141.5,15.87632509
NM_001164457,ZNF705G,5,4,4994,930,4064,1016,186,4.369892473
NM_001205266,DEFB4B,2,1,1971,300,1671,1671,150,5.57
NM_058206,SPAG11B,3,2,1803,523,1280,640,174.3333333,2.447418738
NM_058201,SPAG11B,3,2,13108,721,12387,6193.5,240.3333333,17.18030513
NM_001040705,DEFB107B,2,1,13467,391,13076,13076,195.5,33.44245524
NM_001040703,DEFB105B,3,2,1832,240,1592,796,80,6.633333333
NM_001282479,PRR23D1,4,3,2825,1592,1233,411,398,0.774497487
NM_152250,DEFB105A,3,2,1832,240,1592,796,80,6.633333333
NM_001037668,DEFB107A,2,1,13467,391,13076,13076,195.5,33.44245524
NM_001282478,PRR23D2,4,3,2824,1591,1233,411,397.75,0.774984287
NM_001081552,SPAG11A,4,3,15919,760,15159,5053,190,19.94605263
NM_001040705,DEFB107B,2,1,3998,391,3607,3607,195.5,9.225063939
NM_001040704,DEFB106B,2,1,3883,305,3578,3578,152.5,11.73114754
NM_001040703,DEFB105B,3,2,1832,240,1592,796,80,6.633333333
NM_001040702,DEFB104B,2,1,4773,283,4490,4490,141.5,15.86572438
NM_001282479,PRR23D1,4,3,2825,1592,1233,411,398,0.774497487
NM_152251,DEFB106A,2,1,3883,305,3578,3578,152.5,11.73114754
NM_152250,DEFB105A,3,2,1832,240,1592,796,80,6.633333333
NM_001037668,DEFB107A,2,1,3998,391,3607,3607,195.5,9.225063939
NM_058203,SPAG11B,3,2,2407,654,1753,876.5,218,2.680428135
NM_080389,DEFB104A,2,1,4773,283,4490,4490,141.5,15.86572438
NM_001282478,PRR23D2,4,3,2824,1591,1233,411,397.75,0.774984287
NM_001193630,ZNF705B,7,6,26078,1214,24864,4144,173.4285714,20.48105437
NM_001081551,DEFB103A,2,1,1381,439,942,942,219.5,2.145785877
NM_001256872,USP17L8,1,0,1594,1594,NA,NA,1594,NA
NM_018661,DEFB103B,2,1,1268,326,942,942,163,2.889570552
NM_001256871,USP17L3,1,0,1594,1594,NA,NA,1594,NA
NM_004942,DEFB4A,2,1,2040,338,1702,1702,169,5.035502959
NM_001080826,SGK223,5,4,64001,4632,59369,14842.25,926.4,12.81714162
NM_194284,CLDN23,1,0,1953,1953,NA,NA,1953,NA
NM_153332,ERI1,7,6,30537,4622,25915,4319.166667,660.2857143,5.606880138
NM_024607,PPP1R3B,2,1,14458,5565,8893,8893,2782.5,1.59802336
NM_001201329,PPP1R3B,2,1,15390,5713,9677,9677,2856.5,1.693856118
NM_198464,PRSS55,5,4,13279,1134,12145,3036.25,226.8,10.70987654
NM_001197020,PRSS55,5,4,28622,1010,27612,6903,202,27.33861386
NM_031439,SOX7,2,1,6808,3280,3528,3528,1640,1.075609756
NM_001040032,C8orf74,4,3,27958,1040,26918,8972.666667,260,25.88269231
NM_017884,PINX1,7,6,74940,1577,73363,12227.16667,225.2857143,46.52060875
NM_001284356,PINX1,6,5,74940,1499,73441,14688.2,249.8333333,48.99332889
NM_054028,SLC35G5,1,0,1202,1202,NA,NA,1202,NA
NM_015458,MTMR9,10,9,43656,7415,36241,4026.777778,741.5,4.887525287
NM_053279,FAM167A,3,2,45305,4096,41209,20604.5,1365.333333,10.06079102
NM_002052,GATA4,7,6,55794,3415,52379,8729.833333,487.8571429,15.33792094
NM_145043,NEIL2,5,4,17684,2751,14933,3733.25,550.2,5.428207924
NM_001135746,NEIL2,5,4,17684,2207,15477,3869.25,441.4,7.012686905
NM_001135748,NEIL2,5,4,17684,2021,15663,3915.75,404.2,7.750123701
NM_001135747,NEIL2,4,3,17684,2066,15618,5206,516.5,7.559535334
NM_147780,CTSB,12,11,25614,3956,21658,1968.909091,329.6666667,5.474721941
NM_001287751,FDFT1,7,6,30167,2111,28056,4676,301.5714286,13.2903837
NM_001287749,FDFT1,8,7,31368,2238,29130,4161.428571,279.75,13.01608579
NM_147783,CTSB,11,10,25614,3867,21747,2174.7,351.5454545,5.623739333
NM_147782,CTSB,11,10,25614,3881,21733,2173.3,352.8181818,5.599845401
NM_147781,CTSB,11,10,25614,3912,21702,2170.2,355.6363636,5.547546012
NM_001908,CTSB,10,9,25614,3792,21822,2424.666667,379.2,5.754746835
NM_001287750,FDFT1,7,6,30894,2239,28655,4775.833333,319.8571429,12.79812416
NM_001033018,DEFB136,2,1,664,239,425,425,119.5,1.778242678
NM_001033017,DEFB135,2,1,2271,236,2035,2035,118,8.622881356
NM_001033019,DEFB134,2,1,2273,203,2070,2070,101.5,10.19704433
NM_001039615,ZNF705D,7,6,26180,3690,22490,3748.333333,527.1428571,6.094850949
NM_001256869,USP17L7,1,0,1594,1594,NA,NA,1594,NA
NM_001083537,FAM86B1,7,6,12013,2445,9568,1594.666667,349.2857143,3.913292434
NM_201402,USP17L2,1,0,1594,1594,NA,NA,1594,NA
NM_001195257,LOC100133267,2,1,7356,242,7114,7114,121,29.39669421
NM_001037804,DEFB130,2,1,7356,242,7114,7114,121,29.39669421
NM_001137610,FAM86B2,8,7,10730,1275,9455,1350.714286,159.375,7.415686275
NM_001099677,KIAA1456,2,1,17513,9300,8213,8213,4650,0.88311828
NM_001164271,DLC1,14,13,32883,5800,27083,2083.307692,414.2857143,4.669482759
NM_001007090,C8orf48,1,0,1447,1447,NA,NA,1447,NA
NM_002445,MSR1,9,8,53476,2969,50507,6313.375,329.8888889,17.01145167
NM_019851,FGF20,3,2,9342,1019,8323,4161.5,339.6666667,8.16781158
NM_054026,CNOT7,6,5,15367,1948,13419,2683.8,324.6666667,6.888603696
NM_001145152,VPS37A,11,10,51134,4521,46613,4661.3,411,10.31032957
NM_013354,CNOT7,7,6,17649,2653,14996,2499.333333,379,5.652468903
NM_152415,VPS37A,12,11,51134,4597,46537,4230.636364,383.0833333,10.12334131
NM_001164771,SLC7A2,12,11,31793,7579,24214,2201.272727,631.5833333,3.194880591
NM_003046,SLC7A2,12,11,31793,7576,24217,2201.545455,631.3333333,3.196541711
NM_001008539,SLC7A2,12,11,73482,7583,65899,5990.818182,631.9166667,8.690360016
NM_020749,MTUS1,10,9,53945,3813,50132,5570.222222,381.3,13.14765277
NM_006207,PDGFRL,7,6,66702,1912,64790,10798.33333,273.1428571,33.88598326
NM_201553,FGL1,9,8,31015,1473,29542,3692.75,163.6666667,20.0556687
NM_201552,FGL1,9,8,31149,1385,29764,3720.5,153.8888889,21.49025271
NM_147203,FGL1,8,7,31015,1345,29670,4238.571429,168.125,22.05947955
NM_004467,FGL1,8,7,31149,1257,29892,4270.285714,157.125,23.78042959
NM_001127505,ASAH1,14,13,28584,2499,26085,2006.538462,178.5,10.43817527
NM_004315,ASAH1,14,13,28584,2565,26019,2001.461538,183.2142857,10.14385965
NM_177924,ASAH1,14,13,27956,2632,25324,1948,188,9.621580547
NM_001160179,NAT1,5,4,53229,2014,51215,12803.75,402.8,25.42949355
NM_000662,NAT1,3,2,13582,1802,11780,5890,600.6666667,6.53718091
NM_001160170,NAT1,5,4,13582,2338,11244,2811,467.6,4.809238666
NM_001160171,NAT1,4,3,13582,2187,11395,3798.333333,546.75,5.210333791
NM_001160172,NAT1,5,4,13582,2109,11473,2868.25,421.8,5.440018966
NM_001160173,NAT1,4,3,13582,1953,11629,3876.333333,488.25,5.954429083
NM_001160175,NAT1,5,4,13582,2072,11510,2877.5,414.4,5.555019305
NM_001160176,NAT1,4,3,13582,1921,11661,3887,480.25,6.070275898
NM_001160174,NAT1,1,0,2023,2023,NA,NA,2023,NA
NM_000015,NAT2,2,1,9970,1319,8651,8651,659.5,6.558756634
NM_001174160,SH2D4A,9,8,82650,3023,79627,9953.375,335.8888889,26.34039034
NM_001174159,SH2D4A,10,9,82244,3259,78985,8776.111111,325.9,24.23596195
NM_022071,SH2D4A,10,9,82650,3409,79241,8804.555556,340.9,23.24464652
NM_018142,INTS10,17,16,34670,2551,32119,2007.4375,150.0588235,12.59074873
NM_000237,LPL,10,9,28190,3757,24433,2714.777778,375.7,6.503327123
NM_003053,SLC18A1,16,15,38353,2769,35584,2372.266667,173.0625,12.85084868
NM_001142325,SLC18A1,16,15,38353,2839,35514,2367.6,177.4375,12.50933427
NM_001142324,SLC18A1,16,15,38353,2877,35476,2365.066667,179.8125,12.33090024
NM_001135691,SLC18A1,17,16,38353,2974,35379,2211.1875,174.9411765,11.89609953
NM_001693,ATP6V1B2,14,13,24505,3058,21447,1649.769231,218.4285714,7.013407456
NM_021020,LZTS1,3,2,9129,5462,3667,1833.5,1820.666667,0.6713658
NM_015024,XPO7,28,27,86918,4891,82027,3038.037037,174.6785714,16.77100797
NM_003974,DOK2,5,4,4823,1775,3048,762,355,1.717183099
NM_025232,REEP4,8,7,3917,1702,2215,316.4285714,212.75,1.301410106
NM_001978,DMTN,16,15,23352,2789,20563,1370.866667,174.3125,7.37289351
NM_003867,FGF17,5,4,5893,1227,4666,1166.5,245.4,3.802770986
NM_001114135,DMTN,16,15,24662,2568,22094,1472.933333,160.5,8.603582555
NM_001114136,DMTN,16,15,27710,2525,25185,1679,157.8125,9.974257426
NM_022749,FAM160B2,17,16,15179,3749,11430,714.375,220.5294118,3.048813017
NM_001114137,DMTN,15,14,28957,2617,26340,1881.428571,174.4666667,10.06495988
NM_005144,HR,19,18,16635,5535,11100,616.6666667,291.3157895,2.005420054
NM_001114138,DMTN,15,14,23352,2589,20763,1483.071429,172.6,8.019698725
NM_001114139,DMTN,14,13,27710,2515,25195,1938.076923,179.6428571,10.01789264
NM_139278,LGI3,8,7,10003,3274,6729,961.2857143,409.25,2.055284056
NM_018411,HR,18,17,16635,5369,11266,662.7058824,298.2777778,2.098342336
NM_024815,NUDT18,5,4,2551,1524,1031,257.75,304.8,0.676509186
NM_006129,BMP1,20,19,47189,3846,43343,2281.210526,192.3,11.26963079
NM_001722,POLR3D,9,8,6063,1938,4125,515.625,215.3333333,2.128482972
NM_001199,BMP1,16,15,36345,2755,33590,2239.333333,172.1875,12.1923775
NM_001099335,PHYHIP,6,5,12637,3343,9294,1858.8,557.1666667,2.780137601
NM_014759,PHYHIP,5,4,12637,3220,9417,2354.25,644,2.924534161
NM_015359,SLC39A14,9,8,55489,4701,50788,6348.5,522.3333333,10.8036588
NM_001135153,SLC39A14,9,8,55201,4742,50459,6307.375,526.8888889,10.64086883
NM_001128431,SLC39A14,9,8,55489,4701,50788,6348.5,522.3333333,10.8036588
NM_001243975,PPP3CC,13,12,100176,2304,97872,8156,177.2307692,42.47916667
NM_001243974,PPP3CC,15,14,100176,2363,97813,6986.642857,157.5333333,41.3935675
NM_005605,PPP3CC,14,13,100176,2335,97841,7526.230769,166.7857143,41.90192719
NM_001013842,C8orf58,7,6,4550,2068,2482,413.6666667,295.4285714,1.200193424
NM_021630,PDLIM2,10,9,15558,2245,13313,1479.222222,224.5,5.930066815
NM_001198827,C8orf58,6,5,4550,1960,2590,518,326.6666667,1.321428571
NM_198042,PDLIM2,8,7,13825,1467,12358,1765.428571,183.375,8.423994547
NM_021174,CCAR2,21,20,15446,4012,11434,571.7,191.047619,2.84995015
NM_018688,BIN3,9,8,48716,1856,46860,5857.5,206.2222222,25.24784483
NM_001018003,SORBS3,10,9,9831,2050,7781,864.5555556,205,3.795609756
NM_176871,PDLIM2,10,9,17553,4618,12935,1437.222222,461.8,2.800996102
NM_173686,C8orf58,7,6,4550,2044,2506,417.6666667,292,1.226027397
NM_001199881,EGR3,2,1,4921,3906,1015,1015,1953,0.259856631
NM_001199880,EGR3,2,1,4730,3912,818,818,1956,0.209100204
NM_004430,EGR3,2,1,5643,4336,1307,1307,2168,0.301429889
NM_001160037,RHOBTB2,10,9,24351,4967,19384,2153.777778,496.7,3.902556875
NM_001160036,RHOBTB2,12,11,32782,5273,27509,2500.818182,439.4166667,5.216954295
NM_015178,RHOBTB2,10,9,20620,5459,15161,1684.555556,545.9,2.77724858
NM_147187,TNFRSF10B,10,9,49054,4075,44979,4997.666667,407.5,11.03779141
NM_003842,TNFRSF10B,9,8,49054,4161,44893,5611.625,462.3333333,10.78899303
NM_003841,TNFRSF10C,5,4,14625,1499,13126,3281.5,299.8,8.756504336
NM_003840,TNFRSF10D,9,8,28444,3547,24897,3112.125,394.1111111,7.019171131
NM_001136108,R3HCC1,8,7,8182,1590,6592,941.7142857,198.75,4.14591195
NM_152272,CHMP7,11,10,18364,3421,14943,1494.3,311,4.368021046
NM_001128930,ENTPD4,13,12,28581,5886,22695,1891.25,452.7692308,3.855759429
NM_004901,ENTPD4,13,12,28581,5910,22671,1889.25,454.6153846,3.836040609
NM_016612,SLC25A37,4,3,43702,1869,41833,13944.33333,467.25,22.38255752
NM_006167,NKX3-1,2,1,4246,3283,963,963,1641.5,0.293329272
NM_001136271,NKX2-6,2,1,4149,908,3241,3241,454,3.56938326
NM_001256339,NKX3-1,3,2,4198,3011,1187,593.5,1003.666667,0.394221189
NM_003155,STC1,4,3,12888,3881,9007,3002.333333,970.25,2.32079361
NM_014265,ADAM28,23,22,61148,3243,57905,2632.045455,141,17.85538082
NM_021777,ADAM28,14,13,42034,2122,39912,3070.153846,151.5714286,18.80867107
NM_003817,ADAM7,22,21,68570,3418,65152,3102.47619,155.3636364,19.06143944
NM_006158,NEFL,5,4,5916,3845,2073,518.25,769,0.539141743
NM_000825,GNRH1,3,2,5784,2153,3631,1815.5,717.6666667,1.686483976
NM_001083111,GNRH1,4,3,5784,1285,4499,1499.666667,321.25,3.501167315
NM_152562,CDCA2,15,14,48914,3735,45179,3227.071429,249,12.0961178
NM_004331,BNIP3L,6,5,30123,3506,26617,5323.4,584.3333333,7.591842556
NM_007257,PNMA2,3,2,9289,4849,4440,2220,1616.333333,0.915652712
NM_000680,ADRA1A,2,1,95702,2283,93419,93419,1141.5,40.91940429
NM_033304,ADRA1A,3,2,99553,2004,97549,48774.5,668,48.67714571
NM_033302,ADRA1A,3,2,109011,2092,106919,53459.5,697.3333333,51.1085086
NM_001283053,STMN4,8,7,23118,2403,20715,2959.285714,300.375,8.620474407
NM_030795,STMN4,7,6,23118,2348,20770,3461.666667,335.4285714,8.845826235
NM_001283055,STMN4,6,5,23118,2229,20889,4177.8,371.5,9.371467026
NM_001283054,STMN4,6,5,23118,2266,20852,4170.4,377.6666667,9.20211827
NM_171982,TRIM35,6,5,26432,4233,22199,4439.8,705.5,5.244271202
NM_001282455,CHRNA2,7,6,19537,4029,15508,2584.666667,575.5714286,3.849094068
NM_000742,CHRNA2,7,6,19537,4074,15463,2577.166667,582,3.795532646
NM_001831,CLU,9,8,17896,2869,15027,1878.375,318.7777778,5.237713489
NM_018246,CCDC25,9,8,39339,3649,35690,4461.25,405.4444444,9.780761853
NM_001278945,PBK,8,7,28476,2100,26376,3768,262.5,12.56
NM_018492,PBK,8,7,28476,2125,26351,3764.428571,265.625,12.40047059
NM_001284222,ELP3,15,14,100923,3169,97754,6982.428571,211.2666667,30.84695488
NM_018091,ELP3,15,14,98087,3234,94853,6775.214286,215.6,29.32993197
NM_001284224,ELP3,13,12,98087,3029,95058,7921.5,233,31.38263453
NM_001284220,ELP3,14,13,98087,3133,94954,7304.153846,223.7857143,30.30769231
NM_001284225,ELP3,13,12,98087,3068,95019,7918.25,236,30.97099087
NM_001284226,ELP3,14,13,98087,3094,94993,7307.153846,221,30.70232708
NM_018660,ZNF395,10,9,40877,4812,36065,4007.222222,481.2,7.494804655
NM_001284244,PNOC,3,2,4708,1009,3699,1849.5,336.3333333,3.666005946
NM_145866,FZD3,7,6,80065,13748,66317,11052.83333,1964,4.823756183
NM_017412,FZD3,8,7,80065,13795,66270,9467.142857,1724.375,4.803914462
NM_001394,DUSP4,4,3,17690,5625,12065,4021.666667,1406.25,2.144888889
NM_057158,DUSP4,5,4,15745,6441,9304,2326,1288.2,1.444496196
NM_001128208,LEPROTL1,4,3,42302,825,41477,13825.66667,206.25,50.27515152
NM_015344,LEPROTL1,4,3,12667,2716,9951,3317,679,3.663843888
NM_016127,TMEM66,6,5,20198,2161,18037,3607.4,360.1666667,8.346598797
NM_001100916,MBOAT4,3,2,13015,1666,11349,5674.5,555.3333333,6.81212485
NM_001284239,TMEM66,5,4,20198,1981,18217,4554.25,396.2,9.195860676
NM_002095,GTF2E2,8,7,79709,1544,78165,11166.42857,193,50.625
NM_001206847,SMIM18,3,2,7354,796,6558,3279,265.3333333,8.238693467
NM_001282199,UBXN8,7,6,22840,1331,21509,3584.833333,190.1428571,16.16003005
NM_001282189,UBXN8,8,7,22840,1344,21496,3070.857143,168,15.99404762
NM_001009552,PPP2CB,7,6,27228,1977,25251,4208.5,282.4285714,12.7723824
NM_005671,UBXN8,8,7,22840,1455,21385,3055,181.875,14.6975945
NM_031271,TEX15,4,3,17475,10116,7359,2453,2529,0.727461447
NM_013357,PURG,1,0,1962,1962,NA,NA,1962,NA
NM_001015508,PURG,2,1,37912,2692,35220,35220,1346,13.08320951
NM_001159996,NRG1,9,8,43209,2420,40789,5098.625,268.8888889,16.85495868
NM_025115,TTI2,7,6,14678,2770,11908,1984.666667,395.7142857,4.298916968
NM_001265581,TTI2,8,7,14678,2524,12154,1736.285714,315.5,4.815372425
NM_001102401,TTI2,8,7,14678,2402,12276,1753.714286,300.25,5.110741049
NM_032509,MAK16,10,9,16095,3584,12511,1390.111111,358.4,3.490792411
NM_024025,DUSP26,4,3,8587,1650,6937,2312.333333,412.5,4.204242424
NM_007175,ERLIN2,12,11,21224,4833,16391,1490.090909,402.75,3.391475274
NM_025069,ZNF703,2,1,3097,2176,921,921,1088,0.423253676
NM_001003791,ERLIN2,7,6,9976,1531,8445,1407.5,218.7142857,5.516002613
NM_001003790,ERLIN2,7,6,9876,1760,8116,1352.666667,251.4285714,4.611363636
NM_007198,PROSC,8,7,17187,2577,14610,2087.142857,322.125,5.669383003
NM_032777,GPR124,19,18,47105,6053,41052,2280.666667,318.5789474,6.782091525
NM_018310,BRF2,4,3,6035,2004,4031,1343.666667,501,2.011477046
NM_000025,ADRB3,2,1,3672,2648,1024,1024,1324,0.386706949
NM_152413,GOT1L1,9,8,5849,1386,4463,557.875,154,3.22005772
NM_001261832,ASH2L,15,14,34289,2971,31318,2237,198.0666667,10.54123191
NM_001282272,ASH2L,15,14,34589,2823,31766,2269,188.2,11.25256819
NM_000349,STAR,7,6,8384,2702,5682,947,386,2.102886751
NM_001105214,ASH2L,16,15,34289,3071,31218,2081.2,191.9375,10.16541843
NM_004674,ASH2L,16,15,34589,2970,31619,2107.933333,185.625,10.64612795
NM_004095,EIF4EBP1,3,2,29865,862,29003,14501.5,287.3333333,33.64617169
NM_001164234,DDHD2,5,4,7603,1887,5716,1429,377.4,3.029146794
NM_001102559,PPAPDC1B,7,6,6090,2135,3955,659.1666667,305,1.852459016
NM_001102560,PPAPDC1B,5,4,2242,776,1466,366.5,155.2,1.889175258
NM_001204878,BAG4,4,3,36715,4360,32355,10785,1090,7.42087156
NM_032483,PPAPDC1B,7,6,4482,872,3610,601.6666667,124.5714286,4.139908257
NM_015214,DDHD2,18,17,31280,4727,26553,1561.941176,262.6111111,5.617304845
NM_001164232,DDHD2,18,17,30818,4550,26268,1545.176471,252.7777778,5.773186813
NM_004874,BAG4,5,4,36715,4469,32246,8061.5,893.8,7.215484448
NM_014462,LSM1,4,3,13411,1165,12246,4082,291.25,10.51158798
NM_001286787,LETM2,11,10,23085,2814,20271,2027.1,255.8181818,7.203624733
NM_017778,WHSC1L1,10,9,65857,4005,61852,6872.444444,400.5,15.44369538
NM_001199659,LETM2,11,10,23085,2828,20257,2025.7,257.0909091,7.16301273
NM_144652,LETM2,10,9,23085,2683,20402,2266.888889,268.3,7.604174432
NM_001199660,LETM2,11,10,22395,2667,19728,1972.8,242.4545455,7.397075366
NM_001286819,LETM2,11,10,23085,2899,20186,2018.6,263.5454545,6.963090721
NM_001286821,LETM2,3,2,7994,2104,5890,2945,701.3333333,2.799429658
NM_207412,C8orf86,3,2,17830,2253,15577,7788.5,751,6.913892588
NM_001024381,TM2D2,4,3,7716,3338,4378,1459.333333,834.5,1.311563811
NM_001024380,TM2D2,4,3,7716,3439,4277,1425.666667,859.75,1.243675487
NM_031940,TM2D2,4,3,7716,3645,4071,1357,911.25,1.116872428
NM_153692,HTRA4,9,8,14515,2119,12396,1549.5,235.4444444,5.849929212
NM_078473,TM2D2,4,3,7716,3256,4460,1486.666667,814,1.36977887
NM_001278114,ADAM2,20,19,94555,2502,92053,4844.894737,125.1,36.79176659
NM_001278113,ADAM2,20,19,94555,2634,91921,4837.947368,131.7,34.89787396
NM_001464,ADAM2,21,20,94555,2692,91863,4593.15,128.1904762,34.12444279
NM_002164,IDO1,10,9,14983,1941,13042,1449.111111,194.1,6.719216899
NM_020130,C8orf4,1,0,1842,1842,NA,NA,1842,NA
NM_001002296,GOLGA7,5,4,20328,2032,18296,4574,406.4,9.003937008
NM_032336,GINS4,8,7,15842,3849,11993,1713.285714,481.125,3.115874253
NM_001174124,GOLGA7,6,5,20420,1915,18505,3701,319.1666667,9.663185379
NM_016099,GOLGA7,6,5,20420,1910,18510,3702,318.3333333,9.691099476
NM_020478,ANK1,5,4,12062,3301,8761,2190.25,660.2,2.654044229
NM_020480,ANK1,3,2,12062,3098,8964,4482,1032.666667,2.893479664
NM_152568,NKX6-3,2,1,1051,553,498,498,276.5,0.900542495
NM_001142445,ANK1,4,3,12062,3240,8822,2940.666667,810,2.722839506
NM_178819,AGPAT6,13,12,46815,6323,40492,3374.333333,486.3846154,6.403922189
NM_033011,PLAT,13,12,32960,3048,29912,2492.666667,234.4615385,9.813648294
NM_006803,AP3M2,9,8,18239,3620,14619,1827.375,402.2222222,4.03839779
NM_000930,PLAT,14,13,32960,3187,29773,2290.230769,227.6428571,9.342014434
NM_001134296,AP3M2,10,9,18239,3680,14559,1617.666667,368,3.95625
NM_001190720,IKBKB,21,20,61353,4029,57324,2866.2,191.8571429,14.2278481
NM_001242778,IKBKB,21,20,61353,4057,57296,2864.8,193.1904762,14.1227508
NM_001556,IKBKB,22,21,61353,4153,57200,2723.809524,188.7727273,13.77317602
NM_014420,DKK4,4,3,3090,822,2268,756,205.5,2.759124088
NM_001135694,VDAC3,10,9,14178,1550,12628,1403.111111,155,8.147096774
NM_005662,VDAC3,10,9,14178,1547,12631,1403.444444,154.7,8.164835165
NM_001135674,SMIM19,4,3,11377,1473,9904,3301.333333,368.25,6.723693143
NM_001135676,SMIM19,4,3,11844,766,11078,3692.666667,191.5,14.46214099
NM_001135675,SMIM19,4,3,11203,1081,10122,3374,270.25,9.363552266
NM_138436,SMIM19,4,3,11424,852,10572,3524,213,12.4084507
NM_000749,CHRNB3,6,5,39649,1959,37690,7538,326.5,19.23940786
NM_199003,THAP1,2,1,6659,1973,4686,4686,986.5,2.375063355
NM_001199279,CHRNA6,5,4,16151,2343,13808,3452,468.6,5.893299189
NM_018105,THAP1,3,2,6659,2170,4489,2244.5,723.3333333,2.068663594
NM_004198,CHRNA6,6,5,16151,2389,13762,2752.4,398.1666667,5.760569276
NM_032237,POMK,5,4,29676,1628,28048,7012,325.6,17.22850123
NM_002027,FNTA,9,8,29492,1704,27788,3473.5,189.3333333,16.30751174
NM_001277971,POMK,4,3,29676,1531,28145,9381.666667,382.75,18.38340954
NM_152419,HGSNAT,18,17,62380,5232,57148,3361.647059,290.6666667,10.92278287
NM_001005365,POTEA,14,13,70745,1990,68755,5288.846154,142.1428571,34.55025126
NM_001002920,POTEA,13,12,70745,1851,68894,5741.166667,142.3846154,37.21988115
NM_005195,CEBPD,1,0,1252,1252,NA,NA,1252,NA
NM_003350,UBE2V2,4,3,53461,1528,51933,17311,382,33.98756545
NM_024593,EFCAB1,6,5,11919,2150,9769,1953.8,358.3333333,4.54372093
NM_001142857,EFCAB1,6,5,20398,2292,18106,3621.2,382,7.89965096
NM_003068,SNAI2,3,2,3762,2112,1650,825,704,0.78125
NM_001256596,C8orf22,5,4,21749,1248,20501,5125.25,249.6,16.42708333
NM_001256598,C8orf22,5,4,3744,1998,1746,436.5,399.6,0.873873874
NM_001256597,C8orf22,5,4,3744,1356,2388,597,271.2,1.761061947
NM_001007176,C8orf22,5,4,3744,1273,2471,617.75,254.6,1.941084053
NM_052937,PCMTD1,6,5,81613,4208,77405,15481,701.3333333,18.39472433
NM_001286782,PCMTD1,4,3,81613,3701,77912,25970.66667,925.25,21.05160767
NM_001286783,PCMTD1,6,5,81613,3998,77615,15523,666.3333333,19.41345673
NM_005285,NPBWR1,1,0,988,988,NA,NA,988,NA
NM_001282904,OPRK1,5,4,25983,5201,20782,5195.5,1040.2,3.995770044
NM_000912,OPRK1,4,3,25920,4963,20957,6985.666667,1240.75,4.222647592
NM_003702,RGS20,5,4,78434,1721,76713,19178.25,344.2,44.57466589
NM_001279360,LYPLA1,9,8,55189,2536,52653,6581.625,281.7777778,20.76222397
NM_001279359,LYPLA1,9,8,55652,2554,53098,6637.25,283.7777778,20.79013312
NM_001279357,LYPLA1,8,7,55652,2545,53107,7586.714286,318.125,20.86719057
NM_001279356,LYPLA1,8,7,55652,2491,53161,7594.428571,311.375,21.34122842
NM_006330,LYPLA1,9,8,55652,2594,53058,6632.25,288.2222222,20.4541249
NM_001279358,LYPLA1,9,8,55652,2552,53100,6637.5,283.5555556,20.80721003
NM_022454,SOX17,2,1,2963,2352,611,611,1176,0.259778912
NM_006269,RP1,4,3,14769,7104,7665,2555,1776,1.078969595
NM_024831,TGS1,13,12,52216,3705,48511,4042.583333,285,13.09338731
NM_152417,TMEM68,6,5,34665,2421,32244,6448.8,403.5,13.31846344
NM_001286660,TMEM68,3,2,12636,2443,10193,5096.5,814.3333333,4.172329104
NM_001286661,TMEM68,5,4,34665,2042,32623,8155.75,408.4,15.97600392
NM_001286657,TMEM68,7,6,25238,2484,22754,3792.333333,354.8571429,9.160225443
NM_001146227,RPS20,6,5,6403,1019,5384,1076.8,169.8333333,5.283611384
NM_001023,RPS20,4,3,1774,843,931,310.3333333,210.75,1.104389087
NM_001114635,PLAG1,3,2,50393,6877,43516,21758,2292.333333,6.327759197
NM_001011671,CHCHD7,4,3,6863,1542,5321,1773.666667,385.5,3.450713359
NM_001011670,CHCHD7,4,3,6863,1586,5277,1759,396.5,3.327238335
NM_001011669,CHCHD7,5,4,6863,1715,5148,1287,343,3.001749271
NM_001011668,CHCHD7,5,4,6863,1691,5172,1293,338.2,3.05854524
NM_001011667,CHCHD7,5,4,6863,1735,5128,1282,347,2.955619597
NM_024300,CHCHD7,5,4,6863,1671,5192,1298,334.2,3.107121484
NM_002655,PLAG1,5,4,50393,7343,43050,10762.5,1468.6,5.862726406
NM_001114634,PLAG1,4,3,50393,7237,43156,14385.33333,1809.25,5.963244438
NM_005372,MOS,1,0,1042,1042,NA,NA,1042,NA
NM_138969,SDR16C5,7,6,20673,3044,17629,2938.166667,434.8571429,5.791392904
NM_006211,PENK,2,1,5082,1205,3877,3877,602.5,3.217427386
NM_001135690,PENK,4,3,5771,1340,4431,1477,335,3.306716418
NM_017813,IMPAD1,5,4,35944,7235,28709,7177.25,1447,3.968071873
NM_001077619,UBXN2B,8,7,40239,5076,35163,5023.285714,634.5,6.927304965
NM_001007069,SDCBP,9,8,29693,2173,27520,3440,241.4444444,12.6645191
NM_001007068,SDCBP,9,8,29693,2158,27535,3441.875,239.7777778,12.75949954
NM_000780,CYP7A1,6,5,9985,2881,7104,1420.8,480.1666667,2.465810482
NM_001007070,SDCBP,9,8,29693,2170,27523,3440.375,241.1111111,12.68341014
NM_001007067,SDCBP,9,8,29693,2173,27520,3440,241.4444444,12.6645191
NM_005625,SDCBP,9,8,29693,2176,27517,3439.625,241.7777778,12.64568015
NM_004056,CA8,9,8,92533,2287,90246,11280.75,254.1111111,39.46042851
NM_001164756,ASPH,5,4,39382,1701,37681,9420.25,340.2,22.15226337
NM_001164755,ASPH,13,12,90932,3658,87274,7272.833333,281.3846154,23.85839256
NM_001164754,ASPH,13,12,90932,3730,87202,7266.833333,286.9230769,23.37855228
NM_001164753,ASPH,14,13,66141,3509,62632,4817.846154,250.6428571,17.84895982
NM_001164752,ASPH,14,13,66141,3578,62563,4812.538462,255.5714286,17.48546674
NM_001164751,ASPH,15,14,66141,3636,62505,4464.642857,242.4,17.19059406
NM_020164,ASPH,6,5,27033,3278,23755,4751,546.3333333,7.246796827
NM_032468,ASPH,15,14,66141,3639,62502,4464.428571,242.6,17.17559769
NM_032467,ASPH,5,4,27033,3232,23801,5950.25,646.4,7.364170792
NM_032466,ASPH,14,13,90932,3788,87144,6703.384615,270.5714286,23.00527983
NM_003878,GGH,9,8,23973,1501,22472,2809,166.7777778,14.97135243
NM_000370,TTPA,5,4,26566,2637,23929,5982.25,527.4,9.074326887
NM_152414,BHLHE22,1,0,3398,3398,NA,NA,3398,NA
NM_018120,ARMC1,7,6,31763,3049,28714,4785.666667,435.5714286,9.417513939
NM_001286702,ARMC1,6,5,31763,2858,28905,5781,476.3333333,10.11371589
NM_002603,PDE7A,13,12,74762,6493,68269,5689.083333,499.4615385,10.51424611
NM_184087,TRIM55,5,4,48442,1847,46595,11648.75,369.4,25.22739578
NM_184086,TRIM55,9,8,48442,2484,45958,5744.75,276,18.50161031
NM_184085,TRIM55,10,9,48442,2773,45669,5074.333333,277.3,16.46916697
NM_033058,TRIM55,11,10,48442,2862,45580,4558,260.1818182,15.92592593
NM_000756,CRH,2,1,2236,1436,800,800,718,0.557103064
NM_015169,RRS1,1,0,1707,1707,NA,NA,1707,NA
NM_152765,C8orf46,6,5,25270,3471,21799,4359.8,578.5,6.280322674
NM_025054,VCPIP1,3,2,36966,8179,28787,14393.5,2726.333333,3.519623426
NM_019607,C8orf44,3,2,13592,1888,11704,5852,629.3333333,6.199152542
NM_001193502,TCF24,4,3,16091,2454,13637,4545.666667,613.5,5.557049715
NM_001136161,MCMDC2,13,12,31032,2384,28648,2387.333333,183.3846154,12.01677852
NM_001136160,MCMDC2,14,13,33864,2058,31806,2446.615385,147,15.4548105
NM_173518,MCMDC2,15,14,51301,5111,46190,3299.285714,340.7333333,9.037370378
NM_006837,COPS5,8,7,19249,1497,17752,2536,187.125,11.85838343
NM_001013626,PPP1R42,6,5,40421,1089,39332,7866.4,181.5,36.11753903
NM_024504,PRDM14,8,7,19678,2352,17326,2475.142857,294,7.366496599
NM_014294,TRAM1,11,10,35243,3110,32133,3213.3,282.7272727,10.33215434
NM_001011720,XKR9,5,4,66579,3179,63400,15850,635.8,19.94337842
NM_001287259,XKR9,6,5,66579,3290,63289,12657.8,548.3333333,19.23677812
NM_001287260,XKR9,5,4,66497,3033,63464,15866,606.6,20.9244972
NM_001287258,XKR9,6,5,66579,3298,63281,12656.2,549.6666667,19.18768951
NM_005098,MSC,2,1,2956,2060,896,896,1030,0.434951456
NM_007332,TRPA1,27,26,54335,5217,49118,1889.153846,193.2222222,9.414989458
NM_153225,SBSPON,5,4,28731,3803,24928,6232,760.6,6.554825138
NM_001243237,LOC100130301,4,3,18080,567,17513,5837.666667,141.75,30.88712522
NM_172037,RDH10,6,5,30685,3969,26716,5343.2,661.5,6.731166541
NM_000971,RPL7,7,6,2997,844,2153,358.8333333,120.5714286,2.550947867
NM_015364,LY96,5,4,37745,620,37125,9281.25,124,59.87903226
NM_001204863,TCEB1,3,2,27151,2041,25110,12555,680.3333333,12.30279275
NM_005648,TCEB1,4,3,27151,2096,25055,8351.666667,524,11.95372137
NM_001204864,TCEB1,3,2,27151,1873,25278,12639,624.3333333,13.49599573
NM_001204862,TCEB1,5,4,26772,1981,24791,6197.75,396.2,12.51438667
NM_001204861,TCEB1,6,5,26772,2121,24651,4930.2,353.5,11.62234795
NM_001204860,TCEB1,5,4,27151,2068,25083,6270.75,413.6,12.12911025
NM_001204859,TCEB1,5,4,27151,2236,24915,6228.75,447.2,11.14266547
NM_001204858,TCEB1,5,4,27151,2240,24911,6227.75,448,11.12098214
NM_001204857,TCEB1,4,3,27151,1928,25223,8407.666667,482,13.08246888
NM_017866,TMEM70,3,2,6643,2088,4555,2277.5,696,2.18151341
NM_001195797,LY96,4,3,37745,529,37216,12405.33333,132.25,70.35160681
NM_001040613,TMEM70,3,2,6643,2102,4541,2270.5,700.6666667,2.160323501
NM_020647,JPH1,6,5,86625,4379,82246,16449.2,729.8333333,18.78191368
NM_001040875,GDAP1,6,5,16719,3765,12954,2590.8,627.5,3.44063745
NM_018972,GDAP1,6,5,16719,3895,12824,2564.8,649.1666667,3.292426187
NM_031461,CRISPLD1,15,14,50087,4344,45743,3267.357143,289.6,10.53015654
NM_001286777,CRISPLD1,13,12,34406,3714,30692,2557.666667,285.6923077,8.263866451
NM_001286778,CRISPLD1,14,13,34406,3831,30575,2351.923077,273.6428571,7.980944923
NM_004133,HNF4G,10,9,26860,4103,22757,2528.555556,410.3,5.546429442
NM_001079867,PEX2,3,2,20032,4350,15682,7841,1450,3.605057471
NM_001172086,PEX2,5,4,20788,4390,16398,4099.5,878,3.735307517
NM_001172087,PEX2,3,2,20788,4246,16542,8271,1415.333333,3.895902025
NM_000318,PEX2,4,3,20032,4383,15649,5216.333333,1095.75,3.570385581
NM_016010,ZC2HC1A,9,8,53717,3358,50359,6294.875,373.1111111,14.99672424
NM_007029,STMN2,5,4,55363,2228,53135,13283.75,445.6,23.84874327
NM_001199214,STMN2,6,5,55363,2311,53052,10610.4,385.1666667,22.95629598
NM_001040708,HEY1,5,4,3855,2310,1545,386.25,462,0.668831169
NM_001282851,HEY1,2,1,2467,2037,430,430,1018.5,0.211094747
NM_012258,HEY1,5,4,3855,2298,1557,389.25,459.6,0.677545692
NM_001025252,TPD52,6,5,45965,4307,41658,8331.6,717.8333333,9.672161597
NM_001287143,TPD52,7,6,45965,4335,41630,6938.333333,619.2857143,9.603229527
NM_001287142,TPD52,7,6,45965,4350,41615,6935.833333,621.4285714,9.566666667
NM_001287140,TPD52,8,7,45965,4378,41587,5941,547.25,9.499086341
NM_001277145,ZBTB10,6,5,40648,8648,32000,6400,1441.333333,3.700277521
NM_001105539,ZBTB10,6,5,40054,9957,30097,6019.4,1659.5,3.0226976
NM_023929,ZBTB10,7,6,40054,9886,30168,5028,1412.285714,3.051588104
NM_001444,FABP5,4,3,4296,735,3561,1187,183.75,4.844897959
NM_001080526,FABP9,4,3,3142,403,2739,913,100.75,6.796526055
NM_002677,PMP2,4,3,7157,3570,3587,1195.666667,892.5,1.004761905
NM_001442,FABP4,4,3,4743,842,3901,1300.333333,210.5,4.633016627
NM_001105281,FABP12,4,3,6271,427,5844,1948,106.75,13.68618267
NM_024699,ZFAND1,8,7,19975,2202,17773,2539,275.25,8.071298819
NM_001170797,ZFAND1,7,6,18392,721,17671,2945.166667,103,24.50901526
NM_152284,CHMP4C,5,4,27062,1850,25212,6303,370,13.62810811
NM_001010893,SLC10A5,1,0,1318,1318,NA,NA,1318,NA
NM_001170796,ZFAND1,8,7,19975,2181,17794,2542,272.625,8.158642824
NM_152836,SNX16,8,7,42705,3218,39487,5641,402.25,12.27066501
NM_022133,SNX16,9,8,42705,3465,39240,4905,385,11.32467532
NM_152837,SNX16,7,6,42705,3130,39575,6595.833333,447.1428571,12.64376997
NM_033402,LRRCC1,19,18,38993,3894,35099,1949.944444,204.9473684,9.013610683
NM_198584,CA13,7,6,38588,3862,34726,5787.666667,551.7142857,8.991714138
NM_001099673,C8orf59,4,3,6357,920,5437,1812.333333,230,5.909782609
NM_001099672,C8orf59,5,4,6357,962,5395,1348.75,192.4,5.608108108
NM_001099671,C8orf59,5,4,6357,1046,5311,1327.75,209.2,5.077437859
NM_001099670,C8orf59,5,4,6357,1049,5308,1327,209.8,5.060057197
NM_005181,CA3,7,6,10213,1758,8455,1409.166667,251.1428571,4.809442548
NM_033126,PSKH2,3,2,21162,1161,20001,10000.5,387,17.22739018
NM_138817,SLC7A13,4,3,16318,1869,14449,4816.333333,467.25,7.730872124
NM_016033,RMDN1,10,9,36433,3074,33359,3706.555556,307.4,10.85198439
NM_001286707,RMDN1,9,8,36433,2944,33489,4186.125,327.1111111,11.37533967
NM_001286719,RMDN1,9,8,36433,2983,33450,4181.25,331.4444444,11.21354341
NM_152418,DCAF4L2,1,0,3327,3327,NA,NA,3327,NA
NM_003821,RIPK2,11,10,33319,2596,30723,3072.3,236,11.83474576
NM_001126111,OSGIN2,6,5,25335,4251,21084,4216.8,708.5,4.959774171
NM_004337,OSGIN2,6,5,26001,4205,21796,4359.2,700.8333333,5.183353151
NM_001359,DECR1,10,9,50649,1261,49388,5487.555556,126.1,39.16574148
NM_001146273,TMEM64,2,1,23912,4665,19247,19247,2332.5,4.125830654
NM_001008495,TMEM64,3,2,23912,4822,19090,9545,1607.333333,3.9589382
NM_001190972,C8orf88,6,5,26781,1059,25722,5144.4,176.5,24.28895184
NM_016023,OTUD6B,7,6,16901,3305,13596,2266,472.1428571,4.11376702
NM_001286745,OTUD6B,8,7,16901,3446,13455,1922.142857,430.75,3.904526988
NM_175636,RUNX1T1,10,9,62715,7329,55386,6154,732.9,7.557101924
NM_001191036,TRIQK,5,4,82061,3623,78438,19609.5,724.6,21.6500138
NM_001171798,TRIQK,5,4,82616,3672,78944,19736,734.4,21.49891068
NM_001171799,TRIQK,4,3,82616,3516,79100,26366.66667,879,22.49715586
NM_001171797,TRIQK,5,4,82616,3676,78940,19735,735.2,21.47442873
NM_001171796,TRIQK,6,5,82616,3832,78784,15756.8,638.6666667,20.55949896
NM_001171795,TRIQK,5,4,82616,3673,78943,19735.75,734.6,21.49278519
NM_001191035,TRIQK,5,4,82509,3768,78741,19685.25,753.6,20.89729299
NM_001242668,C8orf87,3,2,32757,591,32166,16083,197,54.42639594
NM_203390,RBM12B,3,2,9495,5104,4391,2195.5,1701.333333,0.860305643
NM_145269,FAM92A1,8,7,28745,1972,26773,3824.714286,246.5,13.57657201
NM_001283034,FAM92A1,7,6,28745,1857,26888,4481.333333,265.2857143,14.47926764
NM_001142301,TMEM67,29,28,63277,4686,58591,2092.535714,161.5862069,12.50341443
NM_153704,TMEM67,28,27,63277,4754,58523,2167.518519,169.7857143,12.31026504
NM_018444,PDP1,2,1,9215,4280,4935,4935,2140,1.153037383
NM_001161780,PDP1,3,2,9136,4237,4899,2449.5,1412.333333,1.156242624
NM_001161779,PDP1,3,2,9123,4363,4760,2380,1454.333333,1.090992436
NM_001161781,PDP1,2,1,9019,4223,4796,4796,2111.5,1.135685532
NM_181702,GEM,5,4,13064,2073,10991,2747.75,414.6,5.30197781
NM_005261,GEM,5,4,13064,2188,10876,2719,437.6,4.970749543
NM_001205262,RAD54B,4,3,47405,5384,42021,14007,1346,7.804791976
NM_001256141,FSBP,2,1,9242,5405,3837,3837,2702.5,0.709898242
NM_181787,DPY19L4,19,18,73975,6253,67722,3762.333333,329.1052632,10.83032145
NM_017864,INTS8,27,26,57205,3416,53789,2068.807692,126.5185185,15.74619438
NM_057749,CCNE2,12,11,15031,2738,12293,1117.545455,228.1666667,4.489773557
NM_152416,NDUFAF6,9,8,33732,1813,31919,3989.875,201.4444444,17.60562603
NM_024613,PLEKHF2,2,1,22966,2967,19999,19999,1483.5,6.740478598
NM_177965,C8orf37,6,5,24323,3379,20944,4188.8,563.1666667,6.198283516
NM_006294,UQCRB,4,3,8960,4823,4137,1379,1205.75,0.857764877
NM_001254752,UQCRB,5,4,8960,4961,3999,999.75,992.2,0.806087482
NM_001199975,UQCRB,5,4,8960,4938,4022,1005.5,987.6,0.814499797
NM_001001557,GDF6,2,1,18464,3703,14761,14761,1851.5,3.986227383
NM_014754,PTDSS1,13,12,72609,2517,70092,5841,193.6153846,27.84743743
NM_033512,TSPYL5,1,0,4464,4464,NA,NA,4464,NA
NM_000989,RPL30,5,4,3882,559,3323,830.75,111.8,5.944543828
NM_005836,HRSP12,6,5,14853,1017,13836,2767.2,169.5,13.60471976
NM_001145861,POP1,16,15,42550,4701,37849,2523.266667,293.8125,8.051265688
NM_015029,POP1,16,15,42003,4689,37314,2487.6,293.0625,7.957773512
NM_001145860,POP1,16,15,42550,4761,37789,2519.266667,297.5625,7.937198068
NM_020697,KCNS2,2,1,3775,3168,607,607,1584,0.191603535
NM_001286841,OSR2,5,4,7703,2131,5572,1393,426.2,2.614734866
NM_001142462,OSR2,4,3,7703,1881,5822,1940.666667,470.25,3.095162148
NM_053001,OSR2,4,3,7703,1799,5904,1968,449.75,3.281823235
NM_181661,VPS13B,8,7,108495,1639,106856,15265.14286,204.875,65.19585113
NM_004374,COX6C,4,3,16021,925,15096,5032,231.25,16.32
NM_001029860,FBXO43,5,4,12513,3310,9203,2300.75,662,2.780362538
NM_005034,POLR2K,4,3,3393,975,2418,806,243.75,2.48
NM_015435,RNF19A,11,10,46202,4342,41860,4186,394.7272727,9.640718563
NM_001270379,ANKRD46,6,5,50036,1736,48300,9660,289.3333333,27.82258065
NM_001270378,ANKRD46,5,4,38941,3279,35662,8915.5,655.8,10.87587679
NM_001270377,ANKRD46,5,4,39016,2681,36335,9083.75,536.2,13.55277881
NM_198401,ANKRD46,6,5,39016,2787,36229,7245.8,464.5,12.99928238
NM_152628,SNX31,14,13,76783,2469,74314,5716.461538,176.3571429,30.09882544
NM_002568,PABPC1,15,14,19173,2875,16298,1164.142857,191.6666667,5.668869565
NM_001135699,YWHAZ,6,5,34419,3016,31403,6280.6,502.6666667,10.41213528
NM_145690,YWHAZ,6,5,33555,3073,30482,6096.4,512.1666667,9.919297104
NM_003406,YWHAZ,6,5,34821,2999,31822,6364.4,499.8333333,10.61087029
NM_001135702,YWHAZ,6,5,31997,3038,28959,5791.8,506.3333333,9.532258065
NM_001135701,YWHAZ,6,5,32758,3019,29739,5947.8,503.1666667,9.850612786
NM_001135700,YWHAZ,6,5,32758,2970,29788,5957.6,495,10.02962963
NM_016096,ZNF706,4,3,8696,2749,5947,1982.333333,687.25,2.163332121
NM_001042510,ZNF706,5,4,8696,2865,5831,1457.75,573,2.035253054
NM_001267708,ZNF706,6,5,8696,2910,5786,1157.2,485,1.988316151
NM_001267709,ZNF706,4,3,9028,2662,6366,2122,665.5,2.391435011
NM_001172478,RRM2B,8,7,34619,4784,29835,4262.142857,598,6.236413043
NM_001172477,RRM2B,9,8,34332,4922,29410,3676.25,546.8888889,5.975213328
NM_015713,RRM2B,9,8,34619,4941,29678,3709.75,549,6.006476422
NM_024410,ODF1,2,1,9399,996,8403,8403,498,8.436746988
NM_005655,KLF10,4,3,7127,3103,4024,1341.333333,775.75,1.296809539
NM_001032282,KLF10,4,3,5189,3261,1928,642.6666667,815.25,0.591229684
NM_015878,AZIN1,13,12,37863,4361,33502,2791.833333,335.4615385,7.682182986
NM_148174,AZIN1,12,11,37863,4214,33649,3059,351.1666667,7.985049834
NM_015420,DCAF13,11,10,28740,2652,26088,2608.8,241.0909091,9.837104072
NM_001256099,CTHRC1,4,3,10573,1217,9356,3118.666667,304.25,7.687756779
NM_030780,SLC25A32,7,6,16699,3126,13573,2262.166667,446.5714286,4.341970569
NM_138455,CTHRC1,4,3,11491,1282,10209,3403,320.5,7.963338534
NM_001257317,DCSTAMP,3,2,16895,1475,15420,7710,491.6666667,10.45423729
NM_030788,DCSTAMP,4,3,16895,1987,14908,4969.333333,496.75,7.502767992
NM_001385,DPYS,10,9,87627,2133,85494,9499.333333,213.3,40.08157525
NM_139166,ABRA,2,1,10763,2756,8007,8007,1378,2.905297533
NM_001568,EIF3E,13,12,46989,1521,45468,3789,117,29.89349112
NM_014673,EMC2,11,10,43285,1249,42036,4203.6,113.5454545,33.65572458
NM_153015,TMEM74,2,1,4426,2089,2337,2337,1044.5,1.11871709
NM_001128211,NUDCD1,10,9,89016,3863,85153,9461.444444,386.3,22.04323065
NM_032869,NUDCD1,10,9,93204,3963,89241,9915.666667,396.3,22.51854656
NM_001193557,ENY2,5,4,11639,2864,8775,2193.75,572.8,3.063896648
NM_020189,ENY2,5,4,11639,2936,8703,2175.75,587.2,2.964237057
NM_001278938,EBAG9,7,6,25372,2201,23171,3861.833333,314.4285714,10.52748751
NM_198120,EBAG9,7,6,26298,2321,23977,3996.166667,331.5714286,10.33046101
NM_004215,EBAG9,7,6,25923,2488,23435,3905.833333,355.4285714,9.419212219
NM_014379,KCNV1,3,2,7728,2932,4796,2398,977.3333333,1.63574352
NM_032334,UTP23,3,2,8181,3694,4487,2243.5,1231.333333,1.214672442
NM_001025357,AARD,2,1,5777,1788,3989,3989,894,2.23098434
NM_006265,RAD21,14,13,28934,3764,25170,1936.153846,268.8571429,6.687035069
NM_001172814,SLC30A8,9,8,41618,5412,36206,4525.75,601.3333333,6.689948263
NM_173851,SLC30A8,8,7,41618,5381,36237,5176.714286,672.625,6.734250139
NM_080651,MED30,4,3,19551,989,18562,6187.333333,247.25,18.76845298
NM_001282986,MED30,3,2,19551,883,18668,9334,294.3333333,21.14156285
NM_002546,TNFRSF11B,5,4,28589,2351,26238,6559.5,470.2,11.16035729
NM_006438,COLEC10,6,5,39780,1709,38071,7614.2,284.8333333,22.27677004
NM_052886,MAL2,5,4,37306,2824,34484,8621,564.8,12.21104816
NM_002514,NOV,5,4,8128,2606,5522,1380.5,521.2,2.118956255
NM_003184,TAF2,26,25,102062,5046,97016,3880.64,194.0769231,19.22631788
NM_014078,MRPL13,7,6,49566,1117,48449,8074.833333,159.5714286,43.37421665
NM_005328,HAS2,4,3,28361,3279,25082,8360.666667,819.75,7.649283318
NM_024295,DERL1,8,7,29261,3348,25913,3701.857143,418.5,7.739844683
NM_001134671,DERL1,8,7,29261,3288,25973,3710.428571,411,7.8993309
NM_032899,FAM83A,5,4,29920,4601,25319,6329.75,920.2,5.502934145
NM_032847,C8orf76,6,5,21444,1348,20096,4019.2,224.6666667,14.90801187
NM_207006,FAM83A,6,5,31034,3707,27327,5465.4,617.8333333,7.371729161
NM_001288587,FAM83A,4,3,28055,2264,25791,8597,566,11.39178445
NM_007222,ZHX1,4,3,26039,5110,20929,6976.333333,1277.5,4.095694716
NM_001017926,ZHX1,4,3,26039,5205,20834,6944.666667,1301.25,4.002689721
NM_018024,WDYHV1,6,5,25517,1574,23943,4788.6,262.3333333,15.2115629
NM_001283027,WDYHV1,7,6,25517,1600,23917,3986.166667,228.5714286,14.948125
NM_001283024,WDYHV1,6,5,25517,1498,24019,4803.8,249.6666667,16.03404539
NM_001081675,KLHL38,3,2,7277,1837,5440,2720,612.3333333,2.961350027
NM_004306,ANXA13,11,10,56615,1481,55134,5513.4,134.6363636,37.22754895
NM_001003954,ANXA13,12,11,56615,1605,55010,5000.909091,133.75,34.2741433
NM_144963,FAM91A1,24,23,46810,5348,41462,1802.695652,222.8333333,7.752804787
NM_194291,TMEM65,7,6,61783,4314,57469,9578.166667,616.2857143,13.32151136
NM_001278646,NDUFB9,4,3,10886,721,10165,3388.333333,180.25,14.09847434
NM_001278645,NDUFB9,4,3,10886,688,10198,3399.333333,172,14.82267442
NM_032026,TATDN1,12,11,50596,1048,49548,4504.363636,87.33333333,47.27862595
NM_001146160,TATDN1,10,9,50596,930,49666,5518.444444,93,53.40430108
NM_007218,RNF139,2,1,13853,3314,10539,10539,1657,3.18014484
NM_017956,TRMT12,1,0,2220,2220,NA,NA,2220,NA
NM_005005,NDUFB9,4,3,10886,723,10163,3387.666667,180.75,14.05670816
NM_003129,SQLE,11,10,23807,3000,20807,2080.7,272.7272727,6.935666667
NM_152412,ZNF572,3,2,6093,3278,2815,1407.5,1092.666667,0.858755339
NM_025195,TRIB1,3,2,8086,3638,4448,2224,1212.666667,1.222649808
NM_001282985,TRIB1,3,2,6198,2812,3386,1693,937.3333333,1.204125178
NM_174911,FAM84B,2,1,6030,5483,547,547,2741.5,0.099762904
NM_001159542,POU5F1B,1,0,1586,1586,NA,NA,1586,NA
NM_002467,MYC,3,2,5367,2369,2998,1499,789.6666667,1.265512875
NM_031415,GSDMC,14,13,38694,2728,35966,2766.615385,194.8571429,13.1840176
NM_015137,EFR3A,23,22,109532,5437,104095,4731.590909,236.3913043,19.14566857
NM_001145095,HHLA1,16,15,43781,4121,39660,2644,257.5625,9.6238777
NM_012472,LRRC6,12,11,103664,1890,101774,9252.181818,157.5,53.84867725
NM_001145153,TMEM71,9,8,50724,1958,48766,6095.75,217.5555556,24.90602656
NM_144649,TMEM71,10,9,50724,2091,48633,5403.666667,209.1,23.25824964
NM_006748,SLA,7,6,23632,2832,20800,3466.666667,404.5714286,7.344632768
NM_001258433,NDRG1,15,14,60135,2990,57145,4081.785714,199.3333333,19.11204013
NM_001258432,NDRG1,14,13,60135,2978,57157,4396.692308,212.7142857,19.19308261
NM_001135242,NDRG1,16,15,60135,3494,56641,3776.066667,218.375,16.21093303
NM_006096,NDRG1,16,15,60135,3097,57038,3802.533333,193.5625,18.41717791
NM_017444,CHRAC1,3,2,5857,2507,3350,1675,835.6666667,1.336258476
NM_014957,DENND3,23,22,67182,5466,61716,2805.272727,237.6521739,11.29088913
NM_001286646,SLC45A4,8,7,47465,7241,40224,5746.285714,905.125,5.555033835
NM_001286648,SLC45A4,7,6,16648,2732,13916,2319.333333,390.2857143,5.093704246
NM_001080431,SLC45A4,8,7,21410,6989,14421,2060.142857,873.625,2.06338532
NM_032611,PTP4A3,5,4,11068,2790,8278,2069.5,558,2.96702509
NM_007079,PTP4A3,4,3,11068,2714,8354,2784.666667,678.5,3.078113486
NM_005293,GPR20,2,1,10780,1528,9252,9252,764,6.054973822
NM_001702,BAI1,30,29,80993,5558,75435,2601.206897,185.2666667,13.57232818
NM_005672,PSCA,3,2,2273,1026,1247,623.5,342,1.21539961
NM_001279352,JRK,5,4,12540,2855,9685,2421.25,571,3.392294221
NM_001160355,LY6K,3,2,4057,1681,2376,1188,560.3333333,1.413444378
NM_001160354,LY6K,3,2,4057,1960,2097,1048.5,653.3333333,1.069897959
NM_017527,LY6K,3,2,4057,1713,2344,1172,571,1.368359603
NM_015193,ARC,3,2,3430,2951,479,239.5,983.6666667,0.162317858
NM_001077527,JRK,4,3,12540,3593,8947,2982.333333,898.25,2.490119677
NM_003724,JRK,3,2,12540,9130,3410,1705,3043.333333,0.373493976
NM_016647,THEM6,2,1,9731,2266,7465,7465,1133,3.29435128
NM_023946,LYNX1,5,4,13885,1295,12590,3147.5,259,9.722007722
NM_205545,LYPD2,3,2,2326,537,1789,894.5,179,3.331471136
NM_020427,SLURP1,3,2,1469,540,929,464.5,180,1.72037037
NM_003695,LY6D,3,2,1712,805,907,453.5,268.3333333,1.126708075
NM_177458,LYNX1,3,2,5492,586,4906,2453,195.3333333,8.372013652
NM_177476,LYNX1,4,3,5824,4595,1229,409.6666667,1148.75,0.267464635
NM_177477,LYNX1,4,3,6131,4710,1421,473.6666667,1177.5,0.301698514
NM_177457,LYNX1,4,3,7027,4953,2074,691.3333333,1238.25,0.41873612
NM_001026213,CYP11B1,8,7,7465,3345,4120,588.5714286,418.125,1.231689088
NM_000497,CYP11B1,9,8,7465,3544,3921,490.125,393.7777778,1.106376975
NM_000498,CYP11B2,9,8,7286,2945,4341,542.625,327.2222222,1.474023769
NM_002346,LY6E,4,3,3927,1180,2747,915.6666667,295,2.327966102
NM_001127213,LY6E,4,3,3927,1175,2752,917.3333333,293.75,2.34212766
NM_173687,C8orf31,6,5,15043,1881,13162,2632.4,313.5,6.997341839
NM_002347,LY6H,4,3,2128,929,1199,399.6666667,232.25,1.290635091
NM_001130478,LY6H,5,4,2724,986,1738,434.5,197.2,1.762677485
NM_001135655,LY6H,4,3,2426,965,1461,487,241.25,1.513989637
NM_178172,GPIHBP1,4,3,3978,2285,1693,564.3333333,571.25,0.740919037
NM_173832,ZFP41,3,2,15779,4800,10979,5489.5,1600,2.287291667
NM_030895,ZNF696,3,2,8563,4687,3876,1938,1562.333333,0.82696821
NM_138465,GLI4,4,3,9496,1347,8149,2716.333333,336.75,6.049740163
NM_052963,TOP1MT,14,13,25566,1964,23602,1815.538462,140.2857143,12.01731161
NM_001271156,ZFP41,3,2,6772,3287,3485,1742.5,1095.666667,1.060237298
NM_201589,MAFA,1,0,2374,2374,NA,NA,2374,NA
NM_052924,RHPN1,15,14,15367,3730,11637,831.2142857,248.6666667,3.119839142
NM_032862,TIGD5,1,0,2413,2413,NA,NA,2413,NA
NM_024736,GSDMD,11,10,4756,1772,2984,298.4,161.0909091,1.683972912
NM_032378,EEF1D,10,9,17980,2508,15472,1719.111111,250.8,6.169059011
NM_001195203,EEF1D,8,7,17980,1227,16753,2393.285714,153.375,13.65362673
NM_023078,PYCRL,6,5,5703,2684,3019,603.8,447.3333333,1.124813711
NM_145201,NAPRT1,13,12,3568,1716,1852,154.3333333,132,1.079254079
NM_001960,EEF1D,8,7,17980,1284,16696,2385.142857,160.5,13.00311526
NM_003313,TSTA3,11,10,4946,1369,3577,357.7,124.4545455,2.612856099
NM_001130057,EEF1D,8,7,17693,1466,16227,2318.142857,183.25,11.06889495
NM_001130056,EEF1D,7,6,17980,1211,16769,2794.833333,173,13.84723369
NM_001130053,EEF1D,10,9,17980,2391,15589,1732.111111,239.1,6.519866165
NM_001100878,MROH6,14,13,6567,3264,3303,254.0769231,233.1428571,1.011948529
NM_001166237,GSDMD,14,13,9676,2329,7347,565.1538462,166.3571429,3.154572778
NM_001286829,NAPRT1,13,12,3568,1677,1891,157.5833333,129,1.127608825
NM_001130055,EEF1D,9,8,17980,1461,16519,2064.875,162.3333333,11.30663929
NM_001289950,EEF1D,8,7,17980,1281,16699,2385.571429,160.125,13.03590945
NM_001162914,CCDC166,2,1,1417,1322,95,95,661,0.071860817
NM_001261843,ZNF623,2,1,17719,3968,13751,13751,1984,3.46547379
NM_001082480,ZNF623,2,1,17570,4089,13481,13481,2044.5,3.296894106
NM_198488,FAM83H,5,4,9813,5602,4211,1052.75,1120.4,0.751695823
NM_014789,ZNF623,1,0,3948,3948,NA,NA,3948,NA
NM_173831,ZNF707,7,6,10935,2293,8642,1440.333333,327.5714286,3.768861753
NM_001100599,ZNF707,5,4,10935,2119,8816,2204,423.8,4.160453044
NM_001100598,ZNF707,6,5,10935,2218,8717,1743.4,369.6666667,3.930117223
NM_139021,MAPK15,14,13,6128,1902,4226,325.0769231,135.8571429,2.221871714
NM_001288805,ZNF707,8,7,10935,2934,8001,1143,366.75,2.726993865
NM_001288806,ZNF707,6,5,10935,2218,8717,1743.4,369.6666667,3.930117223
NM_001288807,ZNF707,6,5,10935,2206,8729,1745.8,367.6666667,3.95693563
NM_001288808,ZNF707,4,3,10935,2051,8884,2961.333333,512.75,4.331545588
NM_001288809,ZNF707,4,3,10935,2225,8710,2903.333333,556.25,3.914606742
NM_001136033,PUF60,12,11,12767,1970,10797,981.5454545,164.1666667,5.48071066
NM_015356,SCRIB,36,35,24461,5179,19282,550.9142857,143.8611111,3.72311257
NM_182706,SCRIB,37,36,24461,5255,19206,533.5,142.027027,3.654804948
NM_001271099,PUF60,11,10,13044,1863,11181,1118.1,169.3636364,6.001610306
NM_014281,PUF60,11,10,13044,1899,11145,1114.5,172.6363636,5.868878357
NM_031308,EPPK1,2,1,13142,8004,5138,5138,4002,0.641929035
NM_001271097,PUF60,10,9,13044,1811,11233,1248.111111,181.1,6.202650469
NM_001271096,PUF60,11,10,13044,1896,11148,1114.8,172.3636364,5.879746835
NM_001271100,PUF60,11,10,12767,1918,10849,1084.9,174.3636364,5.65641293
NM_178564,NRBP2,18,17,7393,3741,3652,214.8235294,207.8333333,0.97620957
NM_078480,PUF60,12,11,13044,1951,11093,1008.454545,162.5833333,5.685802153
NM_001271098,PUF60,12,11,13044,1948,11096,1008.727273,162.3333333,5.696098563
NM_201384,PLEC,32,31,24445,14835,9610,310,463.59375,0.647792383
NM_201383,PLEC,32,31,27379,14727,12652,408.1290323,460.21875,0.859102329
NM_201382,PLEC,32,31,28813,14774,14039,452.8709677,461.6875,0.95025044
NM_201381,PLEC,32,31,29592,14684,14908,480.9032258,458.875,1.015254699
NM_201380,PLEC,32,31,35731,15287,20444,659.483871,477.71875,1.337345457
NM_201379,PLEC,32,31,38775,14789,23986,773.7419355,462.15625,1.621881128
NM_001009184,GRINA,7,6,3359,1863,1496,249.3333333,266.1428571,0.803005904
NM_201378,PLEC,32,31,58384,14721,43663,1408.483871,460.03125,2.966034916
NM_032789,PARP10,11,10,9317,3529,5788,578.8,320.8181818,1.640124681
NM_000837,GRINA,7,6,3359,1975,1384,230.6666667,282.1428571,0.700759494
NM_000445,PLEC,33,32,61600,14837,46763,1461.34375,449.6060606,3.151782705
NM_016458,FAM203A,6,5,2950,2411,539,107.8,401.8333333,0.223558689
NM_032272,MAF1,8,7,3212,1783,1429,204.1428571,222.875,0.801458216
NM_030974,SHARPIN,9,8,5606,1825,3781,472.625,202.7777778,2.071780822
NM_017570,OPLAH,28,27,9419,4037,5382,199.3333333,144.1785714,1.333168194
NM_001916,CYC1,7,6,2494,1241,1253,208.8333333,177.2857143,1.009669621
NM_019037,EXOSC4,3,2,2031,898,1133,566.5,299.3333333,1.26169265
NM_003801,GPAA1,12,11,3597,2079,1518,138,173.25,0.73015873
NM_001008271,SCXA,2,1,1530,608,922,922,304,1.516447368
NM_001080514,SCXB,2,1,1927,1005,922,922,502.5,0.917412935
NM_016458,FAM203A,6,5,2950,2411,539,107.8,401.8333333,0.223558689
NM_012162,FBXL6,9,8,3097,1808,1289,161.125,200.8888889,0.712942478
NM_024531,SLC52A2,5,4,2674,1894,780,195,378.8,0.411826822
NM_024555,FBXL6,9,8,3097,1790,1307,163.375,198.8888889,0.730167598
NM_001280561,TMEM249,6,5,2385,1604,781,156.2,267.3333333,0.486907731
NM_031309,SCRT1,2,1,5717,3780,1937,1937,1890,0.512433862
NM_001253816,SLC52A2,5,4,2733,1780,953,238.25,356,0.535393258
NM_001252404,TMEM249,4,3,1707,903,804,268,225.75,0.890365449
NM_001252402,TMEM249,5,4,1707,999,708,177,199.8,0.708708709
NM_012079,DGAT1,17,16,12338,3738,8600,537.5,219.8823529,2.300695559
NM_005526,HSF1,13,12,23117,2165,20952,1746,166.5384615,9.677598152
NM_174922,ADCK5,15,14,20751,2003,18748,1339.142857,133.5333333,9.35996006
NM_001008271,SCXA,2,1,1530,608,922,922,304,1.516447368
NM_001253815,SLC52A2,5,4,2709,1800,909,227.25,360,0.505
NM_001080514,SCXB,2,1,1927,1005,922,922,502.5,0.917412935
NM_016208,VPS28,10,9,4964,989,3975,441.6666667,98.9,4.019211325
NM_001272036,LRRC14,5,4,7212,5439,1773,443.25,1087.8,0.32597904
NM_130849,SLC39A4,12,11,4483,2186,2297,208.8181818,182.1666667,1.050777676
NM_183057,VPS28,9,8,4964,1106,3858,482.25,122.8888889,3.488245931
NM_001280557,SLC39A4,4,3,1179,677,502,167.3333333,169.25,0.741506647
NM_032902,PPP1R16A,10,9,5397,2284,3113,345.8888889,228.4,1.36295972
NM_145754,KIFC2,17,16,7763,3265,4498,281.125,192.0588235,1.377641654
NM_013432,TONSL,26,25,15651,4541,11110,444.4,174.6538462,2.446597666
NM_004260,RECQL4,22,21,6545,3838,2709,129,174.4545455,0.705836373
NM_017767,SLC39A4,11,10,4121,2329,1792,179.2,211.7272727,0.769428939
NM_001129888,CYHR1,3,2,1833,1165,668,334,388.3333333,0.573390558
NM_014665,LRRC14,4,3,7212,5371,1841,613.6666667,1342.75,0.34276671
NM_138496,CYHR1,5,4,15105,1675,13430,3357.5,335,8.017910448
NM_032687,CYHR1,3,2,1651,1201,450,225,400.3333333,0.37468776
NM_138431,MFSD3,5,4,2039,1451,588,147,290.2,0.405237767
NM_005309,GPT,11,10,3092,1897,1195,119.5,172.4545455,0.629942014
NM_003923,FOXH1,3,2,2605,2186,419,209.5,728.6666667,0.191674291
NM_025251,ARHGAP39,13,12,84327,5156,79171,6597.583333,396.6153846,15.35512025
NM_138367,ZNF251,5,4,34678,3012,31666,7916.5,602.4,10.51328021
NM_030580,ZNF34,6,5,15123,2838,12285,2457,473,4.328752643
NM_001286770,ZNF34,5,4,15123,2717,12406,3101.5,543.4,4.566065513
NM_001286769,ZNF34,6,5,15123,2842,12281,2456.2,473.6666667,4.321252639
NM_213605,ZNF517,5,4,10270,2340,7930,1982.5,468,3.388888889
NM_014066,COMMD5,2,1,2903,1461,1442,1442,730.5,0.986995209
NM_033301,RPL8,6,5,2577,926,1651,330.2,154.3333333,1.782937365
NM_000973,RPL8,6,5,2653,881,1772,354.4,146.8333333,2.011350738
NM_021061,ZNF250,6,5,24512,6370,18142,3628.4,1061.666667,2.848037677
NM_001109689,ZNF250,6,5,24512,6355,18157,3631.4,1059.166667,2.857120378
NM_001282797,ZNF7,4,3,15706,2129,13577,4525.666667,532.25,6.377172381
NM_001282796,ZNF7,5,4,19992,1919,18073,4518.25,383.8,9.417926003
NM_001282795,ZNF7,5,4,15706,2290,13416,3354,458,5.858515284
NM_003416,ZNF7,5,4,15706,2257,13449,3362.25,451.4,5.95879486
NM_001081004,COMMD5,2,1,2903,1307,1596,1596,653.5,1.221117062
NM_001081003,COMMD5,2,1,3414,1439,1975,1975,719.5,1.37248089
NM_001287237,COMMD5,2,1,2903,1574,1329,1329,787,0.844345616
NM_001029976,ZNF16,4,3,20532,2620,17912,5970.666667,655,6.836641221
NM_006958,ZNF16,3,2,20532,2533,17999,8999.5,844.3333333,7.105803395
NM_023080,C8orf33,5,4,3594,2622,972,243,524.4,0.370709382
NM_002839,PTPRD,46,45,2298479,10156,2288323,50851.62222,220.7826087,225.3173494
NM_130393,PTPRD,29,28,419702,8251,411451,14694.67857,284.5172414,49.86680402
NM_130392,PTPRD,31,30,419702,8283,411419,13713.96667,267.1935484,49.67028854
NM_130391,PTPRD,31,30,419702,8280,411422,13714.06667,267.0967742,49.68864734
NM_001040712,PTPRD,30,29,419702,8270,411432,14187.31034,275.6666667,49.74993954
NM_001171025,PTPRD,29,28,419702,8278,411424,14693.71429,285.4482759,49.70089394
NM_017637,BNC2,7,6,461287,12933,448354,74725.66667,1847.571429,34.66743988
NM_001244752,ANKRD18B,16,15,48592,3769,44823,2988.2,235.5625,11.89254444
NM_001199233,RP11-402G3.3,5,4,15657,736,14921,3730.25,147.2,20.27309783
NM_012197,RABGAP1,26,25,163861,5025,158836,6353.44,193.2692308,31.60915423
NM_001042413,GLIS3,11,10,475909,7661,468248,46824.8,696.4545455,61.12100248
NM_003070,SMARCA2,34,33,178406,5913,172493,5227.060606,173.9117647,29.17182479
NM_139045,SMARCA2,33,32,178406,5858,172548,5392.125,177.5151515,29.45510413
NM_001289397,SMARCA2,33,32,178406,5684,172722,5397.5625,172.2424242,30.38740324
NM_001289396,SMARCA2,34,33,171680,5900,165780,5023.636364,173.5294118,28.09830508
NM_178566,ZDHHC21,10,9,82413,9181,73232,8136.888889,918.1,7.976473151
NM_173550,CCDC171,26,25,418802,4385,414417,16576.68,168.6538462,94.50786773
NM_017794,FOCAD,46,45,337647,6141,331506,7366.8,133.5,53.98241329
NM_001040272,ADAMTSL1,29,28,436870,7871,428999,15321.39286,271.4137931,54.50374794
NM_152570,LINGO2,7,6,771221,3243,767978,127996.3333,463.2857143,236.8109775
NM_014314,DDX58,18,17,71024,4774,66250,3897.058824,265.2222222,13.87725178
NM_001258282,LINGO2,7,6,1264916,3163,1261753,210292.1667,451.8571429,398.9102118
NM_024971,TRPM3,26,25,334010,5985,328025,13121,230.1923077,54.80785297
NM_206948,TRPM3,7,6,85198,1294,83904,13984,184.8571429,64.84080371
NM_206947,TRPM3,25,24,334010,5993,328017,13667.375,239.72,54.73335558
NM_001099666,PTAR1,8,7,50440,10059,40381,5768.714286,1257.375,4.014414952
NM_020952,TRPM3,25,24,334010,5948,328062,13669.25,237.92,55.15501009
NM_001085457,CBWD6,15,14,58057,1734,56323,4023.071429,115.6,32.48154556
NM_206945,TRPM3,25,24,334010,5954,328056,13669,238.16,55.09842123
NM_206944,TRPM3,24,23,334010,5917,328093,14264.91304,246.5416667,55.44921413
NM_206946,TRPM3,26,25,334010,6024,327986,13119.44,231.6923077,54.44654714
NM_001007471,TRPM3,25,24,586550,6296,580254,24177.25,251.84,92.16232529
NM_001007470,TRPM3,8,7,85198,1370,83828,11975.42857,171.25,61.18832117
NM_001190482,PCSK5,37,36,471697,9575,462122,12836.72222,258.7837838,48.26339426
NM_006200,PCSK5,21,20,303103,3694,299409,14970.45,175.9047619,81.05278831
NM_001244960,FRMD3,14,13,223120,5080,218040,16772.30769,362.8571429,42.92125984
NM_001244959,FRMD3,15,14,295445,2100,293345,20953.21429,140,139.6880952
NM_004938,DAPK1,26,25,210955,6124,204831,8193.24,235.5384615,33.44725669
NM_174938,FRMD3,14,13,293811,5304,288507,22192.84615,378.8571429,54.39423077
NM_001288729,DAPK1,26,25,210101,5799,204302,8172.08,223.0384615,35.23055699
NM_001288730,DAPK1,26,25,210955,5789,205166,8206.64,222.6538462,35.44066333
NM_001288731,DAPK1,26,25,211408,5772,205636,8225.44,222,35.62647263
NM_032823,C9orf3,15,14,360551,2937,357614,25543.85714,195.8,121.7616616
NM_022755,IPPK,13,12,57083,4414,52669,4389.083333,339.5384615,11.93226099
NM_001193331,C9orf3,8,7,207006,3846,203160,29022.85714,480.75,52.82371295
NM_001001662,ZNF782,6,5,37118,3319,33799,6759.8,553.1666667,10.183489
NM_001855,COL15A1,42,41,127081,5464,121617,2966.268293,130.0952381,22.25786969
NM_207299,LPPR1,8,7,296388,2463,293925,41989.28571,307.875,119.3361754
NM_015051,ERP44,12,11,119869,4872,114997,10454.27273,406,23.60365353
NM_133464,ZNF483,6,5,19275,3735,15540,3108,622.5,4.16064257
NM_001145369,PTPN3,21,20,75692,8786,66906,3345.3,418.3809524,7.615069429
NM_001145370,PTPN3,20,19,75692,8650,67042,3528.526316,432.5,7.750520231
NM_002829,PTPN3,26,25,122621,6742,115879,4635.16,259.3076923,17.18762978
NM_001145368,PTPN3,25,24,122621,6606,116015,4833.958333,264.24,17.56206479
NM_001007169,ZNF483,6,5,52687,2439,50248,10049.6,406.5,20.60188602
NM_153366,SVEP1,48,47,214633,12391,202242,4303.021277,258.1458333,16.32168509
NM_001287036,KIAA1958,5,4,178345,7657,170688,42672,1531.4,22.29175917
NM_133465,KIAA1958,4,3,178345,7572,170773,56924.33333,1893,22.5532224
NM_001287038,KIAA1958,4,3,178345,7562,170783,56927.66667,1890.5,22.58436921
NM_194252,TTLL11,4,3,104697,2015,102682,34227.33333,503.75,50.95880893
NM_014010,ASTN2,22,21,989815,4616,985199,46914.2381,209.8181818,213.4313258
NM_001735,C5,41,40,97942,5505,92437,2310.925,134.2682927,16.79146231
NM_001139442,TTLL11,9,8,271683,3262,268421,33552.625,362.4444444,82.28724709
NM_002721,PPP6C,7,6,43368,4246,39122,6520.333333,606.5714286,9.213848328
NM_015679,TRUB2,8,7,13303,1447,11856,1693.714286,180.875,8.193503801
NM_001123369,PPP6C,6,5,43368,4179,39189,7837.8,696.5,9.377602297
NM_001123355,PPP6C,8,7,43368,4358,39010,5572.857143,544.75,8.951353832
NM_007344,TTF1,11,10,31303,3163,28140,2814,287.5454545,8.896617136
NM_152285,ARRDC1,8,7,9718,1606,8112,1158.857143,200.75,5.051058531
NM_139027,ADAMTS13,29,28,37407,4812,32595,1164.107143,165.9310345,6.773690773
NM_139025,ADAMTS13,29,28,37407,4980,32427,1158.107143,171.7241379,6.511445783
NM_139026,ADAMTS13,29,28,37407,4719,32688,1167.428571,162.7241379,6.926891291
NM_001205296,TTF1,10,9,31303,1788,29515,3279.444444,178.8,16.50727069
NM_203447,DOCK8,48,47,250396,7500,242896,5168,156.25,32.38613333
NM_001190458,DOCK8,46,45,192213,7187,185026,4111.688889,156.2391304,25.74453875
NM_021951,DMRT1,5,4,127402,2227,125175,31293.75,445.4,56.20790301
NM_001256876,KANK1,16,15,275814,5595,270219,18014.6,349.6875,48.29651475
NM_015158,KANK1,12,11,241413,5085,236328,21484.36364,423.75,46.47551622
NM_001256877,KANK1,13,12,241413,5701,235712,19642.66667,438.5384615,41.34572882
NM_018491,CBWD1,15,14,58039,1738,56301,4021.5,115.8666667,32.39413119
NM_001145356,CBWD1,14,13,58039,1680,56359,4335.307692,120,33.54702381
NM_001145355,CBWD1,16,15,58039,1837,56202,3746.8,114.8125,30.59444747
NM_001193536,DOCK8,47,46,192213,7284,184929,4020.195652,154.9787234,25.3883855
NM_134428,RFX3,18,17,307706,9343,298363,17550.76471,519.0555556,31.93438938
NM_002919,RFX3,14,13,148561,2985,145576,11198.15385,213.2142857,48.76917923
NM_001282117,RFX3,11,10,218560,1534,217026,21702.6,139.4545455,141.4771838
NM_001282116,RFX3,17,16,307706,9275,298431,18651.9375,545.5882353,32.17584906
NM_152629,GLIS3,10,9,328057,6676,321381,35709,667.6,48.13975434
NM_016282,AK3,5,4,31754,4330,27424,6856,866,6.333487298
NM_001199856,AK3,5,4,16672,4102,12570,3142.5,820.4,3.064358849
NM_001199855,AK3,5,4,32244,4036,28208,7052,807.2,6.989098117
NM_001199853,AK3,5,4,32488,4029,28459,7114.75,805.8,7.06353934
NM_001199852,AK3,4,3,31754,4209,27545,9181.666667,1052.25,6.544309812
NM_001286699,RCL1,7,6,68245,1941,66304,11050.66667,277.2857143,34.15971149
NM_004972,JAK2,25,24,142940,5310,137630,5734.583333,212.4,25.91902072
NM_001286700,RCL1,8,7,68245,2014,66231,9461.571429,251.75,32.88530288
NM_005772,RCL1,9,8,68245,2191,66054,8256.75,243.4444444,30.14787768
NM_001286701,RCL1,5,4,21310,1466,19844,4961,293.2,13.5361528
NM_020829,KIAA1432,26,25,147439,6799,140640,5625.6,261.5,20.68539491
NM_001206557,KIAA1432,25,24,147439,6687,140752,5864.666667,267.48,21.04860176
NM_018465,PLGRKT,6,5,79972,1003,78969,15793.8,167.1666667,78.7328016
NM_001135920,KIAA1432,22,21,140337,3835,136502,6500.095238,174.3181818,35.59374185
NM_005511,MLANA,5,4,18915,1529,17386,4346.5,305.8,11.37083061
NM_001146695,KDM4C,18,17,319625,3853,315772,18574.82353,214.0555556,81.95484038
NM_001146694,KDM4C,21,20,413281,4625,408656,20432.8,220.2380952,88.35805405
NM_000170,GLDC,25,24,113230,3834,109396,4558.166667,153.36,28.53312467
NM_152896,UHRF2,16,15,93902,3637,90265,6017.666667,227.3125,24.81853176
NM_001146696,KDM4C,18,17,356403,3425,352978,20763.41176,190.2777778,103.0592701
NM_015061,KDM4C,22,21,418009,4692,413317,19681.7619,213.2727273,88.0897272
NM_001261407,MPDZ,45,44,173862,7555,166307,3779.704545,167.8888889,22.01283918
NM_001261406,MPDZ,46,45,173862,7643,166219,3693.755556,166.1521739,21.74787387
NM_003829,MPDZ,46,45,173862,7655,166207,3693.488889,166.4130435,21.71221424
NM_001282787,NFIB,11,10,98961,7633,91328,9132.8,693.9090909,11.9648893
NM_005596,NFIB,9,8,232205,8273,223932,27991.5,919.2222222,27.06781095
NM_001190738,NFIB,9,8,317142,8168,308974,38621.75,907.5555556,37.82737512
NM_001190737,NFIB,11,10,232205,8497,223708,22370.8,772.4545455,26.32788043
NM_001128217,PSIP1,16,15,46940,3389,43551,2903.4,211.8125,12.85069342
NM_001168339,TTC39B,20,19,136518,3275,133243,7012.789474,163.75,40.6848855
NM_001168340,TTC39B,19,18,136518,3241,133277,7404.277778,170.5789474,41.12218451
NM_152574,TTC39B,20,19,136518,3281,133237,7012.473684,164.05,40.6086559
NM_033222,PSIP1,16,15,46940,3392,43548,2903.2,212,12.8384434
NM_144966,FREM1,38,37,176331,10124,166207,4492.081081,266.4210526,16.41712762
NM_001168342,TTC39B,18,17,79358,3154,76204,4482.588235,175.2222222,24.16106531
NM_001168341,TTC39B,18,17,136518,3072,133446,7849.764706,170.6666667,43.43945313
NM_001271829,C9orf92,4,3,49174,368,48806,16268.66667,92,132.625
NM_001114395,CNTLN,7,6,167062,4927,162135,27022.5,703.8571429,32.90744875
NM_003026,SH3GL2,9,8,218171,2737,215434,26929.25,304.1111111,78.71172817
NM_017738,CNTLN,26,25,368934,5593,363341,14533.64,215.1153846,64.96352584
NM_052866,ADAMTSL1,13,12,210875,1893,208982,17415.16667,145.6153846,110.397253
NM_001193288,SLC24A2,9,8,279569,10798,268771,33596.375,1199.777778,24.89081311
NM_001287050,FAM154A,3,2,105600,1967,103633,51816.5,655.6666667,52.68581596
NM_001287049,FAM154A,4,3,121696,1929,119767,39922.33333,482.25,62.08761016
NM_017925,DENND4C,32,31,143376,7814,135562,4372.967742,244.1875,17.34860507
NM_020344,SLC24A2,10,9,279569,10850,268719,29857.66667,1085,24.76672811
NM_153707,FAM154A,4,3,105600,2171,103429,34476.33333,542.75,47.64117918
NM_001286691,MLLT3,11,10,280325,6699,273626,27362.6,609,40.84579788
NM_004529,MLLT3,11,10,280881,6783,274098,27409.8,616.6363636,40.4095533
NM_001171197,ELAVL2,6,5,131377,3768,127609,25521.8,628,33.86650743
NM_001171195,ELAVL2,6,5,131742,3755,127987,25597.4,625.8333333,34.08442077
NM_004432,ELAVL2,7,6,135962,3814,132148,22024.66667,544.8571429,34.64813844
NM_001004352,LOC100506422,7,6,51735,2327,49408,8234.666667,332.4285714,21.23248818
NM_025103,IFT74,20,19,106562,2183,104379,5493.631579,109.15,47.81447549
NM_024828,CAAP1,6,5,52145,2821,49324,9864.8,470.1666667,17.48457994
NM_001099223,IFT74,20,19,115896,2147,113749,5986.789474,107.35,52.98043782
NM_001167575,CAAP1,6,5,52145,2975,49170,9834,495.8333333,16.52773109
NM_022901,LRRC19,5,4,12558,3613,8945,2236.25,722.6,2.475781899
NM_000459,TEK,23,22,121027,4782,116245,5283.863636,207.9130435,24.30886658
NM_001099224,IFT74,14,13,80427,1580,78847,6065.153846,112.8571429,49.90316456
NM_001099222,IFT74,20,19,115623,2191,113432,5970.105263,109.55,51.7717937
NM_024761,MOB3B,4,3,204645,6529,198116,66038.66667,1632.25,30.34400368
NM_020124,IFNK,2,1,2186,1142,1044,1044,571,0.914185639
NM_147133,NFX1,21,20,74752,3609,71143,3557.15,171.8571429,19.71266279
NM_147134,NFX1,16,15,58305,3654,54651,3643.4,228.375,14.95648604
NM_002504,NFX1,24,23,80739,4719,76020,3305.217391,196.625,16.1093452
NM_001497,B4GALT1,6,5,56719,4205,52514,10502.8,700.8333333,12.48846611
NM_001539,DNAJA1,9,8,13855,1547,12308,1538.5,171.8888889,7.956043956
NM_016525,UBAP1,7,6,73520,2750,70770,11795,392.8571429,25.73454545
NM_001244390,NUDT2,3,2,14209,830,13379,6689.5,276.6666667,16.11927711
NM_001281428,DNAI1,20,19,62239,2619,59620,3137.894737,130.95,22.7644139
NM_147172,NUDT2,5,4,14209,1009,13200,3300,201.8,13.08225966
NM_001171204,UBAP1,8,7,73520,2874,70646,10092.28571,359.25,24.58107168
NM_001171202,UBAP1,6,5,73520,2624,70896,14179.2,437.3333333,27.01829268
NM_001171201,UBAP1,6,5,73520,2708,70812,14162.4,451.3333333,26.14918759
NM_001171203,UBAP1,8,7,73520,2906,70614,10087.71429,363.25,24.29938059
NM_012144,DNAI1,20,19,62239,2607,59632,3138.526316,130.35,22.8738013
NM_147173,NUDT2,4,3,14209,966,13243,4414.333333,241.5,13.70910973
NM_018449,UBAP2,29,28,127258,4313,122945,4390.892857,148.7241379,28.5056805
NM_001161,NUDT2,5,4,14209,1080,13129,3282.25,216,12.15648148
NM_001282529,UBAP2,25,24,127258,3995,123263,5135.958333,159.8,30.8543179
NM_006377,UNC13B,39,38,243345,6409,236936,6235.157895,164.3333333,36.96926198
NM_012266,DNAJB5,4,3,8794,2450,6344,2114.666667,612.5,2.589387755
NM_001135005,DNAJB5,4,3,8165,2802,5363,1787.666667,700.5,1.913990007
NM_001135004,DNAJB5,5,4,8794,2596,6198,1549.5,519.2,2.38751926
NM_014806,RUSC2,12,11,71890,5334,66556,6050.545455,444.5,12.47769029
NM_021111,RECK,21,20,87544,4433,83111,4155.55,211.0952381,18.74825175
NM_001280552,PAX5,8,7,201206,8728,192478,27496.85714,1091,22.05293309
NM_001280551,PAX5,7,6,201206,8561,192645,32107.5,1223,22.5026282
NM_001280550,PAX5,7,6,201206,8597,192609,32101.5,1228.142857,22.40421077
NM_001280556,PAX5,9,8,201206,8752,192454,24056.75,972.4444444,21.98971664
NM_001280555,PAX5,8,7,201206,8617,192589,27512.71429,1077.125,22.34988975
NM_001280554,PAX5,9,8,201206,8789,192417,24052.125,976.5555556,21.89293435
NM_001280553,PAX5,8,7,201206,8701,192505,27500.71429,1087.625,22.12446845
NM_001280549,PAX5,8,7,201206,8685,192521,27503,1085.625,22.16706966
NM_001280548,PAX5,9,8,201206,8831,192375,24046.875,981.2222222,21.78405617
NM_001280547,PAX5,9,8,201206,8816,192390,24048.75,979.5555556,21.82282214
NM_032226,ZCCHC7,9,8,237678,2694,234984,29373,299.3333333,87.22494432
NM_022490,POLR1E,12,11,17764,1880,15884,1444,156.6666667,8.44893617
NM_016734,PAX5,10,9,201206,8919,192287,21365.22222,891.9,21.55925552
NM_001282766,POLR1E,13,12,17764,1975,15789,1315.75,151.9230769,7.99443038
NM_001289119,ZCCHC7,9,8,237678,2698,234980,29372.5,299.7777778,87.09414381
NM_001289120,ZCCHC7,9,8,237552,2721,234831,29353.875,302.3333333,86.30319735
NM_001289121,ZCCHC7,9,8,237552,2839,234713,29339.125,315.4444444,82.67453329
NM_003028,SHB,6,5,153317,6027,147290,29458,1004.5,24.43836071
NM_033655,CNTNAP3,24,23,215538,5253,210285,9142.826087,218.875,40.03141062
NM_001201380,CNTNAP3B,24,23,237590,6404,231186,10051.56522,266.8333333,36.10024984
NM_001012421,ANKRD20A2,15,14,43121,3526,39595,2828.214286,235.0666667,11.22943846
NM_001012419,ANKRD20A3,15,14,43540,3945,39595,2828.214286,263,10.03675539
NM_021965,PGM5,11,10,174164,3349,170815,17081.5,304.4545455,51.00477755
NM_201453,CBWD3,15,14,58095,1741,56354,4025.285714,116.0666667,32.36875359
NM_001161706,FXN,5,4,64617,985,63632,15908,197,64.60101523
NM_001278253,PIP5K1B,14,13,303764,2680,301084,23160.30769,191.4285714,112.3447761
NM_003558,PIP5K1B,16,15,303764,2957,300807,20053.8,184.8125,101.7270883
NM_001127608,FAM189A2,11,10,67884,2118,65766,6576.6,192.5454545,31.0509915
NM_201629,TJP2,21,20,81155,4305,76850,3842.5,205,17.85133566
NM_001163,APBA1,13,12,244828,6597,238231,19852.58333,507.4615385,36.11202062
NM_001170415,TJP2,22,21,50199,4481,45718,2177.047619,203.6818182,10.20263334
NM_001170630,TJP2,19,18,75693,4739,70954,3941.888889,249.4210526,14.97235704
NM_001170416,TJP2,23,22,50048,4523,45525,2069.318182,196.6521739,10.0652222
NM_001170414,TJP2,22,21,133946,4151,129795,6180.714286,188.6818182,31.26836907
NM_004816,FAM189A2,11,10,63131,2434,60697,6069.7,221.2727273,24.93714051
NM_004817,TJP2,23,22,81155,4748,76407,3473.045455,206.4347826,16.09245998
NM_001206,KLF9,2,1,30062,5210,24852,24852,2605,4.770057582
NM_015110,SMC5,25,24,95913,5990,89923,3746.791667,239.6,15.01218698
NM_001010940,C9orf135,6,5,85419,857,84562,16912.4,142.8333333,98.67211202
NM_153267,MAMDC2,14,13,183393,3632,179761,13827.76923,259.4285714,49.4936674
NM_013390,TMEM2,24,23,85520,6547,78973,3433.608696,272.7916667,12.06247136
NM_001135820,TMEM2,23,22,85520,6357,79163,3598.318182,276.3913043,12.45288658
NM_001278244,ZFAND5,6,5,13169,5316,7853,1570.6,886,1.477238525
NM_001278243,ZFAND5,7,6,13169,5454,7715,1285.833333,779.1428571,1.414558122
NM_006007,ZFAND5,6,5,13824,5734,8090,1618,955.6666667,1.410882456
NM_138691,TMC1,24,23,314552,3225,311327,13535.95652,134.375,96.53550388
NM_001242507,GDA,14,13,137631,5377,132254,10173.38462,384.0714286,24.59624326
NM_001242505,GDA,16,15,102875,2091,100784,6718.933333,130.6875,48.19894787
NM_001242506,GDA,15,14,102875,5512,97363,6954.5,367.4666667,17.66382438
NM_001278245,ZFAND5,7,6,13169,5451,7718,1286.333333,778.7142857,1.415886993
NM_001102421,ZFAND5,6,5,13824,5737,8087,1617.4,956.1666667,1.409621754
NM_001102420,ZFAND5,7,6,13824,5875,7949,1324.833333,839.2857143,1.353021277
NM_004293,GDA,14,13,102875,5470,97405,7492.692308,390.7142857,17.8071298
NM_182505,C9orf85,4,3,61950,1319,60631,20210.33333,329.75,45.96739955
NM_017662,TRPM6,39,38,165601,8464,157137,4135.184211,217.025641,18.56533554
NM_006914,RORB,10,9,189867,3614,186253,20694.77778,361.4,51.53652463
NM_001177311,TRPM6,39,38,164854,8310,156544,4119.578947,213.0769231,18.83802647
NM_001177310,TRPM6,39,38,165227,8283,156944,4130.105263,212.3846154,18.94772425
NM_012383,OSTF1,10,9,58718,1323,57395,6377.222222,132.3,43.3824641
NM_015225,PRUNE2,19,18,294713,12604,282109,15672.72222,663.3684211,22.38249762
NM_004297,GNA14,7,6,225239,2498,222741,37123.5,356.8571429,89.16773419
NM_015186,VPS13A,69,68,207747,10124,197623,2906.220588,146.7246377,19.52024891
NM_033305,VPS13A,72,71,240040,11334,228706,3221.211268,157.4166667,20.17875419
NM_001018038,VPS13A,69,68,205562,10245,195317,2872.308824,148.4782609,19.06461689
NM_001018037,VPS13A,71,70,240040,11216,228824,3268.914286,157.971831,20.40156919
NM_002072,GNAQ,7,6,315177,6350,308827,51471.16667,907.1428571,48.63417323
NM_032171,CEP78,15,14,30994,2717,28277,2019.785714,181.1333333,10.40743467
NM_001098802,CEP78,16,15,30994,2766,28228,1881.866667,172.875,10.20535069
NM_007005,TLE4,20,19,155110,5097,150013,7895.421053,254.85,29.43162645
NM_001282749,TLE4,19,18,155110,5021,150089,8338.277778,264.2631579,29.89225254
NM_001282753,TLE4,18,17,155110,4888,150222,8836.588235,271.5555556,30.73281506
NM_001282760,TLE4,21,20,155110,5193,149917,7495.85,247.2857143,28.8690545
NM_001282748,TLE4,21,20,155110,5194,149916,7495.8,247.3333333,28.86330381
NM_005077,TLE1,20,19,105000,3289,101711,5353.210526,164.45,30.92459714
NM_025211,GKAP1,13,12,78418,1886,76532,6377.666667,145.0769231,40.57900318
NM_022127,SLC28A3,19,18,92650,4555,88095,4894.166667,239.7368421,19.3402854
NM_017576,KIF27,18,17,84767,4707,80060,4709.411765,261.5,17.00871043
NM_001271928,KIF27,16,15,84767,4414,80353,5356.866667,275.875,18.20412324
NM_001271927,KIF27,17,16,84767,4508,80259,5016.1875,265.1764706,17.80368234
NM_001199633,SLC28A3,18,17,64931,4608,60323,3548.411765,256,13.09092882
NM_001256915,IDNK,5,4,21083,1216,19867,4966.75,243.2,16.33799342
NM_001135953,GKAP1,12,11,78418,1732,76686,6971.454545,144.3333333,44.27598152
NM_001001551,IDNK,5,4,21083,1042,20041,5010.25,208.4,19.23320537
NM_006180,NTRK2,21,20,355041,5629,349412,17470.6,268.047619,62.0735477
NM_001007097,NTRK2,13,12,145997,7124,138873,11572.75,548,19.49368332
NM_001018066,NTRK2,14,13,208220,8290,199930,15379.23077,592.1428571,24.11700844
NM_001018065,NTRK2,15,14,208220,8339,199881,14277.21429,555.9333333,23.96942079
NM_001018064,NTRK2,20,19,355041,5580,349461,18392.68421,279,62.62741935
NM_024635,NAA35,23,22,81162,2680,78482,3567.363636,116.5217391,29.28432836
NM_001276368,C9orf153,5,4,35770,1868,33902,8475.5,373.6,18.14882227
NM_001276367,C9orf153,5,4,39394,1929,37465,9366.25,385.8,19.4219803
NM_001276366,C9orf153,4,3,39394,1849,37545,12515,462.25,20.30557058
NM_001286717,AGTPBP1,25,24,195492,4379,191113,7963.041667,175.16,43.64306919
NM_015239,AGTPBP1,26,25,195492,4445,191047,7641.88,170.9615385,42.98020247
NM_001286715,AGTPBP1,25,24,195492,4499,190993,7958.041667,179.96,42.45232274
NM_016848,SHC3,12,11,172998,9780,163218,14838,815,16.68895706
NM_006378,SEMA4D,18,17,102461,4646,97815,5753.823529,258.1111111,21.05359449
NM_001142287,SEMA4D,21,20,118907,4421,114486,5724.3,210.5238095,25.89595114
NM_005226,S1PR3,2,1,13747,4390,9357,9357,2195,2.13143508
NM_003177,SYK,14,13,96832,5087,91745,7057.307692,363.3571429,18.03518773
NM_001174168,SYK,13,12,96637,4934,91703,7641.916667,379.5384615,18.58593433
NM_001135052,SYK,13,12,96832,5017,91815,7651.25,385.9230769,18.30077736
NM_001698,AUH,10,9,148111,1598,146513,16279.22222,159.8,91.68523154
NM_002161,IARS,34,33,83550,4575,78975,2393.181818,134.5588235,17.26229508
NM_001197296,ECM2,10,9,42547,2665,39882,4431.333333,266.5,14.96510319
NM_033014,OGN,7,6,20690,3074,17616,2936,439.1428571,5.730644112
NM_001197295,ECM2,10,9,40782,3234,37548,4172,323.4,11.61038961
NM_014057,OGN,7,6,20690,2792,17898,2983,398.8571429,6.410458453
NM_013417,IARS,34,33,83550,4745,78805,2388.030303,139.5588235,16.60800843
NM_001393,ECM2,10,9,40782,3300,37482,4164.666667,330,11.35818182
NM_004560,ROR2,9,8,227568,4106,223462,27932.75,456.2222222,54.423283
NM_001012267,CENPP,8,7,289689,3412,286277,40896.71429,426.5,83.90298945
NM_001286969,CENPP,7,6,289689,3229,286460,47743.33333,461.2857143,88.71477238
NM_006648,WNK2,29,28,135644,6863,128781,4599.321429,236.6551724,18.76453446
NM_001282394,WNK2,30,29,134445,8270,126175,4350.862069,275.6666667,15.25695284
NM_152422,PTPDC1,9,8,25429,4444,20985,2623.125,493.7777778,4.72209721
NM_001253829,PTPDC1,9,8,25429,4450,20979,2622.375,494.4444444,4.714382022
NM_001253830,PTPDC1,10,9,79049,4497,74552,8283.555556,449.7,16.57816322
NM_001127628,FBP1,8,7,37112,1497,35615,5087.857143,187.125,23.79091516
NM_000507,FBP1,7,6,36504,1597,34907,5817.833333,228.1428571,21.85785848
NM_177995,PTPDC1,10,9,79064,4527,74537,8281.888889,452.7,16.46498785
NM_001193329,C9orf3,16,15,327571,3152,324419,21627.93333,197,102.9248096
NM_001243744,FANCC,14,13,207485,2725,204760,15750.76923,194.6428571,75.1412844
NM_000136,FANCC,15,14,218657,4607,214050,15289.28571,307.1333333,46.4619058
NM_001243743,FANCC,15,14,218202,4549,213653,15260.92857,303.2666667,46.96702572
NM_007001,SLC35D2,12,11,63006,1638,61368,5578.909091,136.5,37.46520147
NM_001010895,ERCC6L2,14,13,93224,4661,88563,6812.538462,332.9285714,19.00085818
NM_033331,CDC14B,14,13,119719,5603,114116,8778.153846,400.2142857,20.36694628
NM_003671,CDC14B,13,12,119719,5485,114234,9519.5,421.9230769,20.82661805
NM_014282,HABP4,8,7,41183,2673,38510,5501.428571,334.125,14.4070333
NM_001286990,SLC35D2,9,8,63006,1371,61635,7704.375,152.3333333,44.95623632
NM_001166116,TMOD1,10,9,100565,3271,97294,10810.44444,327.1,29.74442067
NM_020893,CCDC180,37,36,69669,5672,63997,1777.694444,153.2972973,11.28296897
NM_003275,TMOD1,10,9,100106,3348,96758,10750.88889,334.8,28.90023895
NM_002486,NCBP1,23,22,40326,5403,34923,1587.409091,234.9130435,6.463631316
NM_003389,CORO2A,12,11,51919,5655,46264,4205.818182,471.25,8.181078691
NM_024642,GALNT12,10,9,42384,2745,39639,4404.333333,274.5,14.44043716
NM_052820,CORO2A,12,11,71701,5505,66196,6017.818182,458.75,12.02470481
NM_005458,GABBR2,19,18,421117,5807,415310,23072.77778,305.6315789,71.51885655
NM_183245,INVS,18,17,201926,3397,198529,11678.17647,188.7222222,58.44244922
NM_001198812,MSANTD3-TMEFF1,10,9,135732,2444,133288,14809.77778,244.4,54.53682488
NM_014425,INVS,17,16,201926,3906,198020,12376.25,229.7647059,50.69636457
NM_003692,TMEFF1,10,9,104400,2496,101904,11322.66667,249.6,40.82692308
NM_133445,GRIN3A,9,8,169230,7780,161450,20181.25,864.4444444,20.75192802
NM_017753,LPPR1,8,7,140102,2330,137772,19681.71429,291.25,59.12961373
NM_001340,CYLC2,8,7,23179,2179,21000,3000,272.375,9.637448371
NM_005502,ABCA1,50,49,147245,10552,136693,2789.653061,211.04,12.95422669
NM_001079802,FKTN,11,10,82990,7467,75523,7552.3,678.8181818,10.11423597
NM_001286730,SLC44A1,16,15,152736,9666,143070,9538,604.125,14.80136561
NM_018112,TMEM38B,6,5,82088,3549,78539,15707.8,591.5,22.12989575
NM_006731,FKTN,10,9,82990,7374,75616,8401.777778,737.4,10.25440738
NM_001198963,FKTN,12,11,82990,2516,80474,7315.818182,209.6666667,31.98489666
NM_080546,SLC44A1,16,15,152736,10537,142199,9479.933333,658.5625,13.49520736
NM_001145313,FSD1L,14,13,104401,7744,96657,7435.153846,553.1428571,12.48153409
NM_001287192,FSD1L,13,12,104401,7644,96757,8063.083333,588,12.65790162
NM_001287191,FSD1L,14,13,104401,7678,96723,7440.230769,548.4285714,12.5974212
NM_021224,ZNF462,13,12,148420,8308,140112,11676,639.0769231,16.86470871
NM_032012,TMEM245,18,17,104812,8015,96797,5693.941176,445.2777778,12.07698066
NM_018424,EPB41L4B,16,15,81239,4026,77213,5147.533333,251.625,19.17858917
NM_019114,EPB41L4B,26,25,148992,5827,143165,5726.6,224.1153846,24.56924661
NM_003640,IKBKAP,37,36,66810,6151,60659,1684.972222,166.2432432,9.861648512
NM_007203,PALM2-AKAP2,11,10,392216,7529,384687,38468.7,684.4545455,51.09403639
NM_147150,PALM2-AKAP2,10,9,392216,7489,384727,42747.44444,748.9,51.37227934
NM_001037293,PALM2,7,6,310690,9272,301418,50236.33333,1324.571429,32.50841242
NM_001198656,AKAP2,5,4,123915,7007,116908,29227,1401.4,16.6844584
NM_053016,PALM2,7,6,171181,9486,161695,26949.16667,1355.142857,17.04564622
NM_001004065,AKAP2,4,3,123915,6967,116948,38982.66667,1741.75,16.7859911
NM_005592,MUSK,14,13,132229,2768,129461,9958.538462,197.7142857,46.77059249
NM_001080398,KIAA0368,51,50,124054,7442,116612,2332.24,145.9215686,15.6694437
NM_057159,LPAR1,5,4,164313,3173,161140,40285,634.6,50.7847463
NM_001401,LPAR1,4,3,164313,3094,161219,53739.66667,773.5,52.10698125
NM_001166281,MUSK,12,11,132229,2478,129751,11795.54545,206.5,52.36117837
NM_001166280,MUSK,13,12,132229,2509,129720,10810,193,51.70187326
NM_001163790,PTBP3,15,14,115951,8006,107945,7710.357143,533.7333333,13.48301274
NM_001163788,PTBP3,14,13,115951,7971,107980,8306.153846,569.3571429,13.54660645
NM_001282640,SUSD1,18,17,134518,3100,131418,7730.470588,172.2222222,42.39290323
NM_032303,HSDL2,11,10,92498,3384,89114,8911.4,307.6363636,26.33392435
NM_001195822,HSDL2,9,8,92498,3163,89335,11166.875,351.4444444,28.24375593
NM_022486,SUSD1,17,16,134518,3034,131484,8217.75,178.4705882,43.33684904
NM_003358,UGCG,9,8,36229,1640,34589,4323.625,182.2222222,21.09085366
NM_001244898,PTBP3,14,13,115313,8010,107303,8254.076923,572.1428571,13.39612984
NM_001244897,PTBP3,14,13,115951,4361,111590,8583.846154,311.5,25.58816785
NM_001244896,PTBP3,13,12,115951,7800,108151,9012.583333,600,13.86551282
NM_001017998,GNG10,3,2,8677,1258,7419,3709.5,419.3333333,5.89745628
NM_001198664,GNG10,3,2,8677,1255,7422,3711,418.3333333,5.913944223
NM_001282643,SUSD1,16,15,134516,2991,131525,8768.333333,186.9375,43.97358743
NM_005156,PTBP3,15,14,115951,7997,107954,7711,533.1333333,13.49931224
NM_004125,DNAJC25-GNG10,3,2,38896,1502,37394,18697,500.6666667,24.89613848
NM_021218,INIP,5,4,31598,1524,30074,7518.5,304.8,19.7335958
NM_001282923,RGS3,23,22,134045,4283,129762,5898.272727,186.2173913,30.29698809
NM_017790,RGS3,18,17,78393,2594,75799,4458.764706,144.1111111,29.22089437
NM_017688,BSPRY,6,5,21703,2354,19349,3869.8,392.3333333,8.219626168
NM_001012994,SNX30,9,8,124135,7615,116520,14565,846.1111111,15.30137886
NM_001859,SLC31A1,5,4,42966,4783,38183,9545.75,956.6,7.983065022
NM_144488,RGS3,26,25,153016,4624,148392,5935.68,177.8461538,32.0916955
NM_032888,COL27A1,61,60,154746,5644,149102,2485.033333,92.52459016,26.4177888
NM_001173425,DFNB31,12,11,103378,4062,99316,9028.727273,338.5,24.45002462
NM_133374,ZNF618,14,13,180315,9127,171188,13168.30769,651.9285714,18.75621782
NM_015404,DFNB31,12,11,103378,4065,99313,9028.454545,338.75,24.43124231
NM_001083885,DFNB31,12,11,101137,2901,98236,8930.545455,241.75,33.86280593
NM_002160,TNC,28,27,98684,8628,90056,3335.407407,308.1428571,10.43764488
NM_017418,Dec-01,8,7,260828,1259,259569,37081.28571,157.375,206.1707705
NM_198187,ASTN2,9,8,262040,1819,260221,32527.625,202.1111111,143.0571743
NM_198186,ASTN2,8,7,261992,2367,259625,37089.28571,295.875,109.6852556
NM_198188,ASTN2,9,8,262040,1798,260242,32530.25,199.7777778,144.7397108
NM_002581,PAPPA,22,21,248531,10992,237539,11311.38095,499.6363636,21.61017103
NM_001184735,ASTN2,5,4,76421,3514,72907,18226.75,702.8,20.7475811
NM_001184734,ASTN2,9,8,262040,1764,260276,32534.5,196,147.5487528
NM_014618,BRINP1,8,7,202833,3204,199629,28518.42857,400.5,62.30617978
NM_001011649,CDK5RAP2,37,36,191303,6041,185262,5146.166667,163.2702703,30.66743917
NM_001080497,MEGF9,6,5,113571,6216,107355,21471,1036,17.2707529
NM_001270427,PSMD5,9,8,26969,3359,23610,2951.25,373.2222222,7.028877642
NM_018249,CDK5RAP2,38,37,191303,6279,185024,5000.648649,165.2368421,29.4671126
NM_001272039,CDK5RAP2,35,34,191303,5586,185717,5462.264706,159.6,33.24686717
NM_005047,PSMD5,10,9,26969,3489,23480,2608.888889,348.9,6.729721983
NM_138709,DAB2IP,14,13,40092,3736,36356,2796.615385,266.8571429,9.731263383
NM_198194,STOM,3,2,31318,2706,28612,14306,902,10.57354028
NM_032552,DAB2IP,17,16,218430,5488,212942,13308.875,322.8235294,38.80138484
NM_001270527,STOM,6,5,31318,1263,30055,6011,210.5,23.79651623
NM_001270526,STOM,7,6,31318,3114,28204,4700.666667,444.8571429,9.057161207
NM_007018,CNTRL,42,41,89314,7473,81841,1996.121951,177.9285714,10.95155895
NM_004099,STOM,7,6,31318,3205,28113,4685.5,457.8571429,8.771606864
NM_001173512,MRRF,6,5,58862,1849,57013,11402.6,308.1666667,30.83450514
NM_199177,MRRF,5,4,52601,1508,51093,12773.25,301.6,33.88129973
NM_014222,NDUFA8,4,3,15762,847,14915,4971.666667,211.75,17.60920897
NM_138777,MRRF,7,6,58862,2006,56856,9476,286.5714286,28.34297109
NM_020946,DENND1A,22,21,550486,5063,545423,25972.52381,230.1363636,107.7272368
NM_001171137,STRBP,19,18,146949,6419,140530,7807.222222,337.8421053,21.8928182
NM_018387,STRBP,19,18,146937,6436,140501,7805.611111,338.7368421,21.83048477
NM_024820,DENND1A,21,20,528549,2153,526396,26319.8,102.5238095,244.4941941
NM_002077,GOLGA1,23,22,62815,4905,57910,2632.272727,213.2608696,11.80632008
NM_002799,PSMB7,8,7,62010,1023,60987,8712.428571,127.875,59.61583578
NM_001278546,NR6A1,10,9,254037,7062,246975,27441.66667,706.2,34.97238743
NM_033334,NR6A1,10,9,254037,7074,246963,27440.33333,707.4,34.91136556
NM_001144877,SCAI,18,17,200952,12159,188793,11105.47059,675.5,15.52701702
NM_001489,NR6A1,10,9,254037,7059,246978,27442,705.9,34.98767531
NM_173690,SCAI,19,18,200952,12229,188723,10484.61111,643.6315789,15.43241475
NM_001006620,MAPKAP1,11,10,269842,3078,266764,26676.4,279.8181818,86.66796621
NM_001006618,MAPKAP1,8,7,185766,1595,184171,26310.14286,199.375,115.4677116
NM_001006617,MAPKAP1,12,11,269842,3407,266435,24221.36364,283.9166667,78.2022307
NM_001006621,MAPKAP1,10,9,269842,2987,266855,29650.55556,298.7,89.33880147
NM_001006619,MAPKAP1,11,10,269842,3265,266577,26657.7,296.8181818,81.64686064
NM_024117,MAPKAP1,11,10,269842,3298,266544,26654.4,299.8181818,80.81989084
NM_001134778,PBX3,9,8,219179,2797,216382,27047.75,310.7777778,77.36217376
NM_006195,PBX3,9,8,220040,2883,217157,27144.625,320.3333333,75.32327437
NM_001282680,GAPVD1,28,27,103219,7040,96179,3562.185185,251.4285714,13.66178977
NM_001282679,GAPVD1,28,27,103219,7094,96125,3560.185185,253.3571429,13.55018325
NM_001190729,RALGPS1,18,17,302673,2380,300293,17664.29412,132.2222222,126.1735294
NM_001011703,MVB12B,6,5,70791,2690,68101,13620.2,448.3333333,25.31635688
NM_014636,RALGPS1,19,18,308394,6357,302037,16779.83333,334.5789474,47.5125059
NM_033446,MVB12B,10,9,180199,4834,175365,19485,483.4,36.27741001
NM_001099270,ZBTB34,2,1,25214,6565,18649,18649,3282.5,2.840670221
NM_001190730,RALGPS1,12,11,263759,1861,261898,23808.90909,155.0833333,140.7297152
NM_001190728,RALGPS1,17,16,255222,2116,253106,15819.125,124.4705882,119.6153119
NM_001131018,CIZ1,17,16,25526,2769,22757,1422.3125,162.8823529,8.21849043
NM_001131017,CIZ1,18,17,25526,2827,22699,1335.235294,157.0555556,8.029359745
NM_001131016,CIZ1,17,16,25526,3009,22517,1407.3125,177,7.483217016
NM_001131015,CIZ1,18,17,38320,2882,35438,2084.588235,160.1111111,12.296322
NM_001032221,STXBP1,19,18,80511,3860,76651,4258.388889,203.1578947,19.85777202
NM_032293,GARNL3,28,27,129074,3766,125308,4641.037037,134.5,33.27349973
NM_022833,FAM129B,14,13,63781,4005,59776,4598.153846,286.0714286,14.92534332
NM_012127,CIZ1,17,16,38320,3049,35271,2204.4375,179.3529412,11.5680551
NM_003165,STXBP1,20,19,80511,3987,76524,4027.578947,199.35,19.19337848
NM_001257975,CIZ1,18,17,26041,3180,22861,1344.764706,176.6666667,7.188993711
NM_001257976,CIZ1,16,15,25526,2892,22634,1508.933333,180.75,7.826417704
NM_001035534,FAM129B,14,13,73671,3793,69878,5375.230769,270.9285714,18.42288426
NM_175039,ST6GALNAC4,6,5,9142,1697,7445,1489,282.8333333,4.387153801
NM_175040,ST6GALNAC4,5,4,9142,1609,7533,1883.25,321.8,4.681789932
NM_001286779,GARNL3,29,28,129889,3630,126259,4509.25,125.1724138,34.78209366
NM_001195532,SPTAN1,55,54,81109,7887,73222,1355.962963,143.4,9.283884874
NM_001122672,CCBL1,12,11,48964,1787,47177,4288.818182,148.9166667,26.40011192
NM_001287390,CCBL1,15,14,49135,2502,46633,3330.928571,166.8,18.63828937
NM_013355,PKN3,22,21,18399,3399,15000,714.2857143,154.5,4.413062665
NM_003127,SPTAN1,56,55,81109,7948,73161,1330.2,141.9285714,9.204957222
NM_000755,CRAT,14,13,15999,2780,13219,1016.846154,198.5714286,4.755035971
NM_015354,NUP188,44,43,59405,5739,53666,1248.046512,130.4318182,9.351106465
NM_001122671,CCBL1,13,12,48964,1932,47032,3919.333333,148.6153846,24.3436853
NM_001130438,SPTAN1,57,56,81109,7964,73145,1306.160714,139.7192982,9.184455048
NM_001257363,CRAT,15,14,15999,2880,13119,937.0714286,192,4.555208333
NM_004059,CCBL1,13,12,48964,1938,47026,3918.833333,149.0769231,24.26522188
NM_001286797,NTMT1,4,3,15920,1505,14415,4805,376.25,9.57807309
NM_199350,C9orf50,7,6,8553,1627,6926,1154.333333,232.4285714,4.256914567
NM_015033,FNBP1,17,16,156009,5442,150567,9410.4375,320.1176471,27.66758545
NM_001286796,NTMT1,4,3,27249,1692,25557,8519,423,15.10460993
NM_004878,PTGES,3,2,14731,1790,12941,6470.5,596.6666667,7.229608939
NM_006059,LAMC3,28,27,83944,6126,77818,2882.148148,218.7857143,12.70290565
NM_007313,ABL1,11,10,173796,5892,167904,16790.4,535.6363636,28.49694501
NM_005085,NUP214,36,35,109111,7636,101475,2899.285714,212.1111111,13.28902567
NM_005312,RAPGEF1,24,23,160770,6109,154661,6724.391304,254.5416667,25.31690948
NM_198679,RAPGEF1,24,23,133074,6198,126876,5516.347826,258.25,20.47047435
NM_001253881,MED27,7,6,219779,1306,218473,36412.16667,186.5714286,167.2840735
NM_013318,PRRC2B,31,30,70100,11090,59010,1967,357.7419355,5.321009919
NM_004269,MED27,8,7,219779,1415,218364,31194.85714,176.875,154.3208481
NM_012087,GTF3C5,11,10,27830,2431,25399,2539.9,221,10.4479638
NM_207417,C9orf171,7,6,163125,1855,161270,26878.33333,265,86.93800539
NM_152572,AK8,13,12,153235,2119,151116,12593,163,71.31477112
NM_022779,DDX31,20,19,76114,3305,72809,3832.052632,165.25,22.02995461
NM_138620,DDX31,15,14,32540,2423,30117,2151.214286,161.5333333,12.42963269
NM_001122823,GTF3C5,12,11,27830,2453,25377,2307,204.4166667,10.34529148
NM_001162427,TSC1,22,21,53287,8485,44802,2133.428571,385.6818182,5.280141426
NM_001162426,TSC1,23,22,53287,8636,44651,2029.590909,375.4782609,5.170333488
NM_000368,TSC1,23,22,53287,8639,44648,2029.454545,375.6086957,5.168190763
NM_001286709,GTF3C5,9,8,27830,2010,25820,3227.5,223.3333333,12.84577114
NM_001282957,C9orf171,6,5,163125,1746,161379,32275.8,291,92.42783505
NM_007101,SARDH,21,20,76395,3398,72997,3649.85,161.8095238,21.48234255
NM_001134398,VAV2,30,29,230432,4881,225551,7777.62069,162.7,46.20999795
NM_002957,RXRA,10,9,114117,5532,108585,12065,553.2,19.62852495
NM_003371,VAV2,27,26,230432,4761,225671,8679.653846,176.3333333,47.39991598
NM_001134707,SARDH,21,20,74797,3239,71558,3577.9,154.2380952,22.09262118
NM_001278074,COL5A1,66,65,203039,8505,194534,2992.830769,128.8636364,22.8728983
NM_000093,COL5A1,66,65,203039,8505,194534,2992.830769,128.8636364,22.8728983
NM_019892,INPP5E,10,9,11191,3390,7801,866.7777778,339,2.301179941
NM_001272003,KCNT1,31,30,90964,4727,86237,2874.566667,152.483871,18.24349482
NM_144653,NACC2,6,5,88750,6905,81845,16369,1150.833333,11.85300507
NM_020822,KCNT1,31,30,90964,4799,86165,2872.166667,154.8064516,17.95478225
NM_024718,RABL6,15,14,33267,3145,30122,2151.571429,209.6666667,9.577742448
NM_001173989,RABL6,8,7,26556,1745,24811,3544.428571,218.125,14.21833811
NM_152286,PNPLA7,34,33,90583,4765,85818,2600.545455,140.1470588,18.01007345
NM_016219,MAN1B1,13,12,22262,2782,19480,1623.333333,214,7.002156722
NM_001173988,RABL6,15,14,33267,3148,30119,2151.357143,209.8666667,9.567662008
NM_001098537,PNPLA7,35,34,90583,4841,85742,2521.823529,138.3142857,17.71162983
NM_017820,EXD3,22,21,116370,2905,113465,5403.095238,132.0454545,39.05851979
NM_024757,EHMT1,27,26,217136,5134,212002,8153.923077,190.1481481,41.29372809
NM_000718,CACNA1B,46,45,246837,9836,237001,5266.688889,213.826087,24.0952623
NM_001243812,CACNA1B,46,45,246837,9649,237188,5270.844444,209.7608696,24.58161468
NM_001145527,EHMT1,16,15,165403,2723,162680,10845.33333,170.1875,59.74293059
NM_207305,FOXD4,1,0,2188,2188,NA,NA,2188,NA
NM_182905,WASH1,11,10,15230,1848,13382,1338.2,168,7.241341991
NM_152569,C9orf66,1,0,2787,2787,NA,NA,2787,NA
NM_153186,KANK1,11,10,39302,5346,33956,3395.6,486,6.351664796
NM_021240,DMRT3,2,1,14766,2182,12584,12584,1091,5.767186068
NM_006557,DMRT2,4,3,7210,2939,4271,1423.666667,734.75,1.453215379
NM_181872,DMRT2,4,3,6936,2171,4765,1588.333333,542.75,2.194841087
NM_001130865,DMRT2,6,5,7202,2380,4822,964.4,396.6666667,2.02605042
NM_001289398,SMARCA2,7,6,35945,1840,34105,5684.166667,262.8571429,18.53532609
NM_001289399,SMARCA2,8,7,35173,1828,33345,4763.571429,228.5,18.24124726
NM_001289400,SMARCA2,8,7,35169,2249,32920,4702.857143,281.125,14.63761672
NM_003383,VLDLR,19,18,32694,3655,29039,1613.277778,192.3684211,7.94500684
NM_001018056,VLDLR,18,17,32694,3570,29124,1713.176471,198.3333333,8.157983193
NM_133497,KCNV2,2,1,12513,2164,10349,10349,1082,4.782347505
NM_014878,KIAA0020,18,17,39977,2237,37740,2220,124.2777778,16.87080912
NM_004170,SLC1A1,12,11,97044,3751,93293,8481.181818,312.5833333,24.87150093
NM_001039395,SPATA6L,11,10,68360,3757,64603,6460.3,341.5454545,17.19536865
NM_017913,CDC37L1,7,6,27030,1705,25325,4220.833333,243.5714286,14.85337243
NM_203453,PPAPDC2,1,0,2980,2980,NA,NA,2980,NA
NM_002195,INSL4,2,1,2550,617,1933,1933,308.5,3.132901135
NM_007179,INSL6,2,1,21757,710,21047,21047,355,29.64366197
NM_134441,RLN2,2,1,4747,823,3924,3924,411.5,4.767922236
NM_005059,RLN2,3,2,4747,925,3822,1911,308.3333333,4.131891892
NM_006911,RLN1,2,1,4943,1006,3937,3937,503,3.913518887
NM_001267706,CD274,6,5,20066,3350,16716,3343.2,558.3333333,4.989850746
NM_014143,CD274,7,6,20066,3693,16373,2728.833333,527.5714286,4.433522881
NM_025239,PDCD1LG2,7,6,60739,2425,58314,9719,346.4285714,24.04701031
NM_024896,ERMP1,15,14,48511,5356,43155,3082.5,357.0666667,8.057318895
NM_001243202,RANBP6,2,1,4623,3568,1055,1055,1784,0.295683857
NM_001017969,KIAA2026,8,7,88997,7212,81785,11683.57143,901.5,11.34012757
NM_012416,RANBP6,1,0,4623,4623,NA,NA,4623,NA
NM_001243203,RANBP6,2,1,4623,3509,1114,1114,1754.5,0.317469364
NM_033439,IL33,8,7,42199,2714,39485,5640.714286,339.25,14.5486367
NM_001199641,IL33,5,4,42199,2333,39866,9966.5,466.6,17.0878697
NM_001199640,IL33,7,6,42199,2587,39612,6602,369.5714286,15.31194434
NM_033516,TPD52L3,1,0,2571,2571,NA,NA,2571,NA
NM_001001875,TPD52L3,2,1,2571,1353,1218,1218,676.5,0.900221729
NM_001001874,TPD52L3,2,1,3553,1541,2012,2012,770.5,1.305645685
NM_033428,TMEM261,2,1,3310,2488,822,822,1244,0.330385852
NM_000550,TYRP1,8,7,16882,2884,13998,1999.714286,360.5,4.853675451
NM_203403,LURAP1L,2,1,48049,2692,45357,45357,1346,16.84881129
NM_001177704,FREM1,14,13,44869,4981,39888,3068.307692,355.7857143,8.008030516
NM_005454,CER1,2,1,2985,1207,1778,1778,603.5,1.473073737
NM_001039697,SNAPC3,9,8,38847,3104,35743,4467.875,344.8888889,11.51514175
NM_021144,PSIP1,10,9,39647,1676,37971,4219,167.6,22.65572792
NM_001286985,CNTLN,3,2,33573,2083,31490,15745,694.3333333,15.11761882
NM_001286984,CNTLN,3,2,33573,2272,31301,15650.5,757.3333333,13.77684859
NM_001122,PLIN2,8,7,11847,2019,9828,1404,252.375,4.867756315
NM_006570,RRAGA,1,0,1651,1651,NA,NA,1651,NA
NM_017645,HAUS6,17,16,49807,6382,43425,2714.0625,375.4117647,6.804293325
NM_001270890,HAUS6,17,16,49807,6277,43530,2720.625,369.2352941,6.934841485
NM_001010,RPS6,6,5,3983,835,3148,629.6,139.1666667,3.77005988
NM_001010887,ACER2,6,5,43577,2858,40719,8143.8,476.3333333,14.24737579
NM_001010915,PTPLAD2,7,6,25272,1423,23849,3974.833333,203.2857143,16.75966268
NM_002176,IFNB1,1,0,841,841,NA,NA,841,NA
NM_002177,IFNW1,1,0,1515,1515,NA,NA,1515,NA
NM_002173,IFNA16,1,0,940,940,NA,NA,940,NA
NM_002175,IFNA21,1,0,1025,1025,NA,NA,1025,NA
NM_021268,IFNA17,1,0,981,981,NA,NA,981,NA
NM_002171,IFNA10,1,0,964,964,NA,NA,964,NA
NM_021068,IFNA4,1,0,982,982,NA,NA,982,NA
NM_021057,IFNA7,1,0,738,738,NA,NA,738,NA
NM_002172,IFNA14,1,0,779,779,NA,NA,779,NA
NM_002169,IFNA5,1,0,701,701,NA,NA,701,NA
NM_018847,KLHL9,1,0,4413,4413,NA,NA,4413,NA
NM_021002,IFNA6,1,0,571,571,NA,NA,571,NA
NM_002170,IFNA8,1,0,1040,1040,NA,NA,1040,NA
NM_000605,IFNA2,1,0,1144,1144,NA,NA,1144,NA
NM_024013,IFNA1,1,0,864,864,NA,NA,864,NA
NM_006900,IFNA13,1,0,706,706,NA,NA,706,NA
NM_176891,IFNE,1,0,1475,1475,NA,NA,1475,NA
NM_002451,MTAP,8,7,63336,4929,58407,8343.857143,616.125,11.84966525
NM_001195132,CDKN2A,4,3,7383,1455,5928,1976,363.75,4.074226804
NM_058197,CDKN2A,3,2,7077,1225,5852,2926,408.3333333,4.777142857
NM_058195,CDKN2A,3,2,26741,1154,25587,12793.5,384.6666667,22.17244367
NM_078487,CDKN2B,2,1,6412,3986,2426,2426,1993,0.608630206
NM_000077,CDKN2A,3,2,7383,1257,6126,3063,419,4.873508353
NM_004936,CDKN2B,2,1,6412,3863,2549,2549,1931.5,0.659849858
NM_022160,DMRTA1,2,1,5634,2304,3330,3330,1152,1.4453125
NM_001271706,IZUMO3,6,5,2463,749,1714,342.8,124.8333333,2.288384513
NM_001004125,TUSC1,1,0,2471,2471,NA,NA,2471,NA
NM_001031689,PLAA,14,13,44102,4968,39134,3010.307692,354.8571429,7.877214171
NM_001161585,EQTN,7,6,12485,956,11529,1921.5,136.5714286,12.05962343
NM_020641,EQTN,8,7,12485,1044,11441,1634.428571,130.5,10.95881226
NM_018325,C9orf72,11,10,26950,3255,23695,2369.5,295.9090909,7.279569892
NM_145005,C9orf72,5,4,13367,1878,11489,2872.25,375.6,6.117678381
NM_001256054,C9orf72,11,10,27323,3350,23973,2397.3,304.5454545,7.156119403
NM_002197,ACO1,21,20,66233,3569,62664,3133.2,169.952381,17.55785934
NM_001278352,ACO1,22,21,66233,3642,62591,2980.52381,165.5454545,17.18588688
NM_182739,NDUFB6,3,2,19660,819,18841,9420.5,273,23.004884
NM_002493,NDUFB6,4,3,19660,865,18795,6265,216.25,21.7283237
NM_005802,TOPORS,3,2,12086,4176,7910,3955,1392,1.894157088
NM_001199987,NDUFB6,3,2,19660,771,18889,9444.5,257,24.49935149
NM_153809,TAF1L,1,0,6217,6217,NA,NA,6217,NA
NM_001195622,TOPORS,2,1,12086,3980,8106,8106,1990,2.036683417
NM_212558,TMEM215,2,1,5704,5385,319,319,2692.5,0.059238626
NM_001195249,APTX,8,7,28972,2177,26795,3827.857143,272.125,12.30822232
NM_001195248,APTX,8,7,29037,2008,27029,3861.285714,251,13.46065737
NM_001195252,APTX,8,7,29037,1792,27245,3892.142857,224,15.20368304
NM_001195254,APTX,7,6,29008,1867,27141,4523.5,266.7142857,14.5372255
NM_001195250,APTX,7,6,29037,1845,27192,4532,263.5714286,14.73821138
NM_001195251,APTX,9,8,29037,2151,26886,3360.75,239,12.49930265
NM_175069,APTX,8,7,29037,2044,26993,3856.142857,255.5,13.20596869
NM_175073,APTX,9,8,29037,2115,26922,3365.25,235,12.72907801
NM_018225,SMU1,12,11,34866,7103,27763,2523.909091,591.9166667,3.908630156
NM_001172415,BAG1,7,6,12291,3879,8412,1402,554.1428571,2.168600155
NM_001195536,CHMP5,7,6,17192,1964,15228,2538,280.5714286,7.753564155
NM_014471,SPINK4,4,3,8371,372,7999,2666.333333,93,21.50268817
NM_016410,CHMP5,8,7,17192,2078,15114,2159.142857,259.75,7.27333975
NM_004323,BAG1,7,6,12291,3879,8412,1402,554.1428571,2.168600155
NM_001170,AQP7,8,7,17571,1264,16307,2329.571429,158,12.90110759
NM_139235,NOL6,16,15,12592,3528,9064,604.2666667,220.5,2.569160998
NM_022917,NOL6,26,25,12592,4879,7713,308.52,187.6538462,1.580856733
NM_004925,AQP3,6,5,6481,1877,4604,920.8,312.8333333,2.452850293
NM_001197098,PRSS3,5,4,48412,792,47620,11905,158.4,60.12626263
NM_001197097,PRSS3,6,5,48767,1151,47616,9523.2,191.8333333,41.36924414
NM_007343,PRSS3,5,4,48767,1022,47745,11936.25,204.4,46.71722114
NM_002771,PRSS3,5,4,3672,813,2859,714.75,162.6,3.516605166
NM_001282530,UBAP2,13,12,12673,2526,10147,845.5833333,194.3076923,4.017022961
NM_017811,UBE2R2,5,4,103221,4462,98759,24689.75,892.4,22.13334827
NM_015397,DCAF12,9,8,40392,3680,36712,4589,408.8888889,9.976086957
NM_194313,KIF24,13,12,76822,6240,70582,5881.833333,480,11.31121795
NM_020702,KIAA1161,2,1,7989,4204,3785,3785,2102,0.900333016
NM_032596,C9orf24,7,6,18834,1177,17657,2942.833333,168.1428571,15.00169924
NM_147202,FAM219A,6,5,60388,3600,56788,11357.6,600,15.77444444
NM_147169,C9orf24,4,3,2583,562,2021,673.6666667,140.5,3.596085409
NM_147168,C9orf24,4,3,2583,716,1867,622.3333333,179,2.607541899
NM_001252195,C9orf24,5,4,2583,641,1942,485.5,128.2,3.029641186
NM_001184945,FAM219A,6,5,60388,3564,56824,11364.8,594,15.94388328
NM_001184943,FAM219A,6,5,60388,3597,56791,11358.2,599.5,15.78843481
NM_001184942,FAM219A,6,5,60388,3615,56773,11354.6,602.5,15.70484094
NM_001184941,FAM219A,6,5,60388,3648,56740,11348,608,15.55372807
NM_001184940,FAM219A,6,5,60388,3651,56737,11347.4,608.5,15.54012599
NM_198573,ENHO,2,1,1999,1080,919,919,540,0.850925926
NM_147164,CNTFR,10,9,38307,2062,36245,4027.222222,206.2,17.57759457
NM_001207011,CNTFR,10,9,38710,1938,36772,4085.777778,193.8,18.97420021
NM_001842,CNTFR,9,8,38307,1950,36357,4544.625,216.6666667,18.64461538
NM_001142784,IL11RA,13,12,9718,1734,7984,665.3333333,133.3846154,4.60438293
NM_006664,CCL27,3,2,798,449,349,174.5,149.6666667,0.777282851
NM_001282209,SIGMAR1,3,2,3106,1574,1532,766,524.6666667,0.973316391
NM_001282207,SIGMAR1,4,3,3106,1655,1451,483.6666667,413.75,0.87673716
NM_001282208,SIGMAR1,4,3,3106,1738,1368,456,434.5,0.787111623
NM_001282206,SIGMAR1,4,3,3106,1668,1438,479.3333333,417,0.862110312
NM_001282205,SIGMAR1,4,3,3106,1497,1609,536.3333333,374.25,1.074816299
NM_001281427,DCTN3,6,5,6980,833,6147,1229.4,138.8333333,7.379351741
NM_001281426,DCTN3,7,6,6980,895,6085,1014.166667,127.8571429,6.798882682
NM_001281425,DCTN3,6,5,6980,779,6201,1240.2,129.8333333,7.960205392
NM_001258332,GALT,9,8,4011,1289,2722,340.25,143.2222222,2.111714507
NM_006274,CCL19,4,3,1709,688,1021,340.3333333,172,1.484011628
NM_007234,DCTN3,7,6,6980,864,6116,1019.333333,123.4285714,7.078703704
NM_147157,SIGMAR1,3,2,3106,1621,1485,742.5,540.3333333,0.916101172
NM_148179,RPP25L,2,1,1630,1104,526,526,552,0.476449275
NM_148178,RPP25L,2,1,1630,900,730,730,450,0.811111111
NM_002989,CCL21,4,3,1164,899,265,88.33333333,224.75,0.294771969
NM_001017363,ARID3C,7,6,6558,1246,5312,885.3333333,178,4.263242376
NM_024348,DCTN3,7,6,6980,961,6019,1003.166667,137.2857143,6.26326743
NM_001141917,FAM205A,4,3,6487,4302,2185,728.3333333,1075.5,0.507903301
NM_000155,GALT,11,10,4011,1416,2595,259.5,128.7272727,1.832627119
NM_005866,SIGMAR1,4,3,3106,1715,1391,463.6666667,428.75,0.811078717
NM_015297,KIAA1045,8,7,24351,5855,18496,2642.285714,731.875,3.159009394
NM_001040411,C9orf131,2,1,4898,3195,1703,1703,1597.5,0.533020344
NM_001040410,C9orf131,2,1,3785,3306,479,479,1653,0.144888082
NM_001201484,PIGO,13,12,7863,2930,4933,411.0833333,225.3846154,1.683617747
NM_025182,FAM214B,9,8,11777,3037,8740,1092.5,337.4444444,2.877839974
NM_001040412,C9orf131,3,2,4898,3271,1627,813.5,1090.333333,0.497401406
NM_032634,PIGO,11,10,7863,4081,3782,378.2,371,0.926733644
NM_007126,VCP,17,16,16676,3876,12800,800,228,3.302373581
NM_152850,PIGO,12,11,7915,2477,5438,494.3636364,206.4166667,2.195397658
NM_013442,STOML2,10,9,3421,1441,1980,220,144.1,1.374045802
NM_203299,C9orf131,2,1,3785,3411,374,374,1705.5,0.109645265
NM_004629,FANCG,14,13,6180,2645,3535,271.9230769,188.9285714,1.336483932
NM_001287032,STOML2,10,9,3421,1330,2091,232.3333333,133,1.572180451
NM_001287391,C9orf131,2,1,3521,3227,294,294,1613.5,0.091106291
NM_001287033,STOML2,9,8,3421,1302,2119,264.875,144.6666667,1.62749616
NM_001287031,STOML2,9,8,3421,1305,2116,264.5,145,1.621455939
NM_006285,TESK1,10,9,4759,2526,2233,248.1111111,252.6,0.884006334
NM_001782,CD72,9,8,8450,1557,6893,861.625,173,4.427103404
NM_001135999,RUSC2,12,11,23268,5648,17620,1601.818182,470.6666667,3.119688385
NM_014450,SIT1,5,4,1652,1241,411,102.75,248.2,0.331184529
NM_001164310,FAM166B,6,5,2071,1082,989,197.8,180.3333333,0.914048059
NM_001099951,FAM166B,6,5,2071,1014,1057,211.4,169,1.042406312
NM_001287238,FAM166B,6,5,2071,1046,1025,205,174.3333333,0.979923518
NM_001287239,FAM166B,6,5,2071,1036,1035,207,172.6666667,0.999034749
NM_006368,CREB3,9,8,4690,1860,2830,353.75,206.6666667,1.521505376
NM_001195201,CCDC107,6,5,3215,1163,2052,410.4,193.8333333,1.764402408
NM_032818,ARHGEF39,9,8,5939,3772,2167,270.875,419.1111111,0.574496288
NM_001195217,CCDC107,5,4,3215,1235,1980,495,247,1.603238866
NM_006289,TLN1,57,56,35060,8491,26569,474.4464286,148.9649123,3.129077847
NM_003289,TPM2,9,8,7132,1336,5796,724.5,148.4444444,4.338323353
NM_213674,TPM2,9,8,8065,1191,6874,859.25,132.3333333,5.771620487
NM_001216,CA9,11,10,7241,1565,5676,567.6,142.2727273,3.626837061
NM_020944,GBA2,17,16,12364,3628,8736,546,213.4117647,2.407938258
NM_001195200,CCDC107,6,5,3215,1183,2032,406.4,197.1666667,1.717666948
NM_001044264,MSMP,3,2,1288,680,608,304,226.6666667,0.894117647
NM_001080496,RGP1,9,8,3989,1726,2263,282.875,191.7777778,1.311123986
NM_174923,CCDC107,5,4,3215,1263,1952,488,252.6,1.545526524
NM_001042590,TMEM8B,13,12,25351,3745,21606,1800.5,288.0769231,5.76929239
NM_001042589,TMEM8B,14,13,25624,3462,22162,1704.769231,247.2857143,6.401502022
NM_032593,HINT2,5,4,2087,657,1430,357.5,131.4,2.176560122
NM_001039792,HRCT1,1,0,951,951,NA,NA,951,NA
NM_001012446,FAM221B,7,6,11732,2953,8779,1463.166667,421.8571429,2.972908906
NM_001039592,SPAG8,7,6,2454,1708,746,124.3333333,244,0.43676815
NM_016446,TMEM8B,11,10,18012,2164,15848,1584.8,196.7272727,7.323475046
NM_003995,NPR2,22,21,17324,3452,13872,660.5714286,156.9090909,4.018539977
NM_172312,SPAG8,8,7,4479,2017,2462,351.7142857,252.125,1.22062469
NM_001004487,OR13J1,1,0,940,940,NA,NA,940,NA
NM_019897,OR2S2,1,0,1048,1048,NA,NA,1048,NA
NM_005893,CCIN,1,0,1944,1944,NA,NA,1944,NA
NM_022343,GLIPR2,5,4,27379,2104,25275,6318.75,420.8,12.0128327
NM_001287014,GLIPR2,2,1,27130,1647,25483,25483,823.5,15.47237401
NM_001287010,GLIPR2,4,3,27379,2025,25354,8451.333333,506.25,12.52049383
NM_001287013,GLIPR2,5,4,27130,1941,25189,6297.25,388.2,12.97733127
NM_001287012,GLIPR2,3,2,27379,1920,25459,12729.5,640,13.25989583
NM_001287011,GLIPR2,5,4,27379,2234,25145,6286.25,446.8,11.25559534
NM_001190383,GNE,11,10,44059,5102,38957,3895.7,463.8181818,7.635633085
NM_007096,CLTA,7,6,21208,1243,19965,3327.5,177.5714286,16.0619469
NM_001184760,CLTA,6,5,21208,1188,20020,4004,198,16.85185185
NM_001076677,CLTA,6,5,21208,1206,20002,4000.4,201,16.5854063
NM_001184762,CLTA,3,2,21208,993,20215,10107.5,331,20.35750252
NM_001184761,CLTA,5,4,21208,1146,20062,5015.5,229.2,17.5061082
NM_001833,CLTA,5,4,21208,1151,20057,5014.25,230.2,17.42571677
NM_001128227,GNE,12,11,62616,5309,57307,5209.727273,442.4166667,10.79431155
NM_001190388,GNE,11,10,62616,5102,57514,5751.4,463.8181818,11.27283418
NM_001190384,GNE,10,9,44059,4964,39095,4343.888889,496.4,7.875705077
NM_005476,GNE,12,11,44059,5325,38734,3521.272727,443.75,7.27399061
NM_194332,RNF38,11,10,64523,5117,59406,5940.6,465.1818182,11.60953684
NM_194330,RNF38,12,11,64798,4999,59799,5436.272727,416.5833333,11.96219244
NM_194328,RNF38,12,11,64523,5268,59255,5386.818182,439,11.24810175
NM_022781,RNF38,12,11,63899,5101,58798,5345.272727,425.0833333,11.52675946
NM_194329,RNF38,11,10,63899,4950,58949,5894.9,450,11.90888889
NM_014791,MELK,18,17,104823,2504,102319,6018.764706,139.1111111,40.86222045
NM_001256693,MELK,16,15,104823,2316,102507,6833.8,144.75,44.26036269
NM_001256692,MELK,15,14,104823,2175,102648,7332,145,47.19448276
NM_001256691,MELK,16,15,104823,2272,102551,6836.733333,142,45.1368838
NM_001256690,MELK,16,15,104823,2299,102524,6834.933333,143.6875,44.59504132
NM_001256689,MELK,17,16,104823,2417,102406,6400.375,142.1764706,42.36905254
NM_001256688,MELK,16,15,104823,2289,102534,6835.6,143.0625,44.79423329
NM_001256687,MELK,17,16,104823,2359,102464,6404,138.7647059,43.43535396
NM_001256685,MELK,17,16,104823,2380,102443,6402.6875,140,43.04327731
NM_012203,GRHPR,9,8,14281,1244,13037,1629.625,138.2222222,10.47990354
NM_014872,ZBTB5,2,1,27309,4651,22658,22658,2325.5,4.871640507
NM_001001790,TOMM5,2,1,4226,748,3478,3478,374,4.64973262
NM_012166,FBXO10,11,10,65363,4586,60777,6077.7,416.9090909,13.25272569
NM_001134485,TOMM5,2,1,4226,850,3376,3376,425,3.971764706
NM_001134484,TOMM5,2,1,4226,907,3319,3319,453.5,3.659316428
NM_014907,FRMPD1,16,15,95851,4932,90919,6061.266667,308.25,18.43450933
NM_001286951,TRMT10B,8,7,25171,2194,22977,3282.428571,274.25,10.47265269
NM_001286950,TRMT10B,8,7,25171,2123,23048,3292.571429,265.375,10.85633537
NM_001286810,DCAF10,7,6,67116,7402,59714,9952.333333,1057.428571,8.067279114
NM_144964,TRMT10B,9,8,25171,2304,22867,2858.375,256,9.924913194
NM_016042,EXOSC3,4,3,5380,1845,3535,1178.333333,461.25,1.91598916
NM_024345,DCAF10,7,6,66884,7928,58956,9826,1132.571429,7.436427851
NM_001286952,TRMT10B,7,6,25171,2041,23130,3855,291.5714286,11.33268006
NM_001286953,TRMT10B,7,6,25171,2030,23141,3856.833333,290,11.39950739
NM_001286954,TRMT10B,8,7,25171,2119,23052,3293.142857,264.875,10.87871638
NM_001002269,EXOSC3,3,2,5380,1692,3688,1844,564,2.179669031
NM_033412,SLC25A51,3,2,16758,1407,15351,7675.5,469,10.91044776
NM_000692,ALDH1B1,2,1,6003,3072,2931,2931,1536,0.954101563
NM_001007563,IGFBPL1,5,4,17921,3564,14357,3589.25,712.8,4.028338945
NM_147195,ANKRD18A,16,15,49001,3754,45247,3016.466667,234.625,12.05301012
NM_001040065,SPATA31A2,4,3,6262,4230,2032,677.3333333,1057.5,0.480378251
NM_001085452,SPATA31A1,4,3,6259,4227,2032,677.3333333,1056.75,0.480719186
NM_001040065,SPATA31A2,4,3,6237,4230,2007,669,1057.5,0.474468085
NM_001085452,SPATA31A1,4,3,6234,4227,2007,669,1056.75,0.474804826
NM_001083124,SPATA31A3,4,3,6248,4227,2021,673.6666667,1056.75,0.478116868
NM_033160,ZNF658,5,4,20712,4030,16682,4170.5,806,4.139454094
NM_001113541,SPATA31A5,4,3,6259,4230,2029,676.3333333,1057.5,0.479669031
NM_001242613,SPATA31A4,4,3,6292,4263,2029,676.3333333,1065.75,0.4759559
NM_015667,SPATA31A7,4,3,6256,4227,2029,676.3333333,1056.75,0.480009463
NM_015667,SPATA31A7,4,3,6245,4227,2018,672.6666667,1056.75,0.477407145
NM_001113541,SPATA31A5,4,3,6248,4230,2018,672.6666667,1057.5,0.477068558
NM_001012419,ANKRD20A3,15,14,43528,3945,39583,2827.357143,263,10.03371356
NM_001012421,ANKRD20A2,15,14,43109,3526,39583,2827.357143,235.0666667,11.22603517
NM_199244,FOXD4L4,1,0,3110,3110,NA,NA,3110,NA
NM_001099279,FOXD4L2,1,0,3110,3110,NA,NA,3110,NA
NM_001145196,SPATA31A6,4,3,6230,4218,2012,670.6666667,1054.5,0.477003319
NM_015667,SPATA31A7,4,3,6246,4227,2019,673,1056.75,0.477643719
NM_001113541,SPATA31A5,4,3,6249,4230,2019,673,1057.5,0.477304965
NM_032250,ANKRD20A1,15,14,43081,3526,39555,2825.357143,235.0666667,11.21809416
NM_001012419,ANKRD20A3,15,14,43500,3945,39555,2825.357143,263,10.02661597
NM_001085476,FOXD4L6,1,0,2726,2726,NA,NA,2726,NA
NM_001286836,CBWD5,3,2,5998,643,5355,2677.5,214.3333333,8.3281493
NM_001098805,ANKRD20A4,15,14,43130,3532,39598,2828.428571,235.4666667,11.21121178
NM_001126334,FOXD4L5,1,0,3110,3110,NA,NA,3110,NA
NM_001024916,CBWD5,13,12,58209,1625,56584,4715.333333,125,34.82092308
NM_001286835,CBWD5,17,16,58209,2881,55328,3458,169.4705882,19.2044429
NM_201453,CBWD3,15,14,58179,1741,56438,4031.285714,116.0666667,32.41700172
NM_199244,FOXD4L4,1,0,3110,3110,NA,NA,3110,NA
NM_001099279,FOXD4L2,1,0,3110,3110,NA,NA,3110,NA
NM_001286836,CBWD5,3,2,5997,643,5354,2677,214.3333333,8.32659409
NM_001286836,CBWD5,3,2,5981,643,5338,2669,214.3333333,8.301710731
NM_199135,FOXD4L3,1,0,2219,2219,NA,NA,2219,NA
NM_153237,TMEM252,2,1,4287,1245,3042,3042,622.5,2.443373494
NM_138333,FAM122A,1,0,3647,3647,NA,NA,3647,NA
NM_000144,FXN,5,4,43516,7173,36343,9085.75,1434.6,5.066638784
NM_002732,PRKACG,1,0,1592,1592,NA,NA,1592,NA
NM_181425,FXN,5,4,43516,7181,36335,9083.75,1436.2,5.05988024
NM_001025780,ABHD17B,4,3,46082,3108,42974,14324.66667,777,13.82689833
NM_016014,ABHD17B,5,4,48782,1618,47164,11791,323.6,29.14956737
NM_001128618,C9orf57,5,4,9226,1502,7724,1931,300.4,5.142476698
NM_000689,ALDH1A1,13,12,52657,2382,50275,4189.583333,183.2307692,21.10621327
NM_000700,ANXA1,13,12,18528,1412,17116,1426.333333,108.6153846,12.12181303
NM_017998,C9orf40,2,1,6305,2327,3978,3978,1163.5,1.709497207
NM_001127603,NMRK1,8,7,27019,1129,25890,3698.571429,141.125,22.93179805
NM_152420,C9orf41,8,7,45439,2201,43238,6176.857143,275.125,19.64470695
NM_017881,NMRK1,9,8,27019,1202,25817,3227.125,133.5555556,21.47836938
NM_018339,RFK,4,3,9013,2711,6302,2100.666667,677.75,2.324603467
NM_001097635,GCNT1,3,2,29077,5517,23560,11780,1839,4.270436832
NM_001097634,GCNT1,3,2,65752,5977,59775,29887.5,1992.333333,10.00083654
NM_001490,GCNT1,4,3,48266,5600,42666,14222,1400,7.618928571
NM_001097636,GCNT1,2,1,6785,5609,1176,1176,2804.5,0.209663042
NM_001097633,GCNT1,3,2,48266,5481,42785,21392.5,1827,7.806057289
NM_001013735,FOXB2,1,0,1300,1300,NA,NA,1300,NA
NM_021154,PSAT1,8,7,33020,2126,30894,4413.428571,265.75,14.53151458
NM_058179,PSAT1,9,8,33020,2265,30755,3844.375,251.6666667,13.57836645
NM_207416,SPATA31D3,4,3,6596,4931,1665,555,1232.75,0.337659704
NM_001145197,SPATA31D4,4,3,6572,4927,1645,548.3333333,1231.75,0.333874569
NM_001001670,SPATA31D1,4,3,6486,4837,1649,549.6666667,1209.25,0.34091379
NM_152573,RASEF,17,16,83545,5593,77952,4872,329,13.93742178
NM_001244962,FRMD3,3,2,24299,967,23332,11666,322.3333333,24.12823164
NM_001244961,FRMD3,10,9,88973,1407,87566,9729.555556,140.7,62.23596304
NM_013438,UBQLN1,11,10,48292,4179,44113,4411.3,379.9090909,10.55587461
NM_053067,UBQLN1,10,9,48292,4094,44198,4910.888889,409.4,10.79579873
NM_024945,RMI1,3,2,23352,3497,19855,9927.5,1165.666667,5.677723763
NM_002140,HNRNPK,17,16,12573,2995,9578,598.625,176.1764706,3.197996661
NM_031263,HNRNPK,17,16,12188,2960,9228,576.75,174.1176471,3.117567568
NM_031262,HNRNPK,17,16,12573,2935,9638,602.375,172.6470588,3.283816014
NM_032307,C9orf64,4,3,18438,2477,15961,5320.333333,619.25,6.443681873
NM_016548,GOLM1,10,9,73454,3096,70358,7817.555556,309.6,22.7254522
NM_177937,GOLM1,10,9,74060,3088,70972,7885.777778,308.8,22.98316062
NM_024617,ZCCHC6,27,26,66756,5707,61049,2348.038462,211.3703704,10.69721395
NM_030940,ISCA1,4,3,18029,2006,16023,5341,501.5,7.987537388
NM_001185059,ZCCHC6,27,26,66756,5597,61159,2352.269231,207.2962963,10.92710381
NM_001185074,ZCCHC6,20,19,66756,4992,61764,3250.736842,249.6,12.37259615
NM_002048,GAS1,1,0,2829,2829,NA,NA,2829,NA
NM_001001709,C9orf170,2,1,11084,3411,7673,7673,1705.5,2.249486954
NM_145918,CTSL,8,7,5412,1577,3835,547.8571429,197.125,2.431832594
NM_001912,CTSL,8,7,5412,1722,3690,527.1428571,215.25,2.142857143
NM_001257973,CTSL,6,5,5412,1145,4267,853.4,190.8333333,3.726637555
NM_001257971,CTSL,8,7,5412,1632,3780,540,204,2.316176471
NM_001257972,CTSL,8,7,5412,1573,3839,548.4285714,196.625,2.440559441
NM_178828,SPATA31E1,4,3,6044,4451,1593,531,1112.75,0.357897102
NM_001145124,SPATA31C1,4,3,5697,3783,1914,638,945.75,0.505947661
NM_001039803,CDK20,8,7,8338,2401,5937,848.1428571,300.125,2.4727197
NM_012119,CDK20,7,6,8338,2337,6001,1000.166667,333.8571429,2.567821994
NM_178432,CDK20,7,6,8338,2376,5962,993.6666667,339.4285714,2.509259259
NM_001170640,CDK20,6,5,8338,2212,6126,1225.2,368.6666667,2.769439421
NM_001170639,CDK20,7,6,8338,2309,6029,1004.833333,329.8571429,2.611087051
NM_001166137,SPATA31C2,4,3,5682,3765,1917,639,941.25,0.509163347
NM_006717,SPIN1,6,5,90327,4540,85787,17157.4,756.6666667,18.89581498
NM_145283,NXNL2,3,2,40690,1464,39226,19613,488,26.79371585
NM_001161625,NXNL2,2,1,9448,807,8641,8641,403.5,10.70755886
NM_001100111,RP13-60M5.2,2,1,4983,684,4299,4299,342,6.285087719
NM_001142413,C9orf47,3,2,5281,4842,439,219.5,1614,0.090665014
NM_001001938,C9orf47,3,2,5281,4899,382,191,1633,0.077975097
NM_024077,SECISBP2,17,16,41192,3525,37667,2354.1875,207.3529412,10.68567376
NM_001827,CKS2,3,2,5507,616,4891,2445.5,205.3333333,7.939935065
NM_001282690,SECISBP2,17,16,40814,3602,37212,2325.75,211.8823529,10.33092726
NM_001282689,SECISBP2,17,16,41192,3404,37788,2361.75,200.2352941,11.10105758
NM_001282688,SECISBP2,17,16,41192,3522,37670,2354.375,207.1764706,10.69562748
NM_006705,GADD45G,4,3,1544,1069,475,158.3333333,267.25,0.444340505
NM_017594,DIRAS2,2,1,32996,4109,28887,28887,2054.5,7.030177659
NM_001174167,SYK,14,13,71139,5080,66059,5081.461538,362.8571429,13.00374016
NM_005384,NFIL3,2,1,14819,2087,12732,12732,1043.5,6.100622904
NM_001281303,SPTLC1,15,14,84342,2840,81502,5821.571429,189.3333333,28.69788732
NM_006415,SPTLC1,15,14,84342,2872,81470,5819.285714,191.4666667,28.36699164
NM_178324,SPTLC1,6,5,36415,1043,35372,7074.4,173.8333333,33.91371045
NM_017948,NOL8,17,16,28238,4336,23902,1493.875,255.0588235,5.512453875
NM_001256394,NOL8,18,17,28238,4441,23797,1399.823529,246.7222222,5.35847782
NM_017680,ASPN,8,7,26357,2532,23825,3403.571429,316.5,9.409557662
NM_001193335,ASPN,6,5,26357,2297,24060,4812,382.8333333,10.474532
NM_005014,OMD,3,2,10311,2545,7766,3883,848.3333333,3.051473477
NM_001286971,CENPP,4,3,14900,2565,12335,4111.666667,641.25,4.808966862
NM_015250,BICD2,8,7,53440,4633,48807,6972.428571,579.125,10.53464278
NM_001003800,BICD2,7,6,53440,6423,47017,7836.166667,917.5714286,7.320099642
NM_031486,ZNF484,5,4,33009,3940,29069,7267.25,788,7.377918782
NM_001261460,ZNF484,6,5,33009,3967,29042,5808.4,661.1666667,7.320897404
NM_001261459,ZNF484,6,5,33009,4037,28972,5794.4,672.8333333,7.176616299
NM_001261458,ZNF484,4,3,33009,3964,29045,9681.666667,991,7.327194753
NM_001007101,ZNF484,4,3,33009,3894,29115,9705,973.5,7.476887519
NM_033086,FGD3,18,17,61802,3371,58431,3437.117647,187.2777778,17.33343222
NM_001083536,FGD3,18,17,88919,3471,85448,5026.352941,192.8333333,24.61768943
NM_001286993,FGD3,18,17,72277,3450,68827,4048.647059,191.6666667,19.94985507
NM_032310,C9orf89,6,5,17117,912,16205,3241,152,17.76864035
NM_004148,NINJ1,4,3,12801,1285,11516,3838.666667,321.25,8.961867704
NM_145006,SUSD3,5,4,26450,1217,25233,6308.25,243.4,20.73377157
NM_001287006,SUSD3,4,3,26450,1084,25366,8455.333333,271,23.400369
NM_001287008,SUSD3,4,3,26450,1027,25423,8474.333333,256.75,24.75462512
NM_001287007,SUSD3,3,2,26450,894,25556,12778,298,28.58612975
NM_001287005,SUSD3,6,5,26450,1332,25118,5023.6,222,18.85735736
NM_001098808,C9orf129,5,4,28217,1159,27058,6764.5,231.8,23.34598792
NM_198841,FAM120AOS,3,2,7094,2768,4326,2163,922.6666667,1.562861272
NM_001286724,FAM120A,9,8,79712,3789,75923,9490.375,421,20.03774083
NM_001286723,FAM120A,10,9,80895,2399,78496,8721.777778,239.9,32.72030013
NM_001286722,FAM120A,18,17,114421,5167,109254,6426.705882,287.0555556,21.14457132
NM_014612,FAM120A,18,17,114421,5170,109251,6426.529412,287.2222222,21.13172147
NM_005392,PHF2,22,21,102962,5371,97591,4647.190476,244.1363636,18.16998697
NM_021570,BARX1,4,3,3701,1486,2215,738.3333333,371.5,1.490578735
NM_017561,NUTM2F,7,6,10450,2568,7882,1313.666667,366.8571429,3.069314642
NM_194320,ZNF169,5,4,43715,3561,40154,10038.5,712.2,11.27604605
NM_032558,HIATL1,12,11,86371,3310,83061,7551,275.8333333,25.0939577
NM_003837,FBP2,7,6,35120,1357,33763,5627.166667,193.8571429,24.88061901
NM_001083602,PTCH1,24,23,73985,8075,65910,2865.652174,336.4583333,8.162229102
NM_001083607,PTCH1,24,23,64219,7841,56378,2451.217391,326.7083333,7.190154317
NM_001083606,PTCH1,24,23,64437,7767,56670,2463.913043,323.625,7.29625338
NM_001083605,PTCH1,24,23,65060,7668,57392,2495.304348,319.5,7.484611372
NM_001083604,PTCH1,24,23,65060,7685,57375,2494.565217,320.2083333,7.46584255
NM_001083603,PTCH1,24,23,73985,7921,66064,2872.347826,330.0416667,8.340361066
NM_000264,PTCH1,24,23,65569,7967,57602,2504.434783,331.9583333,7.230074055
NM_001256408,LOC158434,3,2,9752,2665,7087,3543.5,888.3333333,2.659287054
NM_000197,HSD17B3,11,10,66847,1145,65702,6570.2,104.0909091,57.38165939
NM_153695,ZNF367,5,4,32446,3707,28739,7184.75,741.4,7.752630159
NM_001077181,CDC14B,14,13,66810,5145,61665,4743.461538,367.5,11.98542274
NM_153698,AAED1,6,5,14068,1231,12837,2567.4,205.1666667,10.42810723
NM_014930,ZNF510,6,5,22183,5160,17023,3404.6,860,3.299031008
NM_001045477,NUTM2G,7,6,13288,4201,9087,1514.5,600.1428571,2.163056415
NM_001170741,NUTM2G,7,6,10416,2523,7893,1315.5,360.4285714,3.128418549
NM_001201575,CTSV,8,7,9968,4332,5636,805.1428571,541.5,1.301015697
NM_001333,CTSV,8,7,9635,4535,5100,728.5714286,566.875,1.124586549
NM_014290,TDRD7,17,16,84105,3779,80326,5020.375,222.2941176,21.2558878
NM_139246,TSTD2,10,9,33602,4438,29164,3240.444444,443.8,6.571428571
NM_000380,XPA,6,5,22502,1475,21027,4205.4,245.8333333,14.25559322
NM_004473,FOXE1,1,0,3462,3462,NA,NA,3462,NA
NM_197978,HEMGN,4,3,11604,2309,9295,3098.333333,577.25,4.025552187
NM_006401,ANP32B,7,6,32737,1623,31114,5185.666667,231.8571429,19.1706716
NM_018437,HEMGN,5,4,18126,2256,15870,3967.5,451.2,7.034574468
NM_016481,C9orf156,5,4,18083,1652,16431,4107.75,330.4,9.946125908
NM_033219,TRIM14,7,6,35002,1643,33359,5559.833333,234.7142857,20.30371272
NM_018946,NANS,6,5,26408,1246,25162,5032.4,207.6666667,20.19422151
NM_014788,TRIM14,6,5,35002,4617,30385,6077,769.5,6.581113277
NM_018421,TBC1D2,13,12,56725,3330,53395,4449.583333,256.1538462,16.03453453
NM_001267572,TBC1D2,7,6,14555,2136,12419,2069.833333,305.1428571,5.814138577
NM_001267571,TBC1D2,13,12,56725,3363,53362,4446.833333,258.6923077,15.86738032
NM_173551,ANKS6,15,14,64505,7162,57343,4095.928571,477.4666667,8.006562413
NM_001130916,TGFBR1,8,7,49063,6251,42812,6116,781.375,6.848824188
NM_004612,TGFBR1,9,8,49063,6483,42580,5322.5,720.3333333,6.567946938
NM_033087,ALG2,2,1,5541,2832,2709,2709,1416,0.956567797
NM_006808,SEC61B,4,3,8333,566,7767,2589,141.5,13.72261484
NM_006981,NR4A3,8,7,45038,5642,39396,5628,705.25,6.982630273
NM_173199,NR4A3,5,4,12206,2593,9613,2403.25,518.6,3.707288855
NM_173200,NR4A3,9,8,45038,5715,39323,4915.375,635,6.880664917
NM_017919,STX17,8,7,67905,6916,60989,8712.714286,864.5,8.818536726
NM_001161584,TEX10,15,14,50498,3023,47475,3391.071429,201.5333333,15.70459808
NM_017746,TEX10,15,14,50904,3136,47768,3412,209.0666667,15.23214286
NM_001198807,MSANTD3,4,3,24523,1883,22640,7546.666667,470.75,12.02336697
NM_001198806,MSANTD3,3,2,22222,1781,20441,10220.5,593.6666667,11.47725997
NM_001198805,MSANTD3,3,2,24307,1774,22533,11266.5,591.3333333,12.70180383
NM_080655,MSANTD3,3,2,24523,1813,22710,11355,604.3333333,12.52619967
NM_001018116,MURC,2,1,10310,3098,7212,7212,1549,2.327953518
NM_001278232,ZNF189,3,2,11808,3153,8655,4327.5,1051,2.745004757
NM_001127610,BAAT,4,3,23104,3381,19723,6574.333333,845.25,5.833481219
NM_003452,ZNF189,3,2,11808,3198,8610,4305,1066,2.692307692
NM_000035,ALDOB,9,8,15222,2435,12787,1598.375,270.5555556,5.251334702
NM_197977,ZNF189,4,3,11808,3293,8515,2838.333333,823.25,2.585788035
NM_001701,BAAT,4,3,24590,3482,21108,7036,870.5,6.062033314
NM_019051,MRPL50,2,1,8672,1023,7649,7649,511.5,7.477028348
NM_001278240,ZNF189,4,3,11808,3278,8530,2843.333333,819.5,2.602196461
NM_001278231,ZNF189,3,2,11808,3156,8652,4326,1052,2.741444867
NM_032342,TMEM246,2,1,11869,2091,9778,9778,1045.5,4.676231468
NM_019592,RNF20,20,19,29497,3962,25535,1343.947368,198.1,6.444977284
NM_147180,PPP3R2,1,0,3388,3388,NA,NA,3388,NA
NM_001265602,SMC2,25,24,47161,6027,41134,1713.916667,241.08,6.824954372
NM_006444,SMC2,25,24,47161,6002,41159,1714.958333,240.08,6.857547484
NM_001042551,SMC2,25,24,47161,6011,41150,1714.583333,240.44,6.845782732
NM_001042550,SMC2,25,24,46871,6073,40798,1699.916667,242.92,6.717931829
NM_001004483,OR13C8,1,0,964,964,NA,NA,964,NA
NM_001004485,OR13F1,1,0,961,961,NA,NA,961,NA
NM_001001961,OR13C3,1,0,1045,1045,NA,NA,1045,NA
NM_001001919,OR13C4,1,0,958,958,NA,NA,958,NA
NM_001004484,OR13D1,1,0,1042,1042,NA,NA,1042,NA
NM_001004482,OR13C5,1,0,958,958,NA,NA,958,NA
NM_001004481,OR13C2,1,0,958,958,NA,NA,958,NA
NM_001001956,OR13C9,1,0,958,958,NA,NA,958,NA
NM_015469,NIPSNAP3A,6,5,12436,1639,10797,2159.4,273.1666667,6.587553386
NM_018376,NIPSNAP3B,6,5,9842,1758,8084,1616.8,293,4.598407281
NM_031919,FSD1L,4,3,24107,670,23437,7812.333333,167.5,34.98059701
NM_005421,TAL2,1,0,649,649,NA,NA,649,NA
NM_002874,RAD23B,10,9,48960,4172,44788,4976.444444,417.2,10.73537872
NM_001244724,RAD23B,10,9,48143,3847,44296,4921.777778,384.7,11.51442683
NM_001244713,RAD23B,10,9,47427,3857,43570,4841.111111,385.7,11.29634431
NM_004235,KLF4,5,4,4916,2938,1978,494.5,587.6,0.673247107
NM_006687,ACTL7A,1,0,1529,1529,NA,NA,1529,NA
NM_006686,ACTL7B,1,0,1408,1408,NA,NA,1408,NA
NM_017832,FAM206A,6,5,6566,1917,4649,929.8,319.5,2.425143453
NM_003798,CTNNAL1,19,18,71027,2576,68451,3802.833333,135.5789474,26.57259317
NM_001286974,CTNNAL1,19,18,71027,2613,68414,3800.777778,137.5263158,26.18216609
NM_014334,FRRS1L,5,4,29992,1194,28798,7199.5,238.8,24.11892797
NM_001145372,PTPN3,15,14,53351,6079,47272,3376.571429,405.2666667,7.776278993
NM_001145371,PTPN3,16,15,53351,6215,47136,3142.4,388.4375,7.584231698
NM_001136562,AKAP2,4,3,47012,6805,40207,13402.33333,1701.25,5.908449669
NM_001012993,C9orf152,2,1,8569,2658,5911,5911,1329,2.223852521
NM_001286947,TXNDC8,4,3,15425,1828,13597,4532.333333,457,7.438183807
NM_001244938,TXN,4,3,12830,812,12018,4006,203,14.80049261
NM_003329,TXN,5,4,12830,873,11957,2989.25,174.6,13.69644903
NM_001003936,TXNDC8,6,5,34299,537,33762,6752.4,89.5,62.87150838
NM_001286946,TXNDC8,5,4,34299,476,33823,8455.75,95.2,71.05672269
NM_205859,OR2K2,1,0,952,952,NA,NA,952,NA
NM_012212,PTGR1,10,9,36466,1257,35209,3912.111111,125.7,28.01034208
NM_001146109,PTGR1,10,9,50135,1230,48905,5433.888889,123,39.7601626
NM_001146108,PTGR1,10,9,36890,1417,35473,3941.444444,141.7,25.03387438
NM_001015882,DNAJC25,4,3,23001,2272,20729,6909.666667,568,9.123679577
NM_001080551,C9orf84,24,23,73016,4738,68278,2968.608696,197.4166667,14.41072182
NM_173521,C9orf84,26,25,96982,4747,92235,3689.4,182.5769231,19.43016642
NM_033051,SLC46A2,4,3,11995,2506,9489,3163,626.5,3.78651237
NM_001101338,ZNF883,5,4,15074,2384,12690,3172.5,476.8,5.322986577
NM_003408,ZFP37,4,3,14978,2910,12068,4022.666667,727.5,4.147079038
NM_001282518,ZFP37,4,3,14978,2913,12065,4021.666667,728.25,4.141778235
NM_001282515,ZFP37,4,3,14978,2955,12023,4007.666667,738.75,4.068697124
NM_015258,FKBP15,28,27,55843,4364,51479,1906.62963,155.8571429,11.79628781
NM_001860,SLC31A2,4,3,13186,1778,11408,3802.666667,444.5,6.416197975
NM_145051,RNF183,2,1,1949,1212,737,737,606,0.608085809
NM_001012361,WDR31,11,10,24691,2518,22173,2217.3,228.9090909,8.805798253
NM_145241,WDR31,11,10,24691,2515,22176,2217.6,228.6363636,8.81749503
NM_001244926,PRPF4,14,13,17273,2935,14338,1102.923077,209.6428571,4.885178876
NM_139286,CDC26,4,3,8581,874,7707,2569,218.5,8.818077803
NM_004697,PRPF4,14,13,17273,2938,14335,1102.692308,209.8571429,4.879169503
NM_031219,HDHD3,2,1,2645,1723,922,922,861.5,0.535113175
NM_001278629,C9orf43,14,13,19042,2105,16937,1302.846154,150.3571429,8.04608076
NM_001278255,POLE3,5,4,3512,2239,1273,318.25,447.8,0.568557392
NM_000031,ALAD,12,11,15028,3195,11833,1075.727273,266.25,3.703599374
NM_152786,C9orf43,14,13,18978,2178,16800,1292.307692,155.5714286,7.713498623
NM_017443,POLE3,5,4,3513,2270,1243,310.75,454,0.547577093
NM_001278630,C9orf43,14,13,18977,1962,17015,1308.846154,140.1428571,8.672273191
NM_001276262,RGS3,5,4,3591,1445,2146,536.5,289,1.485121107
NM_001276261,RGS3,15,14,96318,2731,93587,6684.785714,182.0666667,34.26839985
NM_001276260,RGS3,7,6,61268,2799,58469,9744.833333,399.8571429,20.88924616
NM_130795,RGS3,16,15,96318,3710,92608,6173.866667,231.875,24.96172507
NM_144489,RGS3,5,4,3825,1731,2094,523.5,346.2,1.209705373
NM_134427,RGS3,5,4,32791,1719,31072,7768,343.8,18.07562536
NM_001282922,RGS3,8,7,16868,2658,14210,2030,332.25,5.346124906
NM_138424,KIF12,16,15,7421,2019,5402,360.1333333,126.1875,2.675581971
NM_001633,AMBP,10,9,18346,1443,16903,1878.111111,144.3,11.71379071
NM_030767,AKNA,22,21,60254,7405,52849,2516.619048,336.5909091,7.136934504
NM_000608,ORM2,6,5,3469,850,2619,523.8,141.6666667,3.081176471
NM_000607,ORM1,6,5,3458,845,2613,522.6,140.8333333,3.092307692
NM_153045,C9orf91,9,8,34999,4365,30634,3829.25,485,7.018098511
NM_004888,ATP6V1G1,3,2,11160,1614,9546,4773,538,5.914498141
NM_001204344,TNFSF15,2,1,7897,6398,1499,1499,3199,0.234291966
NM_005118,TNFSF15,4,3,21495,6693,14802,4934,1673.25,2.211564321
NM_001244,TNFSF8,4,3,29452,3787,25665,8555,946.75,6.777132295
NM_001252290,TNFSF8,5,4,37254,1528,35726,8931.5,305.6,23.38089005
NM_012210,TRIM32,2,1,14000,3721,10279,10279,1860.5,2.762429454
NM_001099679,TRIM32,2,1,14000,3718,10282,10282,1859,2.765465304
NM_138554,TLR4,3,2,13318,5664,7654,3827,1888,1.351341808
NM_003266,TLR4,4,3,13318,5785,7533,2511,1446.25,1.302160761
NM_138557,TLR4,2,1,13318,5496,7822,7822,2748,1.423216885
NM_012164,FBXW2,8,7,36488,9194,27294,3899.142857,1149.25,2.968675223
NM_015651,PHF19,15,14,21679,4304,17375,1241.071429,286.9333333,4.036942379
NM_001190947,TRAF1,6,5,12181,3721,8460,1692,620.1666667,2.27358237
NM_001190945,TRAF1,9,8,26782,4312,22470,2808.75,479.1111111,5.211038961
NM_001009936,PHF19,5,4,7757,995,6762,1690.5,199,6.795979899
NM_005658,TRAF1,8,7,24504,4458,20046,2863.714286,557.25,4.496635262
NM_001286842,PHF19,10,9,13262,3536,9726,1080.666667,353.6,2.750565611
NM_001286840,PHF19,15,14,39247,4175,35072,2505.142857,278.3333333,8.400479042
NM_001286843,PHF19,5,4,7757,981,6776,1694,196.2,6.907237513
NM_016322,RAB14,8,7,23952,4371,19581,2797.285714,546.375,4.479752917
NM_001127667,GSN,19,18,64742,2736,62006,3444.777778,144,22.6630117
NM_001127666,GSN,19,18,64742,2745,61997,3444.277778,144.4736842,22.58542805
NM_001127665,GSN,19,18,64742,2748,61994,3444.111111,144.6315789,22.55967977
NM_001127664,GSN,19,18,64742,2753,61989,3443.833333,144.8947368,22.51689066
NM_001127663,GSN,19,18,64742,2786,61956,3442,146.6315789,22.23833453
NM_001127662,GSN,17,16,64742,2579,62163,3885.1875,151.7058824,24.1035285
NM_198252,GSN,18,17,64742,2673,62069,3651.117647,148.5,23.22072578
NM_000177,GSN,17,16,33043,2666,30377,1898.5625,156.8235294,11.39422356
NM_001258029,GSN,17,16,46763,2566,44197,2762.3125,150.9411765,17.22408418
NM_001258030,GSN,17,16,46264,2643,43621,2726.3125,155.4705882,16.50435112
NM_199160,LHX6,9,8,26237,3339,22898,2862.25,371,6.857741839
NM_001242335,LHX6,7,6,19165,3600,15565,2594.166667,514.2857143,4.323611111
NM_001242334,LHX6,9,8,25011,3393,21618,2702.25,377,6.371352785
NM_001242333,LHX6,9,8,25853,3305,22548,2818.5,367.2222222,6.822390318
NM_033117,RBM18,6,5,25311,3074,22237,4447.4,512.3333333,7.233897202
NM_014368,LHX6,10,9,26237,3444,22793,2532.555556,344.4,6.618176539
NM_001286828,MORN5,4,3,40182,600,39582,13194,150,65.97
NM_198469,MORN5,5,4,40182,713,39469,9867.25,142.6,55.35624123
NM_001271367,PTGS1,11,10,24700,4910,19790,1979,446.3636364,4.030549898
NM_000962,PTGS1,11,10,24700,5050,19650,1965,459.0909091,3.891089109
NM_001271368,PTGS1,12,11,25175,5388,19787,1798.818182,449,3.672420193
NM_080591,PTGS1,11,10,24700,4939,19761,1976.1,449,4.001012351
NM_001271165,PTGS1,10,9,20383,4998,15385,1709.444444,499.8,3.078231293
NM_001271164,PTGS1,10,9,24700,4905,19795,2199.444444,490.5,4.03567788
NM_001271166,PTGS1,11,10,25175,5165,20010,2001,469.5454545,3.874152953
NM_012363,OR1N1,1,0,937,937,NA,NA,937,NA
NM_054107,OR1J2,1,0,943,943,NA,NA,943,NA
NM_001004452,OR1J4,1,0,943,943,NA,NA,943,NA
NM_001004451,OR1J1,1,0,970,970,NA,NA,970,NA
NM_012364,OR1Q1,1,0,946,946,NA,NA,946,NA
NM_001005236,OR1L1,1,0,934,934,NA,NA,934,NA
NM_001004457,OR1N2,1,0,994,994,NA,NA,994,NA
NM_001004454,OR1L8,1,0,931,931,NA,NA,931,NA
NM_001004450,OR1B1,1,0,958,958,NA,NA,958,NA
NM_080859,OR1K1,1,0,952,952,NA,NA,952,NA
NM_001001923,OR5C1,1,0,964,964,NA,NA,964,NA
NM_001005235,OR1L4,1,0,937,937,NA,NA,937,NA
NM_001005234,OR1L3,1,0,976,976,NA,NA,976,NA
NM_001004453,OR1L6,1,0,937,937,NA,NA,937,NA
NM_020924,ZBTB26,2,1,13403,1912,11491,11491,956,6.009937238
NM_006626,ZBTB6,2,1,5274,4106,1168,1168,2053,0.284461763
NM_001100588,RC3H2,21,20,55832,4012,51820,2591,191.047619,12.91625125
NM_018835,RC3H2,18,17,51540,3583,47957,2821,199.0555556,13.38459392
NM_005388,PDCL,4,3,10561,3089,7472,2490.666667,772.25,2.418905795
NM_005294,GPR21,2,1,2024,1597,427,427,798.5,0.267376331
NM_173689,CRB2,13,12,22590,5658,16932,1411,435.2307692,2.992576882
NM_004789,LHX2,5,4,21555,2421,19134,4783.5,484.2,7.903345725
NM_014397,NEK6,10,9,94525,2643,91882,10209.11111,264.3,34.76428301
NM_001145001,NEK6,11,10,94525,2809,91716,9171.6,255.3636364,32.6507654
NM_001166167,NEK6,10,9,94836,2590,92246,10249.55556,259,35.61621622
NM_001166171,NEK6,11,10,60471,2758,57713,5771.3,250.7272727,20.92567078
NM_001166170,NEK6,10,9,60471,2592,57879,6431,259.2,22.32986111
NM_001166169,NEK6,10,9,60022,2594,57428,6380.888889,259.4,22.1387818
NM_001166168,NEK6,10,9,94191,2585,91606,10178.44444,258.5,35.43752418
NM_004959,NR5A1,7,6,26186,3102,23084,3847.333333,443.1428571,7.441650548
NM_030978,ARPC5L,4,3,8214,1029,7185,2395,257.25,6.982507289
NM_001276375,WDR38,9,8,4476,1300,3176,397,144.4444444,2.443076923
NM_001276376,WDR38,8,7,4476,1279,3197,456.7142857,159.875,2.49960907
NM_001276374,WDR38,9,8,4476,1333,3143,392.875,148.1111111,2.35783946
NM_001045476,WDR38,9,8,4476,1330,3146,393.25,147.7777778,2.365413534
NM_007209,RPL35,4,3,4084,464,3620,1206.666667,116,7.801724138
NM_001282715,OLFML2A,5,4,14019,5975,8044,2011,1195,1.346276151
NM_182487,OLFML2A,8,7,37735,6559,31176,4453.714286,819.875,4.753163592
NM_005833,RABEPK,8,7,33578,1636,31942,4563.142857,204.5,19.52444988
NM_001174153,RABEPK,8,7,33619,1322,32297,4613.857143,165.25,24.43040847
NM_001174152,RABEPK,9,8,33619,1476,32143,4017.875,164,21.77710027
NM_005347,HSPA5,8,7,6541,3978,2563,366.1428571,497.25,0.644293615
NM_001282681,GAPVD1,25,24,66123,6642,59481,2478.375,265.68,8.955284553
NM_002316,LMX1B,8,7,86591,5784,80807,11543.85714,723,13.97078147
NM_001174147,LMX1B,8,7,86591,5805,80786,11540.85714,725.625,13.9166236
NM_001174146,LMX1B,8,7,86591,5817,80774,11539.14286,727.125,13.88585181
NM_014007,ZBTB43,3,2,33204,5975,27229,13614.5,1991.666667,4.557154812
NM_001135776,ZBTB43,2,1,33204,5851,27353,27353,2925.5,4.674927363
NM_012098,ANGPTL2,5,4,35418,3577,31841,7960.25,715.4,8.901593514
NM_007135,ZNF79,5,4,21000,2091,18909,4727.25,418.2,9.043041607
NM_001005373,LRSAM1,26,25,52017,3172,48845,1953.8,122,15.39880202
NM_138361,LRSAM1,25,24,52017,3430,48587,2024.458333,137.2,14.16530612
NM_001005374,LRSAM1,25,24,51248,2876,48372,2015.5,115.04,16.81919332
NM_014580,SLC2A8,10,9,10755,2179,8576,952.8888889,217.9,3.935750344
NM_000976,RPL12,7,6,3760,667,3093,515.5,95.28571429,4.637181409
NM_001271712,SLC2A8,8,7,10755,1807,8948,1278.285714,225.875,4.951853901
NM_001271711,SLC2A8,9,8,10755,2032,8723,1090.375,225.7777778,4.292814961
NM_001190723,LRSAM1,25,24,52017,3090,48927,2038.625,123.6,15.83398058
NM_001286698,ZNF79,3,2,21000,1973,19027,9513.5,657.6666667,9.643689812
NM_001286696,ZNF79,5,4,21000,2198,18802,4700.5,439.6,8.554140127
NM_001286697,ZNF79,6,5,21000,2201,18799,3759.8,366.8333333,8.541117674
NM_001252023,TOR2A,3,2,3827,1164,2663,1331.5,388,2.287800687
NM_001252021,TOR2A,4,3,3827,1290,2537,845.6666667,322.5,1.966666667
NM_001252018,TOR2A,4,3,3827,1293,2534,844.6666667,323.25,1.959783449
NM_001134431,TOR2A,2,1,3827,2269,1558,1558,1134.5,0.6866461
NM_001134430,TOR2A,4,3,3827,1431,2396,798.6666667,357.75,1.674353599
NM_001012502,C9orf117,9,8,7034,1731,5303,662.875,192.3333333,3.063547083
NM_001142533,SH2D3C,10,9,16989,2693,14296,1588.444444,269.3,5.308577794
NM_144965,TTC16,14,13,15523,2898,12625,971.1538462,207,4.356452726
NM_005489,SH2D3C,11,10,33054,2692,30362,3036.2,244.7272727,11.27860327
NM_001252334,SH2D3C,12,11,33054,3064,29990,2726.363636,255.3333333,9.787859008
NM_130459,TOR2A,3,2,3827,2536,1291,645.5,845.3333333,0.509069401
NM_001085347,TOR2A,5,4,3827,1560,2267,566.75,312,1.453205128
NM_001142534,SH2D3C,10,9,16967,2665,14302,1589.111111,266.5,5.366604128
NM_001142532,SH2D3C,11,10,24103,2806,21297,2129.7,255.0909091,7.589807555
NM_001142531,SH2D3C,11,10,24125,2557,21568,2156.8,232.4545455,8.43488463
NM_170600,SH2D3C,12,11,40454,3166,37288,3389.818182,263.8333333,11.7776374
NM_001002913,PTRH1,5,4,1711,820,891,222.75,164,1.086585366
NM_001261,CDK9,7,6,4749,2479,2270,378.3333333,354.1428571,0.915691811
NM_000118,ENG,14,13,39763,3215,36548,2811.384615,229.6428571,11.36796267
NM_004957,FPGS,15,14,11225,2323,8902,635.8571429,154.8666667,3.832113646
NM_013443,ST6GALNAC6,7,6,14329,2462,11867,1977.833333,351.7142857,4.820064988
NM_001287002,ST6GALNAC6,6,5,20029,2402,17627,3525.4,400.3333333,7.338467943
NM_001287001,ST6GALNAC6,6,5,12089,2431,9658,1931.6,405.1666667,3.972850679
NM_001287000,ST6GALNAC6,6,5,14329,2406,11923,2384.6,401,4.955527847
NM_001278138,ENG,15,14,32157,2820,29337,2095.5,188,10.40319149
NM_001114753,ENG,15,14,39763,3080,36683,2620.214286,205.3333333,11.91006494
NM_000476,AK1,7,6,11265,2273,8992,1498.666667,324.7142857,3.956005279
NM_001288803,FPGS,14,13,11225,2244,8981,690.8461538,160.2857143,4.002228164
NM_001018078,FPGS,15,14,10902,2342,8560,611.4285714,156.1333333,3.65499573
NM_001286999,ST6GALNAC6,7,6,14329,2458,11871,1978.5,351.1428571,4.829536208
NM_001287003,ST6GALNAC6,5,4,12089,2023,10066,2516.5,404.6,4.975778547
NM_001035254,FAM102A,11,10,39953,4172,35781,3578.1,379.2727273,8.576462128
NM_203305,FAM102A,8,7,10134,3651,6483,926.1428571,456.375,1.775677896
NM_003863,DPM2,4,3,3391,1550,1841,613.6666667,387.5,1.187741935
NM_001135219,PIP5KL1,10,9,9270,1558,7712,856.8888889,155.8,4.949935815
NM_173492,PIP5KL1,5,4,5964,1109,4855,1213.75,221.8,4.377817854
NM_025072,PTGES2,7,6,7771,2338,5433,905.5,334,2.323781009
NM_024112,C9orf16,2,1,3670,715,2955,2955,357.5,4.132867133
NM_052901,SLC25A25,10,9,10778,3319,7459,828.7777778,331.9,2.247363664
NM_005564,LCN2,7,6,4004,829,3175,529.1666667,118.4285714,3.829915561
NM_197956,NAIF1,2,1,6089,3400,2689,2689,1700,0.790882353
NM_001256335,PTGES2,8,7,7497,1353,6144,877.7142857,169.125,4.541019956
NM_001265614,SLC25A25,11,10,17796,3738,14058,1405.8,339.8181818,3.760834671
NM_001006642,SLC25A25,10,9,17796,3701,14095,1566.111111,370.1,3.808430154
NM_001006641,SLC25A25,10,9,41060,3456,37604,4178.222222,345.6,10.88078704
NM_198938,PTGES2,8,7,7771,1623,6148,878.2857143,202.875,3.788046827
NM_001040011,SWI5,5,4,12845,986,11859,2964.75,197.2,12.02738337
NM_001005336,DNM1,22,21,51895,3303,48592,2313.904762,150.1363636,14.71147442
NM_004486,GOLGA2,26,25,20162,4286,15876,635.04,164.8461538,3.704153056
NM_004408,DNM1,21,20,51895,3265,48630,2431.5,155.4761905,14.89433384
NM_001288739,DNM1,21,20,51895,3265,48630,2431.5,155.4761905,14.89433384
NM_001288738,DNM1,22,21,51895,3948,47947,2283.190476,179.4545455,12.14463019
NM_001288737,DNM1,22,21,51895,3303,48592,2313.904762,150.1363636,14.71147442
NM_016174,CERCAM,13,12,16873,2702,14171,1180.916667,207.8461538,5.244633605
NM_030914,URM1,5,4,20699,2655,18044,4511,531,6.796233522
NM_001265582,URM1,3,2,20699,4372,16327,8163.5,1457.333333,3.734446478
NM_005094,SLC27A4,13,12,20912,3209,17703,1475.25,246.8461538,5.51667186
NM_016035,COQ4,7,6,11562,1579,9983,1663.833333,225.5714286,6.322355921
NM_001135947,URM1,4,3,20699,3010,17689,5896.333333,752.5,5.876744186
NM_001286760,CERCAM,13,12,18193,2226,15967,1330.583333,171.2307692,7.172955975
NM_002540,ODF2,23,22,45288,4210,41078,1867.181818,183.0434783,9.757244656
NM_001242354,ODF2,16,15,38836,2243,36593,2439.533333,140.1875,16.31431119
NM_001242353,ODF2,21,20,45288,4006,41282,2064.1,190.7619048,10.30504244
NM_001242352,ODF2,21,20,45288,3920,41368,2068.4,186.6666667,10.55306122
NM_001499,GLE1,14,13,35187,2271,32916,2532,162.2142857,14.49405548
NM_153440,ODF2,16,15,38442,2187,36255,2417,136.6875,16.57750343
NM_153439,ODF2,16,15,38836,2173,36663,2444.2,135.8125,16.87206627
NM_153437,ODF2,17,16,37935,2408,35527,2220.4375,141.6470588,14.75373754
NM_153435,ODF2,21,20,45288,3826,41462,2073.1,182.1904762,10.83690538
NM_153436,ODF2,16,15,39687,2141,37546,2503.066667,133.8125,17.53666511
NM_153433,ODF2,21,20,44894,3933,40961,2048.05,187.2857143,10.41469616
NM_153432,ODF2,16,15,38836,2317,36519,2434.6,144.8125,15.76132931
NM_001003722,GLE1,16,15,37611,3358,34253,2283.533333,209.875,10.20041691
NM_003011,SET,8,7,7168,2927,4241,605.8571429,365.875,1.448923813
NM_001122821,SET,8,7,12743,2854,9889,1412.714286,356.75,3.464961458
NM_052844,WDR34,9,8,23191,1827,21364,2670.5,203,11.69348659
NM_001248001,SET,8,7,6423,2553,3870,552.8571429,319.125,1.51586369
NM_001248000,SET,8,7,11312,2629,8683,1240.428571,328.625,3.302776721
NM_016390,C9orf114,12,11,10172,4298,5874,534,358.1666667,1.366682178
NM_032799,ZDHHC12,5,4,3261,1156,2105,526.25,231.2,1.820934256
NM_006336,ZER1,16,15,42148,4314,37834,2522.266667,269.625,8.770050997
NM_004435,ENDOG,3,2,4178,1148,3030,1515,382.6666667,2.639372822
NM_001286772,TBC1D13,10,9,23227,3538,19689,2187.666667,353.8,5.565008479
NM_018201,TBC1D13,12,11,23227,3915,19312,1755.636364,326.25,4.932822478
NM_019594,LRRC8A,4,3,35928,4358,31570,10523.33333,1089.5,7.244148692
NM_174933,PHYHD1,12,11,21148,2127,19021,1729.181818,177.25,8.942642219
NM_001127245,LRRC8A,3,2,35928,4250,31678,15839,1416.666667,7.453647059
NM_001127244,LRRC8A,4,3,35538,4627,30911,10303.66667,1156.75,6.680570564
NM_014908,DOLK,1,0,2205,2205,NA,NA,2205,NA
NM_001100877,PHYHD1,10,9,19760,1192,18568,2063.111111,119.2,15.57718121
NM_001100876,PHYHD1,13,12,21148,2150,18998,1583.166667,165.3846154,8.83627907
NM_032809,FAM73B,16,15,35100,3603,31497,2099.8,225.1875,8.741881765
NM_020438,DOLPP1,8,7,9336,2184,7152,1021.714286,273,3.274725275
NM_001135917,DOLPP1,7,6,9336,2054,7282,1213.666667,293.4285714,3.545277507
NM_020145,SH3GLB2,11,10,20562,2289,18273,1827.3,208.0909091,7.982961992
NM_001287046,SH3GLB2,12,11,20562,1757,18805,1709.545455,146.4166667,10.70290268
NM_001287045,SH3GLB2,13,12,20562,2318,18244,1520.333333,178.3076923,7.870578085
NM_178001,PPP2R4,11,10,37634,2857,34777,3477.7,259.7272727,12.17255863
NM_021131,PPP2R4,11,10,37999,2678,35321,3532.1,243.4545455,13.18932039
NM_203434,IER5L,1,0,2711,2711,NA,NA,2711,NA
NM_001271832,PPP2R4,9,8,37634,2663,34971,4371.375,295.8888889,13.13218175
NM_178003,PPP2R4,9,8,37634,2624,35010,4376.25,291.5555556,13.34222561
NM_001193397,PPP2R4,10,9,37260,2537,34723,3858.111111,253.7,13.68663776
NM_178000,PPP2R4,10,9,37634,2751,34883,3875.888889,275.1,12.68011632
NM_001012715,C9orf106,2,1,1589,845,744,744,422.5,0.880473373
NM_016307,PRRX2,4,3,57033,1313,55720,18573.33333,328.25,42.43716679
NM_014064,NTMT1,4,3,9980,1540,8440,2813.333333,385,5.480519481
NM_001286803,NTMT1,3,2,9980,1323,8657,4328.5,441,6.543461829
NM_001286798,NTMT1,4,3,9980,1566,8414,2804.666667,391.5,5.372924649
NM_017873,ASB6,6,5,7567,4628,2939,587.8,771.3333333,0.635047537
NM_001202403,ASB6,5,4,7567,4540,3027,756.75,908,0.666740088
NM_177999,ASB6,5,4,7567,4518,3049,762.25,903.6,0.674856131
NM_001286801,NTMT1,4,3,9980,1481,8499,2833,370.25,5.738690074
NM_001286802,NTMT1,3,2,9980,1349,8631,4315.5,449.6666667,6.398072646
NM_001286799,NTMT1,4,3,9689,1495,8194,2731.333333,373.75,5.480936455
NM_001286800,NTMT1,4,3,9980,1455,8525,2841.666667,363.75,5.859106529
NM_001008563,USP20,26,25,46423,4468,41955,1678.2,171.8461538,9.390107431
NM_006676,USP20,25,24,46423,4546,41877,1744.875,181.84,9.21183458
NM_014506,TOR1B,5,4,8130,2774,5356,1339,554.8,1.930785869
NM_016520,C9orf78,9,8,8010,1827,6183,772.875,203,3.384236453
NM_000113,TOR1A,5,4,11222,2111,9111,2277.75,422.2,4.315963998
NM_001110303,USP20,26,25,46423,4370,42053,1682.12,168.0769231,9.623112128
NM_001136558,GPR107,19,18,86465,7010,79455,4414.166667,368.9473684,11.33452211
NM_001136557,GPR107,20,19,86465,7098,79367,4177.210526,354.9,11.18160045
NM_020960,GPR107,18,17,86465,6952,79513,4677.235294,386.2222222,11.43742808
NM_001287346,GPR107,17,16,76320,3065,73255,4578.4375,180.2941176,23.9004894
NM_001128826,NCS1,8,7,36713,4868,31845,4549.285714,608.5,6.541700904
NM_014286,NCS1,8,7,64728,4999,59729,8532.714286,624.875,11.94818964
NM_000050,ASS1,16,15,56569,1864,54705,3647,116.5,29.34817597
NM_054012,ASS1,15,14,56569,1801,54768,3912,120.0666667,30.40977235
NM_003934,FUBP3,19,18,58781,3176,55605,3089.166667,167.1578947,17.50787154
NM_021619,PRDM12,5,4,18405,2497,15908,3977,499.4,6.370845014
NM_001282708,EXOSC2,8,7,11136,1964,9172,1310.285714,245.5,4.6700611
NM_014285,EXOSC2,9,8,11136,2043,9093,1136.625,227,4.450807636
NM_001282709,EXOSC2,8,7,11136,1952,9184,1312,244,4.704918033
NM_198180,QRFP,1,0,412,412,NA,NA,412,NA
NM_032843,FIBCD1,7,6,36416,3264,33152,5525.333333,466.2857143,10.15686275
NM_001145106,FIBCD1,8,7,36632,3127,33505,4786.428571,390.875,10.71474256
NM_005157,ABL1,11,10,52233,5399,46834,4683.4,490.8181818,8.674569365
NM_031426,AIF1L,6,5,26678,3443,23235,4647,573.8333333,6.748475167
NM_001185096,AIF1L,6,5,26678,3372,23306,4661.2,562,6.911625148
NM_001185095,AIF1L,7,6,26678,3522,23156,3859.333333,503.1428571,6.574673481
NM_032728,PPAPDC3,2,1,19570,2097,17473,17473,1048.5,8.33237959
NM_033387,FAM78A,2,1,18443,3938,14505,14505,1969,3.683341798
NM_001136113,POMT1,20,19,20906,3340,17566,924.5263158,167,5.259281437
NM_007171,POMT1,20,19,20906,3166,17740,933.6842105,158.3,5.603284902
NM_031432,UCK1,7,6,7481,2186,5295,882.5,312.2857143,2.422232388
NM_001136114,POMT1,18,17,20906,2839,18067,1062.764706,157.7222222,6.363860514
NM_001077366,POMT1,19,18,20906,2947,17959,997.7222222,155.1052632,6.093993892
NM_001077365,POMT1,20,19,20906,3100,17806,937.1578947,155,5.743870968
NM_001135954,UCK1,6,5,7481,2090,5391,1078.2,348.3333333,2.579425837
NM_001261451,UCK1,7,6,7481,2201,5280,880,314.4285714,2.398909587
NM_001261450,UCK1,7,6,7481,2159,5322,887,308.4285714,2.465030107
NM_001253882,MED27,3,2,6538,786,5752,2876,262,7.318066158
NM_032536,NTNG2,8,7,80888,3099,77789,11112.71429,387.375,25.10132301
NM_015046,SETX,26,25,93547,11042,82505,3300.2,424.6923077,7.471925376
NM_020064,BARHL1,3,2,7649,1910,5739,2869.5,636.6666667,3.004712042
NM_012204,GTF3C4,5,4,19744,3870,15874,3968.5,774,4.101808786
NM_018956,C9orf9,5,4,11130,724,10406,2601.5,144.8,14.37292818
NM_001135031,GFI1B,6,5,12988,1659,11329,2265.8,276.5,6.828812538
NM_004188,GFI1B,7,6,12988,1798,11190,1865,256.8571429,6.223581758
NM_001042368,RALGDS,18,17,51502,3705,47797,2811.588235,205.8333333,12.90067476
NM_001288573,GBGT1,7,6,10999,2029,8970,1495,289.8571429,4.420896994
NM_001288572,GBGT1,7,6,10999,2029,8970,1495,289.8571429,4.420896994
NM_006266,RALGDS,18,17,23532,3726,19806,1165.058824,207,5.315619968
NM_001807,CEL,11,10,9887,2397,7490,749,217.9090909,3.124739257
NM_001271776,RALGDS,18,17,23532,3690,19842,1167.176471,205,5.377235772
NM_001271775,RALGDS,18,17,31683,3710,27973,1645.470588,206.1111111,7.539892183
NM_001271774,RALGDS,18,17,33439,3617,29822,1754.235294,200.9444444,8.244954382
NM_021996,GBGT1,7,6,10999,1992,9007,1501.166667,284.5714286,4.521586345
NM_001282632,GBGT1,6,5,10999,1940,9059,1811.8,323.3333333,4.669587629
NM_001282629,GBGT1,7,6,10999,1973,9026,1504.333333,281.8571429,4.57475925
NM_020469,ABO,7,6,20069,1586,18483,3080.5,226.5714286,11.65384615
NM_014581,OBP2B,7,6,3973,705,3268,544.6666667,100.7142857,4.635460993
NM_001288987,OBP2B,7,6,3973,969,3004,500.6666667,138.4285714,3.100103199
NM_017503,SURF2,6,5,4622,851,3771,754.2,141.8333333,4.431257344
NM_006753,SURF6,5,4,5506,2331,3175,793.75,466.2,1.362076362
NM_133640,MED22,5,4,7262,1485,5777,1444.25,297,3.89023569
NM_020385,REXO4,8,7,12036,2424,9612,1373.142857,303,3.965346535
NM_001278928,SURF2,6,5,4622,848,3774,754.8,141.3333333,4.450471698
NM_001280792,SURF4,5,4,14714,2869,11845,2961.25,573.8,4.128616243
NM_001280787,SURF1,8,7,4703,999,3704,529.1428571,124.875,3.707707708
NM_001279351,REXO4,8,7,12112,2107,10005,1429.285714,263.375,4.748457523
NM_001279350,REXO4,8,7,12036,2246,9790,1398.571429,280.75,4.358860196
NM_001279349,REXO4,6,5,12036,1906,10130,2026,317.6666667,5.314795383
NM_153710,C9orf96,18,17,27938,2797,25141,1478.882353,155.3888889,8.988559171
NM_003172,SURF1,9,8,4703,1052,3651,456.375,116.8888889,3.470532319
NM_181491,MED22,4,3,7262,3919,3343,1114.333333,979.75,0.853023731
NM_000972,RPL7A,8,7,3213,898,2315,330.7142857,112.25,2.577951002
NM_033161,SURF4,6,5,14714,3057,11657,2331.4,509.5,3.813215571
NM_001280793,SURF4,5,4,14714,2979,11735,2933.75,595.8,3.939241356
NM_001280791,SURF4,6,5,14714,3155,11559,2311.8,525.8333333,3.663708399
NM_001280790,SURF4,7,6,14714,3208,11506,1917.666667,458.2857143,3.586658354
NM_001280789,SURF4,6,5,14714,2698,12016,2403.2,449.6666667,4.453669385
NM_001280788,SURF4,6,5,16497,2912,13585,2717,485.3333333,4.665178571
NM_001278942,SURF6,5,4,5506,2330,3176,794,466,1.363090129
NM_017586,CACFD1,5,4,10824,2760,8064,2016,552,2.92173913
NM_001242369,CACFD1,6,5,10824,2886,7938,1587.6,481,2.750519751
NM_001242370,CACFD1,5,4,10824,2759,8065,2016.25,551.8,2.923160565
NM_001080515,FAM163B,2,1,1833,1133,700,700,566.5,0.617828773
NM_001080483,TMEM8C,5,4,10362,823,9539,2384.75,164.6,11.59052248
NM_001145099,SLC2A6,9,8,8062,2369,5693,711.625,263.2222222,2.403123681
NM_001135775,CACFD1,4,3,10824,2633,8191,2730.333333,658.25,3.110900114
NM_014694,ADAMTSL2,19,18,40668,3745,36923,2051.277778,197.1052632,9.859279039
NM_017585,SLC2A6,10,9,8062,2556,5506,611.7777778,255.6,2.154147105
NM_001145320,ADAMTSL2,19,18,43357,4087,39270,2181.666667,215.1052632,9.608514803
NM_000787,DBH,12,11,22983,2772,20211,1837.363636,231,7.291125541
NM_007371,BRD3,12,11,37697,5647,32050,2913.636364,470.5833333,5.675579954
NM_052821,WDR5,13,12,20182,3083,17099,1424.916667,237.1538462,5.546221213
NM_017588,WDR5,14,13,23886,3169,20717,1593.615385,226.3571429,6.5373935
NM_015837,FCN2,7,6,6710,950,5760,960,135.7142857,6.063157895
NM_004108,FCN2,8,7,6710,1065,5645,806.4285714,133.125,5.300469484
NM_002003,FCN1,9,8,8377,1292,7085,885.625,143.5555556,5.48374613
NM_001282611,OLFM1,6,5,33518,2792,30726,6145.2,465.3333333,11.00501433
NM_006334,OLFM1,4,3,22851,1182,21669,7223,295.5,18.33248731
NM_001282612,OLFM1,6,5,33926,2503,31423,6284.6,417.1666667,12.55413504
NM_014279,OLFM1,6,5,45943,2880,43063,8612.6,480,14.95243056
NM_173520,C9orf62,3,2,3311,1923,1388,694,641,0.721788872
NM_016034,MRPS2,4,3,4044,1515,2529,843,378.75,1.669306931
NM_001048265,C9orf116,3,2,4737,725,4012,2006,241.6666667,5.533793103
NM_014811,PPP1R26,4,3,9093,4936,4157,1385.666667,1234,0.842179903
NM_144654,C9orf116,3,2,4737,679,4058,2029,226.3333333,5.976435935
NM_182974,GLT6D1,5,4,15886,1531,14355,3588.75,306.2,9.37622469
NM_001018049,PAEP,7,6,5020,847,4173,695.5,121,4.926800472
NM_001252617,LCN1,7,6,5104,791,4313,718.8333333,113,5.452591656
NM_014582,OBP2A,7,6,3832,696,3136,522.6666667,99.42857143,4.505747126
NM_002297,LCN1,7,6,5104,796,4308,718,113.7142857,5.412060302
NM_002571,PAEP,7,6,5020,818,4202,700.3333333,116.8571429,5.136919315
NM_001252619,LCN1,7,6,5104,783,4321,720.1666667,111.8571429,5.518518519
NM_001252618,LCN1,7,6,5104,792,4312,718.6666667,113.1428571,5.444444444
NM_001012415,SOHLH1,7,6,6121,1992,4129,688.1666667,284.5714286,2.072791165
NM_001101677,SOHLH1,8,7,6121,1421,4700,671.4285714,177.625,3.307529909
NM_001001676,LCN9,6,5,2589,530,2059,411.8,88.33333333,3.88490566
NM_015447,CAMSAP1,17,16,98674,7648,91026,5689.125,449.8823529,11.90193515
NM_016172,UBAC1,10,9,28413,1877,26536,2948.444444,187.7,14.13745338
NM_001256526,C9orf69,2,1,3852,2806,1046,1046,1403,0.37277263
NM_152833,C9orf69,2,1,4306,2847,1459,1459,1423.5,0.512469266
NM_014564,LHX3,6,5,6910,2409,4501,900.2,401.5,1.868410129
NM_181701,QSOX2,12,11,39507,4539,34968,3178.909091,378.25,7.703899537
NM_178138,LHX3,6,5,8861,2372,6489,1297.8,395.3333333,2.735666105
NM_015597,GPSM1,9,8,14358,2274,12084,1510.5,252.6666667,5.313984169
NM_001200003,GPSM1,4,3,4807,2185,2622,874,546.25,1.2
NM_001039708,SDCCAG3,8,7,8682,2168,6514,930.5714286,271,3.004612546
NM_001039707,SDCCAG3,10,9,8682,2389,6293,699.2222222,238.9,2.634156551
NM_001080849,DNLZ,3,2,1913,749,1164,582,249.6666667,1.554072096
NM_052814,CARD9,13,12,9727,1827,7900,658.3333333,140.5384615,4.324028462
NM_001145639,GPSM1,4,3,6550,2061,4489,1496.333333,515.25,2.178068899
NM_052813,CARD9,13,12,9727,2136,7591,632.5833333,164.3076923,3.553838951
NM_015160,PMPCA,13,12,13190,2184,11006,917.1666667,168,5.039377289
NM_006643,SDCCAG3,9,8,8682,2319,6363,795.375,257.6666667,2.74385511
NM_003086,SNAPC4,23,22,22862,4673,18189,826.7727273,203.173913,3.892360368
NM_001145638,GPSM1,14,13,32127,3647,28480,2190.769231,260.5,7.809158212
NM_001282944,PMPCA,12,11,13190,2088,11102,1009.272727,174,5.317049808
NM_001282946,PMPCA,13,12,13190,2182,11008,917.3333333,167.8461538,5.044912924
NM_001276418,SEC16A,29,28,43665,9012,34653,1237.607143,310.7586207,3.845206391
NM_014866,SEC16A,32,31,42961,9074,33887,1093.129032,283.5625,3.7345162
NM_017617,NOTCH1,34,33,51344,9329,42015,1273.181818,274.3823529,4.503698146
NM_152571,C9orf163,1,0,2574,2574,NA,NA,2574,NA
NM_016215,EGFL7,11,10,9753,1759,7994,799.4,159.9090909,4.544627629
NM_201446,EGFL7,9,8,6908,1311,5597,699.625,145.6666667,4.269260107
NM_001012727,AGPAT2,5,4,14318,1457,12861,3215.25,291.4,8.827041867
NM_006412,AGPAT2,6,5,14318,1554,12764,2552.8,259,8.213642214
NM_203347,LCN15,7,6,4881,769,4112,685.3333333,109.8571429,5.347204161
NM_198946,LCN6,7,6,4513,718,3795,632.5,102.5714286,5.28551532
NM_001039374,CCDC183,14,13,11405,1730,9675,744.2307692,123.5714286,5.592485549
NM_032928,TMEM141,5,4,1994,863,1131,282.75,172.6,1.310544612
NM_178469,LCN8,7,6,3893,925,2968,494.6666667,132.1428571,3.208648649
NM_152421,FAM69B,5,4,12148,2339,9809,2452.25,467.8,4.19367251
NM_001001712,LCN10,6,5,4794,2023,2771,554.2,337.1666667,1.369747899
NM_014172,PHPT1,3,2,2229,1192,1037,518.5,397.3333333,0.869966443
NM_001135861,PHPT1,4,3,2229,1248,981,327,312,0.786057692
NM_001281299,EDF1,5,4,4224,646,3578,894.5,129.2,5.53869969
NM_001281298,EDF1,5,4,4224,637,3587,896.75,127.4,5.631083203
NM_001281297,EDF1,5,4,4224,851,3373,843.25,170.2,3.963572268
NM_001080482,C9orf172,1,0,2932,2932,NA,NA,2932,NA
NM_153200,EDF1,4,3,3669,704,2965,988.3333333,176,4.211647727
NM_178536,LCN12,6,5,3183,695,2488,497.6,115.8333333,3.579856115
NM_021138,TRAF2,11,10,40104,2288,37816,3781.6,208,16.52797203
NM_018998,FBXW5,9,8,4323,2389,1934,241.75,265.4444444,0.809543742
NM_000606,C8G,7,6,1730,884,846,141,126.2857143,0.957013575
NM_003792,EDF1,5,4,4224,700,3524,881,140,5.034285714
NM_206920,MAMDC4,27,26,8434,3687,4747,182.5769231,136.5555556,1.28749661
NM_001287342,PHPT1,3,2,2229,1198,1031,515.5,399.3333333,0.860601002
NM_001287343,PHPT1,4,3,2229,1251,978,326,312.75,0.78177458
NM_015392,NPDC1,9,8,6769,1537,5232,654,170.7777778,3.404033832
NM_203468,ENTPD2,9,8,5954,2109,3845,480.625,234.3333333,1.823138928
NM_207511,C9orf139,3,2,9320,3818,5502,2751,1272.666667,1.441068622
NM_004479,FUT7,2,1,2668,2416,252,252,1208,0.104304636
NM_001606,ABCA2,49,48,21056,8203,12853,267.7708333,167.4081633,1.566865781
NM_212533,ABCA2,49,48,21690,8195,13495,281.1458333,167.244898,1.646735815
NM_001246,ENTPD2,9,8,5954,2040,3914,489.25,226.6666667,1.918627451
NM_000954,PTGDS,7,6,4240,819,3421,570.1666667,117,4.177045177
NM_207510,LCNL1,3,2,2767,1839,928,464,613,0.504622077
NM_207309,UAP1L1,9,8,7039,3374,3665,458.125,374.8888889,1.086247777
NM_004669,CLIC3,6,5,1966,819,1147,229.4,136.5,1.4004884
NM_183241,C9orf142,7,6,1560,819,741,123.5,117,0.904761905
NM_178448,SAPCD2,6,5,8451,3839,4612,922.4,639.8333333,1.201354519
NM_031297,RNF208,1,0,1078,1078,NA,NA,1078,NA
NM_001282477,TMEM210,4,3,1120,514,606,202,128.5,1.178988327
NM_001185091,GRIN1,20,19,29607,3991,25616,1348.210526,199.55,6.418441493
NM_003731,SSNA1,3,2,1770,944,826,413,314.6666667,0.875
NM_001128228,TPRN,4,3,9096,2635,6461,2153.666667,658.75,2.45199241
NM_001013653,LRRC26,2,1,1281,1197,84,84,598.5,0.070175439
NM_053045,TMEM203,1,0,1557,1557,NA,NA,1557,NA
NM_007327,GRIN1,20,19,29607,4402,25205,1326.578947,220.1,5.725806452
NM_013379,DPP7,13,12,4205,1630,2575,214.5833333,125.3846154,1.579754601
NM_013366,ANAPC2,13,12,13823,2713,11110,925.8333333,208.6923077,4.095097678
NM_021569,GRIN1,19,18,29607,4290,25317,1406.5,225.7894737,5.901398601
NM_001185090,GRIN1,21,20,29607,4103,25504,1275.2,195.3809524,6.215939556
NM_000832,GRIN1,19,18,29607,3927,25680,1426.666667,206.6842105,6.53934301
NM_001144026,NDOR1,14,13,13696,4891,8805,677.3076923,349.3571429,1.800245349
NM_001144027,NDOR1,13,12,13696,4739,8957,746.4166667,364.5384615,1.890061194
NM_001144028,NDOR1,14,13,13696,4843,8853,681,345.9285714,1.827999174
NM_014434,NDOR1,14,13,13696,4864,8832,679.3846154,347.4285714,1.815789474
NM_001190228,RNF224,3,2,2074,1506,568,284,502,0.377158035
NM_001177317,SLC34A3,13,12,5799,2175,3624,302,167.3076923,1.666206897
NM_015456,NELFB,13,12,18243,2579,15664,1305.333333,198.3846154,6.073671966
NM_001177316,SLC34A3,13,12,5799,2172,3627,302.25,167.0769231,1.669889503
NM_001256699,C9orf173,6,5,2224,1213,1011,202.2,202.1666667,0.833470734
NM_001256701,C9orf173,6,5,2224,1032,1192,238.4,172,1.15503876
NM_001256700,C9orf173,6,5,2224,1048,1176,235.2,174.6666667,1.122137405
NM_006088,TUBB4B,4,3,2450,1595,855,285,398.75,0.536050157
NM_017723,TOR4A,2,1,4815,4071,744,744,2035.5,0.18275608
NM_080877,SLC34A3,13,12,5623,2137,3486,290.5,164.3846154,1.631258774
NM_001004354,NRARP,1,0,2622,2622,NA,NA,2622,NA
NM_001004353,C9orf173,6,5,2224,1197,1027,205.4,199.5,0.857978279
NM_199001,C9orf169,2,1,1678,1299,379,379,649.5,0.291762895
NM_001001710,FAM166A,7,6,4211,1155,3056,509.3333333,165,2.645887446
NM_001178064,NSMF,15,14,11765,3573,8192,585.1428571,238.2,2.292751189
NM_198585,ENTPD8,9,8,7087,2120,4967,620.875,235.5555556,2.342924528
NM_006647,NOXA1,14,13,11013,1647,9366,720.4615385,117.6428571,5.686703097
NM_001033113,ENTPD8,10,9,7087,2232,4855,539.4444444,223.2,2.175179211
NM_015537,NSMF,15,14,11765,3657,8108,579.1428571,243.8,2.217117856
NM_001256068,NOXA1,12,11,11013,1477,9536,866.9090909,123.0833333,6.456330399
NM_001256067,NOXA1,14,13,11013,1626,9387,722.0769231,116.1428571,5.773062731
NM_001130971,NSMF,14,13,11765,3587,8178,629.0769231,256.2142857,2.279899638
NM_001130969,NSMF,16,15,11765,3664,8101,540.0666667,229,2.210971616
NM_001130970,NSMF,15,14,11765,3594,8171,583.6428571,239.6,2.273511408
NM_001286823,EXD3,8,7,57119,1077,56042,8006,134.625,52.03528319
NM_032477,MRPL41,2,1,700,606,94,94,303,0.155115512
NM_138778,DPH7,9,8,24028,1856,22172,2771.5,206.2222222,11.94612069
NM_138462,ZMYND19,6,5,8408,1376,7032,1406.4,229.3333333,5.110465116
NM_032937,C9orf37,3,2,3526,1455,2071,1035.5,485,1.423367698
NM_001145249,FAM157B,7,6,27537,1285,26252,4375.333333,183.5714286,20.42957198
NM_032796,SYAP1,9,8,43102,3534,39568,4946,392.6666667,11.19637804
NM_001199974,RPL36A-HNRNPH2,4,3,23252,2540,20712,6904,635,8.154330709
NM_001032393,HNRNPH2,2,1,6009,2382,3627,3627,1191,1.522670025
NM_001199973,RPL36A-HNRNPH2,5,4,23252,2664,20588,5147,532.8,7.728228228
NM_019597,HNRNPH2,2,1,6009,2394,3615,3615,1197,1.510025063
NM_002063,GLRA2,9,8,202515,3454,199061,24882.625,383.7777778,57.63202085
NM_001193278,MID1,7,6,98340,1933,96407,16067.83333,276.1428571,49.87428867
NM_001193280,MID1,6,5,98340,1665,96675,19335,277.5,58.06306306
NM_001193281,MID1,3,2,62264,1846,60418,30209,615.3333333,32.7291441
NM_005647,TBL1X,18,17,254581,5733,248848,14638.11765,318.5,43.40624455
NM_001118885,GLRA2,10,9,202515,3027,199488,22165.33333,302.7,65.90287413
NM_000381,MID1,10,9,175326,6473,168853,18761.44444,647.3,26.08574077
NM_001171942,GLRA2,11,10,202515,3195,199320,19932,290.4545455,62.38497653
NM_001167890,EGFL6,12,11,64002,2444,61558,5596.181818,203.6666667,25.18739771
NM_006125,ARHGAP6,11,10,522306,3643,518663,51866.3,331.1818182,142.3724952
NM_013427,ARHGAP6,13,12,528160,5131,523029,43585.75,394.6923077,101.9351004
NM_001139468,TBL1X,18,17,256447,5604,250843,14755.47059,311.3333333,44.76142041
NM_001139467,TBL1X,17,16,256447,5468,250979,15686.1875,321.6470588,45.89959766
NM_001139466,TBL1X,18,17,256447,5614,250833,14754.88235,311.8888889,44.67990737
NM_015507,EGFL6,12,11,64002,2441,61561,5596.454545,203.4166667,25.21958214
NM_001098624,MID1,10,9,232431,6403,226028,25114.22222,640.3,35.30032797
NM_001118886,GLRA2,9,8,202515,3454,199061,24882.625,383.7777778,57.63202085
NM_014728,FRMPD4,17,16,586059,8482,577577,36098.5625,498.9411765,68.09443527
NM_033290,MID1,10,9,438461,6265,432196,48021.77778,626.5,68.98579409
NM_001193279,MID1,6,5,98340,1779,96561,19312.2,296.5,54.27824621
NM_001193277,MID1,10,9,131609,6262,125347,13927.44444,626.2,20.01708719
NM_033289,MID1,10,9,175326,6359,168967,18774.11111,635.9,26.57131624
NM_001172732,RAI2,3,2,61290,2079,59211,29605.5,693,28.48051948
NM_001172743,RAI2,3,2,61290,2426,58864,29432,808.6666667,24.26380874
NM_001172739,RAI2,3,2,61290,2423,58867,29433.5,807.6666667,24.29508873
NM_021785,RAI2,2,1,61290,2228,59062,59062,1114,26.50897666
NM_004012,DMD,51,50,1293028,9965,1283063,25661.26,195.3921569,128.7569493
NM_014271,IL1RAPL1,11,10,1368338,2690,1365648,136564.8,244.5454545,507.6758364
NM_004014,DMD,25,24,389072,5648,383424,15976,225.92,67.88668555
NM_000109,DMD,79,78,2220383,14148,2206235,28285.0641,179.0886076,155.9397088
NM_004011,DMD,51,50,1293028,9822,1283206,25664.12,192.5882353,130.6461006
NM_004013,DMD,36,35,1036243,7446,1028797,29394.2,206.8333333,138.1677411
NM_004023,DMD,31,30,1036243,7079,1029164,34305.46667,228.3548387,145.3826812
NM_004022,DMD,34,33,1036243,7373,1028870,31177.87879,216.8529412,139.5456395
NM_004021,DMD,35,34,1036243,7413,1028830,30259.70588,211.8,138.7872656
NM_004020,DMD,32,31,1036243,7112,1029131,33197.77419,222.25,144.7034589
NM_004010,DMD,79,78,2009201,14162,1995039,25577.42308,179.2658228,140.8726875
NM_004009,DMD,79,78,2009202,14079,1995123,25578.5,178.2151899,141.7091413
NM_004006,DMD,79,78,2092330,14072,2078258,26644.33333,178.1265823,147.6874645
NM_025184,EFHC2,15,14,195797,3267,192530,13752.14286,217.8,58.93174166
NM_012196,GAGE8,5,4,125598,525,125073,31268.25,105,238.2342857
NM_012196,GAGE8,5,4,96983,522,96461,24115.25,104.4,184.7911877
NM_012196,GAGE8,5,4,87487,522,86965,21741.25,104.4,166.5996169
NM_001472,GAGE2C,5,4,77952,543,77409,19352.25,108.6,142.558011
NM_001127212,GAGE2A,5,4,116120,547,115573,28893.25,109.4,211.285192
NM_001127212,GAGE2A,5,4,97011,547,96464,24116,109.4,176.3510055
NM_001127212,GAGE2A,5,4,77956,547,77409,19352.25,109.4,141.5155393
NM_001127200,GAGE2E,5,4,87487,522,86965,21741.25,104.4,166.5996169
NM_001173480,ARHGEF9,9,8,120185,5268,114917,14364.625,585.3333333,21.81416097
NM_001173479,ARHGEF9,9,8,150580,4862,145718,18214.75,540.2222222,29.97079391
NM_015185,ARHGEF9,10,9,120185,5460,114725,12747.22222,546,21.01190476
NM_001013627,NHSL2,8,7,232488,3686,228802,32686,460.75,62.07325014
NM_001399,EDA,8,7,423412,5288,418124,59732,661,79.07034796
NM_001005612,EDA,8,7,423412,5273,418139,59734.14286,659.125,79.29812251
NM_001005609,EDA,8,7,423412,5282,418130,59732.85714,660.25,79.16130254
NM_001170574,FAM46D,5,4,109809,3111,106698,26674.5,622.2,34.29701061
NM_152630,FAM46D,3,2,24866,3033,21833,10916.5,1011,7.19848335
NM_001139514,DACH2,12,11,684152,2437,681715,61974.09091,203.0833333,279.7353303
NM_032968,PCDH11X,7,6,788571,9185,779386,129897.6667,1312.142857,84.85421884
NM_053281,DACH2,12,11,684152,2429,681723,61974.81818,202.4166667,280.6599424
NM_032969,PCDH11X,6,5,788571,9154,779417,155883.4,1525.666667,85.14496395
NM_001139515,DACH2,12,11,569636,1815,567821,51620.09091,151.25,312.8490358
NM_001168363,PCDH11X,5,4,787770,8328,779442,194860.5,1665.6,93.59293948
NM_001168362,PCDH11X,5,4,787770,8271,779499,194874.75,1654.2,94.24483134
NM_001168361,PCDH11X,7,6,787770,8221,779549,129924.8333,1174.428571,94.82410899
NM_001168360,PCDH11X,6,5,787770,8359,779411,155882.2,1393.166667,93.24213423
NM_020766,PCDH19,5,4,118631,9617,109014,27253.5,1923.4,11.33555163
NM_007309,DIAPH2,27,26,785177,3809,781368,30052.61538,141.0740741,205.1373064
NM_006729,DIAPH2,27,26,915937,5010,910927,35035.65385,185.5555556,181.8217565
NM_001105243,PCDH19,5,4,118631,9620,109011,27252.75,1924,11.33170478
NM_001184880,PCDH19,6,5,118631,9762,108869,21773.8,1627,11.15232534
NM_080879,RAB40A,3,2,19738,1349,18389,9194.5,449.6666667,13.63157895
NM_017416,IL1RAPL2,11,10,1200828,2996,1197832,119783.2,272.3636364,399.8104139
NM_018015,CXorf57,14,13,67515,3918,63597,4892.076923,279.8571429,16.23200613
NM_001184782,CXorf57,13,12,67515,3626,63889,5324.083333,278.9230769,17.61969112
NM_012471,TRPC5,11,10,308464,5851,302613,30261.3,531.9090909,51.71987694
NM_014253,TENM1,31,30,587912,12903,575009,19166.96667,416.2258065,44.56397737
NM_001163279,TENM1,32,31,587912,12922,574990,18548.06452,403.8125,44.49698189
NM_001163278,TENM1,32,31,587912,12925,574987,18547.96774,403.90625,44.48642166
NM_016032,ZDHHC9,11,10,40648,4630,36018,3601.8,420.9090909,7.779265659
NM_001281736,ENOX2,14,13,279936,4046,275890,21222.30769,289,68.18833416
NM_001008222,ZDHHC9,10,9,40299,4649,35650,3961.111111,464.9,7.668315767
NM_006375,ENOX2,15,14,279936,4191,275745,19696.07143,279.4,65.79455977
NM_182314,ENOX2,16,15,279936,4281,275655,18377,267.5625,64.39032936
NM_001159700,FHL1,7,6,62783,2444,60339,10056.5,349.1428571,24.6886252
NM_001159703,FHL1,6,5,63961,2325,61636,12327.2,387.5,26.51010753
NM_001159702,FHL1,8,7,63961,2714,61247,8749.571429,339.25,22.56705969
NM_001167819,FHL1,7,6,41724,2381,39343,6557.166667,340.1428571,16.52372953
NM_001159704,FHL1,6,5,42065,2894,39171,7834.2,482.3333333,13.53524534
NM_001449,FHL1,7,6,63961,2513,61448,10241.33333,359,24.45204934
NM_002025,AFF2,21,20,500056,13767,486289,24314.45,655.5714286,35.3228009
NM_031462,CD99L2,11,10,132482,3726,128756,12875.6,338.7272727,34.55609232
NM_134446,CD99L2,9,8,132482,3577,128905,16113.125,397.4444444,36.037182
NM_134445,CD99L2,8,7,132482,3507,128975,18425,438.375,36.77644711
NM_001169125,AFF2,20,19,500056,13649,486407,25600.36842,682.45,35.63682321
NM_001169124,AFF2,20,19,500056,13661,486395,25599.73684,683.05,35.60464095
NM_001184808,CD99L2,8,7,132482,3504,128978,18425.42857,438,36.80878995
NM_001169122,AFF2,20,19,500056,13661,486395,25599.73684,683.05,35.60464095
NM_001242614,CD99L2,12,11,132482,3757,128725,11702.27273,313.0833333,34.26270961
NM_001169123,AFF2,21,20,500056,13737,486319,24315.95,654.1428571,35.40212565
NM_001170628,AFF2,18,17,281580,12298,269282,15840.11765,683.2222222,21.89640592
NM_000132,F8,26,25,186936,9061,177875,7115,348.5,19.63083545
NM_032512,PDZD4,8,7,28382,3753,24629,3518.428571,469.125,6.562483347
NM_002414,CD99,10,9,50124,1247,48877,5430.777778,124.7,39.19566961
NM_001184704,GYG2,8,7,54000,2955,51045,7292.142857,369.375,17.27411168
NM_001079855,GYG2,11,10,54000,3313,50687,5068.7,301.1818182,15.2994265
NM_001201538,ARSF,11,10,72497,2093,70404,7040.4,190.2727273,33.63784042
NM_145177,DHRSX,7,6,281462,2576,278886,46481,368,108.2631988
NM_001277710,CD99,11,10,50124,1263,48861,4886.1,114.8181818,38.68646081
NM_001184703,GYG2,10,9,54000,3192,50808,5645.333333,319.2,15.91729323
NM_001184702,GYG2,11,10,54000,3310,50690,5069,300.9090909,15.3141994
NM_001122898,CD99,9,8,50124,1198,48926,6115.75,133.1111111,40.83973289
NM_001201539,ARSF,11,10,71260,2178,69082,6908.2,198,31.71808999
NM_001282631,ARSE,10,9,33680,2000,31680,3520,200,15.84
NM_004042,ARSF,11,10,45932,2059,43873,4387.3,187.1818182,21.30791646
NM_003918,GYG2,12,11,54000,3407,50593,4599.363636,283.9166667,14.84972116
NM_005044,PRKX,9,8,109293,6093,103200,12900,677,16.93746923
NM_181332,NLGN4X,6,5,338858,5895,332963,66592.6,982.5,56.48227311
NM_020742,NLGN4X,6,5,337823,5712,332111,66422.2,952,58.14268207
NM_001282146,NLGN4X,6,5,337179,5877,331302,66260.4,979.5,56.3726391
NM_001282145,NLGN4X,7,6,338858,6203,332655,55442.5,886.1428571,53.62808319
NM_000351,STS,10,9,135212,6387,128825,14313.88889,638.7,20.16987631
NM_000216,KAL1,14,13,203314,6328,196986,15152.76923,452,31.12926675
NM_015691,WWC3,23,22,128725,6477,122248,5556.727273,281.6086957,18.87417014
NM_000273,GPR143,9,8,40554,1705,38849,4856.125,189.4444444,22.78533724
NM_001649,SHROOM2,10,9,162987,7455,155532,17281.33333,745.5,20.86277666
NM_001122608,HCCS,7,6,11800,2305,9495,1582.5,329.2857143,4.119305857
NM_001171991,HCCS,7,6,11800,2268,9532,1588.666667,324,4.202821869
NM_013423,ARHGAP6,13,12,128434,3960,124474,10372.83333,304.6153846,31.43282828
NM_005333,HCCS,7,6,11800,2363,9437,1572.833333,337.5714286,3.993652137
NM_001287242,ARHGAP6,13,12,290244,3908,286336,23861.33333,300.6153846,73.2691914
NM_003611,OFD1,23,22,34650,3674,30976,1408,159.7391304,8.431137725
NM_001001994,GPM6B,7,6,164740,1520,163220,27203.33333,217.1428571,107.3815789
NM_021804,ACE2,19,18,41038,3526,37512,2084,185.5789474,10.63868406
NM_001018109,PIR,10,9,108789,1536,107253,11917,153.6,69.82617188
NM_003662,PIR,10,9,108789,1570,107219,11913.22222,157,68.29235669
NM_001272071,AP1S2,6,5,29210,2335,26875,5375,389.1666667,11.50963597
NM_019857,CTPS2,19,18,124982,3895,121087,6727.055556,205,31.08780488
NM_001144002,CTPS2,19,18,124220,4342,119878,6659.888889,228.5263158,27.60893597
NM_003916,AP1S2,5,4,29210,2325,26885,6721.25,465,11.56344086
NM_175859,CTPS2,19,18,124681,3981,120700,6705.555556,209.5263158,30.31901532
NM_001080975,REPS2,18,17,206591,7968,198623,11683.70588,442.6666667,24.92758534
NM_004726,REPS2,18,17,206591,7971,198620,11683.52941,442.8333333,24.91782712
NM_198270,NHS,8,7,360572,8768,351804,50257.71429,1096,40.12363139
NM_001136024,NHS,9,8,100702,8237,92465,11558.125,915.2222222,11.22556756
NM_006240,PPEF1,19,18,136991,2891,134100,7450,152.1578947,46.38533379
NM_006089,SCML2,15,14,115413,4213,111200,7942.857143,280.8666667,26.39449324
NM_152226,PPEF1,18,17,136991,2704,134287,7899.235294,150.2222222,49.66235207
NM_152224,PPEF1,19,18,136991,2807,134184,7454.666667,147.7368421,47.80334877
NM_003159,CDKL5,21,20,228026,3452,224574,11228.7,164.3809524,65.0561993
NM_001184767,BEND2,11,10,49969,2141,47828,4782.8,194.6363636,22.33909388
NM_001037343,CDKL5,22,21,211407,3449,207958,9902.761905,156.7727273,60.29515802
NM_153346,BEND2,14,13,57975,4646,53329,4102.230769,331.8571429,11.47847611
NM_005756,GPR64,29,28,133332,4873,128459,4587.821429,168.0344828,26.36137903
NM_001024666,SH3KBP1,17,16,265836,4471,261365,16335.3125,263,58.45783941
NM_001079858,GPR64,29,28,133332,4882,128450,4587.5,168.3448276,26.31093814
NM_001079860,GPR64,27,26,133332,4814,128518,4943,178.2962963,26.69671791
NM_031892,SH3KBP1,18,17,353663,4784,348879,20522.29412,265.7777778,72.92621237
NM_001079859,GPR64,28,27,133332,4839,128493,4759,172.8214286,26.55362678
NM_001184960,SH3KBP1,13,12,137038,3877,133161,11096.75,298.2307692,34.34640186
NM_001184837,GPR64,27,26,133332,4790,128542,4943.923077,177.4074074,26.83549061
NM_001184836,GPR64,27,26,133332,4808,128524,4943.230769,178.0740741,26.7312812
NM_001184835,GPR64,26,25,133332,4765,128567,5142.68,183.2692308,26.981532
NM_001184834,GPR64,28,27,133332,4728,128604,4763.111111,168.8571429,27.20050761
NM_001184833,GPR64,28,27,133332,4833,128499,4759.222222,172.6071429,26.58783364
NM_001001671,MAP3K15,29,28,155205,4662,150543,5376.535714,160.7586207,32.29150579
NM_004586,RPS6KA3,22,21,116723,7732,108991,5190.047619,351.4545455,14.09609415
NM_152780,MAP7D2,16,15,110285,4044,106241,7082.733333,252.75,26.27126607
NM_001168467,MAP7D2,16,15,109927,3881,106046,7069.733333,242.5625,27.32440093
NM_001168466,MAP7D2,15,14,110285,3908,106377,7598.357143,260.5333333,27.2203173
NM_001168465,MAP7D2,17,16,110285,4168,106117,6632.3125,245.1764706,25.45993282
NM_015884,MBTPS2,11,10,45887,4536,41351,4135.1,412.3636364,9.116181658
NM_001168649,CNKSR2,20,19,268446,4375,264071,13898.47368,218.75,60.35908571
NM_001168648,CNKSR2,21,20,268446,4523,263923,13196.15,215.3809524,58.3513155
NM_001168647,CNKSR2,21,20,280279,5690,274589,13729.45,270.952381,48.25817223
NM_014927,CNKSR2,22,21,280279,5781,274498,13071.33333,262.7727273,47.48278844
NM_014332,SMPX,5,4,52190,940,51250,12812.5,188,54.5212766
NM_000444,PHEX,22,21,218867,6191,212676,10127.42857,281.4090909,34.3524471
NM_001282754,PHEX,21,20,218867,6113,212754,10637.7,291.0952381,34.80353345
NM_024122,APOO,9,8,74594,1138,73456,9182,126.4444444,64.5483304
NM_001037171,ACOT9,16,15,39632,1743,37889,2525.933333,108.9375,21.73780838
NM_001033583,ACOT9,15,14,39632,1715,37917,2708.357143,114.3333333,22.1090379
NM_016937,POLA1,37,36,303040,5476,297564,8265.666667,148,54.33966399
NM_001142386,PDK3,12,11,85241,12791,72450,6586.363636,1065.916667,5.664138848
NM_001163265,PCYT1B,9,8,89253,5233,84020,10502.5,581.4444444,16.05579973
NM_001163264,PCYT1B,8,7,114777,5500,109277,15611,687.5,19.86854545
NM_005391,PDK3,11,10,69200,1814,67386,6738.6,164.9090909,37.1477398
NM_004845,PCYT1B,8,7,89253,5557,83696,11956.57143,694.625,15.06136405
NM_004016,DMD,17,16,147681,4608,143073,8942.0625,271.0588235,31.04882813
NM_004015,DMD,18,17,147681,4641,143040,8414.117647,257.8333333,30.82094376
NM_004018,DMD,16,15,147681,4568,143113,9540.866667,285.5,31.32946585
NM_004017,DMD,17,16,147681,4601,143080,8942.5,270.6470588,31.09758748
NM_001098843,CXorf30,19,18,156540,2928,153612,8534,154.1052632,52.46311475
NM_001173486,PRRG1,4,3,92951,1771,91180,30393.33333,442.75,51.4850367
NM_198511,LANCL3,6,5,105930,3338,102592,20518.4,556.3333333,30.7345716
NM_001173489,PRRG1,5,4,107967,4608,103359,25839.75,921.6,22.43033854
NM_001173490,PRRG1,4,3,107967,4516,103451,34483.66667,1129,22.90766165
NM_001170331,LANCL3,5,4,105930,3254,102676,25669,650.8,31.55377996
NM_001142395,PRRG1,4,3,108022,4497,103525,34508.33333,1124.25,23.02090282
NM_000950,PRRG1,5,4,108022,4589,103433,25858.25,917.8,22.53933319
NM_001163335,SYTL5,18,17,122240,4835,117405,6906.176471,268.6111111,24.28231644
NM_006307,SRPX,10,9,71591,1913,69678,7742,191.3,36.42341871
NM_001170751,SRPX,9,8,71591,1735,69856,8732,192.7777778,40.26282421
NM_001170750,SRPX,9,8,71591,1852,69739,8717.375,205.7777778,37.65604752
NM_001170752,SRPX,9,8,71591,1790,69801,8725.125,198.8888889,38.99497207
NM_000328,RPGR,19,18,58367,3091,55276,3070.888889,162.6842105,17.8828858
NM_138780,SYTL5,17,16,122240,4743,117497,7343.5625,279,24.77271769
NM_000531,OTC,10,9,68969,1657,67312,7479.111111,165.7,40.62281231
NM_004615,TSPAN7,8,7,127443,1814,125629,17947,226.75,69.25523705
NM_001123383,BCOR,15,14,126085,6407,119678,8548.428571,427.1333333,18.67925706
NM_001123384,BCOR,14,13,126085,6352,119733,9210.230769,453.7142857,18.84965365
NM_144970,CXorf38,7,6,20648,4257,16391,2731.833333,608.1428571,3.850364106
NM_001126055,CASK,25,24,408100,8249,399851,16660.45833,329.96,48.47266335
NM_001126054,CASK,26,25,408100,8253,399847,15993.88,317.4230769,48.44868533
NM_003688,CASK,27,26,408100,8323,399777,15376.03846,308.2592593,48.03280067
NM_001039591,USP9X,45,44,150946,12398,138548,3148.818182,275.5111111,11.17502823
NM_001097579,GPR34,3,2,8306,1931,6375,3187.5,643.6666667,3.301398239
NM_001039590,USP9X,45,44,150946,12446,138500,3147.727273,276.5777778,11.12807328
NM_005300,GPR34,3,2,8306,1855,6451,3225.5,618.3333333,3.477628032
NM_000898,MAOB,15,14,115866,2610,113256,8089.714286,174,43.39310345
NM_000240,MAOA,15,14,91918,5345,86573,6183.785714,356.3333333,16.19700655
NM_001270458,MAOA,16,15,91918,5454,86464,5764.266667,340.875,15.85331867
NM_021140,KDM6A,29,28,239424,5799,233625,8343.75,199.9655172,40.28711847
NM_001146291,ZNF674,6,5,47734,4079,43655,8731,679.8333333,10.70237803
NM_003334,UBA1,26,25,21328,3625,17703,708.12,139.4230769,4.883586207
NM_001190417,ZNF674,6,5,47734,4082,43652,8730.4,680.3333333,10.69377756
NM_001039891,ZNF674,6,5,47734,4097,43637,8727.4,682.8333333,10.65096412
NM_032591,SLC9A7,17,16,159923,10039,149884,9367.75,590.5294118,14.93017233
NM_001077445,JADE3,11,10,148932,4721,144211,14421.1,429.1818182,30.54670621
NM_014735,JADE3,11,10,148775,4943,143832,14383.2,449.3636364,29.09811855
NM_001257291,SLC9A7,17,16,159923,10042,149881,9367.5625,590.7058824,14.92541326
NM_153280,UBA1,26,25,24330,3553,20777,831.08,136.6538462,5.847734309
NM_007137,ZNF81,5,4,85356,7864,77492,19373,1572.8,9.854018311
NM_007130,ZNF41,5,4,36786,4380,32406,8101.5,876,7.398630137
NM_006962,ZNF182,7,6,29129,3589,25540,4256.666667,512.7142857,7.116188353
NM_001178099,ZNF182,7,6,29146,3611,25535,4255.833333,515.8571429,7.071448352
NM_133499,SYN1,13,12,47958,3185,44773,3731.083333,245,14.05745683
NM_006950,SYN1,13,12,47958,3223,44735,3727.916667,247.9230769,13.87992554
NM_153380,ZNF41,5,4,36786,4253,32533,8133.25,850.6,7.649423936
NM_001007088,ZNF182,6,5,29129,3494,25635,5127,582.3333333,7.336863194
NM_005710,PQBP1,6,5,4883,1117,3766,753.2,186.1666667,3.371530886
NM_001099681,MAGIX,5,4,5316,2586,2730,682.5,517.2,1.055684455
NM_001282142,TFE3,10,9,14807,3395,11412,1268,339.5,3.361413844
NM_001032384,PQBP1,7,6,4883,973,3910,651.6666667,139,4.018499486
NM_001167990,PQBP1,7,6,5209,943,4266,711,134.7142857,4.523860021
NM_001167992,PQBP1,6,5,4647,581,4066,813.2,96.83333333,6.99827883
NM_001167989,PQBP1,7,6,5229,984,4245,707.5,140.5714286,4.31402439
NM_024859,MAGIX,6,5,5316,2815,2501,500.2,469.1666667,0.888454707
NM_006521,TFE3,10,9,14807,3460,11347,1260.777778,346,3.279479769
NM_001099682,MAGIX,5,4,5316,2571,2745,686.25,514.2,1.067677946
NM_144495,PQBP1,6,5,5227,767,4460,892,127.8333333,5.814863103
NM_001080489,GLOD5,4,3,11912,741,11171,3723.666667,185.25,15.07557355
NM_001032383,PQBP1,7,6,5227,1064,4163,693.8333333,152,3.912593985
NM_001032382,PQBP1,7,6,5227,1053,4174,695.6666667,150.4285714,3.963912631
NM_001032381,PQBP1,7,6,5227,985,4242,707,140.7142857,4.306598985
NM_001127899,CLCN5,15,14,176669,10123,166546,11896.14286,674.8666667,16.45223748
NM_001127898,CLCN5,15,14,176669,9864,166805,11914.64286,657.6,16.91048256
NM_033031,CCNB3,12,11,67373,4523,62850,5713.636364,376.9166667,13.89564448
NM_033670,CCNB3,8,7,67373,1207,66166,9452.285714,150.875,54.81855841
NM_001013742,DGKK,28,27,105333,7436,97897,3625.814815,265.5714286,13.16527703
NM_020717,SHROOM4,9,8,222403,9569,212834,26604.25,1063.222222,22.24203156
NM_006986,MAGED1,13,12,8754,2757,5997,499.75,212.0769231,2.175190424
NM_001005333,MAGED1,14,13,8754,2926,5828,448.3076923,209,1.991797676
NM_001005332,MAGED1,13,12,99297,2662,96635,8052.916667,204.7692308,36.30165289
NM_018969,GPR173,2,1,31292,4253,27039,27039,2126.5,6.357629908
NM_001111125,IQSEC2,15,14,88466,6026,82440,5888.571429,401.7333333,13.68071689
NM_020922,WNK3,24,23,165184,11367,153817,6687.695652,473.625,13.53189056
NM_017848,FAM120C,16,15,114959,8099,106860,7124,506.1875,13.19422151
NM_015107,PHF8,22,21,107496,6080,101416,4829.333333,276.3636364,16.68026316
NM_001184897,PHF8,22,21,107496,4675,102821,4896.238095,212.5,21.99379679
NM_031407,HUWE1,84,83,154619,14825,139794,1684.26506,176.4880952,9.429612142
NM_001184898,PHF8,22,21,100581,3584,96997,4618.904762,162.9090909,27.06389509
NM_001184896,PHF8,22,21,108458,5929,102529,4882.333333,269.5,17.29279811
NM_001002838,WNK3,23,22,165184,11195,153989,6999.5,486.7391304,13.75515855
NM_198510,ITIH6,13,12,49343,4981,44362,3696.833333,383.1538462,8.906243726
NM_138362,FAM104B,4,3,18095,1068,17027,5675.666667,267,15.9428839
NM_001166699,FAM104B,4,3,18095,1071,17024,5674.666667,267.75,15.89542484
NM_000032,ALAS2,11,10,22011,2038,19973,1997.3,185.2727273,9.800294406
NM_001166704,FAM104B,3,2,15952,1236,14716,7358,412,11.90614887
NM_001166703,FAM104B,3,2,15859,1408,14451,7225.5,469.3333333,10.26349432
NM_001166700,FAM104B,3,2,15952,1232,14720,7360,410.6666667,11.94805195
NM_001166702,FAM104B,3,2,15891,1330,14561,7280.5,443.3333333,10.9481203
NM_001166701,FAM104B,3,2,15952,1229,14723,7361.5,409.6666667,11.97965826
NM_001037968,ALAS2,11,10,22011,2034,19977,1997.7,184.9090909,9.821533923
NM_001037967,ALAS2,10,9,22011,1926,20085,2231.666667,192.6,10.42834891
NM_001282461,SPIN2B,3,2,1876,969,907,453.5,323,0.936016512
NM_174912,FAAH2,11,10,202521,2023,200498,20049.8,183.9090909,99.1092437
NM_001282462,SPIN2B,3,2,1876,914,962,481,304.6666667,1.052516411
NM_001006682,SPIN2B,2,1,1866,1209,657,657,604.5,0.543424318
NM_001006683,SPIN2B,2,1,1866,1206,660,660,603,0.547263682
NM_001006681,SPIN2B,2,1,1866,1261,605,605,630.5,0.479777954
NM_007156,ZXDA,1,0,5205,5205,NA,NA,5205,NA
NM_017677,MTMR8,14,13,127374,2675,124699,9592.230769,191.0714286,46.6164486
NM_001178032,ZC4H2,5,4,118944,2979,115965,28991.25,595.8,38.92749245
NM_031206,LAS1L,14,13,22226,2503,19723,1517.153846,178.7857143,7.879744307
NM_001243804,ZC4H2,5,4,118944,2724,116220,29055,544.8,42.66519824
NM_001170650,LAS1L,12,11,22226,2324,19902,1809.272727,193.6666667,8.563683305
NM_001170649,LAS1L,13,12,22226,2451,19775,1647.916667,188.5384615,8.068135455
NM_001282141,HEPH,18,17,103160,3889,99271,5839.470588,216.0555556,25.52609925
NM_001130860,HEPH,21,20,103160,4465,98695,4934.75,212.6190476,22.10414334
NM_014799,HEPH,20,19,103160,4287,98873,5203.842105,214.35,23.06344763
NM_138737,HEPH,21,20,104841,4555,100286,5014.3,216.9047619,22.01668496
NM_001011645,AR,8,7,161780,8115,153665,21952.14286,1014.375,18.93592113
NM_000044,AR,8,7,186589,10664,175925,25132.14286,1333,16.49709302
NM_002547,OPHN1,25,24,391115,7556,383559,15981.625,302.24,50.76217575
NM_001142503,STARD8,15,14,78175,4961,73214,5229.571429,330.7333333,14.75791171
NM_014725,STARD8,14,13,78175,4878,73297,5638.230769,348.4285714,15.02603526
NM_001005610,EDA,2,1,244986,848,244138,244138,424,287.8985849
NM_001005613,EDA,3,2,244986,933,244053,122026.5,311,261.5787781
NM_031276,TEX11,30,29,379779,3048,376731,12990.72414,101.6,123.5994094
NM_012310,KIF4A,31,30,130897,4532,126365,4212.166667,146.1935484,27.88283319
NM_001003811,TEX11,31,30,379779,3171,376608,12553.6,102.2903226,118.7663198
NM_007363,NONO,12,11,17978,3116,14862,1351.090909,259.6666667,4.76957638
NM_138923,TAF1,38,37,99768,7692,92076,2488.540541,202.4210526,11.97035881
NM_181672,OGT,22,21,42837,5504,37333,1777.761905,250.1818182,6.782885174
NM_018977,NLGN3,7,6,26372,3932,22440,3740,561.7142857,5.707019329
NM_001145410,NONO,10,9,17978,2894,15084,1676,289.4,5.212163096
NM_001145408,NONO,13,12,17978,3231,14747,1228.916667,248.5384615,4.564221603
NM_001145409,NONO,11,10,17978,3058,14920,1492,278,4.879005886
NM_001286074,TAF1,38,37,99768,7761,92007,2486.675676,204.2368421,11.85504445
NM_001166660,NLGN3,6,5,26372,3871,22501,4500.2,645.1666667,5.812709894
NM_004606,TAF1,38,37,99768,7755,92013,2486.837838,204.0789474,11.86499033
NM_181673,OGT,22,21,42837,5474,37363,1779.190476,248.8181818,6.825538911
NM_181303,NLGN3,8,7,26372,3993,22379,3197,499.125,5.604557976
NM_001122670,PHKA1,31,30,135367,6153,129214,4307.133333,198.483871,21.00016252
NM_017669,ERCC6L,2,1,34353,4209,30144,30144,2104.5,7.161796151
NM_002637,PHKA1,32,31,135367,6193,129174,4166.903226,193.53125,20.85806556
NM_001166448,HDAC8,5,4,99689,2047,97642,24410.5,409.4,47.70004885
NM_001166419,HDAC8,8,7,99689,2401,97288,13898.28571,300.125,40.51978342
NM_001166418,HDAC8,9,8,243589,1750,241839,30229.875,194.4444444,138.1937143
NM_001172436,PHKA1,30,29,135367,5975,129392,4461.793103,199.1666667,21.65556485
NM_001170747,PIN4,4,3,82290,1609,80681,26893.66667,402.25,50.14356743
NM_018486,HDAC8,11,10,243589,2025,241564,24156.4,184.0909091,119.2908642
NM_001039840,CHIC1,6,5,123955,6915,117040,23408,1152.5,16.92552422
NM_001008537,KIAA2022,4,3,192598,11721,180877,60292.33333,2930.25,15.43187441
NM_006517,SLC16A2,6,5,112438,4147,108291,21658.2,691.1666667,26.1130938
NM_004299,ABCB7,16,15,103170,2544,100626,6708.4,159,39.55424528
NM_001271699,ABCB7,15,14,103170,2423,100747,7196.214286,161.5333333,41.57944697
NM_001271698,ABCB7,15,14,103170,2462,100708,7193.428571,164.1333333,40.90495532
NM_001271696,ABCB7,16,15,103170,2541,100629,6708.6,158.8125,39.60212515
NM_001271697,ABCB7,15,14,103170,2420,100750,7196.428571,161.3333333,41.6322314
NM_001146257,ZDHHC15,3,2,73184,1315,71869,35934.5,438.3333333,54.65323194
NM_144969,ZDHHC15,12,11,155077,6055,149022,13547.45455,504.5833333,24.61139554
NM_001146256,ZDHHC15,11,10,155077,6027,149050,14905,547.9090909,24.73037996
NM_000489,ATRX,35,34,281401,11255,270146,7945.470588,321.5714286,24.00231008
NM_000052,ATP7A,23,22,139741,8552,131189,5963.136364,371.826087,15.34015435
NM_138270,ATRX,34,33,281401,11140,270261,8189.727273,327.6470588,24.26041293
NM_001282224,ATP7A,22,21,139741,8317,131424,6258.285714,378.0454545,15.80185163
NM_003022,SH3BGRL,4,3,96745,2066,94679,31559.66667,516.5,45.82720232
NM_153252,BRWD3,41,40,140248,12834,127414,3185.35,313.0243902,9.927847904
NM_001177479,HDX,11,10,184607,6346,178261,17826.1,576.9090909,28.0902931
NM_144657,HDX,10,9,184607,6236,178371,19819,623.6,28.60343169
NM_014496,RPS6KA6,22,21,129591,8227,121364,5779.238095,373.9545455,14.75191443
NM_001177478,HDX,10,9,184607,6198,178409,19823.22222,619.8,28.78493062
NM_024921,POF1B,17,16,102355,3965,98390,6149.375,233.2352941,24.81462799
NM_198450,APOOL,9,8,89427,6476,82951,10368.875,719.5555556,12.80898703
NM_000390,CHM,15,14,186383,5457,180926,12923.28571,363.8,33.15484699
NM_019117,KLHL4,11,10,152337,5866,146471,14647.1,533.2727273,24.96948517
NM_057162,KLHL4,11,10,151883,2558,149325,14932.5,232.5454545,58.37568413
NM_032967,PCDH11X,6,5,104748,4773,99975,19995,795.5,20.94594595
NM_014522,PCDH11X,2,1,45340,4605,40735,40735,2302.5,8.845819761
NM_001171111,FAM133A,3,2,38263,3295,34968,17484,1098.333333,10.6124431
NM_001171110,FAM133A,5,4,38263,3421,34842,8710.5,684.2,10.1847413
NM_001171109,FAM133A,4,3,38263,3385,34878,11626,846.25,10.30369276
NM_173698,FAM133A,4,3,38263,3365,34898,11632.66667,841.25,10.37087667
NM_024917,TRMT2B,14,13,42773,3571,39202,3015.538462,255.0714286,10.97787735
NM_024885,TAF7L,13,12,24820,2368,22452,1871,182.1538462,9.481418919
NM_001167972,TRMT2B,13,12,42773,3120,39653,3304.416667,240,12.70929487
NM_001167971,TRMT2B,14,13,42773,3159,39614,3047.230769,225.6428571,12.54004432
NM_006733,CENPI,21,20,63182,2584,60598,3029.9,123.047619,23.45123839
NM_001168474,TAF7L,13,12,23086,2200,20886,1740.5,169.2307692,9.493636364
NM_001167970,TRMT2B,14,13,42773,3178,39595,3045.769231,227,12.45909377
NM_022053,NXF2,23,22,79542,2424,77118,3505.363636,105.3913043,31.81435644
NM_001099686,NXF2B,23,22,79542,2424,77118,3505.363636,105.3913043,31.81435644
NM_207318,FAM199X,6,5,29428,7607,21821,4364.2,1267.833333,2.868542132
NM_031274,TEX13A,5,4,1749,1382,371,92.75,276.4,0.26845152
NM_198465,NRK,29,28,136068,8091,127977,4570.607143,279,15.8172043
NM_024539,RNF128,7,6,103180,2684,100496,16749.33333,383.4285714,37.44262295
NM_194463,RNF128,7,6,70354,2847,67507,11251.16667,406.7142857,23.71162627
NM_017681,NUP62CL,9,8,83015,1771,81244,10155.5,196.7777778,45.87464709
NM_020384,CLDN2,2,1,10487,2989,7498,7498,1494.5,2.508531281
NM_001171095,CLDN2,2,1,12503,2923,9580,9580,1461.5,3.27745467
NM_001171092,CLDN2,2,1,30699,3154,27545,27545,1577,8.733354471
NM_032428,FRMPD3,16,15,82796,7320,75476,5031.733333,457.5,10.31092896
NM_033380,COL4A5,51,50,257703,6563,251140,5022.8,128.6862745,38.26603687
NM_033641,COL4A6,45,44,282825,6745,276080,6274.545455,149.8888889,40.93106004
NM_012216,MID2,10,9,105785,7355,98430,10936.66667,735.5,13.38273283
NM_052817,MID2,10,9,105785,7265,98520,10946.66667,726.5,13.56090847
NM_001287760,COL4A6,43,42,282825,6572,276253,6577.452381,152.8372093,42.0348448
NM_001287758,COL4A6,46,45,282825,6797,276028,6133.955556,147.7608696,40.61026924
NM_001847,COL4A6,45,44,283892,6640,277252,6301.181818,147.5555556,41.75481928
NM_052936,ATG4A,13,12,63004,2327,60677,5056.416667,179,26.07520413
NM_000495,COL4A5,51,50,257703,6558,251145,5022.9,128.5882353,38.29597438
NM_178270,ATG4A,12,11,63004,2140,60864,5533.090909,178.3333333,28.4411215
NM_001287759,COL4A6,44,43,282825,6672,276153,6422.162791,151.6363636,41.38983813
NM_022977,ACSL4,17,16,92059,5352,86707,5419.1875,314.8235294,16.20085949
NM_001522,GUCY2F,20,19,109152,3718,105434,5549.157895,185.9,28.3577192
NM_004458,ACSL4,16,15,92059,5039,87020,5801.333333,314.9375,17.26929946
NM_015365,AMMECR1,6,5,123968,5423,118545,23709,903.8333333,21.85967177
NM_001025580,AMMECR1,5,4,123968,5311,118657,29664.25,1062.2,22.34174355
NM_032227,TMEM164,7,6,174676,5577,169099,28183.16667,796.7142857,30.32078178
NM_001171689,AMMECR1,8,7,246049,5612,240437,34348.14286,701.5,42.84337135
NM_145234,CHRDL1,12,11,121994,3955,118039,10730.81818,329.5833333,29.84551201
NM_017698,TMEM164,6,5,175155,4985,170170,34034,830.8333333,34.13640923
NM_001143983,CHRDL1,10,9,122204,3871,118333,13148.11111,387.1,30.56910359
NM_001143982,CHRDL1,12,11,122204,4110,118094,10735.81818,342.5,28.73333333
NM_001143981,CHRDL1,12,11,122204,4113,118091,10735.54545,342.75,28.711646
NM_002578,PAK3,18,17,124800,2772,122028,7178.117647,154,44.02164502
NM_178153,DCX,7,6,118455,9115,109340,18223.33333,1302.142857,11.99561163
NM_178151,DCX,7,6,118414,9242,109172,18195.33333,1320.285714,11.81259468
NM_000555,DCX,7,6,117369,9413,107956,17992.66667,1344.714286,11.46881972
NM_001128167,PAK3,15,14,276662,2519,274143,19581.64286,167.9333333,108.8300913
NM_001128166,PAK3,16,15,276662,2593,274069,18271.26667,162.0625,105.6957192
NM_014289,CAPN6,13,12,25449,3608,21841,1820.083333,277.5384615,6.053492239
NM_001195553,DCX,7,6,118455,9133,109322,18220.33333,1304.714286,11.96999891
NM_178152,DCX,7,6,118455,9130,109325,18220.83333,1304.285714,11.97426068
NM_133265,AMOT,12,11,65940,6526,59414,5401.272727,543.8333333,9.10419859
NM_001004308,ZCCHC16,3,2,374222,2961,371261,185630.5,987,125.3836542
NM_001256761,HTR2C,6,5,326075,4662,321413,64282.6,777,68.94315744
NM_001256760,HTR2C,7,6,326075,4849,321226,53537.66667,692.7142857,66.24582388
NM_000868,HTR2C,6,5,326075,4757,321318,64263.6,792.8333333,67.54635274
NM_001282337,PLS3,18,17,90004,3774,86230,5072.352941,209.6666667,22.84843667
NM_001145346,RBMXL3,1,0,3470,3470,NA,NA,3470,NA
NM_001243963,LRCH2,20,19,123454,4894,118560,6240,244.7,24.22558235
NM_020871,LRCH2,21,20,123454,4946,118508,5925.4,235.5238095,23.96037202
NM_005032,PLS3,16,15,90004,3626,86378,5758.533333,226.625,23.82184225
NM_001168299,KLHL13,8,7,87602,3213,84389,12055.57143,401.625,26.2648615
NM_001168303,KLHL13,7,6,219054,3330,215724,35954,475.7142857,64.78198198
NM_001168302,KLHL13,8,7,219054,3405,215649,30807,425.625,63.33303965
NM_033495,KLHL13,7,6,75927,3980,71947,11991.16667,568.5714286,18.07713568
NM_001168301,KLHL13,8,7,219529,3111,216418,30916.85714,388.875,69.56541305
NM_001168300,KLHL13,7,6,75986,3460,72526,12087.66667,494.2857143,20.96127168
NM_020721,KIAA1210,14,13,71946,7838,64108,4931.384615,559.8571429,8.179127328
NM_001184966,WDR44,18,17,103889,3897,99992,5881.882353,216.5,25.65871183
NM_001184965,WDR44,20,19,103889,4142,99747,5249.842105,207.1,24.08184452
NM_144658,DOCK11,53,52,190253,6691,183562,3530.038462,126.245283,27.4341653
NM_019045,WDR44,20,19,103889,4166,99723,5248.578947,208.3,23.93734998
NM_145802,Sep-06,10,9,77647,2573,75074,8341.555556,257.3,29.17761368
NM_145800,Sep-06,11,10,77647,2619,75028,7502.8,238.0909091,28.64757541
NM_145799,Sep-06,11,10,76426,4707,71719,7171.9,427.9090909,15.23666879
NM_015129,Sep-06,10,9,76426,3396,73030,8114.444444,339.6,21.50471143
NM_017938,TMEM255A,10,9,52888,3507,49381,5486.777778,350.7,14.08069575
NM_001104544,TMEM255A,9,8,52888,3434,49454,6181.75,381.5555556,14.4012813
NM_001104545,TMEM255A,7,6,52888,3180,49708,8284.666667,454.2857143,15.63144654
NM_001080145,CT47A2,3,2,54808,1296,53512,26756,432,41.29012346
NM_003588,CUL4B,22,21,51240,5371,45869,2184.238095,244.1363636,8.540122882
NM_001242922,CT47A12,3,2,54808,1296,53512,26756,432,41.29012346
NM_001079872,CUL4B,20,19,36373,5202,31171,1640.578947,260.1,5.992118416
NM_173571,CT47A11,3,2,54808,1296,53512,26756,432,41.29012346
NM_001080144,CT47A3,3,2,54808,1296,53512,26756,432,41.29012346
NM_001080143,CT47A4,3,2,54808,1296,53512,26756,432,41.29012346
NM_001080142,CT47A5,3,2,54808,1296,53512,26756,432,41.29012346
NM_001080139,CT47A8,3,2,54808,1296,53512,26756,432,41.29012346
NM_001080138,CT47A9,3,2,54808,1296,53512,26756,432,41.29012346
NM_001080137,CT47A10,3,2,54808,1296,53512,26756,432,41.29012346
NM_001080146,CT47A1,3,2,54808,1296,53512,26756,432,41.29012346
NM_007325,GRIA3,16,15,306672,5198,301474,20098.26667,324.875,57.99807618
NM_000828,GRIA3,16,15,306672,5198,301474,20098.26667,324.875,57.99807618
NM_001282418,STAG2,34,33,141345,6080,135265,4098.939394,178.8235294,22.24753289
NM_001042751,STAG2,34,33,140951,6101,134850,4086.363636,179.4411765,22.10293395
NM_001042750,STAG2,35,34,140951,6213,134738,3962.882353,177.5142857,21.68646387
NM_006603,STAG2,33,32,140951,6035,134916,4216.125,182.8787879,22.35559238
NM_001081550,THOC2,39,38,132494,5649,126845,3338.026316,144.8461538,22.45441671
NM_001042749,STAG2,35,34,142097,6369,135728,3992,181.9714286,21.31072382
NM_001282875,SMARCA1,24,23,77006,3997,73009,3174.304348,166.5416667,18.26594946
NM_000276,OCRL,24,23,52280,5178,47102,2047.913043,215.75,9.096562379
NM_003069,SMARCA1,25,24,77006,4133,72873,3036.375,165.32,17.63198645
NM_001587,OCRL,23,22,52280,5153,47127,2142.136364,224.0434783,9.145546284
NM_001282874,SMARCA1,25,24,77006,4034,72972,3040.5,161.36,18.08924145
NM_001127197,ELF4,9,8,45795,4105,41690,5211.25,456.1111111,10.15590743
NM_001282198,SLC25A14,10,9,33475,1413,32062,3562.444444,141.3,22.69072895
NM_001282197,SLC25A14,12,11,33475,1746,31729,2884.454545,145.5,18.17239404
NM_001282196,SLC25A14,11,10,33475,1652,31823,3182.3,150.1818182,19.26331719
NM_001282195,SLC25A14,11,10,33475,1661,31814,3181.4,151,19.15352197
NM_017666,ZNF280C,19,18,66251,4714,61537,3418.722222,248.1052632,13.05409419
NM_001421,ELF4,9,8,45582,4187,41395,5174.375,465.2222222,9.886553618
NM_001170962,IGSF1,19,18,15922,4573,11349,630.5,240.6842105,2.481740652
NM_001170961,IGSF1,20,19,15922,4616,11306,595.0526316,230.8,2.449306759
NM_001555,IGSF1,20,19,15922,4601,11321,595.8421053,230.05,2.460552054
NM_001004486,OR13H1,1,0,928,928,NA,NA,928,NA
NM_147175,HS6ST2,4,3,335387,4451,330936,110312,1112.75,74.35093237
NM_001042453,MST4,11,10,52728,3116,49612,4961.2,283.2727273,15.92169448
NM_001042452,MST4,10,9,52337,2869,49468,5496.444444,286.9,17.24224468
NM_001170704,MBNL3,9,8,120655,11541,109114,13639.25,1282.333333,9.454466684
NM_016542,MST4,12,11,52728,3348,49380,4489.090909,279,14.74910394
NM_001077188,HS6ST2,6,5,335387,4573,330814,66162.8,762.1666667,72.34069539
NM_004484,GPC3,8,7,449899,2324,447575,63939.28571,290.5,192.58821
NM_001164619,GPC3,7,6,449899,2161,447738,74623,308.7142857,207.1901897
NM_001164618,GPC3,8,7,449899,2276,447623,63946.14286,284.5,196.6709139
NM_001164617,GPC3,9,8,449899,2394,447505,55938.125,266,186.927736
NM_001448,GPC4,9,8,114143,3723,110420,13802.5,413.6666667,29.65887725
NM_138819,FAM122C,7,6,47420,1372,46048,7674.666667,196,33.56268222
NM_032458,PHF6,10,9,55482,4772,50710,5634.444444,477.2,10.62657167
NM_001170784,FAM122C,4,3,15812,2078,13734,4578,519.5,6.609239654
NM_001170783,FAM122C,3,2,15794,2257,13537,6768.5,752.3333333,5.99778467
NM_001170782,FAM122C,4,3,15812,1936,13876,4625.333333,484,7.167355372
NM_001170780,FAM122C,6,5,26574,2167,24407,4881.4,361.1666667,11.26303646
NM_001170779,FAM122C,7,6,47420,1376,46044,7674,196.5714286,33.4622093
NM_001015877,PHF6,11,10,55482,4443,51039,5103.9,403.9090909,11.48750844
NM_152582,CT45A2,5,4,8056,1033,7023,1755.75,206.6,6.798644724
NM_152695,ZNF449,5,4,18644,4064,14580,3645,812.8,3.587598425
NM_001017436,CT45A4,5,4,25307,1013,24294,6073.5,202.6,23.982231
NM_153834,GPR112,26,25,115927,9957,105970,4238.8,382.9615385,10.64276388
NM_004840,ARHGEF6,22,21,115793,5291,110502,5262,240.5,20.88489888
NM_033642,FGF13,5,4,107783,1945,105838,26459.5,389,54.41542416
NM_001139500,FGF13,7,6,573453,2319,571134,95189,331.2857143,246.2846054
NM_001139498,FGF13,6,5,573453,2150,571303,114260.6,358.3333333,265.7223256
NM_001139502,FGF13,6,5,235985,2071,233914,46782.8,345.1666667,112.9473684
NM_001139501,FGF13,8,7,573453,2430,571023,81574.71429,303.75,234.9888889
NM_004114,FGF13,5,4,80095,2682,77413,19353.25,536.4,28.86390753
NM_001171879,MCF2,26,25,61072,3875,57197,2287.88,149.0384615,14.76051613
NM_001171878,MCF2,23,22,61072,3601,57471,2612.318182,156.5652174,15.95973341
NM_001171877,MCF2,22,21,61072,3483,57589,2742.333333,158.3181818,16.5343095
NM_001171876,MCF2,29,28,126453,3896,122557,4377.035714,134.3448276,31.45713552
NM_001099855,MCF2,28,27,126453,3847,122606,4540.962963,137.3928571,31.87054848
NM_005369,MCF2,25,24,61072,3826,57246,2385.25,153.04,14.96236278
NM_001177465,MAMLD1,5,4,150905,4423,146482,36620.5,884.6,33.11824553
NM_000252,MTM1,15,14,104571,3451,101120,7222.857143,230.0666667,29.3016517
NM_024082,PRRG3,4,3,6335,1307,5028,1676,326.75,3.846977812
NM_173493,PASD1,16,15,113206,3266,109940,7329.333333,204.125,33.66197183
NM_000808,GABRA3,10,9,284199,2795,281404,31267.11111,279.5,100.6812165
NM_004961,GABRE,9,8,21557,3161,18396,2299.5,351.2222222,5.819677317
NM_001001344,ATP2B3,20,19,46809,6440,40369,2124.684211,322,6.268478261
NM_001142806,SLC6A8,13,12,7084,3127,3957,329.75,240.5384615,1.265430125
NM_001142805,SLC6A8,13,12,8298,3548,4750,395.8333333,272.9230769,1.338782413
NM_021949,ATP2B3,21,20,46809,6595,40214,2010.7,314.047619,6.097649735
NM_005629,SLC6A8,13,12,8298,3578,4720,393.3333333,275.2307692,1.319172722
NM_001166462,MPP1,13,12,26845,2210,24635,2052.916667,170,11.14705882
NM_001166461,MPP1,12,11,26845,2000,24845,2258.636364,166.6666667,12.4225
NM_001166460,MPP1,12,11,26845,2009,24836,2257.818182,167.4166667,12.36236934
NM_002436,MPP1,12,11,26845,2060,24785,2253.181818,171.6666667,12.0315534
NM_001110792,MECP2,3,2,67504,1698,65806,32903,566,38.75500589
NM_000513,OPN1MW,6,5,14269,2004,12265,2453,334,6.120259481
NM_001048181,OPN1MW2,6,5,13554,1289,12265,2453,214.8333333,9.515128006
NM_004992,MECP2,4,3,75926,10245,65681,21893.66667,2561.25,6.411029771
NM_005334,HCFC1,26,25,23813,8452,15361,614.44,325.0769231,1.817439659
NM_023934,FUNDC2,5,4,30129,2969,27160,6790,593.8,9.147861233
NM_001289,CLIC2,6,5,58496,2700,55796,11159.2,450,20.66518519
NM_001184797,TMLHE,7,6,120428,1339,119089,19848.16667,191.2857143,88.93876027
NM_018196,TMLHE,8,7,123951,3968,119983,17140.42857,496,30.23765121
NM_012227,GTPBP6,6,5,9463,1186,8277,1655.4,197.6666667,6.978920742
NM_018390,PLCXD1,7,6,21963,5311,16652,2775.333333,758.7142857,3.135379401
NM_013239,PPP2R3B,13,12,53024,2439,50585,4215.416667,187.6153846,20.7400574
NM_006883,SHOX,6,5,35069,1957,33112,6622.4,326.1666667,16.91977517
NM_000451,SHOX,6,5,22481,3763,18718,3743.6,627.1666667,4.974222695
NM_001161532,CSF2RA,11,10,41137,1633,39504,3950.4,148.4545455,24.1910594
NM_001161531,CSF2RA,13,12,37020,1523,35497,2958.083333,117.1538462,23.30728825
NM_001161530,CSF2RA,12,11,27259,1799,25460,2314.545455,149.9166667,14.15230684
NM_001161529,CSF2RA,14,13,41137,1995,39142,3010.923077,142.5,19.62005013
NM_001012288,CRLF2,5,4,16642,676,15966,3991.5,135.2,23.6183432
NM_006140,CSF2RA,13,12,41137,1866,39271,3272.583333,143.5384615,21.04555198
NM_022148,CRLF2,6,5,16638,776,15862,3172.4,129.3333333,20.44072165
NM_172249,CSF2RA,9,8,41137,1465,39672,4959,162.7777778,27.07986348
NM_172247,CSF2RA,10,9,27259,1598,25661,2851.222222,159.8,16.05819775
NM_172246,CSF2RA,11,10,41137,1685,39452,3945.2,153.1818182,23.41364985
NM_172245,CSF2RA,13,12,41137,1842,39295,3274.583333,141.6923077,21.33279045
NM_002183,IL3RA,12,11,46075,1722,44353,4032.090909,143.5,25.75667828
NM_001173473,ASMTL,13,12,50625,2061,48564,4047,158.5384615,23.56331878
NM_001173474,ASMTL,12,11,49840,2097,47743,4340.272727,174.75,22.7672866
NM_001636,SLC25A6,4,3,5996,1488,4508,1502.666667,372,3.029569892
NM_001267713,IL3RA,10,9,46075,1486,44589,4954.333333,148.6,30.00605653
NM_004192,ASMTL,13,12,49840,2146,47694,3974.5,165.0769231,22.22460391
NM_178129,P2RY8,2,1,74573,4236,70337,70337,2118,16.60457979
NM_001171039,ASMT,7,6,27950,1038,26912,4485.333333,148.2857143,25.92678227
NM_001171038,ASMT,9,8,28035,1350,26685,3335.625,150,19.76666667
NM_005088,AKAP17A,5,4,10927,3213,7714,1928.5,642.6,2.40087146
NM_004043,ASMT,10,9,47628,1344,46284,5142.666667,134.4,34.4375
NM_001171136,ZBED1,2,1,14555,4512,10043,10043,2256,2.225842199
NM_001171135,ZBED1,2,1,14127,4590,9537,9537,2295,2.077777778
NM_004729,ZBED1,2,1,14555,4509,10046,10046,2254.5,2.227988468
NM_001141920,XG,10,9,64450,2899,61551,6839,289.9,21.23180407
NM_001141919,XG,11,10,64450,2942,61508,6150.8,267.4545455,20.90686608
NM_175569,XG,10,9,64450,2896,61554,6839.333333,289.6,21.25483425
NM_001282628,ARSE,12,11,29823,2518,27305,2482.272727,209.8333333,10.84392375
NM_000047,ARSE,11,10,29823,2231,27592,2759.2,202.8181818,12.36754818
NM_001669,ARSD,10,9,25407,5193,20214,2246,519.3,3.89254766
NM_001011719,ARSH,9,8,26774,1698,25076,3134.5,188.6666667,14.76796231
NM_015419,MXRA5,7,6,38077,9799,28278,4713,1399.857143,2.885804674
NM_016379,VCX3A,3,2,1502,998,504,252,332.6666667,0.50501002
NM_001135565,HDHD1,5,4,99272,2214,97058,24264.5,442.8,43.83830172
NM_012080,HDHD1,4,3,99272,2144,97128,32376,536,45.30223881
NM_001178136,HDHD1,4,3,99272,2015,97257,32419,503.75,48.26650124
NM_001178135,HDHD1,4,3,90606,829,89777,29925.66667,207.25,108.2955368
NM_013452,VCX,3,2,1883,970,913,456.5,323.3333333,0.941237113
NM_001172672,PNPLA4,6,5,28978,2565,26413,5282.6,427.5,10.29746589
NM_001142389,PNPLA4,7,6,28978,2759,26219,4369.833333,394.1428571,9.503080826
NM_004650,PNPLA4,7,6,28673,2854,25819,4303.166667,407.7142857,9.046601261
NM_016378,VCX2,3,2,1325,818,507,253.5,272.6666667,0.619804401
NM_001001888,VCX3B,3,2,1682,1178,504,252,392.6666667,0.427843803
NM_001171186,FAM9A,10,9,10543,1553,8990,998.8888889,155.3,5.788795879
NM_174951,FAM9A,10,9,10589,1528,9061,1006.777778,152.8,5.929973822
NM_205849,FAM9B,8,7,8081,1071,7010,1001.428571,133.875,6.545284781
NM_001195081,LOC100288814,1,0,646,646,NA,NA,646,NA
NM_001830,CLCN4,13,12,80716,6801,73915,6159.583333,523.1538462,10.86825467
NM_001256944,CLCN4,11,10,80716,6544,74172,7417.2,594.9090909,11.33435208
NM_001142,AMELX,6,5,7350,799,6551,1310.2,133.1666667,8.198998748
NM_182681,AMELX,5,4,7350,750,6600,1650,150,8.8
NM_182680,AMELX,7,6,7350,842,6508,1084.666667,120.2857143,7.729216152
NM_001282174,MSL3,12,11,17596,2274,15322,1392.909091,189.5,6.737906772
NM_078629,MSL3,13,12,17596,2358,15238,1269.833333,181.3846154,6.462256149
NM_078628,MSL3,9,8,9820,3533,6287,785.875,392.5555556,1.779507501
NM_001193270,MSL3,13,12,17173,2343,14830,1235.833333,180.2307692,6.329492104
NM_006800,MSL3,12,11,16139,2327,13812,1255.636364,193.9166667,5.935539321
NM_001039091,PRPS2,7,6,32874,2547,30327,5054.5,363.8571429,11.90694935
NM_002765,PRPS2,7,6,32874,2538,30336,5056,362.5714286,11.95271868
NM_016562,TLR7,3,2,23280,4995,18285,9142.5,1665,3.660660661
NM_138636,TLR8,2,1,16551,4218,12333,12333,2109,2.923897582
NM_021109,TMSB4X,3,2,2122,632,1490,745,210.6666667,2.357594937
NM_174901,FAM9C,8,7,9183,1263,7920,1131.428571,157.875,6.270783848
NM_001135995,ATXN3L,1,0,1752,1752,NA,NA,1752,NA
NM_001195328,RAB9A,2,1,20706,1275,19431,19431,637.5,15.24
NM_001128835,TRAPPC2,6,5,22395,2860,19535,3907,476.6666667,6.83041958
NM_001011658,TRAPPC2,6,5,22395,2866,19529,3905.8,477.6666667,6.814026518
NM_014563,TRAPPC2,5,4,22395,2723,19672,4918,544.6,7.22438487
NM_152634,TCEANC,4,3,10942,1959,8983,2994.333333,489.75,4.585502808
NM_004251,RAB9A,3,2,20706,1365,19341,9670.5,455,14.16923077
NM_005278,GPM6B,7,6,43223,1666,41557,6926.166667,238,24.94417767
NM_001001996,GPM6B,8,7,43223,1787,41436,5919.428571,223.375,23.18746503
NM_001001995,GPM6B,8,7,46254,3224,43030,6147.142857,403,13.34677419
NM_001042480,GEMIN8,4,3,23192,3093,20099,6699.666667,773.25,6.498221791
NM_001042479,GEMIN8,5,4,23192,3176,20016,5004,635.2,6.302267003
NM_017856,GEMIN8,5,4,23192,3264,19928,4982,652.8,6.105392157
NM_001018113,FANCB,10,9,29657,3018,26639,2959.888889,301.8,8.826706428
NM_152581,MOSPD2,15,14,47934,3224,44710,3193.571429,214.9333333,13.867866
NM_001177475,MOSPD2,14,13,36048,3187,32861,2527.769231,227.6428571,10.31095074
NM_152633,FANCB,9,8,29657,2896,26761,3345.125,321.7777778,9.240676796
NM_080873,ASB11,7,6,33917,2794,31123,5187.166667,399.1428571,11.13922691
NM_024087,ASB9,7,6,26186,1769,24417,4069.5,252.7142857,13.8027134
NM_001201583,ASB11,7,6,33917,2743,31174,5195.666667,391.8571429,11.36492891
NM_001168531,ASB9,8,7,26482,1957,24525,3503.571429,244.625,12.53193664
NM_001168530,ASB9,7,6,26186,1739,24447,4074.5,248.4285714,14.05807936
NM_001031739,ASB9,7,6,26186,1708,24478,4079.666667,244,14.33138173
NM_001012428,ASB11,7,6,32852,2785,30067,5011.166667,397.8571429,10.79605027
NM_002641,PIGA,6,5,16105,3632,12473,2494.6,605.3333333,3.434196035
NM_020473,PIGA,5,4,16105,2854,13251,3312.75,570.8,4.642957253
NM_004469,FIGF,7,6,38824,2081,36743,6123.833333,297.2857143,17.65641519
NM_203281,BMX,19,18,55754,2602,53152,2952.888889,136.9473684,20.42736357
NM_001721,BMX,19,18,49223,2540,46683,2593.5,133.6842105,18.37913386
NM_020665,TMEM27,6,5,37717,1586,36131,7226.2,264.3333333,22.78121059
NM_007220,CA5B,8,7,49338,6040,43298,6185.428571,755,7.168543046
NM_005089,ZRSR2,11,10,32810,1522,31288,3128.8,138.3636364,20.55716163
NM_001277307,MAGEB17,2,1,3914,1365,2549,2549,682.5,1.867399267
NM_005314,GRPR,3,2,30219,2684,27535,13767.5,894.6666667,10.25894188
NM_004057,S100G,3,2,4512,456,4056,2028,152,8.894736842
NM_001168683,TXLNG,8,7,58089,4008,54081,7725.857143,501,13.49326347
NM_002893,RBBP7,12,11,25761,2031,23730,2157.272727,169.25,11.68389956
NM_018360,TXLNG,10,9,58089,4406,53683,5964.777778,440.6,12.18406718
NM_001198719,RBBP7,12,11,25205,2019,23186,2107.818182,168.25,11.48390292
NM_006746,SCML1,7,6,17541,2860,14681,2446.833333,408.5714286,5.133216783
NM_001037536,SCML1,6,5,17541,2707,14834,2966.8,451.1666667,5.479867011
NM_001037540,SCML1,8,7,17541,2942,14599,2085.571429,367.75,4.962270564
NM_001037535,SCML1,6,5,17541,2710,14831,2966.2,451.6666667,5.472693727
NM_000330,RS1,6,5,32417,3032,29385,5877,505.3333333,9.691622691
NM_000292,PHKA2,33,32,92066,5358,86708,2709.625,162.3636364,16.18290407
NM_000284,PDHA1,11,10,17816,3383,14433,1443.3,307.5454545,4.266331658
NM_001173456,PDHA1,10,9,17816,3289,14527,1614.111111,328.9,4.416844026
NM_001173455,PDHA1,11,10,17816,3404,14412,1441.2,309.4545455,4.233842538
NM_001173454,PDHA1,12,11,17816,3498,14318,1301.636364,291.5,4.093196112
NM_198279,CXorf23,11,10,57404,6503,50901,5090.1,591.1818182,7.827310472
NM_001412,EIF1AX,7,6,17332,4438,12894,2149,634,2.905362776
NM_153270,KLHL34,1,0,2841,2841,NA,NA,2841,NA
NM_206923,YY2,1,0,2742,2742,NA,NA,2742,NA
NM_004595,SMS,11,10,54266,1850,52416,5241.6,168.1818182,28.33297297
NM_001258423,SMS,9,8,54266,1689,52577,6572.125,187.6666667,31.12907046
NM_152577,ZNF645,1,0,1548,1548,NA,NA,1548,NA
NM_182699,DDX53,1,0,2130,2130,NA,NA,2130,NA
NM_173495,PTCHD1,3,2,61935,5294,56641,28320.5,1764.666667,10.69909331
NM_006406,PRDX4,7,6,18871,928,17943,2990.5,132.5714286,19.33512931
NM_002970,SAT1,6,5,3054,1070,1984,396.8,178.3333333,1.854205607
NM_152761,CXorf58,9,8,31503,1556,29947,3743.375,172.8888889,19.24614396
NM_001169574,CXorf58,9,8,31503,1550,29953,3744.125,172.2222222,19.32451613
NM_030624,KLHL15,4,3,43472,6280,37192,12397.33333,1570,5.922292994
NM_001415,EIF2S3,12,11,23864,3477,20387,1853.363636,289.75,5.863387978
NM_001178086,ZFX,6,5,66612,6807,59805,11961,1134.5,8.785808726
NM_001178095,ZFX,8,7,66612,7542,59070,8438.571429,942.75,7.832140016
NM_001178085,ZFX,11,10,66528,7751,58777,5877.7,704.6363636,7.583150561
NM_001178084,ZFX,8,7,66533,7404,59129,8447,925.5,7.986088601
NM_003410,ZFX,10,9,66520,7614,58906,6545.111111,761.4,7.736537956
NM_001136233,SUPT20HL2,1,0,2455,2455,NA,NA,2455,NA
NM_001136234,SUPT20HL1,1,0,2665,2665,NA,NA,2665,NA
NM_139058,ARX,5,4,12254,2879,9375,2343.75,575.8,3.256339007
NM_173699,MAGEB18,3,2,2395,1815,580,290,605,0.319559229
NM_173523,MAGEB6,2,1,3208,1951,1257,1257,975.5,0.644284982
NM_001271752,MAGEB5,2,1,2103,1218,885,885,609,0.726600985
NM_001136533,DCAF8L2,1,0,2014,2014,NA,NA,2014,NA
NM_182506,MAGEB10,3,2,15026,1956,13070,6535,652,6.68200409
NM_001017930,DCAF8L1,1,0,3458,3458,NA,NA,3458,NA
NM_002364,MAGEB2,2,1,4533,1614,2919,2919,807,1.808550186
NM_002363,MAGEB1,4,3,8309,1869,6440,2146.666667,467.25,3.445692884
NM_002365,MAGEB3,5,4,7059,2311,4748,1187,462.2,2.054521852
NM_002367,MAGEB4,1,0,2253,2253,NA,NA,2253,NA
NM_177415,MAGEB1,3,2,8309,1785,6524,3262,595,3.654901961
NM_177404,MAGEB1,2,1,4886,1710,3176,3176,855,1.857309942
NM_000475,NR0B1,2,1,4958,1587,3371,3371,793.5,2.124133585
NM_025159,CXorf21,3,2,19094,1930,17164,8582,643.3333333,8.893264249
NM_001128127,GK,20,19,78103,4579,73524,3869.684211,228.95,16.05678096
NM_000167,GK,19,18,78103,4491,73612,4089.555556,236.3684211,16.39100423
NM_203391,GK,20,19,78103,4510,73593,3873.315789,225.5,16.31773836
NM_001205019,GK,21,20,78103,4598,73505,3675.25,218.952381,15.98629839
NM_152787,TAB3,11,10,61954,6798,55156,5515.6,618,8.113562813
NM_031894,FTHL17,1,0,814,814,NA,NA,814,NA
NM_004019,DMD,9,8,88714,1580,87134,10891.75,175.5555556,55.14810127
NM_203408,FAM47A,1,0,2580,2580,NA,NA,2580,NA
NM_031442,TMEM47,3,2,30226,4057,26169,13084.5,1352.333333,6.450332758
NM_152631,FAM47B,1,0,2123,2123,NA,NA,2123,NA
NM_001099921,MAGEB16,2,1,5395,1820,3575,3575,910,1.964285714
NM_152632,CXorf22,16,15,70420,3629,66791,4452.733333,226.8125,18.40479471
NM_173695,CHDC2,11,10,98136,1967,96169,9616.9,178.8181818,48.89120488
NM_001271682,FTH1P18,1,0,914,914,NA,NA,914,NA
NM_001013736,FAM47C,1,0,3309,3309,NA,NA,3309,NA
NM_021083,XK,3,2,46252,5088,41164,20582,1696,8.090408805
NM_000397,CYBB,13,12,33446,4331,29115,2426.25,333.1538462,6.722465943
NM_006520,DYNLT3,5,4,8802,2221,6581,1645.25,444.2,2.963079694
NM_012274,CXorf27,1,0,502,502,NA,NA,502,NA
NM_001163334,SYTL5,17,16,95288,4722,90566,5660.375,277.7647059,19.17958492
NM_001034853,RPGR,15,14,43088,4733,38355,2739.642857,315.5333333,8.1037397
NM_021242,MID1IP1,3,2,5100,3786,1314,657,1262,0.347068146
NM_001098790,MID1IP1,3,2,5100,2011,3089,1544.5,670.3333333,1.536051716
NM_001098791,MID1IP1,2,1,5100,1906,3194,3194,953,1.675760756
NM_001123385,BCOR,15,14,46222,6438,39784,2841.714286,429.2,6.179558869
NM_017745,BCOR,15,14,46222,6336,39886,2849,422.4,6.295138889
NM_005765,ATP6AP2,9,8,25674,2045,23629,2953.625,227.2222222,11.55452323
NM_001195522,MPC1L,1,0,575,575,NA,NA,575,NA
NM_004229,MED14,31,30,86011,6799,79212,2640.4,219.3225806,11.65053684
NM_001289773,MED14-AS1,2,1,3307,906,2401,2401,453,2.650110375
NM_001193416,DDX3X,17,16,16875,5410,11465,716.5625,318.2352941,2.11922366
NM_001193417,DDX3X,16,15,16875,5364,11511,767.4,335.25,2.145973154
NM_001356,DDX3X,17,16,16875,5413,11462,716.375,318.4117647,2.11749492
NM_022567,NYX,2,1,28194,2631,25563,25563,1315.5,9.716077537
NM_080817,GPR82,3,2,5982,3352,2630,1315,1117.333333,0.784606205
NM_000266,NDP,3,2,24899,2005,22894,11447,668.3333333,11.41845387
NM_173794,FUNDC1,5,4,19338,1175,18163,4540.75,235,15.45787234
NM_022076,DUSP21,1,0,887,887,NA,NA,887,NA
NM_024689,CXorf36,3,2,38593,2516,36077,18038.5,838.6666667,14.33903021
NM_176819,CXorf36,5,4,52530,4661,47869,11967.25,932.2,10.27011371
NM_001129899,KRBOX4,7,6,27452,2493,24959,4159.833333,356.1428571,10.01163257
NM_001129898,KRBOX4,6,5,27452,2448,25004,5000.8,408,10.21405229
NM_017776,KRBOX4,6,5,27452,2433,25019,5003.8,405.5,10.28318948
NM_001129900,KRBOX4,7,6,27452,2478,24974,4162.333333,354,10.07828894
NM_019886,CHST7,2,1,24811,2476,22335,22335,1238,9.020597738
NM_006915,RP2,5,4,45446,3834,41612,10403,766.8,10.8534168
NM_152856,RBM10,23,22,41599,3191,38408,1745.818182,138.7391304,12.03635224
NM_152869,RGN,8,7,14961,2265,12696,1813.714286,283.125,5.605298013
NM_019056,NDUFB11,3,2,2996,1127,1869,934.5,375.6666667,1.658385093
NM_001135998,NDUFB11,3,2,2996,1097,1899,949.5,365.6666667,1.731084777
NM_001282848,RGN,8,7,14961,2216,12745,1820.714286,277,5.751353791
NM_001282849,RGN,7,6,14961,2048,12913,2152.166667,292.5714286,6.305175781
NM_001204467,RBM10,24,23,41599,3423,38176,1659.826087,142.625,11.15278995
NM_001204468,RBM10,24,23,41599,3457,38142,1658.347826,144.0416667,11.03326584
NM_001204466,RBM10,23,22,41599,3194,38405,1745.681818,138.8695652,12.0241077
NM_005676,RBM10,24,23,41599,3426,38173,1659.695652,142.75,11.14214828
NM_004683,RGN,7,6,14961,1644,13317,2219.5,234.8571429,8.100364964
NM_006201,CDK16,16,15,11320,3169,8151,543.4,198.0625,2.572104765
NM_033018,CDK16,16,15,11868,3276,8592,572.8,204.75,2.622710623
NM_001170460,CDK16,16,15,6979,3034,3945,263,189.625,1.300263678
NM_004651,USP11,21,20,15415,3311,12104,605.2,157.6666667,3.655693144
NM_003446,ZNF157,4,3,43101,1699,41402,13800.66667,424.75,24.36845203
NM_003254,TIMP1,6,5,4502,922,3580,716,153.6666667,3.882863341
NM_001654,ARAF,16,15,10823,2512,8311,554.0666667,157,3.308519108
NM_001256196,ARAF,16,15,10823,2521,8302,553.4666667,157.5625,3.293137644
NM_001256197,ARAF,6,5,4876,1398,3478,695.6,233,2.487839771
NM_001114123,ELK1,7,6,15086,2925,12161,2026.833333,417.8571429,4.157606838
NM_005229,ELK1,6,5,15086,2818,12268,2453.6,469.6666667,4.353442158
NM_002621,CFP,10,9,6094,1724,4370,485.5555556,172.4,2.534802784
NM_001257168,ELK1,6,5,15086,2046,13040,2608,341,6.373411535
NM_001145252,CFP,9,8,5759,1607,4152,519,178.5555556,2.583696329
NM_004182,UXT,7,6,7390,606,6784,1130.666667,86.57142857,11.19471947
NM_153477,UXT,6,5,7390,783,6607,1321.4,130.5,8.438058748
NM_001079900,SPACA5B,4,3,1958,599,1359,453,149.75,2.268781302
NM_001037735,ZNF630,5,4,12943,2521,10422,2605.5,504.2,4.13407378
NM_001282201,ZNF630,5,4,13460,2836,10624,2656,567.2,3.746121298
NM_001190255,ZNF630,5,4,13460,2595,10865,2716.25,519,4.186897881
NM_205856,SPACA5,5,4,5394,737,4657,1164.25,147.4,6.318860244
NM_001282202,ZNF630,5,4,13460,2832,10628,2657,566.4,3.752824859
NM_001079900,SPACA5B,4,3,1958,599,1359,453,149.75,2.268781302
NM_021015,SSX5,9,8,10545,1393,9152,1144,154.7777778,6.569992821
NM_205856,SPACA5,5,4,5394,737,4657,1164.25,147.4,6.318860244
NM_175723,SSX5,8,7,10545,1269,9276,1325.142857,158.625,7.309692671
NM_021014,SSX3,8,7,10327,1327,9000,1285.714286,165.875,6.782215524
NM_001278691,SSX1,9,8,12129,1393,10736,1342,154.7777778,7.707106963
NM_005635,SSX1,8,7,12129,1306,10823,1546.142857,163.25,8.287136294
NM_012280,FTSJ1,13,12,10345,2104,8241,686.75,161.8461538,3.916825095
NM_001282157,FTSJ1,9,8,10345,1678,8667,1083.375,186.4444444,5.165077473
NM_001034832,SSX4B,8,7,9830,1236,8594,1227.714286,154.5,6.953074434
NM_001034832,SSX4B,8,7,9833,1236,8597,1228.142857,154.5,6.955501618
NM_001040612,SSX4B,7,6,9830,1099,8731,1455.166667,157,7.944494995
NM_001040612,SSX4B,7,6,9833,1099,8734,1455.666667,157,7.94722475
NM_175729,SSX4,7,6,9819,1088,8731,1455.166667,155.4285714,8.024816176
NM_033518,SLC38A5,17,16,11726,2013,9713,607.0625,118.4117647,4.825136612
NM_005636,SSX4,8,7,9819,1225,8594,1227.714286,153.125,7.015510204
NM_005636,SSX4,8,7,9822,1225,8597,1228.142857,153.125,7.017959184
NM_177439,FTSJ1,14,13,10345,2205,8140,626.1538462,157.5,3.691609977
NM_175729,SSX4,7,6,9822,1088,8734,1455.666667,155.4285714,8.027573529
NM_203475,PORCN,15,14,11857,1921,9936,709.7142857,128.0666667,5.172306091
NM_203473,PORCN,14,13,11857,1905,9952,765.5384615,136.0714286,5.224146982
NM_006579,EBP,5,4,6942,1162,5780,1445,232.4,4.974182444
NM_001282167,PORCN,13,12,11857,2031,9826,818.8333333,156.2307692,4.838010832
NM_022825,PORCN,13,12,11857,1886,9971,830.9166667,145.0769231,5.286850477
NM_006743,RBM3,7,6,6814,4439,2375,395.8333333,634.1428571,0.535030412
NM_002536,TBC1D25,6,5,22924,3818,19106,3821.2,636.3333333,5.004190676
NM_017883,WDR13,9,8,7704,2134,5570,696.25,237.1111111,2.610121837
NM_203474,PORCN,13,12,11032,1756,9276,773,135.0769231,5.282460137
NM_001166426,WDR13,8,7,7360,2468,4892,698.8571429,308.5,1.982171799
NM_000377,WAS,12,11,7633,1842,5791,526.4545455,153.5,3.143865364
NM_001282166,SUV39H1,6,5,13463,2989,10474,2094.8,498.1666667,3.504182001
NM_003173,SUV39H1,6,5,12284,2742,9542,1908.4,457,3.479941648
NM_002049,GATA1,6,5,7737,1485,6252,1250.4,247.5,4.21010101
NM_005834,TIMM17B,7,6,4698,957,3741,623.5,136.7142857,3.909090909
NM_006044,HDAC6,29,28,22895,4128,18767,670.25,142.3448276,4.54626938
NM_013271,PCSK1N,3,2,4540,1060,3480,1740,353.3333333,3.283018868
NM_001167947,TIMM17B,8,7,4698,1108,3590,512.8571429,138.5,3.240072202
NM_181532,ERAS,2,1,3358,828,2530,2530,414,3.055555556
NM_017602,OTUD5,9,8,35592,2934,32658,4082.25,326,11.13087935
NM_006875,PIM2,6,5,5956,2193,3763,752.6,365.5,1.715914273
NM_001042498,SLC35A2,4,3,8348,2623,5725,1908.333333,655.75,2.182615326
NM_001136159,OTUD5,9,8,36347,2419,33928,4241,268.7777778,14.02563043
NM_001136158,OTUD5,10,9,35592,2694,32898,3655.333333,269.4,12.21158129
NM_001136157,OTUD5,9,8,35592,2919,32673,4084.125,324.3333333,11.19321686
NM_005660,SLC35A2,5,4,8780,1776,7004,1751,355.2,3.943693694
NM_001032289,SLC35A2,4,3,8348,2033,6315,2105,508.25,3.106246926
NM_020137,GRIPAP1,26,25,28546,3061,25485,1019.4,117.7307692,8.325710552
NM_001282649,SLC35A2,3,2,8348,2439,5909,2954.5,813,2.422714227
NM_001282650,SLC35A2,4,3,8348,2662,5686,1895.333333,665.5,2.135987979
NM_001282648,SLC35A2,4,3,8348,1720,6628,2209.333333,430,3.853488372
NM_001282647,SLC35A2,5,4,8780,1186,7594,1898.5,237.2,6.403035413
NM_004979,KCND1,6,5,9614,4726,4888,977.6,787.6666667,1.03427846
NM_001282651,SLC35A2,5,4,8348,2708,5640,1410,541.6,2.082717873
NM_007075,WDR45,12,11,25969,1907,24062,2187.454545,158.9166667,12.61772417
NM_001163322,CCDC120,11,10,11015,3572,7443,744.3,324.7272727,2.083706607
NM_001163321,CCDC120,11,10,11015,3631,7384,738.4,330.0909091,2.033599559
NM_001029896,WDR45,11,10,5474,1636,3838,383.8,148.7272727,2.34596577
NM_033626,CCDC120,10,9,11015,4001,7014,779.3333333,400.1,1.753061735
NM_015698,GPKOW,11,10,9830,1757,8073,807.3,159.7272727,4.594763802
NM_001271836,CCDC120,10,9,16551,4412,12139,1348.777778,441.2,2.751359927
NM_001271835,CCDC120,10,9,11015,4060,6955,772.7777778,406,1.713054187
NM_001163323,CCDC120,10,9,11015,4060,6955,772.7777778,406,1.713054187
NM_007213,PRAF2,3,2,2893,1313,1580,790,437.6666667,1.203351104
NM_014009,FOXP3,12,11,14393,2394,11999,1090.818182,199.5,5.012113617
NM_003179,SYP,7,6,12398,2440,9958,1659.666667,348.5714286,4.081147541
NM_033215,PPP1R3F,4,3,18251,3434,14817,4939,858.5,4.314793244
NM_006150,PRICKLE3,9,8,10872,1999,8873,1109.125,222.1111111,4.43871936
NM_001256789,CACNA1F,48,47,28312,6085,22227,472.9148936,126.7708333,3.652752671
NM_001256790,CACNA1F,48,47,28312,5923,22389,476.3617021,123.3958333,3.78001013
NM_014008,CCDC22,17,16,15062,2336,12726,795.375,137.4117647,5.447773973
NM_002668,PLP2,5,4,3286,1053,2233,558.25,210.6,2.120607787
NM_001114377,FOXP3,11,10,14393,2288,12105,1210.5,208,5.290646853
NM_001184745,PPP1R3F,4,3,18251,2491,15760,5253.333333,622.75,6.326776395
NM_005183,CACNA1F,48,47,28312,6118,22194,472.212766,127.4583333,3.627656097
NM_021123,GAGE7,5,4,7263,502,6761,1690.25,100.4,13.46812749
NM_001098405,GAGE12F,4,3,15618,358,15260,5086.666667,89.5,42.62569832
NM_012196,GAGE8,5,4,7262,522,6740,1685,104.4,12.91187739
NM_001477,GAGE12I,5,4,7268,507,6761,1690.25,101.4,13.33530572
NM_001472,GAGE2C,5,4,16836,543,16293,4073.25,108.6,30.00552486
NM_001472,GAGE2C,5,4,16806,543,16263,4065.75,108.6,29.95027624
NM_001472,GAGE2C,5,4,7322,543,6779,1694.75,108.6,12.48434622
NM_001475,GAGE5,5,4,7288,527,6761,1690.25,105.4,12.82922201
NM_001474,GAGE4,5,4,7292,531,6761,1690.25,106.2,12.73258004
NM_001098413,GAGE10,5,4,16188,554,15634,3908.5,110.8,28.22021661
NM_001098412,GAGE13,5,4,7273,531,6742,1685.5,106.2,12.69679849
NM_001098411,GAGE2B,5,4,7291,514,6777,1694.25,102.8,13.1848249
NM_001098407,GAGE2D,5,4,26382,566,25816,6454,113.2,45.61130742
NM_001098407,GAGE2D,5,4,7306,566,6740,1685,113.2,11.90812721
NM_001098407,GAGE2D,5,4,7345,566,6779,1694.75,113.2,11.9770318
NM_001098406,GAGE12J,5,4,7352,569,6783,1695.75,113.8,11.92091388
NM_001127200,GAGE2E,5,4,7267,525,6742,1685.5,105,12.84190476
NM_001127200,GAGE2E,5,4,7318,522,6796,1699,104.4,13.01915709
NM_001127200,GAGE2E,5,4,7262,522,6740,1685,104.4,12.91187739
NM_001098409,GAGE12G,5,4,7368,569,6799,1699.75,113.8,11.94903339
NM_001098409,GAGE12G,5,4,7359,569,6790,1697.5,113.8,11.93321617
NM_001098410,GAGE12H,5,4,7366,569,6797,1699.25,113.8,11.94551845
NM_001098410,GAGE12H,5,4,7366,569,6797,1699.25,113.8,11.94551845
NM_001098410,GAGE12H,5,4,7362,569,6793,1698.25,113.8,11.93848858
NM_001098408,GAGE12C,5,4,7366,569,6797,1699.25,113.8,11.94551845
NM_001098408,GAGE12C,5,4,7366,569,6797,1699.25,113.8,11.94551845
NM_001098408,GAGE12C,5,4,7362,569,6793,1698.25,113.8,11.93848858
NM_001098408,GAGE12C,5,4,7368,569,6799,1699.75,113.8,11.94903339
NM_001098408,GAGE12C,5,4,7359,569,6790,1697.5,113.8,11.93321617
NM_001098408,GAGE12C,5,4,7357,569,6788,1697,113.8,11.92970123
NM_001098405,GAGE12F,4,3,6119,358,5761,1920.333333,89.5,16.09217877
NM_001098405,GAGE12F,4,3,6110,358,5752,1917.333333,89.5,16.06703911
NM_001127345,GAGE12B,5,4,7267,470,6797,1699.25,94,14.46170213
NM_001127345,GAGE12B,5,4,7267,470,6797,1699.25,94,14.46170213
NM_001127345,GAGE12B,5,4,7263,470,6793,1698.25,94,14.45319149
NM_001127199,GAGE12D,5,4,7387,590,6797,1699.25,118,11.52033898
NM_001127199,GAGE12D,5,4,7387,590,6797,1699.25,118,11.52033898
NM_001127199,GAGE12D,5,4,7383,590,6793,1698.25,118,11.51355932
NM_001127199,GAGE12D,5,4,7389,590,6799,1699.75,118,11.52372881
NM_001127199,GAGE12D,5,4,7380,590,6790,1697.5,118,11.50847458
NM_001127199,GAGE12D,5,4,7378,590,6788,1697,118,11.50508475
NM_001040663,GAGE1,5,4,9525,3003,6522,1630.5,600.6,2.171828172
NM_001477,GAGE12I,5,4,7306,507,6799,1699.75,101.4,13.41025641
NM_001477,GAGE12I,5,4,7297,507,6790,1697.5,101.4,13.39250493
NM_001476,GAGE6,5,4,7329,530,6799,1699.75,106,12.82830189
NM_001476,GAGE6,5,4,7320,530,6790,1697.5,106,12.81132075
NM_001098418,GAGE12E,5,4,7368,569,6799,1699.75,113.8,11.94903339
NM_001098418,GAGE12E,5,4,7359,569,6790,1697.5,113.8,11.93321617
NM_001098418,GAGE12E,5,4,7357,569,6788,1697,113.8,11.92970123
NM_001098409,GAGE12G,5,4,7366,569,6797,1699.25,113.8,11.94551845
NM_001098409,GAGE12G,5,4,7366,569,6797,1699.25,113.8,11.94551845
NM_001098409,GAGE12G,5,4,7362,569,6793,1698.25,113.8,11.93848858
NM_001098418,GAGE12E,5,4,7366,569,6797,1699.25,113.8,11.94551845
NM_001098418,GAGE12E,5,4,7366,569,6797,1699.25,113.8,11.94551845
NM_001098418,GAGE12E,5,4,7362,569,6793,1698.25,113.8,11.93848858
NM_001127212,GAGE2A,5,4,7314,547,6767,1691.75,109.4,12.37111517
NM_001098410,GAGE12H,5,4,7357,569,6788,1697,113.8,11.92970123
NM_003785,PAGE1,6,5,8544,670,7874,1574.8,111.6666667,11.75223881
NM_007003,PAGE4,5,4,4733,565,4168,1042,113,7.37699115
NM_001145073,USP27X,1,0,2700,2700,NA,NA,2700,NA
NM_001272102,CLCN5,4,3,119927,628,119299,39766.33333,157,189.9665605
NM_001282163,CLCN5,12,11,29738,9560,20178,1834.363636,796.6666667,2.110669456
NM_000084,CLCN5,12,11,31679,9517,22162,2014.727273,793.0833333,2.328675003
NM_139289,AKAP4,6,5,9586,2851,6735,1347,475.1666667,2.362329007
NM_003886,AKAP4,6,5,10255,2887,7368,1473.6,481.1666667,2.552130239
NM_005448,BMP15,2,1,5908,1264,4644,4644,632,3.674050633
NM_153183,NUDT10,3,2,5296,2004,3292,1646,668,1.642714571
NM_018159,NUDT11,2,1,6598,2398,4200,4200,1199,1.75145955
NM_018094,GSPT2,1,0,2847,2847,NA,NA,2847,NA
NM_030801,MAGED4B,13,12,7447,2615,4832,402.6666667,201.1538462,1.847801147
NM_001242362,MAGED4B,14,13,7447,2685,4762,366.3076923,191.7857143,1.773556797
NM_001272063,MAGED4,13,12,7447,2615,4832,402.6666667,201.1538462,1.847801147
NM_001098800,MAGED4,13,12,7447,2597,4850,404.1666667,199.7692308,1.867539469
NM_177537,MAGED4B,13,12,7447,2597,4850,404.1666667,199.7692308,1.867539469
NM_177535,MAGED4B,13,12,7447,2585,4862,405.1666667,198.8461538,1.880851064
NM_001272061,MAGED4,14,13,7447,2685,4762,366.3076923,191.7857143,1.773556797
NM_001272062,MAGED4,13,12,7447,2585,4862,405.1666667,198.8461538,1.880851064
NM_030801,MAGED4B,13,12,7447,2615,4832,402.6666667,201.1538462,1.847801147
NM_001242362,MAGED4B,14,13,7447,2685,4762,366.3076923,191.7857143,1.773556797
NM_001098800,MAGED4,13,12,7449,2599,4850,404.1666667,199.9230769,1.866102347
NM_001272063,MAGED4,13,12,7449,2617,4832,402.6666667,201.3076923,1.846388995
NM_177535,MAGED4B,13,12,7447,2585,4862,405.1666667,198.8461538,1.880851064
NM_177537,MAGED4B,13,12,7447,2597,4850,404.1666667,199.7692308,1.867539469
NM_001272061,MAGED4,14,13,7449,2687,4762,366.3076923,191.9285714,1.772236695
NM_001272062,MAGED4,13,12,7449,2587,4862,405.1666667,199,1.879396985
NM_130777,XAGE2,5,4,6746,717,6029,1507.25,143.4,8.408647141
NM_001079538,XAGE2B,4,3,5578,340,5238,1746,85,15.40588235
NM_001097593,XAGE1A,4,3,4992,488,4504,1501.333333,122,9.229508197
NM_001097605,XAGE1E,4,3,4992,488,4504,1501.333333,122,9.229508197
NM_001097605,XAGE1E,4,3,4992,488,4504,1501.333333,122,9.229508197
NM_001097604,XAGE1E,4,3,5145,625,4520,1506.666667,156.25,7.232
NM_001097604,XAGE1E,4,3,5145,625,4520,1506.666667,156.25,7.232
NM_001097592,XAGE1A,4,3,5145,625,4520,1506.666667,156.25,7.232
NM_001097592,XAGE1A,4,3,5145,625,4520,1506.666667,156.25,7.232
NM_001097593,XAGE1A,4,3,4992,488,4504,1501.333333,122,9.229508197
NM_001097594,XAGE1B,4,3,5145,625,4520,1506.666667,156.25,7.232
NM_001097594,XAGE1B,4,3,5145,625,4520,1506.666667,156.25,7.232
NM_133430,XAGE1D,4,3,4992,488,4504,1501.333333,122,9.229508197
NM_133430,XAGE1D,4,3,4992,488,4504,1501.333333,122,9.229508197
NM_020411,XAGE1D,4,3,5145,625,4520,1506.666667,156.25,7.232
NM_020411,XAGE1D,4,3,5145,625,4520,1506.666667,156.25,7.232
NM_001097598,XAGE1C,4,3,4992,488,4504,1501.333333,122,9.229508197
NM_001097598,XAGE1C,4,3,4992,488,4504,1501.333333,122,9.229508197
NM_001097597,XAGE1C,4,3,5145,625,4520,1506.666667,156.25,7.232
NM_001097597,XAGE1C,4,3,5145,625,4520,1506.666667,156.25,7.232
NM_001097596,XAGE1B,4,3,4992,488,4504,1501.333333,122,9.229508197
NM_001097596,XAGE1B,4,3,4992,488,4504,1501.333333,122,9.229508197
NM_130777,XAGE2,5,4,6746,717,6029,1507.25,143.4,8.408647141
NM_001079538,XAGE2B,4,3,5578,340,5238,1746,85,15.40588235
NM_001097605,XAGE1E,4,3,4992,488,4504,1501.333333,122,9.229508197
NM_001097605,XAGE1E,4,3,4992,488,4504,1501.333333,122,9.229508197
NM_001097605,XAGE1E,4,3,4992,488,4504,1501.333333,122,9.229508197
NM_001097604,XAGE1E,4,3,5145,625,4520,1506.666667,156.25,7.232
NM_001097604,XAGE1E,4,3,5145,625,4520,1506.666667,156.25,7.232
NM_001097604,XAGE1E,4,3,5145,625,4520,1506.666667,156.25,7.232
NM_001097593,XAGE1A,4,3,4992,488,4504,1501.333333,122,9.229508197
NM_001097593,XAGE1A,4,3,4992,488,4504,1501.333333,122,9.229508197
NM_001097592,XAGE1A,4,3,5145,625,4520,1506.666667,156.25,7.232
NM_001097592,XAGE1A,4,3,5145,625,4520,1506.666667,156.25,7.232
NM_001097592,XAGE1A,4,3,5145,625,4520,1506.666667,156.25,7.232
NM_001097593,XAGE1A,4,3,4992,488,4504,1501.333333,122,9.229508197
NM_001097596,XAGE1B,4,3,4992,488,4504,1501.333333,122,9.229508197
NM_001097596,XAGE1B,4,3,4992,488,4504,1501.333333,122,9.229508197
NM_001097594,XAGE1B,4,3,5145,625,4520,1506.666667,156.25,7.232
NM_133430,XAGE1D,4,3,4992,488,4504,1501.333333,122,9.229508197
NM_133430,XAGE1D,4,3,4992,488,4504,1501.333333,122,9.229508197
NM_133430,XAGE1D,4,3,4992,488,4504,1501.333333,122,9.229508197
NM_020411,XAGE1D,4,3,5145,625,4520,1506.666667,156.25,7.232
NM_020411,XAGE1D,4,3,5145,625,4520,1506.666667,156.25,7.232
NM_020411,XAGE1D,4,3,5145,625,4520,1506.666667,156.25,7.232
NM_001097594,XAGE1B,4,3,5145,625,4520,1506.666667,156.25,7.232
NM_001097594,XAGE1B,4,3,5145,625,4520,1506.666667,156.25,7.232
NM_001097598,XAGE1C,4,3,4992,488,4504,1501.333333,122,9.229508197
NM_001097598,XAGE1C,4,3,4992,488,4504,1501.333333,122,9.229508197
NM_001097598,XAGE1C,4,3,4992,488,4504,1501.333333,122,9.229508197
NM_001097597,XAGE1C,4,3,5145,625,4520,1506.666667,156.25,7.232
NM_001097597,XAGE1C,4,3,5145,625,4520,1506.666667,156.25,7.232
NM_001097597,XAGE1C,4,3,5145,625,4520,1506.666667,156.25,7.232
NM_001097596,XAGE1B,4,3,4992,488,4504,1501.333333,122,9.229508197
NM_173358,SSX7,8,7,10841,1348,9493,1356.142857,168.5,7.042284866
NM_001164417,SSX2B,8,7,10338,1341,8997,1285.285714,167.625,6.70917226
NM_001164417,SSX2B,8,7,10332,1337,8995,1285,167.125,6.727748691
NM_001278697,SSX2,9,8,10339,1421,8918,1114.75,157.8888889,6.275862069
NM_001278697,SSX2,9,8,10333,1417,8916,1114.5,157.4444444,6.292166549
NM_003147,SSX2,9,8,10333,1485,8848,1106,165,5.958249158
NM_003147,SSX2,9,8,10339,1489,8850,1106.25,165.4444444,5.9435863
NM_001278702,SSX2B,9,8,10332,1416,8916,1114.5,157.3333333,6.296610169
NM_001278702,SSX2B,9,8,10338,1420,8918,1114.75,157.7777778,6.28028169
NM_001278701,SSX2B,9,8,10332,1484,8848,1106,164.8888889,5.962264151
NM_001278701,SSX2B,9,8,10338,1488,8850,1106.25,165.3333333,5.947580645
NM_175698,SSX2,8,7,10339,1342,8997,1285.285714,167.75,6.704172876
NM_175698,SSX2,8,7,10333,1338,8995,1285,167.25,6.722720478
NM_001099684,FAM156B,3,2,9178,1702,7476,3738,567.3333333,4.392479436
NM_130776,XAGE3,5,4,4776,490,4286,1071.5,98,8.746938776
NM_133179,XAGE3,5,4,5563,521,5042,1260.5,104.2,9.677543186
NM_001009616,SPANXN5,2,1,1204,563,641,641,281.5,1.138543517
NM_001242491,FAM156A,3,2,11265,2050,9215,4607.5,683.3333333,4.495121951
NM_130775,XAGE5,5,4,6096,482,5614,1403.5,96.4,11.6473029
NM_001099684,FAM156B,3,2,9167,1702,7465,3732.5,567.3333333,4.386016451
NM_014138,FAM156A,5,4,48189,2240,45949,11487.25,448,20.51294643
NM_001242493,FAM156A,5,4,48189,1831,46358,11589.5,366.2,25.31840524
NM_001242492,FAM156A,5,4,48189,1938,46251,11562.75,387.6,23.86532508
NM_001242489,FAM156A,3,2,48189,2103,46086,23043,701,21.91440799
NM_001242490,FAM156A,4,3,48189,2088,46101,15367,522,22.07902299
NM_001242491,FAM156A,3,2,11253,2050,9203,4601.5,683.3333333,4.489268293
NM_001242496,FAM156A,4,3,48189,1679,46510,15503.33333,419.75,27.70101251
NM_001242494,FAM156A,4,3,48189,1788,46401,15467,447,25.95134228
NM_001242495,FAM156A,3,2,48189,1694,46495,23247.5,564.6666667,27.44687131
NM_001242497,FAM156A,3,2,48189,1585,46604,23302,528.3333333,29.40315457
NM_022117,TSPYL2,7,6,6188,2835,3353,558.8333333,405,1.182716049
NM_001146702,KDM5C,24,23,34103,6120,27983,1216.652174,255,4.572385621
NM_001243197,IQSEC2,3,2,15292,959,14333,7166.5,319.6666667,14.94577685
NM_015075,IQSEC2,14,13,48740,5252,43488,3345.230769,375.1428571,8.280274181
NM_004187,KDM5C,26,25,34103,6888,27215,1088.6,264.9230769,3.951074332
NM_001282622,KDM5C,26,25,34103,6885,27218,1088.72,264.8076923,3.953231663
NM_001267053,RIBC1,6,5,8265,1287,6978,1395.6,214.5,5.421911422
NM_001037811,HSD17B10,6,5,3119,942,2177,435.4,157,2.31104034
NM_006306,SMC1A,25,24,48609,9809,38800,1616.666667,392.36,3.955551025
NM_144968,RIBC1,5,4,6973,1988,4985,1246.25,397.6,2.507545272
NM_001031745,RIBC1,8,7,8265,1518,6747,963.8571429,189.75,4.444664032
NM_001281463,SMC1A,26,25,48609,9956,38653,1546.12,382.9230769,3.882382483
NM_004493,HSD17B10,6,5,3119,969,2150,430,161.5,2.21878225
NM_198456,FAM120C,2,1,9494,1142,8352,8352,571,7.313485114
NM_058163,TSR2,5,4,4880,1331,3549,887.25,266.2,2.666416228
NM_004463,FGD1,18,17,50714,4293,46421,2730.647059,238.5,10.81318425
NM_019067,GNL3L,16,15,37078,8589,28489,1899.266667,536.8125,3.316916987
NM_001184819,GNL3L,16,15,37078,8706,28372,1891.466667,544.125,3.258901907
NM_201222,MAGED2,13,12,6957,2170,4787,398.9166667,166.9230769,2.205990783
NM_014599,MAGED2,13,12,7679,2102,5577,464.75,161.6923077,2.653187441
NM_177433,MAGED2,13,12,8418,2210,6208,517.3333333,170,2.809049774
NM_016157,TRO,13,12,10872,2589,8283,690.25,199.1538462,3.199304751
NM_001039705,TRO,13,12,10872,4910,5962,496.8333333,377.6923077,1.214256619
NM_177556,TRO,13,12,10872,2574,8298,691.5,198,3.223776224
NM_014481,APEX2,6,5,7552,2101,5451,1090.2,350.1666667,2.59447882
NM_002625,PFKFB1,14,13,60946,1770,59176,4552,126.4285714,33.43276836
NM_001271748,APEX2,5,4,7552,1919,5633,1408.25,383.8,2.935383012
NM_001271805,PFKFB1,13,12,65402,1604,63798,5316.5,123.3846154,39.77431421
NM_001271804,PFKFB1,14,13,60946,1704,59242,4557.076923,121.7142857,34.76643192
NM_001271184,TRO,12,11,10611,3529,7082,643.8181818,294.0833333,2.006800793
NM_177557,TRO,12,11,10872,1382,9490,862.7272727,115.1666667,6.866859624
NM_001271183,TRO,11,10,10872,3628,7244,724.4,329.8181818,1.996692393
NM_207339,PAGE2,5,4,3765,485,3280,820,97,6.762886598
NM_001015038,PAGE2B,5,4,3849,513,3336,834,102.6,6.502923977
NM_001190708,MTRNR2L10,1,0,1122,1122,NA,NA,1122,NA
NM_001013435,PAGE5,5,4,3751,545,3206,801.5,109,5.882568807
NM_130467,PAGE5,5,4,3752,745,3007,751.75,149,4.036241611
NM_201286,USP51,2,1,4584,4405,179,179,2202.5,0.040635641
NM_014061,MAGEH1,1,0,1481,1481,NA,NA,1481,NA
NM_198451,FOXR2,1,0,2790,2790,NA,NA,2790,NA
NM_016656,RRAGB,11,10,41099,2218,38881,3888.1,201.6363636,17.52975654
NM_006064,RRAGB,10,9,41099,2133,38966,4329.555556,213.3,18.2681669
NM_001159296,KLF8,6,5,55454,4827,50627,10125.4,804.5,10.48829501
NM_007250,KLF8,6,5,55502,5427,50075,10015,904.5,9.227013083
NM_013444,UBQLN2,1,0,3419,3419,NA,NA,3419,NA
NM_001010862,SPIN3,2,1,4726,4461,265,265,2230.5,0.059403721
NM_019003,SPIN2A,2,1,1977,1321,656,656,660.5,0.49659349
NM_007157,ZXDB,1,0,5643,5643,NA,NA,5643,NA
NM_001012968,SPIN4,1,0,4113,4113,NA,NA,4113,NA
NM_152424,AMER1,2,1,20629,8445,12184,12184,4222.5,1.442747188
NM_130388,ASB12,3,2,6441,1296,5145,2572.5,432,3.969907407
NM_001178033,ZC4H2,4,3,60733,2653,58080,19360,663.25,21.89219751
NM_018684,ZC4H2,5,4,60733,2817,57916,14479,563.4,20.55946042
NM_001010888,ZC3H12B,5,4,19154,7261,11893,2973.25,1452.2,1.63792866
NM_002444,MSN,13,12,74284,3983,70301,5858.416667,306.3846154,17.65026362
NM_007268,VSIG4,8,7,18389,1860,16529,2361.285714,232.5,8.88655914
NM_001184830,VSIG4,7,6,18389,2199,16190,2698.333333,314.1428571,7.362437472
NM_001100431,VSIG4,7,6,18389,1577,16812,2802,225.2857143,10.66074826
NM_001257403,VSIG4,8,7,18389,1526,16863,2409,190.75,11.05045872
NM_001184831,VSIG4,6,5,18389,1916,16473,3294.6,319.3333333,8.597599165
NM_001242310,EDA2R,7,6,20392,3438,16954,2825.666667,491.1428571,4.931355439
NM_001199687,EDA2R,7,6,43660,3473,40187,6697.833333,496.1428571,11.57126404
NM_021783,EDA2R,7,6,43412,3431,39981,6663.5,490.1428571,11.65287088
NM_001195214,YIPF6,6,5,38505,6159,32346,6469.2,1026.5,5.251826595
NM_173834,YIPF6,7,6,38505,6289,32216,5369.333333,898.4285714,5.122595007
NM_001142504,STARD8,14,13,32204,4854,27350,2103.846154,346.7142857,5.634528224
NM_004429,EFNB1,5,4,13168,3335,9833,2458.25,667,2.948425787
NM_001032396,PJA1,2,1,4786,2556,2230,2230,1278,0.872456964
NM_022368,PJA1,3,2,4786,2319,2467,1233.5,773,1.063820612
NM_145119,PJA1,2,1,4786,2882,1904,1904,1441,0.660652325
NM_015686,FAM155B,3,2,27275,4022,23253,11626.5,1340.666667,5.781452014
NM_001002254,AWAT2,8,7,9398,2132,7266,1038,266.5,3.408067542
NM_207320,OTUD6A,1,0,1690,1690,NA,NA,1690,NA
NM_198512,DGAT2L6,7,6,28219,1715,26504,4417.333333,245,15.45422741
NM_001013579,AWAT1,7,6,6008,1406,4602,767,200.8571429,3.27311522
NM_001551,IGBP1,7,6,32857,1667,31190,5198.333333,238.1428571,18.71025795
NM_001032726,RAB41,8,7,2832,1079,1753,250.4285714,134.875,1.624652456
NM_002565,P2RY4,1,0,1640,1640,NA,NA,1640,NA
NM_016484,PDZD11,7,6,3589,1253,2336,389.3333333,179,1.864325619
NM_004312,ARR3,17,16,13507,1326,12181,761.3125,78,9.18627451
NM_021120,DLG3,19,18,60636,6040,54596,3033.111111,317.8947368,9.039072848
NM_020730,DLG3,14,13,53186,5090,48096,3699.692308,363.5714286,9.449115914
NM_001171191,GDPD2,14,13,10362,2082,8280,636.9230769,148.7142857,3.976945245
NM_001171193,GDPD2,15,14,10362,2187,8175,583.9285714,145.8,3.737997257
NM_001171192,GDPD2,17,16,10362,2456,7906,494.125,144.4705882,3.219055375
NM_017711,GDPD2,16,15,10362,2302,8060,537.3333333,143.875,3.501303215
NM_001166278,DLG3,12,11,50395,4545,45850,4168.181818,378.75,10.0880088
NM_001048164,SLC7A3,12,11,5547,2255,3292,299.2727273,187.9166667,1.459866962
NM_032803,SLC7A3,12,11,5547,2279,3268,297.0909091,189.9166667,1.433962264
NM_001170931,FOXO4,4,3,7387,3187,4200,1400,796.75,1.317853781
NM_013346,SNX12,4,3,9203,2404,6799,2266.333333,601,2.828202995
NM_001256188,SNX12,4,3,9203,2392,6811,2270.333333,598,2.847408027
NM_001256186,SNX12,3,2,9203,2266,6937,3468.5,755.3333333,3.061341571
NM_001256187,SNX12,3,2,9203,2278,6925,3462.5,759.3333333,3.039947322
NM_001256185,SNX12,5,4,14181,2429,11752,2938,485.8,4.838205023
NM_000206,IL2RG,8,7,4229,1542,2687,383.8571429,192.75,1.742542153
NM_005120,MED12,45,44,23900,7014,16886,383.7727273,155.8666667,2.407470773
NM_005938,FOXO4,3,2,7387,3351,4036,2018,1117,1.204416592
NM_001025265,CXorf65,6,5,2901,888,2013,402.6,148,2.266891892
NM_201599,ZMYM3,25,24,14566,5609,8957,373.2083333,224.36,1.596897843
NM_001171163,ZMYM3,7,6,5446,1921,3525,587.5,274.4285714,1.83498178
NM_001171162,ZMYM3,25,24,15575,6143,9432,393,245.72,1.535406153
NM_000166,GJB1,2,1,2011,1656,355,355,828,0.214371981
NM_001097642,GJB1,2,1,10005,1605,8400,8400,802.5,5.23364486
NM_005096,ZMYM3,25,24,15027,5618,9409,392.0416667,224.72,1.674795301
NM_012278,ITGB1BP2,11,10,3578,1246,2332,233.2,113.2727273,1.871589085
NM_052957,ACRC,13,12,35561,3191,32370,2697.5,245.4615385,10.14415544
NM_001142797,CXCR3,2,1,2603,1870,733,733,935,0.39197861
NM_001504,CXCR3,2,1,2603,1626,977,977,813,0.600861009
NM_001145140,CXorf49,6,5,3913,1857,2056,411.2,309.5,1.107162089
NM_001145140,CXorf49,6,5,3913,1857,2056,411.2,309.5,1.107162089
NM_001145139,CXorf49B,6,5,3913,1857,2056,411.2,309.5,1.107162089
NM_001145139,CXorf49B,6,5,3913,1857,2056,411.2,309.5,1.107162089
NM_006223,PIN4,4,3,16670,1328,15342,5114,332,11.55271084
NM_207422,FLJ44635,2,1,17568,2271,15297,15297,1135.5,6.735799207
NM_001024455,RGAG4,2,1,4792,4340,452,452,2170,0.104147465
NM_001007,RPS4X,7,6,4690,963,3727,621.1666667,137.5714286,3.8701973
NM_001144887,CITED1,3,2,4278,825,3453,1726.5,275,4.185454545
NM_001144886,CITED1,3,2,5551,898,4653,2326.5,299.3333333,5.181514477
NM_001144885,CITED1,4,3,4278,947,3331,1110.333333,236.75,3.517423442
NM_004143,CITED1,3,2,5351,1246,4105,2052.5,415.3333333,3.294542536
NM_001166420,HDAC8,4,3,5523,1090,4433,1477.666667,272.5,4.066972477
NM_001166422,HDAC8,5,4,5523,999,4524,1131,199.8,4.528528529
NM_001080851,DMRTC1B,6,5,3762,1106,2656,531.2,184.3333333,2.401446655
NM_033053,DMRTC1,6,5,3762,1106,2656,531.2,184.3333333,2.401446655
NM_001080851,DMRTC1B,6,5,3765,1106,2659,531.8,184.3333333,2.404159132
NM_033053,DMRTC1,6,5,3765,1106,2659,531.8,184.3333333,2.404159132
NM_001042506,PABPC1L2B,1,0,2201,2201,NA,NA,2201,NA
NM_001012977,PABPC1L2A,1,0,2176,2176,NA,NA,2176,NA
NM_021963,NAP1L2,1,0,2575,2575,NA,NA,2575,NA
NM_005193,CDX4,3,2,7333,858,6475,3237.5,286,7.546620047
NM_203303,ZCCHC13,1,0,846,846,NA,NA,846,NA
NM_016120,RLIM,4,3,31652,10571,21081,7027,2642.75,1.994229496
NM_183353,RLIM,5,4,31652,10634,21018,5254.5,2126.8,1.976490502
NM_145052,UPRT,7,6,30840,2519,28321,4720.166667,359.8571429,11.24295355
NM_138703,MAGEE2,1,0,2258,2258,NA,NA,2258,NA
NM_016500,PBDC1,6,5,5264,1201,4063,812.6,200.1666667,3.383014155
NM_020932,MAGEE1,1,0,3702,3702,NA,NA,3702,NA
NM_003868,FGF16,2,1,2368,353,2015,2015,176.5,5.708215297
NM_032121,MAGT1,10,9,69205,4031,65174,7241.555556,403.1,16.16819648
NM_001866,COX7B,3,2,5922,459,5463,2731.5,153,11.90196078
NM_001029891,PGAM4,1,0,1679,1679,NA,NA,1679,NA
NM_000291,PGK1,11,10,22660,2434,20226,2022.6,221.2727273,8.309778143
NM_015975,TAF9B,7,6,9936,2696,7240,1206.666667,385.1428571,2.685459941
NM_001282187,CYSLTR1,4,3,56221,2863,53358,17786,715.75,18.63709396
NM_001282186,CYSLTR1,2,1,56221,2691,53530,53530,1345.5,19.89223337
NM_001282188,CYSLTR1,4,3,56221,2840,53381,17793.66667,710,18.79612676
NM_006639,CYSLTR1,3,2,56221,2779,53442,26721,926.3333333,19.23065851
NM_152694,ZCCHC5,2,1,3261,2650,611,611,1325,0.230566038
NM_001278000,LPAR4,5,4,8697,2160,6537,1634.25,432,3.026388889
NM_005296,LPAR4,2,1,9374,2619,6755,6755,1309.5,2.579228713
NM_014499,P2RY10,4,3,16611,1794,14817,4939,448.5,8.259197324
NM_198333,P2RY10,2,1,16611,1600,15011,15011,800,9.381875
NM_032553,GPR174,1,0,1259,1259,NA,NA,1259,NA
NM_001171581,ITM2A,5,4,7170,1707,5463,1365.75,341.4,3.200351494
NM_004867,ITM2A,6,5,7170,1840,5330,1066,306.6666667,2.89673913
NM_016954,TBX22,8,7,9528,2256,7272,1038.857143,282,3.223404255
NM_001109879,TBX22,9,8,17015,2360,14655,1831.875,262.2222222,6.209745763
NM_001109878,TBX22,9,8,17015,2364,14651,1831.375,262.6666667,6.197546531
NM_030763,HMGN5,7,6,88243,2133,86110,14351.66667,304.7142857,40.37037037
NM_000307,POU3F4,1,0,1508,1508,NA,NA,1508,NA
NM_021118,CYLC1,5,4,25576,2134,23442,5860.5,426.8,10.98500469
NM_001271680,CYLC1,4,3,25576,384,25192,8397.333333,96,65.60416667
NM_001012980,SATL1,5,4,16684,2157,14527,3631.75,431.4,6.734816875
NM_021998,ZNF711,9,8,29373,4176,25197,3149.625,464,6.033764368
NM_001145414,CHM,5,4,78469,2841,75628,18907,568.2,26.62020415
NM_033048,CPXCR1,3,2,7561,1632,5929,2964.5,544,3.632965686
NM_001184771,CPXCR1,3,2,7561,1594,5967,2983.5,531.3333333,3.743412798
NM_138960,TGIF2LX,2,1,944,849,95,95,424.5,0.111896349
NM_080832,PABPC5,2,1,3988,3449,539,539,1724.5,0.156277182
NM_004538,NAP1L3,1,0,2759,2759,NA,NA,2759,NA
NM_013347,RPA4,1,0,1545,1545,NA,NA,1545,NA
NM_022144,TNMD,7,6,15094,1355,13739,2289.833333,193.5714286,10.13948339
NM_001174068,SYTL4,17,16,57035,3756,53279,3329.9375,220.9411765,14.18503727
NM_001278740,TSPAN6,8,7,9626,4119,5507,786.7142857,514.875,1.336974994
NM_001278742,TSPAN6,7,6,9998,3780,6218,1036.333333,540,1.644973545
NM_001278741,TSPAN6,8,7,9998,3889,6109,872.7142857,486.125,1.570840833
NM_001278743,TSPAN6,7,6,9998,3804,6194,1032.333333,543.4285714,1.628286015
NM_014467,SRPX2,11,10,27135,2201,24934,2493.4,200.0909091,11.32848705
NM_003270,TSPAN6,8,7,9751,3827,5924,846.2857143,478.375,1.547948785
NM_080737,SYTL4,19,18,57035,3927,53108,2950.444444,206.6842105,13.52380952
NM_001129896,SYTL4,18,17,57648,3878,53770,3162.941176,215.4444444,13.86539453
NM_001325,CSTF2,14,13,20577,2030,18547,1426.692308,145,9.136453202
NM_007052,NOX1,13,12,31023,2542,28481,2373.416667,195.5384615,11.20416994
NM_013955,NOX1,12,11,31023,2394,28629,2602.636364,199.5,11.95864662
NM_001271815,NOX1,12,11,31023,2430,28593,2599.363636,202.5,11.76666667
NM_212559,XKRX,3,2,15469,2854,12615,6307.5,951.3333333,4.420112123
NM_001162491,ARL13A,8,7,21125,1138,19987,2855.285714,142.25,17.56326889
NM_021637,TMEM35,2,1,17521,2072,15449,15449,1036,7.456081081
NM_001171184,DRP2,22,21,44554,6857,37697,1795.095238,311.6818182,5.4975937
NM_001939,DRP2,24,23,44554,7142,37412,1626.608696,297.5833333,5.238308597
NM_004085,TIMM8A,2,1,3315,1444,1871,1871,722,1.295706371
NM_001145951,TIMM8A,2,1,684,554,130,130,277,0.23465704
NM_000169,GLA,7,6,10224,1425,8799,1466.5,203.5714286,6.174736842
NM_000061,BTK,19,18,36779,2630,34149,1897.166667,138.4210526,12.98441065
NM_001199972,RPL36A,3,2,2964,2364,600,300,788,0.253807107
NM_021029,RPL36A,5,4,5266,886,4380,1095,177.2,4.943566591
NM_001287345,BTK,17,16,36779,2265,34514,2157.125,133.2352941,15.23796909
NM_001287344,BTK,19,18,41351,2786,38565,2142.5,146.6315789,13.84242642
NM_001256155,ARMCX4,2,1,7769,7426,343,343,3713,0.046189065
NM_016607,ARMCX3,5,4,4713,3400,1313,328.25,680,0.386176471
NM_016608,ARMCX1,4,3,4163,2137,2026,675.3333333,534.25,0.948058025
NM_001009584,ARMCX6,2,1,2885,1768,1117,1117,884,0.63178733
NM_001282231,ARMCX2,6,5,4610,2853,1757,351.4,475.5,0.615842972
NM_019007,ARMCX6,3,2,2885,1851,1034,517,617,0.558616964
NM_001184768,ARMCX6,4,3,2885,1940,945,315,485,0.487113402
NM_177949,ARMCX2,6,5,4610,2865,1745,349,477.5,0.609075044
NM_177948,ARMCX3,5,4,4482,3323,1159,289.75,664.6,0.348781222
NM_014782,ARMCX2,5,4,4610,2813,1797,449.25,562.6,0.638819765
NM_177947,ARMCX3,5,4,4713,3372,1341,335.25,674.4,0.397686833
NM_001282400,ZMAT1,10,9,49781,4055,45726,5080.666667,405.5,11.27644883
NM_001011657,ZMAT1,7,6,49781,3496,46285,7714.166667,499.4285714,13.23941648
NM_032946,NXF5,16,15,25466,1629,23837,1589.133333,101.8125,14.63290362
NM_001282401,ZMAT1,9,8,49781,4001,45780,5722.5,444.5555556,11.44213947
NM_001012978,BEX5,3,2,2309,822,1487,743.5,274,1.809002433
NM_001159560,BEX5,3,2,2085,864,1221,610.5,288,1.413194444
NM_080390,TCEAL2,3,2,2026,1104,922,461,368,0.835144928
NM_001006938,TCEAL6,3,2,2457,1535,922,461,511.6666667,0.600651466
NM_001277423,TCP11X2,10,9,11507,1757,9750,1083.333333,175.7,5.549231645
NM_022053,NXF2,23,22,79615,2424,77191,3508.681818,105.3913043,31.84447195
NM_001099686,NXF2B,23,22,79615,2424,77191,3508.681818,105.3913043,31.84447195
NM_001277423,TCP11X2,10,9,11494,1757,9737,1081.888889,175.7,5.541832669
NM_021992,TMSB15A,3,2,3091,669,2422,1211,223,3.620328849
NM_001199818,ARMCX5-GPRASP2,7,6,118387,3947,114440,19073.33333,563.8571429,28.99417279
NM_001168485,ARMCX5,5,4,4991,2789,2202,550.5,557.8,0.789530298
NM_014710,GPRASP1,5,4,7718,5975,1743,435.75,1195,0.291715481
NM_138437,GPRASP2,4,3,5559,3724,1835,611.6666667,931,0.492749731
NM_001184727,GPRASP1,6,5,7683,5988,1695,339,998,0.283066132
NM_001004051,GPRASP2,5,4,5559,3813,1746,436.5,762.6,0.45790716
NM_022838,ARMCX5,3,2,4661,2677,1984,992,892.3333333,0.741128129
NM_001099411,GPRASP1,3,2,7718,5814,1904,952,1938,0.32748538
NM_001099410,GPRASP1,4,3,7718,5883,1835,611.6666667,1470.75,0.311915689
NM_001184876,GPRASP2,5,4,5559,3852,1707,426.75,770.4,0.443146417
NM_001184875,GPRASP2,4,3,5559,3852,1707,569,963,0.443146417
NM_001184874,GPRASP2,5,4,5559,3941,1618,404.5,788.2,0.410555697
NM_001168482,ARMCX5,3,2,4661,2689,1972,986,896.3333333,0.733358126
NM_001168480,ARMCX5,6,5,4991,2903,2088,417.6,483.8333333,0.719255942
NM_001168479,ARMCX5,6,5,4991,2909,2082,416.4,484.8333333,0.715709866
NM_001168478,ARMCX5,4,3,4661,2791,1870,623.3333333,697.75,0.670010749
NM_001142526,BHLHB9,4,3,31729,4021,27708,9236,1005.25,6.890823178
NM_001142525,BHLHB9,4,3,31729,4085,27644,9214.666667,1021.25,6.767197062
NM_001142524,BHLHB9,4,3,31729,4089,27640,9213.333333,1022.25,6.759598924
NM_001142529,BHLHB9,3,2,6464,4037,2427,1213.5,1345.666667,0.601189002
NM_001142530,BHLHB9,2,1,6464,3941,2523,2523,1970.5,0.640192844
NM_001142528,BHLHB9,4,3,31729,4005,27724,9241.333333,1001.25,6.922347066
NM_001142527,BHLHB9,4,3,31729,4073,27656,9218.666667,1018.25,6.790081021
NM_030639,BHLHB9,3,2,31729,3989,27740,13870,1329.666667,6.954123841
NM_001031834,RAB40AL,1,0,1030,1030,NA,NA,1030,NA
NM_022052,NXF3,20,19,17274,1915,15359,808.3684211,95.75,8.020365535
NM_018476,BEX1,3,2,1589,865,724,362,288.3333333,0.83699422
NM_001127688,BEX4,2,1,2110,1201,909,909,600.5,0.756869276
NM_001080425,BEX4,3,2,2110,1285,825,412.5,428.3333333,0.642023346
NM_001006614,WBP5,2,1,2019,1009,1010,1010,504.5,1.00099108
NM_001006612,WBP5,3,2,2019,1089,930,465,363,0.85399449
NM_016303,WBP5,3,2,2019,1092,927,463.5,364,0.848901099
NM_001006684,TCEAL8,2,1,2200,1141,1059,1059,570.5,0.928133216
NM_001006613,WBP5,2,1,2019,1012,1007,1007,506,0.995059289
NM_001012979,TCEAL5,3,2,3181,1169,2012,1006,389.6666667,1.72112917
NM_032621,BEX2,3,2,1702,902,800,400,300.6666667,0.88691796
NM_152278,TCEAL7,3,2,2139,1187,952,476,395.6666667,0.802021904
NM_153333,TCEAL8,3,2,2200,1215,985,492.5,405,0.810699588
NM_001168399,BEX2,3,2,1611,1088,523,261.5,362.6666667,0.480698529
NM_001168401,BEX2,3,2,1666,830,836,418,276.6666667,1.007228916
NM_001168400,BEX2,3,2,1611,1085,526,263,361.6666667,0.484792627
NM_014380,NGFRAP1,1,0,985,985,NA,NA,985,NA
NM_001282674,NGFRAP1,2,1,1843,995,848,848,497.5,0.852261307
NM_206917,NGFRAP1,3,2,1843,1028,815,407.5,342.6666667,0.792801556
NM_206915,NGFRAP1,3,2,1843,1075,768,384,358.3333333,0.714418605
NM_024863,TCEAL4,3,2,2238,1348,890,445,449.3333333,0.660237389
NM_001006937,TCEAL4,3,2,2238,1284,954,477,428,0.742990654
NM_001006935,TCEAL4,3,2,2238,1289,949,474.5,429.6666667,0.736229635
NM_032926,TCEAL3,3,2,2023,1116,907,453.5,372,0.812724014
NM_001006640,TCEAL1,3,2,2230,1209,1021,510.5,403,0.844499586
NM_001006639,TCEAL1,3,2,1986,1197,789,394.5,399,0.65914787
NM_001006933,TCEAL3,3,2,2023,1128,895,447.5,376,0.793439716
NM_004780,TCEAL1,3,2,1986,1209,777,388.5,403,0.642679901
NM_001024452,GLRA4,9,8,21282,1684,19598,2449.75,187.1111111,11.63776722
NM_001172285,GLRA4,7,6,10052,1844,8208,1368,263.4285714,4.451193059
NM_001142428,MORF4L2,5,4,12662,1970,10692,2673,394,5.427411168
NM_001142424,MORF4L2,5,4,11322,1988,9334,2333.5,397.6,4.695171026
NM_001142423,MORF4L2,4,3,11322,1938,9384,3128,484.5,4.842105263
NM_001142419,MORF4L2,4,3,12662,1971,10691,3563.666667,492.75,5.424150178
NM_001142432,MORF4L2,5,4,12662,1990,10672,2668,398,5.36281407
NM_001142418,MORF4L2,5,4,11322,2039,9283,2320.75,407.8,4.552721923
NM_012286,MORF4L2,4,3,11322,1989,9333,3111,497.25,4.692307692
NM_001142431,MORF4L2,4,3,12662,1867,10795,3598.333333,466.75,5.782003214
NM_001142429,MORF4L2,5,4,11322,2008,9314,2328.5,401.6,4.638446215
NM_001142430,MORF4L2,4,3,11322,1885,9437,3145.666667,471.25,5.006366048
NM_001142427,MORF4L2,4,3,12662,1940,10722,3574,485,5.526804124
NM_001142426,MORF4L2,3,2,11322,1835,9487,4743.5,611.6666667,5.170027248
NM_001142422,MORF4L2,5,4,12662,2021,10641,2660.25,404.2,5.26521524
NM_001142420,MORF4L2,3,2,12662,1817,10845,5422.5,605.6666667,5.968629609
NM_001142421,MORF4L2,4,3,12662,1920,10742,3580.666667,480,5.594791667
NM_001142425,MORF4L2,4,3,11322,1958,9364,3121.333333,489.5,4.782431052
NM_182541,TMEM31,3,2,3125,735,2390,1195,245,3.25170068
NM_199478,PLP1,7,6,15795,2927,12868,2144.666667,418.1428571,4.396310215
NM_000533,PLP1,7,6,15795,3032,12763,2127.166667,433.1428571,4.209432718
NM_001128834,PLP1,8,7,16110,3143,12967,1852.428571,392.875,4.125676106
NM_016370,RAB9B,3,2,9959,3802,6157,3078.5,1267.333333,1.619410836
NM_194324,TMSB15B,3,2,3365,669,2696,1348,223,4.029895366
NM_001002916,H2BFWT,3,2,2542,897,1645,822.5,299,1.833890747
NM_001164416,H2BFM,3,2,2507,1885,622,311,628.3333333,0.329973475
NM_001012755,SLC25A53,2,1,57812,6226,51586,51586,3113,8.285576614
NM_001143978,ZCCHC18,3,2,3323,2945,378,189,981.6666667,0.128353141
NM_153448,ESX1,4,3,4882,1484,3398,1132.666667,371,2.289757412
NM_000354,SERPINA7,5,4,5530,1601,3929,982.25,320.2,2.454091193
NM_001171020,MUM1L1,4,3,40653,4177,36476,12158.66667,1044.25,8.732583194
NM_152423,MUM1L1,5,4,40653,4314,36339,9084.75,862.8,8.423504868
NM_198881,TBC1D8B,12,11,47146,2603,44543,4049.363636,216.9166667,17.11217826
NM_138382,RIPPLY1,4,3,3270,1190,2080,693.3333333,297.5,1.74789916
NM_001171706,RIPPLY1,2,1,3270,1047,2223,2223,523.5,2.123209169
NM_017752,TBC1D8B,21,20,73460,5731,67729,3386.45,272.9047619,11.81800733
NM_024657,MORC4,17,16,59512,3851,55661,3478.8125,226.5294118,14.4536484
NM_001085354,MORC4,17,16,59512,3813,55699,3481.1875,224.2941176,14.60765801
NM_001171080,RBM41,8,7,56941,5146,51795,7399.285714,643.25,10.06509911
NM_018301,RBM41,7,6,52526,2527,49999,8333.166667,361,19.78591215
NM_001169154,PIH1D3,8,7,37613,1935,35678,5096.857143,241.875,18.43824289
NM_173494,PIH1D3,7,6,37613,1659,35954,5992.333333,237,21.67209162
NM_002764,PRPS1,7,6,22604,2163,20441,3406.833333,309,9.450300509
NM_001204402,PRPS1,4,3,22604,1752,20852,6950.666667,438,11.90182648
NM_198057,TSC22D3,3,2,62567,2271,60296,30148,757,26.55041832
NM_001015881,TSC22D3,3,2,3261,1750,1511,755.5,583.3333333,0.863428571
NM_004089,TSC22D3,3,2,3841,1955,1886,943,651.6666667,0.964705882
NM_031273,TEX13B,3,2,1508,1251,257,128.5,417,0.205435651
NM_001170553,VSIG1,8,7,34216,3244,30972,4424.571429,405.5,9.547472256
NM_002814,PSMD10,5,4,7441,1579,5862,1465.5,315.8,3.712476251
NM_170750,PSMD10,5,4,7441,1500,5941,1485.25,300,3.960666667
NM_182607,VSIG1,7,6,34216,3135,31081,5180.166667,447.8571429,9.914194577
NM_003604,IRS4,1,0,3882,3882,NA,NA,3882,NA
NM_018698,NXT2,5,4,8919,2711,6208,1552,542.2,2.289929915
NM_001242618,NXT2,4,3,7582,2581,5001,1667,645.25,1.937621077
NM_001242617,NXT2,4,3,7870,2620,5250,1750,655,2.003816794
NM_012282,KCNE1L,1,0,1466,1466,NA,NA,1466,NA
NM_020769,RGAG1,4,3,37279,5430,31849,10616.33333,1357.5,5.865377532
NM_001128168,PAK3,16,15,97870,2284,95586,6372.4,142.75,41.8502627
NM_001128173,PAK3,15,14,97870,2220,95650,6832.142857,148,43.08558559
NM_001128172,PAK3,15,14,97870,2238,95632,6830.857143,149.2,42.73100983
NM_001039210,ALG13,4,3,9279,2938,6341,2113.666667,734.5,2.158270933
NM_001168385,ALG13,5,4,9279,3036,6243,1560.75,607.2,2.056324111
NM_001257241,ALG13,4,3,9227,3011,6216,2072,752.75,2.064430422
NM_018466,ALG13,4,3,9279,2997,6282,2094,749.25,2.096096096
NM_001099922,ALG13,27,26,79531,4190,75341,2897.730769,155.1851852,17.98114558
NM_001257240,ALG13,4,3,9227,3070,6157,2052.333333,767.5,2.005537459
NM_001257239,ALG13,4,3,8740,2985,5755,1918.333333,746.25,1.927973199
NM_001257237,ALG13,26,25,79479,4025,75454,3018.16,154.8076923,18.7463354
NM_001257235,ALG13,4,3,9227,2966,6261,2087,741.5,2.110923803
NM_001257234,ALG13,26,25,79479,3921,75558,3022.32,150.8076923,19.27008416
NM_001257231,ALG13,27,26,79479,4204,75275,2895.192308,155.7037037,17.90556613
NM_001257230,ALG13,26,25,79531,3848,75683,3027.32,148,19.66813929
NM_001195577,TRPC5OS,4,3,22090,2805,19285,6428.333333,701.25,6.875222816
NM_001195576,TRPC5OS,4,3,27936,2824,25112,8370.666667,706,8.892351275
NM_001195578,TRPC5OS,4,3,27787,2759,25028,8342.666667,689.75,9.071402682
NM_178175,LHFPL1,4,3,49498,1769,47729,15909.66667,442.25,26.9807801
NM_001113490,AMOT,11,10,48251,6956,41295,4129.5,632.3636364,5.936601495
NM_000640,IL13RA2,10,9,13671,1383,12288,1365.333333,138.3,8.885032538
NM_016383,LUZP4,4,3,17831,1732,16099,5366.333333,433,9.295034642
NM_001282338,PLS3,17,16,57362,3724,53638,3352.375,219.0588235,14.40332975
NM_001136025,PLS3,16,15,57362,3341,54021,3601.4,208.8125,16.16911104
NM_001172335,PLS3,16,15,57362,3260,54102,3606.8,203.75,16.59570552
NM_000686,AGTR2,3,2,4269,2902,1367,683.5,967.3333333,0.471054445
NM_001017978,CT83,2,1,1343,576,767,767,288,1.331597222
NM_007231,SLC6A14,14,13,24880,4578,20302,1561.692308,327,4.434687637
NM_001560,IL13RA1,11,10,66939,4017,62922,6292.2,365.1818182,15.6639283
NM_173798,ZCCHC12,4,3,3146,2201,945,315,550.25,0.429350295
NM_001031855,LONRF3,11,10,43743,3123,40620,4062,283.9090909,13.0067243
NM_024778,LONRF3,10,9,43743,2999,40744,4527.111111,299.9,13.58586195
NM_001289109,LONRF3,12,11,42025,2910,39115,3555.909091,242.5,13.44158076
NM_006667,PGRMC1,3,2,8223,1922,6301,3150.5,640.6666667,3.278355879
NM_001282621,PGRMC1,2,1,8223,1765,6458,6458,882.5,3.658923513
NM_145305,SLC25A43,5,4,55181,2549,52632,13158,509.8,20.64809729
NM_001152,SLC25A5,4,3,2998,1355,1643,547.6666667,338.75,1.212546125
NM_001282161,UBE2A,6,5,9964,1877,8087,1617.4,312.8333333,4.308470964
NM_001173488,NKRF,2,1,4815,3743,1072,1072,1871.5,0.286401282
NM_001173487,NKRF,4,3,17548,3359,14189,4729.666667,839.75,4.224173861
NM_001170570,CXorf56,6,5,27287,2290,24997,4999.4,381.6666667,10.91572052
NM_001170569,CXorf56,7,6,27262,2415,24847,4141.166667,345,10.28861284
NM_003336,UBE2A,6,5,9964,1884,8080,1616,314,4.288747346
NM_181762,UBE2A,5,4,9964,1793,8171,2042.75,358.6,4.55716676
NM_017544,NKRF,3,2,17548,3260,14288,7144,1086.666667,4.382822086
NM_022101,CXorf56,7,6,27287,2333,24954,4159,333.2857143,10.69609944
NM_006978,RNF113A,1,0,1298,1298,NA,NA,1298,NA
NM_001000,RPL39,3,2,5157,422,4735,2367.5,140.6666667,11.22037915
NM_080632,UPF3B,11,10,19004,2415,16589,1658.9,219.5454545,6.869151139
NM_001105576,SOWAHD,1,0,1591,1591,NA,NA,1591,NA
NM_023010,UPF3B,10,9,19004,2375,16629,1847.666667,237.5,7.001684211
NM_004541,NDUFA1,3,2,4897,489,4408,2204,163,9.014314928
NM_024528,NKAP,9,8,18724,1594,17130,2141.25,177.1111111,10.74654956
NM_001008535,AKAP14,4,3,7686,474,7212,2404,118.5,15.21518987
NM_001008534,AKAP14,6,5,24745,667,24078,4815.6,111.1666667,36.09895052
NM_178813,AKAP14,7,6,24745,848,23897,3982.833333,121.1428571,28.18042453
NM_032498,RHOXF2,4,3,5468,1301,4167,1389,325.25,3.20292083
NM_001099685,RHOXF2B,4,3,5480,1313,4167,1389,328.25,3.173648134
NM_139282,RHOXF1,3,2,6838,772,6066,3033,257.3333333,7.857512953
NM_032498,RHOXF2,4,3,5468,1301,4167,1389,325.25,3.20292083
NM_006777,ZBTB33,2,1,7646,5211,2435,2435,2605.5,0.467280752
NM_001099685,RHOXF2B,4,3,5480,1313,4167,1389,328.25,3.173648134
NM_001184742,ZBTB33,3,2,7643,5311,2332,1166,1770.333333,0.439088684
NM_001142447,ATP1B4,8,7,21166,4781,16385,2340.714286,597.625,3.4271073
NM_012069,ATP1B4,8,7,21166,4769,16397,2342.428571,596.125,3.438247012
NM_002294,LAMP2,9,8,43203,6597,36606,4575.75,733,5.548885857
NM_001122606,LAMP2,9,8,43203,3761,39442,4930.25,417.8888889,10.48710449
NM_013995,LAMP2,9,8,32857,4082,28775,3596.875,453.5555556,7.049240568
NM_001137554,MCTS1,6,5,16466,9609,6857,1371.4,1601.5,0.713601832
NM_001011551,C1GALT1C1,2,1,4478,1734,2744,2744,867,1.582468281
NM_152692,C1GALT1C1,3,2,4478,1907,2571,1285.5,635.6666667,1.348190876
NM_014060,MCTS1,6,5,17274,9797,7477,1495.4,1632.833333,0.763192814
NM_001145718,CT47B1,3,2,3329,1332,1997,998.5,444,1.499249249
NM_001080146,CT47A1,3,2,3319,1296,2023,1011.5,432,1.56095679
NM_001080146,CT47A1,3,2,8180,1296,6884,3442,432,5.311728395
NM_001080146,CT47A1,3,2,3319,1296,2023,1011.5,432,1.56095679
NM_001080146,CT47A1,3,2,3319,1296,2023,1011.5,432,1.56095679
NM_001080145,CT47A2,3,2,3319,1296,2023,1011.5,432,1.56095679
NM_001080145,CT47A2,3,2,3319,1296,2023,1011.5,432,1.56095679
NM_001080145,CT47A2,3,2,3319,1296,2023,1011.5,432,1.56095679
NM_001080145,CT47A2,3,2,3319,1296,2023,1011.5,432,1.56095679
NM_001080145,CT47A2,3,2,3319,1296,2023,1011.5,432,1.56095679
NM_001080145,CT47A2,3,2,3319,1296,2023,1011.5,432,1.56095679
NM_001080140,CT47A7,3,2,3319,1296,2023,1011.5,432,1.56095679
NM_012084,GLUD2,1,0,2336,2336,NA,NA,2336,NA
NM_001242922,CT47A12,3,2,3319,1296,2023,1011.5,432,1.56095679
NM_001242922,CT47A12,3,2,3319,1296,2023,1011.5,432,1.56095679
NM_001242922,CT47A12,3,2,3319,1296,2023,1011.5,432,1.56095679
NM_001242922,CT47A12,3,2,3319,1296,2023,1011.5,432,1.56095679
NM_001242922,CT47A12,3,2,3319,1296,2023,1011.5,432,1.56095679
NM_001242922,CT47A12,3,2,3319,1296,2023,1011.5,432,1.56095679
NM_001242922,CT47A12,3,2,3319,1296,2023,1011.5,432,1.56095679
NM_001242922,CT47A12,3,2,3319,1296,2023,1011.5,432,1.56095679
NM_173571,CT47A11,3,2,3319,1296,2023,1011.5,432,1.56095679
NM_173571,CT47A11,3,2,3319,1296,2023,1011.5,432,1.56095679
NM_173571,CT47A11,3,2,3319,1296,2023,1011.5,432,1.56095679
NM_173571,CT47A11,3,2,3319,1296,2023,1011.5,432,1.56095679
NM_173571,CT47A11,3,2,3319,1296,2023,1011.5,432,1.56095679
NM_173571,CT47A11,3,2,3319,1296,2023,1011.5,432,1.56095679
NM_173571,CT47A11,3,2,3319,1296,2023,1011.5,432,1.56095679
NM_173571,CT47A11,3,2,3319,1296,2023,1011.5,432,1.56095679
NM_001080146,CT47A1,3,2,3319,1296,2023,1011.5,432,1.56095679
NM_001080146,CT47A1,3,2,3319,1296,2023,1011.5,432,1.56095679
NM_001080144,CT47A3,3,2,3319,1296,2023,1011.5,432,1.56095679
NM_001080144,CT47A3,3,2,3319,1296,2023,1011.5,432,1.56095679
NM_001080144,CT47A3,3,2,3319,1296,2023,1011.5,432,1.56095679
NM_001080144,CT47A3,3,2,3319,1296,2023,1011.5,432,1.56095679
NM_001080144,CT47A3,3,2,3319,1296,2023,1011.5,432,1.56095679
NM_001080144,CT47A3,3,2,3319,1296,2023,1011.5,432,1.56095679
NM_001080144,CT47A3,3,2,3319,1296,2023,1011.5,432,1.56095679
NM_001080144,CT47A3,3,2,3319,1296,2023,1011.5,432,1.56095679
NM_001080143,CT47A4,3,2,3319,1296,2023,1011.5,432,1.56095679
NM_001080143,CT47A4,3,2,3319,1296,2023,1011.5,432,1.56095679
NM_001080143,CT47A4,3,2,3319,1296,2023,1011.5,432,1.56095679
NM_001080143,CT47A4,3,2,3319,1296,2023,1011.5,432,1.56095679
NM_001080143,CT47A4,3,2,3319,1296,2023,1011.5,432,1.56095679
NM_001080143,CT47A4,3,2,3319,1296,2023,1011.5,432,1.56095679
NM_001080143,CT47A4,3,2,3319,1296,2023,1011.5,432,1.56095679
NM_001080143,CT47A4,3,2,3319,1296,2023,1011.5,432,1.56095679
NM_001080142,CT47A5,3,2,3319,1296,2023,1011.5,432,1.56095679
NM_001080142,CT47A5,3,2,3319,1296,2023,1011.5,432,1.56095679
NM_001080142,CT47A5,3,2,3319,1296,2023,1011.5,432,1.56095679
NM_001080142,CT47A5,3,2,3319,1296,2023,1011.5,432,1.56095679
NM_001080142,CT47A5,3,2,3319,1296,2023,1011.5,432,1.56095679
NM_001080142,CT47A5,3,2,3319,1296,2023,1011.5,432,1.56095679
NM_001080142,CT47A5,3,2,3319,1296,2023,1011.5,432,1.56095679
NM_001080142,CT47A5,3,2,3319,1296,2023,1011.5,432,1.56095679
NM_001080139,CT47A8,3,2,3319,1296,2023,1011.5,432,1.56095679
NM_001080139,CT47A8,3,2,3319,1296,2023,1011.5,432,1.56095679
NM_001080139,CT47A8,3,2,3319,1296,2023,1011.5,432,1.56095679
NM_001080139,CT47A8,3,2,3319,1296,2023,1011.5,432,1.56095679
NM_001080139,CT47A8,3,2,3319,1296,2023,1011.5,432,1.56095679
NM_001080139,CT47A8,3,2,3319,1296,2023,1011.5,432,1.56095679
NM_001080139,CT47A8,3,2,3319,1296,2023,1011.5,432,1.56095679
NM_001080139,CT47A8,3,2,3319,1296,2023,1011.5,432,1.56095679
NM_001080138,CT47A9,3,2,3319,1296,2023,1011.5,432,1.56095679
NM_001080138,CT47A9,3,2,3319,1296,2023,1011.5,432,1.56095679
NM_001080138,CT47A9,3,2,3319,1296,2023,1011.5,432,1.56095679
NM_001080138,CT47A9,3,2,3319,1296,2023,1011.5,432,1.56095679
NM_001080138,CT47A9,3,2,3319,1296,2023,1011.5,432,1.56095679
NM_001080138,CT47A9,3,2,3319,1296,2023,1011.5,432,1.56095679
NM_001080138,CT47A9,3,2,3319,1296,2023,1011.5,432,1.56095679
NM_001080138,CT47A9,3,2,3319,1296,2023,1011.5,432,1.56095679
NM_001080137,CT47A10,3,2,3319,1296,2023,1011.5,432,1.56095679
NM_001080137,CT47A10,3,2,3319,1296,2023,1011.5,432,1.56095679
NM_001080137,CT47A10,3,2,3319,1296,2023,1011.5,432,1.56095679
NM_001080137,CT47A10,3,2,3319,1296,2023,1011.5,432,1.56095679
NM_001080137,CT47A10,3,2,3319,1296,2023,1011.5,432,1.56095679
NM_001080137,CT47A10,3,2,3319,1296,2023,1011.5,432,1.56095679
NM_001080137,CT47A10,3,2,3319,1296,2023,1011.5,432,1.56095679
NM_001080137,CT47A10,3,2,3319,1296,2023,1011.5,432,1.56095679
NM_001080146,CT47A1,3,2,3319,1296,2023,1011.5,432,1.56095679
NM_001080146,CT47A1,3,2,3319,1296,2023,1011.5,432,1.56095679
NM_001080146,CT47A1,3,2,3319,1296,2023,1011.5,432,1.56095679
NM_001080145,CT47A2,3,2,3319,1296,2023,1011.5,432,1.56095679
NM_001080145,CT47A2,3,2,3319,1296,2023,1011.5,432,1.56095679
NM_001080141,CT47A6,3,2,3319,1296,2023,1011.5,432,1.56095679
NM_001080141,CT47A6,3,2,3319,1296,2023,1011.5,432,1.56095679
NM_001080141,CT47A6,3,2,3319,1296,2023,1011.5,432,1.56095679
NM_001080141,CT47A6,3,2,3319,1296,2023,1011.5,432,1.56095679
NM_001080141,CT47A6,3,2,3319,1296,2023,1011.5,432,1.56095679
NM_001080141,CT47A6,3,2,3319,1296,2023,1011.5,432,1.56095679
NM_001080141,CT47A6,3,2,3319,1296,2023,1011.5,432,1.56095679
NM_001080141,CT47A6,3,2,3319,1296,2023,1011.5,432,1.56095679
NM_001080141,CT47A6,3,2,3319,1296,2023,1011.5,432,1.56095679
NM_001080141,CT47A6,3,2,3319,1296,2023,1011.5,432,1.56095679
NM_001256743,GRIA3,4,3,20439,993,19446,6482,248.25,19.58308157
NM_001204401,XIAP,7,6,54169,8425,45744,7624,1203.571429,5.429554896
NM_001167,XIAP,7,6,53814,8458,45356,7559.333333,1208.285714,5.362497044
NM_001114937,SH2D1A,4,3,26880,2512,24368,8122.666667,628,9.700636943
NM_002351,SH2D1A,4,3,26880,2521,24359,8119.666667,630.25,9.662435541
NM_001195272,LOC100129520,1,0,2983,2983,NA,NA,2983,NA
NM_001013628,DCAF12L2,1,0,2600,2600,NA,NA,2600,NA
NM_178470,DCAF12L1,2,1,3478,3392,86,86,1696,0.025353774
NM_001122716,CXorf64,2,1,2023,1229,794,794,614.5,0.646053702
NM_138289,ACTRT1,1,0,1443,1443,NA,NA,1443,NA
NM_017413,APLN,3,2,9699,3227,6472,3236,1075.666667,2.005577936
NM_003399,XPNPEP2,21,20,30581,3354,27227,1361.35,159.7142857,8.117769827
NM_018990,SASH3,8,7,15286,2701,12585,1797.857143,337.625,4.659385413
NM_006649,UTP14A,15,14,23643,2575,21068,1504.857143,171.6666667,8.181747573
NM_001166221,UTP14A,14,13,23643,2418,21225,1632.692308,172.7142857,8.777915633
NM_021946,BCORL1,12,11,52896,7139,45757,4159.727273,594.9166667,6.409441098
NM_145813,AIFM1,8,7,36525,1414,35111,5015.857143,176.75,24.83097595
NM_145812,AIFM1,16,15,36525,2271,34254,2283.6,141.9375,15.08322325
NM_001130847,AIFM1,17,16,36525,2487,34038,2127.375,146.2941176,13.68636912
NM_001130846,AIFM1,7,6,8679,1931,6748,1124.666667,275.8571429,3.494562403
NM_004794,RAB33A,2,1,13073,1110,11963,11963,555,10.77747748
NM_004208,AIFM1,16,15,36525,2283,34242,2282.8,142.6875,14.99868594
NM_016024,RBMX2,6,5,11376,1534,9842,1968.4,255.6666667,6.415906128
NM_178471,GPR119,1,0,1194,1194,NA,NA,1194,NA
NM_144967,ARHGAP36,12,11,31643,3099,28544,2594.909091,258.25,9.210713133
NM_001282607,ARHGAP36,12,11,31645,2865,28780,2616.363636,238.75,10.04537522
NM_001170963,IGSF1,5,4,4897,1792,3105,776.25,358.4,1.732700893
NM_205833,IGSF1,5,4,5265,1968,3297,824.25,393.6,1.675304878
NM_194277,FRMD7,12,11,51031,3214,47817,4347,267.8333333,14.87772246
NM_021183,RAP2C,4,3,15139,3938,11201,3733.666667,984.5,2.844337227
NM_001271186,RAP2C,6,5,16458,4012,12446,2489.2,668.6666667,3.10219342
NM_001271187,RAP2C,6,5,16458,3347,13111,2622.2,557.8333333,3.917239319
NM_133486,MBNL3,9,8,70377,11473,58904,7363,1274.777778,5.134141027
NM_001170703,MBNL3,8,7,44295,11273,33022,4717.428571,1409.125,2.929300098
NM_001170702,MBNL3,7,6,44262,11303,32959,5493.166667,1614.714286,2.915951517
NM_001170701,MBNL3,8,7,44262,11340,32922,4703.142857,1417.5,2.903174603
NM_018388,MBNL3,8,7,70377,11503,58874,8410.571429,1437.875,5.118143093
NM_031907,USP26,1,0,2795,2795,NA,NA,2795,NA
NM_016521,TFDP3,1,0,1681,1681,NA,NA,1681,NA
NM_001101357,CCDC160,2,1,8733,1301,7432,7432,650.5,5.712528824
NM_032335,PHF6,8,7,41981,1218,40763,5823.285714,152.25,33.46715928
NM_000194,HPRT1,9,8,40525,1424,39101,4887.625,158.2222222,27.45856742
NM_021796,PLAC1,3,2,92642,1129,91513,45756.5,376.3333333,81.05668733
NM_001170781,FAM122C,2,1,3990,2513,1477,1477,1256.5,0.587743733
NM_001170757,FAM122B,10,9,27668,2436,25232,2803.555556,243.6,10.35796388
NM_001170756,FAM122B,10,9,26791,3534,23257,2584.111111,353.4,6.580928127
NM_145284,FAM122B,9,8,26791,3479,23312,2914,386.5555556,6.700776085
NM_001166599,FAM122B,9,8,27591,4276,23315,2914.375,475.1111111,5.452525725
NM_001166600,FAM122B,11,10,27668,2718,24950,2495,247.0909091,9.179543782
NM_019556,MOSPD1,6,5,27637,2364,25273,5054.6,394,10.69077834
NM_001163438,SMIM10,1,0,1537,1537,NA,NA,1537,NA
NM_001078172,FAM127B,1,0,1260,1260,NA,NA,1260,NA
NM_001078171,FAM127A,1,0,1244,1244,NA,NA,1244,NA
NM_001134321,FAM127B,2,1,1260,713,547,547,356.5,0.767180926
NM_001078173,FAM127C,1,0,2034,2034,NA,NA,2034,NA
NM_001031705,CT55,6,5,15292,1880,13412,2682.4,313.3333333,7.134042553
NM_017863,CT55,5,4,15292,2166,13126,3281.5,433.2,6.060018467
NM_001185063,ZNF75D,4,3,10248,2992,7256,2418.666667,748,2.42513369
NM_007131,ZNF75D,7,6,58295,5600,52695,8782.5,800,9.409821429
NM_182540,DDX26B,17,16,61907,3865,58042,3627.625,227.3529412,15.01733506
NM_001017417,CT45A1,5,4,9805,1013,8792,2198,202.6,8.67917078
NM_001007551,CT45A5,5,4,8345,1326,7019,1754.75,265.2,5.293363499
NM_001172288,CT45A5,5,4,8345,1343,7002,1750.5,268.6,5.21370067
NM_001017436,CT45A4,5,4,8040,1013,7027,1756.75,202.6,6.936821323
NM_001017435,CT45A3,5,4,8033,1013,7020,1755,202.6,6.929911155
NM_018666,SAGE1,20,19,19437,3066,16371,861.6315789,153.3,5.339530333
NM_001017438,CT45A6,5,4,8031,1013,7018,1754.5,202.6,6.927936821
NM_001042537,SLC9A6,16,15,61844,4743,57101,3806.733333,296.4375,12.03900485
NM_006359,SLC9A6,16,15,61844,4647,57197,3813.133333,290.4375,12.30837099
NM_173470,MMGT1,4,3,11905,3652,8253,2751,913,2.259857612
NM_001177651,SLC9A6,17,16,61847,4622,57225,3576.5625,271.8823529,12.38100389
NM_024597,MAP7D3,19,18,34766,4582,30184,1676.888889,241.1578947,6.587516368
NM_001159699,FHL1,6,5,14465,2448,12017,2403.4,408,4.908905229
NM_001159701,FHL1,6,5,14607,2319,12288,2457.6,386.5,5.298835705
NM_001173517,MAP7D3,18,17,38361,4591,33770,1986.470588,255.0555556,7.355695927
NM_001173516,MAP7D3,19,18,39669,4470,35199,1955.5,235.2631579,7.874496644
NM_014500,HTATSF1,9,8,14834,2781,12053,1506.625,309,4.334052499
NM_016267,VGLL1,5,4,24657,1220,23437,5859.25,244,19.21065574
NM_001727,BRS3,3,2,4475,1416,3059,1529.5,472,2.160310734
NM_001163280,HTATSF1,10,9,15267,3031,12236,1359.555556,303.1,4.036951501
NM_000074,CD40LG,5,4,12215,1838,10377,2594.25,367.6,5.645810664
NM_001164803,RBMX,8,7,11588,2060,9528,1361.142857,257.5,4.625242718
NM_002139,RBMX,9,8,7335,2090,5245,655.625,232.2222222,2.509569378
NM_054021,GPR101,1,0,1528,1528,NA,NA,1528,NA
NM_003413,ZIC3,3,2,5915,3942,1973,986.5,1314,0.500507357
NM_000133,F9,8,7,32724,2810,29914,4273.428571,351.25,10.6455516
NM_173694,ATP11C,30,29,105944,6148,99796,3441.241379,204.9333333,16.23227066
NM_001010986,ATP11C,29,28,105944,6042,99902,3567.928571,208.3448276,16.53459119
NM_001013403,CXorf66,3,2,9795,1282,8513,4256.5,427.3333333,6.640405616
NM_001271560,LOC389895,1,0,1246,1246,NA,NA,1246,NA
NM_005634,SOX3,1,0,2075,2075,NA,NA,2075,NA
NM_004065,CDR1,1,0,1300,1300,NA,NA,1300,NA
NM_032461,SPANXB1,2,1,1117,471,646,646,235.5,1.371549894
NM_032461,SPANXB1,2,1,1117,471,646,646,235.5,1.371549894
NM_145664,SPANXB2,2,1,1117,471,646,646,235.5,1.371549894
NM_145664,SPANXB2,2,1,1117,471,646,646,235.5,1.371549894
NM_139019,SPANXF1,2,1,1117,471,646,646,235.5,1.371549894
NM_139019,SPANXF1,2,1,1117,471,646,646,235.5,1.371549894
NM_012317,LDOC1,1,0,1470,1470,NA,NA,1470,NA
NM_022661,SPANXC,2,1,1052,406,646,646,203,1.591133005
NM_145662,SPANXA2,2,1,1066,420,646,646,210,1.538095238
NM_145662,SPANXA2,2,1,1066,420,646,646,210,1.538095238
NM_013453,SPANXA1,2,1,1032,386,646,646,193,1.67357513
NM_013453,SPANXA1,2,1,1032,386,646,646,193,1.67357513
NM_032417,SPANXD,2,1,1032,386,646,646,193,1.67357513
NM_145665,SPANXE,2,1,1089,443,646,646,221.5,1.458239278
NM_005462,MAGEC1,4,3,5547,4325,1222,407.3333333,1081.25,0.282543353
NM_138702,MAGEC3,8,7,59518,1940,57578,8225.428571,242.5,29.67938144
NM_177456,MAGEC3,5,4,3168,1712,1456,364,342.4,0.85046729
NM_016249,MAGEC2,3,2,2950,1997,953,476.5,665.6666667,0.477215824
NM_001009613,SPANXN4,2,1,8364,433,7931,7931,216.5,18.31639723
NM_001009609,SPANXN3,2,1,8745,596,8149,8149,298,13.67281879
NM_001184750,SLITRK4,3,2,11726,8548,3178,1589,2849.333333,0.371782873
NM_173078,SLITRK4,3,2,12426,8698,3728,1864,2899.333333,0.428604277
NM_001184749,SLITRK4,3,2,13333,8745,4588,2294,2915,0.524642653
NM_001009615,SPANXN2,2,1,9463,1379,8084,8084,689.5,5.862218999
NM_001012989,UBE2NL,1,0,1186,1186,NA,NA,1186,NA
NM_001009614,SPANXN1,2,1,8623,615,8008,8008,307.5,13.02113821
NM_032539,SLITRK2,5,4,8015,4412,3603,900.75,882.4,0.816636446
NM_001144006,SLITRK2,3,2,4496,4147,349,174.5,1382.333333,0.084157222
NM_001144004,SLITRK2,5,4,8015,3917,4098,1024.5,783.4,1.046208833
NM_001144003,SLITRK2,5,4,8015,3929,4086,1021.5,785.8,1.039959277
NM_001144005,SLITRK2,5,4,8015,3939,4076,1019,787.8,1.034780401
NM_001144009,SLITRK2,2,1,4496,3999,497,497,1999.5,0.12428107
NM_001144010,SLITRK2,3,2,4496,4137,359,179.5,1379,0.086777858
NM_001144008,SLITRK2,3,2,4496,4159,337,168.5,1386.333333,0.081029094
NM_004709,TMEM257,1,0,2444,2444,NA,NA,2444,NA
NM_001244892,CXorf51B,2,1,629,440,189,189,220,0.429545455
NM_001244892,CXorf51B,2,1,629,440,189,189,220,0.429545455
NM_001144064,CXorf51A,2,1,629,440,189,189,220,0.429545455
NM_001144064,CXorf51A,2,1,629,440,189,189,220,0.429545455
NM_001185076,FMR1,16,15,39180,4364,34816,2321.066667,272.75,7.978001833
NM_001185075,FMR1,16,15,39180,4156,35024,2334.933333,259.75,8.427333975
NM_002024,FMR1,17,16,39180,4428,34752,2172,260.4705882,7.848238482
NM_001185081,FMR1,15,14,39180,4092,35088,2506.285714,272.8,8.574780059
NM_001185082,FMR1,16,15,39180,4289,34891,2326.066667,268.0625,8.134996503
NM_152578,FMR1NB,6,5,45340,1027,44313,8862.6,171.1666667,43.14800389
NM_000202,IDS,9,8,26591,5861,20730,2591.25,651.2222222,3.536939089
NM_001171908,CXorf40A,5,4,7359,2398,4961,1240.25,479.6,2.068807339
NM_001171907,CXorf40A,5,4,7359,2449,4910,1227.5,489.8,2.004899959
NM_006123,IDS,8,7,18224,1414,16810,2401.428571,176.75,11.88826025
NM_178124,CXorf40A,5,4,7359,2430,4929,1232.25,486,2.028395062
NM_001171909,CXorf40A,5,4,6022,2090,3932,983,418,1.881339713
NM_001166550,IDS,9,8,26591,5817,20774,2596.75,646.3333333,3.571256662
NM_032508,TMEM185A,7,6,35354,2820,32534,5422.333333,402.8571429,11.53687943
NM_001164415,HSFX2,2,1,2800,1964,836,836,982,0.425661914
NM_016153,HSFX1,2,1,2793,1957,836,836,978.5,0.427184466
NM_001282302,TMEM185A,4,3,28195,1094,27101,9033.666667,273.5,24.77239488
NM_001080790,MAGEA9B,4,3,5809,1818,3991,1330.333333,454.5,2.195269527
NM_001174092,TMEM185A,6,5,35354,2642,32712,6542.4,440.3333333,12.38152914
NM_005365,MAGEA9,4,3,5802,1811,3991,1330.333333,452.75,2.203754832
NM_001011544,MAGEA11,5,4,29027,1890,27137,6784.25,378,14.35820106
NM_001164415,HSFX2,2,1,2800,1964,836,836,982,0.425661914
NM_016153,HSFX1,2,1,2793,1957,836,836,978.5,0.427184466
NM_001080790,MAGEA9B,4,3,5808,1818,3990,1330,454.5,2.194719472
NM_005366,MAGEA11,5,4,5192,1889,3303,825.75,377.8,1.748544203
NM_005365,MAGEA9,4,3,5801,1811,3990,1330,452.75,2.20320265
NM_001166401,MAGEA8,3,2,4670,2087,2583,1291.5,695.6666667,1.237661715
NM_001166400,MAGEA8,4,3,4670,2116,2554,851.3333333,529,1.206994329
NM_005364,MAGEA8,3,2,4670,1836,2834,1417,612,1.543572985
NM_001013845,CXorf40B,5,4,6303,1345,4958,1239.5,269,3.686245353
NM_001177466,MAMLD1,6,5,68730,4538,64192,12838.4,756.3333333,14.14543852
NM_005491,MAMLD1,7,6,68730,4614,64116,10686,659.1428571,13.89596879
NM_003828,MTMR1,16,15,71708,2748,68960,4597.333333,171.75,25.09461426
NM_005342,HMGB3,5,4,7487,3561,3926,981.5,712.2,1.102499298
NM_004224,GPR50,2,1,4883,2022,2861,2861,1011,1.414935707
NM_001017980,VMA21,3,2,12181,4739,7442,3721,1579.666667,1.570373497
NM_033085,FATE1,5,4,7158,1074,6084,1521,214.8,5.664804469
NM_005140,CNGA2,7,6,10820,3292,7528,1254.666667,470.2857143,2.286755772
NM_002362,MAGEA4,3,2,8935,1730,7205,3602.5,576.6666667,4.164739884
NM_001011550,MAGEA4,3,2,6884,1715,5169,2584.5,571.6666667,3.013994169
NM_001011549,MAGEA4,3,2,8247,1724,6523,3261.5,574.6666667,3.783642691
NM_001011548,MAGEA4,3,2,12283,1727,10556,5278,575.6666667,6.112333526
NM_001204811,MAGEA10-MAGEA5,4,3,24531,1877,22654,7551.333333,469.25,12.06925946
NM_021048,MAGEA10,4,3,5269,2656,2613,871,664,0.983810241
NM_001011543,MAGEA10,5,4,5269,2748,2521,630.25,549.6,0.917394469
NM_001251828,MAGEA10,5,4,5269,2676,2593,648.25,535.2,0.968983558
NM_021049,MAGEA5,3,2,3892,1667,2225,1112.5,555.6666667,1.334733053
NM_001282505,MAGEA2,2,1,4023,1665,2358,2358,832.5,1.416216216
NM_001080848,CSAG2,2,1,1006,849,157,157,424.5,0.184923439
NM_018558,GABRQ,9,8,15190,2009,13181,1647.625,223.2222222,6.56097561
NM_005363,MAGEA6,3,2,3571,1701,1870,935,567,1.099353322
NM_001102576,CSAG1,4,3,6292,663,5629,1876.333333,165.75,8.490196078
NM_001282504,MAGEA2,3,2,4023,1732,2291,1145.5,577.3333333,1.322748268
NM_001282502,MAGEA2,4,3,4023,1853,2170,723.3333333,463.25,1.171073934
NM_001282501,MAGEA2,5,4,4023,1952,2071,517.75,390.4,1.060963115
NM_153478,CSAG1,5,4,6292,880,5412,1353,176,6.15
NM_001129828,CSAG3,2,1,1006,798,208,208,399,0.260651629
NM_001129826,CSAG3,2,1,929,772,157,157,386,0.203367876
NM_001166387,MAGEA12,3,2,3893,1773,2120,1060,591,1.19571348
NM_001166386,MAGEA12,3,2,3810,1865,1945,972.5,621.6666667,1.042895442
NM_005367,MAGEA12,2,1,3893,1666,2227,2227,833,1.336734694
NM_005361,MAGEA2,4,3,4023,2028,1995,665,507,0.983727811
NM_004909,CSAG2,2,1,1006,798,208,208,399,0.260651629
NM_175868,MAGEA6,3,2,3571,1765,1806,903,588.3333333,1.023229462
NM_175743,MAGEA2,6,5,4023,2032,1991,398.2,338.6666667,0.979822835
NM_175742,MAGEA2,6,5,4023,2016,2007,401.4,336,0.995535714
NM_153488,MAGEA2B,2,1,1697,1618,79,79,809,0.048825711
NM_001282505,MAGEA2,2,1,4023,1665,2358,2358,832.5,1.416216216
NM_005362,MAGEA3,3,2,3590,1727,1863,931.5,575.6666667,1.078749276
NM_001282504,MAGEA2,3,2,4023,1732,2291,1145.5,577.3333333,1.322748268
NM_001282502,MAGEA2,4,3,4023,1853,2170,723.3333333,463.25,1.171073934
NM_001282501,MAGEA2,5,4,4023,1952,2071,517.75,390.4,1.060963115
NM_001129765,NSDHL,9,8,38398,1639,36759,4594.875,182.1111111,22.42769982
NM_001129828,CSAG3,2,1,1006,798,208,208,399,0.260651629
NM_001129826,CSAG3,2,1,929,772,157,157,386,0.203367876
NM_015922,NSDHL,8,7,38398,1571,36827,5261,196.375,23.44175684
NM_001080848,CSAG2,2,1,1006,849,157,157,424.5,0.184923439
NM_005361,MAGEA2,4,3,4023,2028,1995,665,507,0.983727811
NM_004909,CSAG2,2,1,1006,798,208,208,399,0.260651629
NM_004344,CETN2,5,4,3432,1085,2347,586.75,217,2.163133641
NM_175743,MAGEA2,6,5,4023,2032,1991,398.2,338.6666667,0.979822835
NM_175742,MAGEA2,6,5,4023,2016,2007,401.4,336,0.995535714
NM_153488,MAGEA2B,2,1,1697,1618,79,79,809,0.048825711
NM_001178115,ZNF185,9,8,31812,3239,28573,3571.625,359.8888889,8.821549861
NM_001178113,ZNF185,15,14,55618,3894,51724,3694.571429,259.6,13.28299949
NM_001178110,ZNF185,21,20,59041,4170,54871,2743.55,198.5714286,13.15851319
NM_001178109,ZNF185,22,21,59041,4261,54780,2608.571429,193.6818182,12.85613706
NM_001178108,ZNF185,23,22,59041,4352,54689,2485.863636,189.2173913,12.56640625
NM_001178107,ZNF185,23,22,59041,4358,54683,2485.590909,189.4782609,12.54772832
NM_001178106,ZNF185,24,23,59041,4446,54595,2373.695652,185.25,12.27957715
NM_007150,ZNF185,23,22,59041,4349,54692,2486,189.0869565,12.57576454
NM_001103151,PNMA5,3,2,3395,3117,278,139,1039,0.089188322
NM_001103150,PNMA5,2,1,3395,3216,179,179,1608,0.055659204
NM_052926,PNMA5,2,1,3395,3202,193,193,1601,0.060274828
NM_001184924,PNMA5,4,3,5305,3203,2102,700.6666667,800.75,0.656259756
NM_032882,PNMA6A,2,1,1808,1481,327,327,740.5,0.220796759
NM_032882,PNMA6A,2,1,1808,1481,327,327,740.5,0.220796759
NM_001170944,PNMA6C,2,1,2585,2258,327,327,1129,0.144818423
NM_013364,PNMA3,2,1,4063,3753,310,310,1876.5,0.082600586
NM_001282535,PNMA3,3,2,4063,3633,430,215,1211,0.118359483
NM_004988,MAGEA1,3,2,4596,1712,2884,1442,570.6666667,1.684579439
NM_001080485,ZNF275,5,4,18773,6325,12448,3112,1265,1.968063241
NM_001136273,ZFP92,4,3,3307,1255,2052,684,313.75,1.635059761
NM_080701,TREX2,2,1,1769,1257,512,512,628.5,0.407319014
NM_017518,HAUS7,10,9,22968,1374,21594,2399.333333,137.4,15.71615721
NM_001711,BGN,8,7,14659,2452,12207,1743.857143,306.5,4.978384992
NM_001130997,FAM58A,5,4,11251,1233,10018,2504.5,246.6,8.124898621
NM_152274,FAM58A,5,4,11251,1293,9958,2489.5,258.6,7.701469451
NM_001135740,PNCK,12,11,3557,1518,2039,185.3636364,126.5,1.343214756
NM_001039582,PNCK,12,11,4630,1884,2746,249.6363636,157,1.457537155
NM_001395,DUSP9,4,3,8886,2384,6502,2167.333333,596,2.727348993
NM_001204527,SSR4,7,6,4339,782,3557,592.8333333,111.7142857,4.54859335
NM_001170761,SRPK3,16,15,4733,1916,2817,187.8,119.75,1.470250522
NM_001170760,SRPK3,15,14,4733,2014,2719,194.2142857,134.2666667,1.350049652
NM_001256447,BCAP31,8,7,24256,1651,22605,3229.285714,206.375,13.691702
NM_006280,SSR4,6,5,3950,731,3219,643.8,121.8333333,4.403556772
NM_005745,BCAP31,8,7,23893,1421,22472,3210.285714,177.625,15.81421534
NM_001139457,BCAP31,8,7,23611,1832,21779,3111.285714,229,11.88810044
NM_001163257,PLXNB3,37,36,15152,6414,8738,242.7222222,173.3513514,1.362332398
NM_000033,ABCD1,10,9,19895,3674,16221,1802.333333,367.4,4.415078933
NM_001139441,BCAP31,8,7,23637,1350,22287,3183.857143,168.75,16.50888889
NM_014370,SRPK3,15,14,4733,2017,2716,194,134.4666667,1.346554289
NM_001204526,SSR4,7,6,4065,759,3306,551,108.4285714,4.355731225
NM_005393,PLXNB3,36,35,15152,6247,8905,254.4285714,173.5277778,1.425484232
NM_004135,IDH3G,13,12,8759,1498,7261,605.0833333,115.2307692,4.847129506
NM_174869,IDH3G,12,11,8759,1735,7024,638.5454545,144.5833333,4.048414986
NM_001164741,ARHGAP4,23,22,18886,3395,15491,704.1363636,147.6086957,4.562886598
NM_001146151,AVPR2,2,1,2093,1733,360,360,866.5,0.207732256
NM_001278116,L1CAM,29,28,24661,5170,19491,696.1071429,178.2758621,3.770019342
NM_024003,L1CAM,27,26,14432,5046,9386,361,186.8888889,1.860087198
NM_000054,AVPR2,3,2,2093,1628,465,232.5,542.6666667,0.285626536
NM_002910,RENBP,11,10,9512,1482,8030,803,134.7272727,5.418353576
NM_001666,ARHGAP4,22,21,18886,3274,15612,743.4285714,148.8181818,4.768478925
NM_001256120,NAA10,8,7,5329,1108,4221,603,138.5,3.809566787
NM_001256119,NAA10,7,6,5329,1080,4249,708.1666667,154.2857143,3.934259259
NM_001143963,L1CAM,26,25,14432,5030,9402,376.08,193.4615385,1.869184891
NM_000425,L1CAM,28,27,14533,5160,9373,347.1481481,184.2857143,1.816472868
NM_003491,NAA10,8,7,5329,1126,4203,600.4285714,140.75,3.73268206
NM_001569,IRAK1,14,13,9387,3585,5802,446.3076923,256.0714286,1.618410042
NM_001025243,IRAK1,13,12,9387,3347,6040,503.3333333,257.4615385,1.804601135
NM_001025242,IRAK1,14,13,9387,3495,5892,453.2307692,249.6428571,1.68583691
NM_003492,TMEM187,2,1,10657,1669,8988,8988,834.5,5.385260635
NM_000513,OPN1MW,6,5,14269,2004,12265,2453,334,6.120259481
NM_001048181,OPN1MW2,6,5,13554,1289,12265,2453,214.8333333,9.515128006
NM_020061,OPN1LW,6,5,14811,1267,13544,2708.8,211.1666667,10.68981847
NM_000117,EMD,6,5,2288,1345,943,188.6,224.1666667,0.701115242
NM_001145933,TKTL1,13,12,34688,2647,32041,2670.083333,203.6153846,12.10464677
NM_001205201,TEX28,5,4,24636,1554,23082,5770.5,310.8,14.85328185
NM_012253,TKTL1,13,12,34688,2665,32023,2668.583333,205,12.01613508
NM_001586,TEX28,5,4,24526,1548,22978,5744.5,309.6,14.84366925
NM_001456,FLNA,47,46,26108,8533,17575,382.0652174,181.5531915,2.059650768
NM_001110556,FLNA,48,47,26108,8558,17550,373.4042553,178.2916667,2.050712783
NM_001145934,TKTL1,12,11,25306,2591,22715,2065,215.9166667,8.766885372
NM_001282311,FAM3A,10,9,10078,1923,8155,906.1111111,192.3,4.240769631
NM_001282312,FAM3A,10,9,10078,1669,8409,934.3333333,166.9,5.038346315
NM_001256580,RPL10,6,5,4111,2216,1895,379,369.3333333,0.855144404
NM_001256577,RPL10,6,5,4111,2161,1950,390,360.1666667,0.902360019
NM_001009933,DNASE1L1,9,8,10850,2759,8091,1011.375,306.5555556,2.93258427
NM_001009932,DNASE1L1,10,9,10850,3018,7832,870.2222222,301.8,2.59509609
NM_019848,SLC10A3,2,1,3386,2163,1223,1223,1081.5,0.5654184
NM_001009934,DNASE1L1,8,7,10850,2673,8177,1168.142857,334.125,3.059109615
NM_001142391,SLC10A3,4,3,3386,1843,1543,514.3333333,460.75,0.837221921
NM_000116,TAZ,11,10,10188,1914,8274,827.4,174,4.322884013
NM_001171134,FAM3A,8,7,10078,1772,8306,1186.571429,221.5,4.687358916
NM_001171133,FAM3A,9,8,10078,1613,8465,1058.125,179.2222222,5.247985121
NM_001171132,FAM3A,10,9,10078,1728,8350,927.7777778,172.8,4.832175926
NM_001142392,SLC10A3,3,2,3386,1929,1457,728.5,643,0.755313634
NM_014235,UBL4A,4,3,2955,2386,569,189.6666667,596.5,0.238474434
NM_017514,PLXNA3,33,32,15370,6785,8585,268.28125,205.6060606,1.265291083
NM_006014,LAGE3,3,2,1490,952,538,269,317.3333333,0.56512605
NM_181313,TAZ,9,8,10188,1780,8408,1051,197.7777778,4.723595506
NM_181312,TAZ,10,9,10188,1871,8317,924.1111111,187.1,4.445216462
NM_181311,TAZ,10,9,10188,1823,8365,929.4444444,182.3,4.588590236
NM_001493,GDI1,11,10,6557,2492,4065,406.5,226.5454545,1.631219904
NM_001183,ATP6AP1,10,9,7887,2110,5777,641.8888889,211,2.737914692
NM_021806,FAM3A,9,8,10078,1824,8254,1031.75,202.6666667,4.525219298
NM_006730,DNASE1L1,8,7,7998,3155,4843,691.8571429,394.375,1.535023772
NM_006013,RPL10,7,6,4111,2325,1786,297.6666667,332.1428571,0.768172043
NM_004699,FAM50A,13,12,6531,1365,5166,430.5,105,3.784615385
NM_001042351,G6PD,13,12,16198,2298,13900,1158.333333,176.7692308,6.048738033
NM_001327,CTAG1B,3,2,1659,751,908,454,250.3333333,1.209054594
NM_001327,CTAG1B,3,2,1659,751,908,454,250.3333333,1.209054594
NM_001145255,IKBKG,8,7,17701,1970,15731,2247.285714,246.25,7.985279188
NM_001099857,IKBKG,10,9,17701,2269,15432,1714.666667,226.9,6.801234024
NM_001099856,IKBKG,10,9,22804,2079,20725,2302.777778,207.9,9.968734969
NM_139250,CTAG1A,3,2,1659,751,908,454,250.3333333,1.209054594
NM_139250,CTAG1A,3,2,1659,751,908,454,250.3333333,1.209054594
NM_000402,G6PD,13,12,15630,2409,13221,1101.75,185.3076923,5.488169365
NM_003639,IKBKG,10,9,17201,2113,15088,1676.444444,211.3,7.140558448
NM_001282283,GAB3,9,8,75833,4642,71191,8898.875,515.7777778,15.33627747
NM_020994,CTAG2,2,1,1609,995,614,614,497.5,0.617085427
NM_001081573,GAB3,10,9,75833,4760,71073,7897,476,14.93130252
NM_080612,GAB3,10,9,75833,4757,71076,7897.333333,475.7,14.94134959
NM_001363,DKC1,15,14,14949,2606,12343,881.6428571,173.7333333,4.73637759
NM_001142463,DKC1,15,14,14949,2591,12358,882.7142857,172.7333333,4.769587032
NM_172377,CTAG2,3,2,1609,767,842,421,255.6666667,1.097783572
NM_001288747,DKC1,14,13,14949,3094,11855,911.9230769,221,3.831609567
NM_012151,F8A1,1,0,1703,1703,NA,NA,1703,NA
NM_001007524,F8A3,1,0,1117,1117,NA,NA,1117,NA
NM_001007523,F8A2,1,0,1117,1117,NA,NA,1117,NA
NM_019863,F8,5,4,50515,2609,47906,11976.5,521.8,18.36182445
NM_080720,H2AFB3,1,0,518,518,NA,NA,518,NA
NM_001162936,SMIM9,5,4,11316,1021,10295,2573.75,204.2,10.08325171
NM_001017991,H2AFB2,1,0,595,595,NA,NA,595,NA
NM_001017990,H2AFB1,1,0,518,518,NA,NA,518,NA
NM_001018055,BRCC3,11,10,51656,2865,48791,4879.1,260.4545455,17.03001745
NM_024332,BRCC3,12,11,51656,2941,48715,4428.636364,245.0833333,16.56409385
NM_001242640,BRCC3,11,10,51656,2868,48788,4878.8,260.7272727,17.0111576
NM_001018025,MTCP1,5,4,7240,2325,4915,1228.75,465,2.113978495
NM_001018024,CMC4,3,2,9649,1017,8632,4316,339,8.487708948
NM_003372,VBP1,6,5,23399,1634,21765,4353,272.3333333,13.32007344
NM_171998,RAB39B,2,1,6357,3514,2843,2843,1757,0.809049516
NM_012151,F8A1,1,0,1703,1703,NA,NA,1703,NA
NM_001007524,F8A3,1,0,1117,1117,NA,NA,1117,NA
NM_001007523,F8A2,1,0,1117,1117,NA,NA,1117,NA
NM_080720,H2AFB3,1,0,518,518,NA,NA,518,NA
NM_001017991,H2AFB2,1,0,595,595,NA,NA,595,NA
NM_001017990,H2AFB1,1,0,518,518,NA,NA,518,NA
NM_012151,F8A1,1,0,1703,1703,NA,NA,1703,NA
NM_001007524,F8A3,1,0,1117,1117,NA,NA,1117,NA
NM_001007523,F8A2,1,0,1117,1117,NA,NA,1117,NA
NM_080720,H2AFB3,1,0,518,518,NA,NA,518,NA
NM_001017991,H2AFB2,1,0,595,595,NA,NA,595,NA
NM_001017990,H2AFB1,1,0,518,518,NA,NA,518,NA
NM_005840,SPRY3,2,1,14668,9040,5628,5628,4520,0.622566372
NM_001145149,VAMP7,7,6,62492,2543,59949,9991.5,363.2857143,23.57412505
NM_001185183,VAMP7,7,6,62492,2598,59894,9982.333333,371.1428571,23.05388761
NM_005638,VAMP7,8,7,62492,2667,59825,8546.428571,333.375,22.43157105
NM_002186,IL9R,9,8,13238,2162,11076,1384.5,240.2222222,5.123034228
NM_176786,IL9R,9,8,13238,2166,11072,1384,240.6666667,5.111726685
NM_001206850,NLGN4Y,6,5,321362,5085,316277,63255.4,847.5,62.19803343
NM_014893,NLGN4Y,6,5,320224,5415,314809,62961.8,902.5,58.13647276
NM_001164238,NLGN4Y,4,3,111530,886,110644,36881.33333,221.5,124.8803612
NM_145177,DHRSX,7,6,281462,2576,278886,46481,368,108.2631988
NM_032973,PCDH11Y,5,4,686140,9048,677092,169273,1809.6,74.83333333
NM_013239,PPP2R3B,13,12,53024,2439,50585,4215.416667,187.6153846,20.7400574
NM_002183,IL3RA,12,11,46075,1722,44353,4032.090909,143.5,25.75667828
NM_001171039,ASMT,7,6,27950,1038,26912,4485.333333,148.2857143,25.92678227
NM_001171038,ASMT,9,8,28035,1350,26685,3335.625,150,19.76666667
NM_178129,P2RY8,2,1,74573,4236,70337,70337,2118,16.60457979
NM_001267713,IL3RA,10,9,46075,1486,44589,4954.333333,148.6,30.00605653
NM_004043,ASMT,10,9,47628,1344,46284,5142.666667,134.4,34.4375
NM_001171136,ZBED1,2,1,14555,4512,10043,10043,2256,2.225842199
NM_001171135,ZBED1,2,1,14127,4590,9537,9537,2295,2.077777778
NM_004729,ZBED1,2,1,14555,4509,10046,10046,2254.5,2.227988468
NM_134259,TBL1Y,18,17,180999,2330,178669,10509.94118,129.4444444,76.68197425
NM_134258,TBL1Y,18,17,180999,2394,178605,10506.17647,133,74.60526316
NM_033284,TBL1Y,19,18,180999,2426,178573,9920.722222,127.6842105,73.6079967
NM_001164471,TSPY4,7,6,132211,1140,131071,21845.16667,162.8571429,114.9745614
NM_003308,TSPY1,6,5,2796,1167,1629,325.8,194.5,1.395886889
NM_001197242,TSPY1,6,5,2796,1178,1618,323.6,196.3333333,1.373514431
NM_182659,UTY,25,24,183163,4947,178216,7425.666667,197.88,36.0250657
NM_182660,UTY,20,19,157638,4345,153293,8068.052632,217.25,35.28032221
NM_007125,UTY,28,27,232293,6554,225739,8360.703704,234.0714286,34.44293561
NM_001258270,UTY,28,27,232293,6197,226096,8373.925926,221.3214286,36.48475069
NM_001258268,UTY,29,28,232293,6333,225960,8070,218.3793103,35.67977262
NM_001258256,UTY,28,27,232293,6518,225775,8362.037037,232.7857143,34.63869285
NM_001258254,UTY,28,27,232293,6146,226147,8375.814815,219.5,36.79580215
NM_001258253,UTY,28,27,232293,6431,225862,8365.259259,229.6785714,35.12082102
NM_001258249,UTY,30,29,232293,6847,225446,7774,228.2333333,32.92624507
NM_001258266,UTY,28,27,232293,6614,225679,8358.481481,236.2142857,34.12140913
NM_001258265,UTY,24,23,232293,6301,225992,9825.73913,262.5416667,35.86605301
NM_001258264,UTY,29,28,232293,6642,225651,8058.964286,229.0344828,33.9733514
NM_001258260,UTY,29,28,232293,6645,225648,8058.857143,229.137931,33.95756208
NM_001258259,UTY,28,27,232293,6506,225787,8362.481481,232.3571429,34.70442668
NM_001258262,UTY,30,29,232293,6475,225818,7786.827586,215.8333333,34.8753668
NM_001258261,UTY,29,28,232293,6681,225612,8057.571429,230.3793103,33.76919623
NM_001258258,UTY,29,28,232293,6711,225582,8056.5,231.4137931,33.61376844
NM_001258257,UTY,28,27,232293,6182,226111,8374.481481,220.7857143,36.57570366
NM_001258255,UTY,29,28,232293,6318,225975,8070.535714,217.862069,35.7668566
NM_001258263,UTY,27,26,232293,6382,225911,8688.884615,236.3703704,35.39815105
NM_001258269,UTY,30,29,232293,6424,225869,7788.586207,214.1333333,35.16018057
NM_001258267,UTY,28,27,232293,6569,225724,8360.148148,234.6071429,34.36200335
NM_001258251,UTY,29,28,232293,6603,225690,8060.357143,227.6896552,34.17991822
NM_001258250,UTY,28,27,232293,6134,226159,8376.259259,219.0714286,36.86974242
NM_001258252,UTY,29,28,232293,6690,225603,8057.25,230.6896552,33.72242152
NM_004654,USP9Y,46,45,159610,10086,149524,3322.755556,219.2608696,14.82490581
NM_152584,HSFY1,2,1,42274,1040,41234,41234,520,39.64807692
NM_001001877,HSFY2,2,1,42274,1040,41234,41234,520,39.64807692
NM_153716,HSFY2,2,1,1922,1445,477,477,722.5,0.330103806
NM_033108,HSFY1,2,1,1906,1429,477,477,714.5,0.33379986
NM_001146706,KDM5D,26,25,39526,5343,34183,1367.32,205.5,6.397716639
NM_001146705,KDM5D,28,27,39526,5609,33917,1256.185185,200.3214286,6.046888929
NM_004653,KDM5D,27,26,39526,5515,34011,1308.115385,204.2592593,6.166999093
NM_001039567,RPS4Y2,7,6,24966,895,24071,4011.833333,127.8571429,26.89497207
NM_152585,RBMY1F,12,11,109020,1893,107127,9738.818182,157.75,56.5911252
NM_004676,PRY,5,4,24242,1243,22999,5749.75,248.6,18.50281577
NM_001002758,PRY2,5,4,24242,1243,22999,5749.75,248.6,18.50281577
NM_020363,DAZ2,24,23,71901,3877,68024,2957.565217,161.5416667,17.54552489
NM_020364,DAZ3,19,18,71924,3535,68389,3799.388889,186.0526316,19.34625177
NM_001005375,DAZ4,23,22,69754,3962,65792,2990.545455,172.2608696,16.60575467
NM_020420,DAZ4,17,16,69754,3389,66365,4147.8125,199.3529412,19.58247271
NM_020420,DAZ4,17,16,71924,3389,68535,4283.4375,199.3529412,20.22277958
NM_004081,DAZ1,28,27,69739,4447,65292,2418.222222,158.8214286,14.6822577
NM_001005785,DAZ2,23,22,71901,3804,68097,3095.318182,165.3913043,17.90141956
NM_001005786,DAZ2,16,15,71901,3293,68608,4573.866667,205.8125,20.83449742
NM_020364,DAZ3,19,18,73222,3535,69687,3871.5,186.0526316,19.71343706
NM_020420,DAZ4,17,16,73222,3389,69833,4364.5625,199.3529412,20.60578342
NM_001005375,DAZ4,23,22,73222,3962,69260,3148.181818,172.2608696,17.48107017
NM_001005786,DAZ2,16,15,73199,3293,69906,4660.4,205.8125,21.22866687
NM_001005785,DAZ2,23,22,73199,3804,69395,3154.318182,165.3913043,18.24263933
NM_005840,SPRY3,2,1,14668,9040,5628,5628,4520,0.622566372
NM_001185183,VAMP7,7,6,62492,2598,59894,9982.333333,371.1428571,23.05388761
NM_001145149,VAMP7,7,6,62492,2543,59949,9991.5,363.2857143,23.57412505
NM_005638,VAMP7,8,7,62492,2667,59825,8546.428571,333.375,22.43157105
NM_012227,GTPBP6,6,5,9463,1186,8277,1655.4,197.6666667,6.978920742
NM_018390,PLCXD1,7,6,21963,5311,16652,2775.333333,758.7142857,3.135379401
NM_006883,SHOX,6,5,35069,1957,33112,6622.4,326.1666667,16.91977517
NM_000451,SHOX,6,5,22481,3763,18718,3743.6,627.1666667,4.974222695
NM_001012288,CRLF2,5,4,16642,676,15966,3991.5,135.2,23.6183432
NM_022148,CRLF2,6,5,16638,776,15862,3172.4,129.3333333,20.44072165
NM_001161532,CSF2RA,11,10,41137,1633,39504,3950.4,148.4545455,24.1910594
NM_001161531,CSF2RA,13,12,37020,1523,35497,2958.083333,117.1538462,23.30728825
NM_001161529,CSF2RA,14,13,41137,1995,39142,3010.923077,142.5,19.62005013
NM_001161530,CSF2RA,12,11,27259,1799,25460,2314.545455,149.9166667,14.15230684
NM_006140,CSF2RA,13,12,41137,1866,39271,3272.583333,143.5384615,21.04555198
NM_172249,CSF2RA,9,8,41137,1465,39672,4959,162.7777778,27.07986348
NM_172247,CSF2RA,10,9,27259,1598,25661,2851.222222,159.8,16.05819775
NM_172246,CSF2RA,11,10,41137,1685,39452,3945.2,153.1818182,23.41364985
NM_172245,CSF2RA,13,12,41137,1842,39295,3274.583333,141.6923077,21.33279045
NM_001173473,ASMTL,13,12,50625,2061,48564,4047,158.5384615,23.56331878
NM_001173474,ASMTL,12,11,49840,2097,47743,4340.272727,174.75,22.7672866
NM_001636,SLC25A6,4,3,5996,1488,4508,1502.666667,372,3.029569892
NM_004192,ASMTL,13,12,49840,2146,47694,3974.5,165.0769231,22.22460391
NM_005088,AKAP17A,5,4,10927,3213,7714,1928.5,642.6,2.40087146
NM_002414,CD99,10,9,50124,1247,48877,5430.777778,124.7,39.19566961
NM_001277710,CD99,11,10,50124,1263,48861,4886.1,114.8181818,38.68646081
NM_001122898,CD99,9,8,50124,1198,48926,6115.75,133.1111111,40.83973289
NM_003140,SRY,1,0,888,888,NA,NA,888,NA
NM_001008,RPS4Y1,7,6,25376,904,24472,4078.666667,129.1428571,27.07079646
NM_001145275,ZFY,6,5,47031,5004,42027,8405.4,834,8.398681055
NM_003411,ZFY,8,7,47031,5248,41783,5969,656,7.961699695
NM_001145276,ZFY,7,6,47437,4757,42680,7113.333333,679.5714286,8.972041202
NM_139214,TGIF2LY,2,1,958,863,95,95,431.5,0.110081112
NM_032971,PCDH11Y,6,5,105374,4870,100504,20100.8,811.6666667,20.63737166
NM_032972,PCDH11Y,3,2,49510,5121,44389,22194.5,1707,8.668033587
NM_001278619,PCDH11Y,7,6,105374,5040,100334,16722.33333,720,19.90753968
NM_022573,TSPY2,6,5,2791,1166,1625,325,194.3333333,1.393653516
NM_001143,AMELY,6,5,8111,808,7303,1460.6,134.6666667,9.038366337
NM_001164471,TSPY4,7,6,23030,1139,21891,3648.5,162.7142857,19.21949078
NM_001164471,TSPY4,7,6,23097,1140,21957,3659.5,162.8571429,19.26052632
NM_001282469,TSPY10,6,5,2616,985,1631,326.2,164.1666667,1.655837563
NM_001243721,TSPY8,6,5,2752,1121,1631,326.2,186.8333333,1.454950937
NM_001077697,TSPY3,6,5,2798,1167,1631,326.2,194.5,1.397600686
NM_001282469,TSPY10,6,5,2616,985,1631,326.2,164.1666667,1.655837563
NM_001077697,TSPY3,6,5,2798,1167,1631,326.2,194.5,1.397600686
NM_001122665,DDX3Y,18,17,16373,4666,11707,688.6470588,259.2222222,2.509001286
NM_004660,DDX3Y,17,16,15693,4505,11188,699.25,265,2.483462819
NM_004202,TMSB4Y,2,1,2457,1669,788,788,834.5,0.472139005
NM_181880,VCY1B,2,1,738,547,191,191,273.5,0.349177331
NM_004679,VCY,2,1,742,551,191,191,275.5,0.346642468
NM_181880,VCY1B,2,1,738,547,191,191,273.5,0.349177331
NM_004679,VCY,2,1,742,551,191,191,275.5,0.346642468
NM_001002906,XKRY2,1,0,1582,1582,NA,NA,1582,NA
NM_004677,XKRY,1,0,1582,1582,NA,NA,1582,NA
NM_001001722,CDY2B,1,0,1961,1961,NA,NA,1961,NA
NM_004825,CDY2A,1,0,1961,1961,NA,NA,1961,NA
NM_001001722,CDY2B,1,0,1961,1961,NA,NA,1961,NA
NM_004825,CDY2A,1,0,1961,1961,NA,NA,1961,NA
NM_001002906,XKRY2,1,0,1582,1582,NA,NA,1582,NA
NM_004677,XKRY,1,0,1582,1582,NA,NA,1582,NA
NM_001001877,HSFY2,2,1,42277,1040,41237,41237,520,39.65096154
NM_152584,HSFY1,2,1,42277,1040,41237,41237,520,39.65096154
NM_153716,HSFY2,2,1,1922,1445,477,477,722.5,0.330103806
NM_033108,HSFY1,2,1,1906,1429,477,477,714.5,0.33379986
NM_013230,CD24,1,0,2181,2181,NA,NA,2181,NA
NM_001278612,EIF1AY,6,5,17445,1359,16086,3217.2,226.5,11.83664459
NM_004681,EIF1AY,7,6,17445,1411,16034,2672.333333,201.5714286,11.36357193
NM_001282471,CYorf17,4,3,3388,862,2526,842,215.5,2.930394432
NM_001006121,RBMY1B,12,11,14450,1933,12517,1137.909091,161.0833333,6.475426798
NM_001006121,RBMY1B,12,11,14449,1933,12516,1137.818182,161.0833333,6.474909467
NM_005058,RBMY1A1,12,11,14415,1899,12516,1137.818182,158.25,6.590837283
NM_005058,RBMY1A1,12,11,14416,1899,12517,1137.909091,158.25,6.591363876
NM_001006120,RBMY1D,12,11,14410,1893,12517,1137.909091,157.75,6.612255679
NM_001006120,RBMY1D,12,11,14409,1893,12516,1137.818182,157.75,6.611727417
NM_001006118,RBMY1E,12,11,14410,1893,12517,1137.909091,157.75,6.612255679
NM_001006120,RBMY1D,12,11,14411,1893,12518,1138,157.75,6.612783941
NM_001006120,RBMY1D,12,11,14412,1893,12519,1138.090909,157.75,6.613312203
NM_005058,RBMY1A1,12,11,14418,1899,12519,1138.090909,158.25,6.592417062
NM_001006118,RBMY1E,12,11,14412,1893,12519,1138.090909,157.75,6.613312203
NM_001006118,RBMY1E,12,11,14411,1893,12518,1138,157.75,6.612783941
NM_001006121,RBMY1B,12,11,14452,1933,12519,1138.090909,161.0833333,6.476461459
NM_001006121,RBMY1B,12,11,14451,1933,12518,1138,161.0833333,6.475944128
NM_004676,PRY,5,4,24253,1243,23010,5752.5,248.6,18.51166533
NM_001002758,PRY2,5,4,24253,1243,23010,5752.5,248.6,18.51166533
NM_152585,RBMY1F,12,11,14402,1893,12509,1137.181818,157.75,6.608029583
NM_001006117,RBMY1J,12,11,14402,1893,12509,1137.181818,157.75,6.608029583
NM_001006117,RBMY1J,12,11,14407,1892,12515,1137.727273,157.6666667,6.614693446
NM_001002761,BPY2C,9,8,21202,1213,19989,2498.625,134.7777778,16.47897774
NM_001002760,BPY2B,9,8,21202,1213,19989,2498.625,134.7777778,16.47897774
NM_004678,BPY2,9,8,21202,1213,19989,2498.625,134.7777778,16.47897774
NM_004680,CDY1,2,1,2786,2367,419,419,1183.5,0.177017322
NM_170723,CDY1,1,0,2223,2223,NA,NA,2223,NA
NM_001003894,CDY1B,1,0,2223,2223,NA,NA,2223,NA
NM_001003895,CDY1B,2,1,2786,2367,419,419,1183.5,0.177017322
NM_001002761,BPY2C,9,8,21203,1213,19990,2498.75,134.7777778,16.47980214
NM_001002760,BPY2B,9,8,21203,1213,19990,2498.75,134.7777778,16.47980214
NM_004678,BPY2,9,8,21203,1213,19990,2498.75,134.7777778,16.47980214
NM_020364,DAZ3,19,18,50425,3535,46890,2605,186.0526316,13.26449788
NM_020420,DAZ4,17,16,50425,3389,47036,2939.75,199.3529412,13.87902036
NM_001002761,BPY2C,9,8,21203,1213,19990,2498.75,134.7777778,16.47980214
NM_001002760,BPY2B,9,8,21203,1213,19990,2498.75,134.7777778,16.47980214
NM_004678,BPY2,9,8,21203,1213,19990,2498.75,134.7777778,16.47980214
NM_170723,CDY1,1,0,2223,2223,NA,NA,2223,NA
NM_004680,CDY1,2,1,2786,2367,419,419,1183.5,0.177017322
NM_001003894,CDY1B,1,0,2223,2223,NA,NA,2223,NA
NM_001003895,CDY1B,2,1,2786,2367,419,419,1183.5,0.177017322
NM_002186,IL9R,9,8,13238,2162,11076,1384.5,240.2222222,5.123034228
NM_176786,IL9R,9,8,13238,2166,11072,1384,240.6666667,5.111726685
NM_138499,PWWP2B,3,2,20658,2615,18043,9021.5,871.6666667,6.899808795
NM_001098637,PWWP2B,3,2,20658,2312,18346,9173,770.6666667,7.935121107
NM_001024628,NRP1,12,11,137288,2490,134798,12254.36364,207.5,54.13574297
NM_001024629,NRP1,11,10,137288,2384,134904,13490.4,216.7272727,56.58724832
NM_152724,RSU1,8,7,226838,3649,223189,31884.14286,456.125,61.16442861
NM_012425,RSU1,9,8,226838,3762,223076,27884.5,418,59.29718235
NM_003873,NRP1,17,16,157416,5897,151519,9469.9375,346.8823529,25.69425131
NM_001244972,NRP1,17,16,157416,5879,151537,9471.0625,345.8235294,25.77598231
NM_001244973,NRP1,17,16,157416,5876,151540,9471.25,345.6470588,25.78965283
NM_020200,PRTFDC1,9,8,104039,1993,102046,12755.75,221.4444444,51.20220773
NM_001282786,PRTFDC1,8,7,104039,1915,102124,14589.14286,239.375,53.32845953
NM_001010848,NRG3,9,8,1111867,3701,1108166,138520.75,411.2222222,299.4233991
NM_015892,CHST15,8,7,84760,4790,79970,11424.28571,598.75,16.69519833
NM_001166246,HPSE2,13,12,778800,4432,774368,64530.66667,340.9230769,174.7220217
NM_001166244,HPSE2,11,10,778800,4186,774614,77461.4,380.5454545,185.0487339
NM_001165973,NRG3,11,10,1109494,3359,1106135,110613.5,305.3636364,329.3048526
NM_014863,CHST15,6,5,72773,3569,69204,13840.8,594.8333333,19.39030541
NM_021828,HPSE2,12,11,778800,4361,774439,70403.54545,363.4166667,177.5828938
NM_001270765,CHST15,6,5,73956,3607,70349,14069.8,601.1666667,19.50346548
NM_001270764,CHST15,8,7,85943,4828,81115,11587.85714,603.5,16.80095278
NM_207303,ATRNL1,29,28,855374,8761,846613,30236.17857,302.1034483,96.63428832
NM_001166245,HPSE2,10,9,778800,4023,774777,86086.33333,402.3,192.5868755
NM_001165972,NRG3,9,8,1111867,3698,1108169,138521.125,410.8888889,299.6671174
NM_001029880,SFMBT2,21,20,252864,8045,244819,12240.95,383.0952381,30.4311995
NM_012341,GTPBP4,17,16,29361,2534,26827,1676.6875,149.0588235,10.58681926
NM_002627,PFKP,22,21,69287,2679,66608,3171.809524,121.7727273,24.86300859
NM_001242339,PFKP,24,23,68180,2805,65375,2842.391304,116.875,23.30659537
NM_001818,AKR1C4,9,8,22114,1201,20913,2614.125,133.4444444,17.41298918
NM_001018039,SFMBT2,21,20,250719,7943,242776,12138.8,378.2380952,30.56477401
NM_001282695,FAM107B,6,5,256342,3860,252482,50496.4,643.3333333,65.40984456
NM_020397,CAMK1D,10,9,476556,1732,474824,52758.22222,173.2,274.147806
NM_001080491,USP6NL,14,13,71767,4526,67241,5172.384615,323.2857143,14.85660627
NM_031453,FAM107B,5,4,256342,3793,252549,63137.25,758.6,66.5829159
NM_014688,USP6NL,15,14,151172,4754,146418,10458.42857,316.9333333,30.79890618
NM_003675,PRPF18,10,9,43931,1715,42216,4690.666667,171.5,24.61574344
NM_003638,ITGA8,30,29,202684,3291,199393,6875.62069,109.7,60.58735947
NM_153498,CAMK1D,11,10,480152,2251,477901,47790.1,204.6363636,212.3060862
NM_001142308,MALRD1,40,39,685709,6920,678789,17404.84615,173,98.09089595
NM_001195626,MLLT10,22,21,208987,4876,204111,9719.571429,221.6363636,41.86033634
NM_001098500,KIAA1217,19,18,853104,6147,846957,47053.16667,323.5263158,137.783797
NM_001098844,TMEM236,4,3,48608,5458,43150,14383.33333,1364.5,7.90582631
NM_004641,MLLT10,24,23,209460,5151,204309,8883,214.625,39.66394875
NM_182543,NSUN6,11,10,106288,2437,103851,10385.1,221.5454545,42.61427985
NM_001282854,CCNY,8,7,235798,4577,231221,33031.57143,572.125,50.51802491
NM_145012,CCNY,10,9,235798,4716,231082,25675.77778,471.6,48.99957591
NM_019619,PARD3,25,24,705767,6035,699732,29155.5,241.4,115.9456504
NM_001184792,PARD3,21,20,503067,3539,499528,24976.4,168.5238095,141.1494773
NM_181698,CCNY,12,11,325691,4742,320949,29177.18182,395.1666667,67.6822016
NM_001282853,CCNY,11,10,235798,4780,231018,23101.8,434.5454545,48.33012552
NM_001184793,PARD3,21,20,503067,3446,499621,24981.05,164.0952381,144.9857806
NM_001184794,PARD3,20,19,503067,3409,499658,26297.78947,170.45,146.5702552
NM_001184790,PARD3,23,22,705767,5763,700004,31818.36364,250.5652174,121.4652091
NM_001184789,PARD3,23,22,705767,5784,699983,31817.40909,251.4782609,121.020574
NM_001282852,CCNY,9,8,235798,4640,231158,28894.75,515.5555556,49.81853448
NM_001184791,PARD3,21,20,705767,5695,700072,35003.6,271.1904762,122.9274802
NM_001184788,PARD3,24,23,705767,5896,699871,30429.17391,245.6666667,118.7026798
NM_001184787,PARD3,24,23,705767,5923,699844,30428,246.7916667,118.157015
NM_001184786,PARD3,24,23,705767,5986,699781,30425.26087,249.4166667,116.9029402
NM_001184785,PARD3,25,24,705767,6026,699741,29155.875,241.04,116.120312
NM_001128324,ZFAND4,10,9,57314,3381,53933,5992.555556,338.1,15.95178941
NM_001282906,ZFAND4,11,10,57314,3484,53830,5383,316.7272727,15.45063146
NM_001282905,ZFAND4,11,10,57233,3832,53401,5340.1,348.3636364,13.9355428
NM_174890,ZFAND4,10,9,57233,3729,53504,5944.888889,372.9,14.3480826
NM_001190810,AGAP9,8,7,21786,2395,19391,2770.142857,299.375,8.096450939
NM_001142772,PCDH15,34,33,998520,9269,989251,29977.30303,272.6176471,106.7268314
NM_001142771,PCDH15,35,34,998520,9285,989235,29095.14706,265.2857143,106.5411955
NM_001142769,PCDH15,36,35,992601,5804,986797,28194.2,161.2222222,170.0201585
NM_001098512,PRKG1,18,17,1307201,6712,1300489,76499.35294,372.8888889,193.7558105
NM_006258,PRKG1,18,17,1223878,6646,1217232,71601.88235,369.2222222,183.152573
NM_000242,MBL2,4,3,6322,3573,2749,916.3333333,893.25,0.769381472
NM_001142770,PCDH15,35,34,992601,5838,986763,29022.44118,166.8,169.0241521
NM_001204403,ANK3,44,43,707230,9385,697845,16228.95349,213.2954545,74.35748535
NM_020987,ANK3,44,43,363580,17064,346516,8058.511628,387.8181818,20.30684482
NM_032776,JMJD1C,26,25,298782,8812,289970,11598.8,338.9230769,32.90626419
NM_145307,RTKN2,12,11,75779,6917,68862,6260.181818,576.4166667,9.955472025
NM_001149,ANK3,21,20,114720,7224,107496,5374.8,344,14.88039867
NM_001204404,ANK3,44,43,546660,9628,537032,12489.11628,218.8181818,55.77814707
NM_001282948,JMJD1C,25,24,102004,8700,93304,3887.666667,348,10.7245977
NM_022124,CDH23,68,67,419015,11192,407823,6086.910448,164.5882353,36.43879557
NM_001127384,CTNNA3,18,17,1745693,3192,1742501,102500.0588,177.3333333,545.8963033
NM_001171930,CDH23,31,30,335792,4874,330918,11030.6,157.2258065,67.89454247
NM_001171931,CDH23,25,24,310575,3979,306596,12774.83333,159.16,77.05353104
NM_052836,CDH23,13,12,250530,2697,247833,20652.75,207.4615385,91.89210234
NM_152707,SLC25A16,9,8,45192,2255,42937,5367.125,250.5555556,19.04079823
NM_013266,CTNNA3,18,17,1776226,3266,1772960,104291.7647,181.4444444,542.8536436
NM_032024,C10orf11,6,5,774609,898,773711,154742.2,149.6666667,861.5935412
NM_001271518,KCNMA1,28,27,768220,11860,756360,28013.33333,423.5714286,63.77403035
NM_001014797,KCNMA1,29,28,768220,12023,756197,27007.03571,414.5862069,62.89586626
NM_001031709,RNLS,7,6,299225,2423,296802,49467,346.1428571,122.493603
NM_213606,SLC16A12,8,7,105264,4630,100634,14376.28571,578.75,21.73520518
NM_001284223,LRIT2,4,3,5098,3183,1915,638.3333333,795.75,0.601633679
NM_017551,GRID1,16,15,766940,5865,761075,50738.33333,366.5625,129.7655584
NM_018363,RNLS,7,6,309463,2187,307276,51212.66667,312.4285714,140.5011431
NM_001017924,LRIT2,3,2,5098,3152,1946,973,1050.666667,0.617385787
NM_001164179,ENTPD1,10,9,121352,12627,108725,12080.55556,1262.7,8.610517146
NM_001010917,GOLGA7B,5,4,21342,6453,14889,3722.25,1290.6,2.307298931
NM_001128925,CYP2C18,8,7,52698,2376,50322,7188.857143,297,21.17929293
NM_001164183,ENTPD1,8,7,121352,12479,108873,15553.28571,1559.875,8.724497155
NM_001776,ENTPD1,10,9,121352,12750,108602,12066.88889,1275,8.517803922
NM_000772,CYP2C18,9,8,52698,2554,50144,6268,283.7777778,19.63351605
NM_001098175,ENTPD1,10,9,165489,12625,152864,16984.88889,1262.5,12.1080396
NM_001164182,ENTPD1,9,8,121352,12598,108754,13594.25,1399.777778,8.632640102
NM_001164181,ENTPD1,9,8,121616,12396,109220,13652.5,1377.333333,8.810906744
NM_001164178,ENTPD1,10,9,121616,12525,109091,12121.22222,1252.5,8.709860279
NM_006204,PDE6C,22,21,53086,2991,50095,2385.47619,135.9545455,16.74857907
NM_004523,KIF11,22,21,62329,5100,57229,2725.190476,231.8181818,11.22137255
NM_025145,WDR96,38,37,102476,5403,97073,2623.594595,142.1842105,17.96650009
NM_014978,SORCS3,27,26,624136,5784,618352,23782.76923,214.2222222,106.9073306
NM_024541,C10orf76,26,25,210578,4127,206451,8258.04,158.7307692,50.02447298
NM_032429,LZTS2,5,4,10731,2853,7878,1969.5,570.6,2.761303891
NM_001134373,NT5C2,18,17,105291,3454,101837,5990.411765,191.8888889,29.48378691
NM_012229,NT5C2,19,18,105291,3553,101738,5652.111111,187,28.63439347
NM_015221,DNMBP,17,16,134344,6417,127927,7995.4375,377.4705882,19.93563971
NM_002313,ABLIM1,22,21,227191,7608,219583,10456.33333,345.8181818,28.86211882
NM_001177660,HABP2,13,12,38772,2990,35782,2981.833333,230,11.96722408
NM_145206,VTI1A,8,7,371750,4400,367350,52478.57143,550,83.48863636
NM_004132,HABP2,13,12,36584,3031,33553,2796.083333,233.1538462,11.06994391
NM_001003408,ABLIM1,23,22,253547,7716,245831,11174.13636,335.4782609,31.8599015
NM_001003407,ABLIM1,22,21,253547,7631,245916,11710.28571,346.8636364,32.22592059
NM_025015,HSPA12A,12,11,71384,5734,65650,5968.181818,477.8333333,11.44925009
NM_001167865,NSMCE4A,11,10,18142,1413,16729,1672.9,128.4545455,11.8393489
NM_017615,NSMCE4A,11,10,18142,1416,16726,1672.6,128.7272727,11.81214689
NM_001609,ACADSB,11,10,49379,5952,43427,4342.7,541.0909091,7.296202957
NM_021641,ADAM12,19,18,347218,3439,343779,19098.83333,181,99.96481535
NM_003474,ADAM12,23,22,376175,8060,368115,16732.5,350.4347826,45.67183623
NM_001380,DOCK1,52,51,656759,6803,649956,12744.23529,130.8269231,95.53961488
NM_001039762,FAM196A,6,5,60734,4413,56321,11264.2,735.5,12.76251983
NM_001288973,ADAM12,23,22,376175,8051,368124,16732.90909,350.0434783,45.72400944
NM_001288975,ADAM12,19,18,347218,3430,343788,19099.33333,180.5263158,100.2297376
NM_001288974,ADAM12,19,18,347218,3436,343782,19099,180.8421053,100.0529686
NM_212479,ZMYND11,14,13,115307,2826,112481,8652.384615,201.8571429,39.80219391
NM_014974,DIP2C,37,36,415480,7933,407547,11320.75,214.4054054,51.37362914
NM_006624,ZMYND11,15,14,120174,4332,115842,8274.428571,288.8,26.74099723
NM_015155,LARP4B,18,17,124793,8564,116229,6837,475.7777778,13.57181224
NM_001202468,ZMYND11,13,12,69797,2419,67378,5614.833333,186.0769231,27.85365854
NM_001202464,ZMYND11,14,13,119155,3923,115232,8864,280.2142857,29.37343869
NM_001202467,ZMYND11,12,11,69797,2256,67541,6140.090909,188,29.93838652
NM_001202466,ZMYND11,14,13,120155,4253,115902,8915.538462,303.7857143,27.25182224
NM_001202465,ZMYND11,13,12,120155,4162,115993,9666.083333,320.1538462,27.86953388
NM_018702,ADARB2,10,9,556419,8436,547983,60887,843.6,64.95768137
NM_001253908,AKR1C3,9,8,58922,1210,57712,7214,134.4444444,47.69586777
NM_017782,FAM208B,21,20,78904,8647,70257,3512.85,411.7619048,8.125014456
NM_001242413,PRKCQ,17,16,153160,3113,150047,9377.9375,183.1176471,48.20012849
NM_006257,PRKCQ,18,17,153160,3303,149857,8815.117647,183.5,45.3699667
NM_001282644,PRKCQ,18,17,153160,3301,149859,8815.235294,183.3888889,45.39806119
NM_001282645,PRKCQ,17,16,153160,3241,149919,9369.9375,190.6470588,46.25701944
NM_031923,TAF3,7,6,196551,3305,193246,32207.66667,472.1428571,58.47080182
NM_032817,ITIH5,11,10,60406,6094,54314,5431.4,554,8.912701017
NM_030569,ITIH5,15,14,107731,6763,100970,7212.142857,450.8666667,14.9297649
NM_006561,CELF2,15,14,318781,8003,310778,22198.42857,533.5333333,38.83268774
NM_001025077,CELF2,14,13,331415,9253,322162,24781.69231,660.9285714,34.81703231
NM_001025076,CELF2,15,14,171681,8057,163624,11687.42857,537.1333333,20.30830334
NM_001083591,CELF2,15,14,171681,8051,163630,11687.85714,536.7333333,20.32418333
NM_024693,ECHDC3,5,4,21711,1659,20052,5013,331.8,12.08679928
NM_001142628,SEC61A2,11,10,35765,2473,33292,3329.2,224.8181818,13.46219167
NM_001142627,SEC61A2,12,11,40319,2104,38215,3474.090909,175.3333333,18.16302281
NM_015542,UPF2,22,21,122821,5222,117599,5599.952381,237.3636364,22.51991574
NM_018144,SEC61A2,12,11,35765,2540,33225,3020.454545,211.6666667,13.08070866
NM_080599,UPF2,22,21,123150,5392,117758,5607.52381,245.0909091,21.83939169
NM_018518,MCM10,20,19,49552,4567,44985,2367.631579,228.35,9.850010948
NM_182751,MCM10,20,19,49552,4570,44982,2367.473684,228.5,9.842888403
NM_001100912,BEND7,8,7,61890,1915,59975,8567.857143,239.375,31.31853786
NM_031455,CCDC3,3,2,105081,2741,102340,51170,913.6666667,37.33673842
NM_012247,SEPHS1,9,8,30862,3269,27593,3449.125,363.2222222,8.440807586
NM_001195604,SEPHS1,8,7,30862,3055,27807,3972.428571,381.875,9.10212766
NM_152751,BEND7,9,8,64494,2401,62093,7761.625,266.7777778,25.86130779
NM_001195602,SEPHS1,8,7,30862,2997,27865,3980.714286,374.625,9.297630964
NM_001282658,CCDC3,7,6,203150,3310,199840,33306.66667,472.8571429,60.37462236
NM_018027,FRMD4A,25,24,687162,6829,680333,28347.20833,273.16,99.62410309
NM_001193426,SUV39H2,6,5,25524,2598,22926,4585.2,433,8.82448037
NM_001010924,FAM171A1,8,7,159416,3958,155458,22208.28571,494.75,39.27690753
NM_024670,SUV39H2,5,4,25407,3082,22325,5581.25,616.4,7.24367294
NM_001193427,SUV39H2,6,5,25441,2556,22885,4577,426,8.953442879
NM_001193425,SUV39H2,6,5,25441,3096,22345,4469,516,7.217377261
NM_001193424,SUV39H2,6,5,25524,3138,22386,4477.2,523,7.133843212
NM_004808,NMT2,12,11,62926,5016,57910,5264.545455,418,11.54505582
NM_024948,FAM188A,15,14,82346,2390,79956,5711.142857,159.3333333,33.45439331
NM_001261838,PTER,4,3,76804,3216,73588,24529.33333,804,22.8818408
NM_001261837,PTER,5,4,76804,3690,73114,18278.5,738,19.81409214
NM_001261836,PTER,5,4,76804,3697,73107,18276.75,739.4,19.77468217
NM_030664,PTER,6,5,76804,3777,73027,14605.4,629.5,19.33465714
NM_001001484,PTER,6,5,76804,3832,72972,14594.4,638.6666667,19.04279749
NM_003473,STAM,14,13,72699,3894,68805,5292.692308,278.1428571,17.66949153
NM_001004470,ST8SIA6,8,7,133580,1406,132174,18882,175.75,94.00711238
NM_001081,CUBN,67,66,305853,12000,293853,4452.318182,179.1044776,24.48775
NM_201597,CACNB2,14,13,401084,4020,397064,30543.38462,287.1428571,98.7721393
NM_002438,MRC1,30,29,348751,5221,343530,11845.86207,174.0333333,65.7977399
NM_201572,CACNB2,14,13,400948,4243,396705,30515.76923,303.0714286,93.49634692
NM_201571,CACNB2,14,13,400948,4315,396633,30510.23077,308.2142857,91.91958285
NM_201596,CACNB2,14,13,401084,4092,396992,30537.84615,292.2857143,97.01661779
NM_201593,CACNB2,14,13,401084,3978,397106,30546.61538,284.1428571,99.82554047
NM_201570,CACNB2,13,12,141177,4335,136842,11403.5,333.4615385,31.56678201
NM_000724,CACNB2,13,12,281106,4481,276625,23052.08333,344.6923077,61.73287213
NM_201590,CACNB2,13,12,201076,4111,196965,16413.75,316.2307692,47.91170032
NM_001098844,TMEM236,4,3,48629,5459,43170,14390,1364.75,7.908041766
NM_001167945,CACNB2,14,13,400948,4201,396747,30519,300.0714286,94.44108546
NM_032812,PLXDC2,14,13,473414,12277,461137,35472.07692,876.9285714,37.56104912
NM_001282736,PLXDC2,13,12,473414,12129,461285,38440.41667,933,38.03157721
NM_213569,NEBL,7,6,394215,6947,387268,64544.66667,992.4285714,55.74607744
NM_001173484,NEBL,7,6,394215,6945,387270,64545,992.1428571,55.76241901
NM_006393,NEBL,28,27,117630,9243,108387,4014.333333,330.1071429,11.72638754
NM_012443,SPAG6,11,10,72167,2630,69537,6953.7,239.0909091,26.43992395
NM_001253855,SPAG6,11,10,72167,2795,69372,6937.2,254.0909091,24.82003578
NM_001253854,SPAG6,14,13,72167,2988,69179,5321.461538,213.4285714,23.15227577
NM_022365,DNAJC1,12,11,247175,2103,245072,22279.27273,175.25,116.5344746
NM_005028,PIP4K2A,10,9,179739,3843,175896,19544,384.3,45.7704918
NM_172242,SPAG6,10,9,72167,2483,69684,7742.666667,248.3,28.06443818
NM_020824,ARHGAP21,26,25,140061,7193,132868,5314.72,276.6538462,18.47184763
NM_019590,KIAA1217,21,20,339059,7780,331279,16563.95,370.4761905,42.58084833
NM_001282769,KIAA1217,14,13,95885,3343,92542,7118.615385,238.7857143,27.68232127
NM_001282770,KIAA1217,12,11,78813,3097,75716,6883.272727,258.0833333,24.44817565
NM_001282768,KIAA1217,18,17,339059,5995,333064,19592,333.0555556,55.55696414
NM_001282767,KIAA1217,19,18,339059,6071,332988,18499.33333,319.5263158,54.84895404
NM_020752,GPR158,11,10,426869,6673,420196,42019.6,606.6363636,62.9695789
NM_145010,ENKUR,6,5,34179,3388,30791,6158.2,564.6666667,9.088252656
NM_001270383,ENKUR,6,5,80302,3301,77001,15400.2,550.1666667,23.32656771
NM_017433,MYO3A,35,34,278465,5819,272646,8019,166.2571429,46.85444234
NM_005470,ABI1,12,11,114493,3737,110756,10068.72727,311.4166667,29.63767728
NM_001012752,ABI1,10,9,114493,3639,110854,12317.11111,363.9,30.4627645
NM_001012751,ABI1,10,9,114493,3567,110926,12325.11111,356.7,31.09784132
NM_001012750,ABI1,11,10,114493,3655,110838,11083.8,332.2727273,30.3250342
NM_001178122,ABI1,10,9,114493,3477,111016,12335.11111,347.7,31.92867414
NM_001178121,ABI1,9,8,114493,3548,110945,13868.125,394.2222222,31.26972943
NM_001178120,ABI1,10,9,114493,3564,110929,12325.44444,356.4,31.12485971
NM_001178119,ABI1,11,10,114493,3652,110841,11084.1,332,30.3507667
NM_001178116,ABI1,12,11,114493,3701,110792,10072,308.4166667,29.93569306
NM_014317,PDSS1,12,11,49133,1630,47503,4318.454545,135.8333333,29.14294479
NM_019043,APBB1IP,15,14,129468,2652,126816,9058.285714,176.8,47.81900452
NM_001178125,ABI1,7,6,114493,3195,111298,18549.66667,456.4285714,34.83505477
NM_001178124,ABI1,8,7,114493,3373,111120,15874.28571,421.625,32.9439668
NM_001178123,ABI1,9,8,114493,3389,111104,13888,376.5555556,32.78371201
NM_001042473,ACBD5,13,12,46927,3873,43054,3587.833333,297.9230769,11.1164472
NM_001271512,ACBD5,12,11,45667,4186,41481,3771,348.8333333,9.909460105
NM_018076,ARMC4,20,19,186882,3592,183290,9646.842105,179.6,51.02728285
NM_145698,ACBD5,13,12,45667,3998,41669,3472.416667,307.5384615,10.42246123
NM_016628,WAC,14,13,89622,5552,84070,6466.923077,396.5714286,15.14229107
NM_012342,BAMBI,3,2,5446,1727,3719,1859.5,575.6666667,2.153445281
NM_100486,WAC,13,12,89622,5242,84380,7031.666667,403.2307692,16.09690958
NM_173496,MPP7,19,18,231146,5225,225921,12551.16667,275,43.2384689
NM_003174,SVIL,36,35,278455,6752,271703,7762.942857,187.5555556,40.24037322
NM_021738,SVIL,38,37,177626,8335,169291,4575.432432,219.3421053,20.31085783
NM_182755,ZNF438,8,7,187303,3255,184048,26292.57143,406.875,56.54316436
NM_001143771,ZNF438,8,7,187303,3325,183978,26282.57143,415.625,55.33172932
NM_001143770,ZNF438,9,8,187303,3355,183948,22993.5,372.7777778,54.82801788
NM_001143769,ZNF438,8,7,154883,3428,151455,21636.42857,428.5,44.18173862
NM_001143766,ZNF438,8,7,187303,3303,184000,26285.71429,412.875,55.70693309
NM_001143767,ZNF438,6,5,187303,3114,184189,36837.8,519,59.14868337
NM_001143768,ZNF438,7,6,187303,3173,184130,30688.33333,453.2857143,58.03025528
NM_001128128,ZEB1,9,8,208680,6277,202403,25300.375,697.4444444,32.24518082
NM_001174095,ZEB1,8,7,210643,5795,204848,29264,724.375,35.34909405
NM_001174093,ZEB1,8,7,210643,5936,204707,29243.85714,742,34.48568059
NM_001174096,ZEB1,9,8,210643,6000,204643,25580.375,666.6666667,34.10716667
NM_001174094,ZEB1,9,8,208680,6274,202406,25300.75,697.1111111,32.26107746
NM_030751,ZEB1,9,8,210643,5997,204646,25580.75,666.3333333,34.12472903
NM_018287,ARHGAP12,20,19,123480,5125,118355,6229.210526,256.25,23.09365854
NM_001270695,ARHGAP12,19,18,123480,5109,118371,6576.166667,268.8947368,23.16911333
NM_001270696,ARHGAP12,18,17,123480,5033,118447,6967.470588,279.6111111,23.5340751
NM_001270699,ARHGAP12,16,15,103530,4732,98798,6586.533333,295.75,20.87869822
NM_001270698,ARHGAP12,17,16,123480,4891,118589,7411.8125,287.7058824,24.24637089
NM_001270697,ARHGAP12,19,18,123480,4983,118497,6583.166667,262.2631579,23.78025286
NM_024688,CCDC7,23,22,315143,2742,312401,14200.04545,119.2173913,113.9318016
NM_001026383,CCDC7,18,17,128484,1975,126509,7441.705882,109.7222222,64.05518987
NM_145023,CCDC7,18,17,128484,2209,126275,7427.941176,122.7222222,57.16387506
NM_001282391,EPC1,14,13,111084,3958,107126,8240.461538,282.7142857,27.06568974
NM_052997,ANKRD30A,36,35,106712,4441,102271,2922.028571,123.3611111,23.02882234
NM_021045,ZNF248,6,5,28873,5173,23700,4740,862.1666667,4.581480766
NM_003421,ZNF37A,7,6,29016,6562,22454,3742.333333,937.4285714,3.421822615
NM_001178101,ZNF37A,7,6,29016,6558,22458,3743,936.8571429,3.424519671
NM_001267607,ZNF248,7,6,81112,964,80148,13358,137.7142857,83.14107884
NM_001267597,ZNF248,6,5,29321,4801,24520,4904,800.1666667,5.107269319
NM_001267606,ZNF248,5,4,28873,4209,24664,6166,841.8,5.859824186
NM_001267605,ZNF248,7,6,28873,3462,25411,4235.166667,494.5714286,7.339976892
NM_001007094,ZNF37A,8,7,29016,7037,21979,3139.857143,879.625,3.123348018
NM_006955,ZNF33B,5,4,49439,5963,43476,10869,1192.6,7.290960926
NM_018590,CSGALNACT2,8,7,46863,3777,43086,6155.142857,472.125,11.40746624
NM_032023,RASSF4,11,10,34955,2506,32449,3244.9,227.8181818,12.94852354
NM_145021,Mar-08,7,6,140323,5287,135036,22506,755.2857143,25.54113864
NM_000698,ALOX5,14,13,71945,2575,69370,5336.153846,183.9285714,26.93980583
NM_001256154,ALOX5,13,12,71945,2403,69542,5795.166667,184.8461538,28.93965876
NM_001256153,ALOX5,14,13,71945,2479,69466,5343.538462,177.0714286,28.02178298
NM_001282866,Mar-08,8,7,80811,5646,75165,10737.85714,705.75,13.31296493
NM_001002266,Mar-08,7,6,80811,4799,76012,12668.66667,685.5714286,15.83913315
NM_001169107,FAM21C,28,27,65766,4448,61318,2271.037037,158.8571429,13.78552158
NM_001169106,FAM21C,29,28,65766,4551,61215,2186.25,156.9310345,13.45088991
NM_015262,FAM21C,30,29,65766,4675,61091,2106.586207,155.8333333,13.06759358
NM_001042393,PTPN20A,8,7,90541,2327,88214,12602,290.875,37.90889557
NM_001042395,PTPN20A,10,9,90884,2882,88002,9778,288.2,30.53504511
NM_001042397,PTPN20A,4,3,90884,1889,88995,29665,472.25,47.11222869
NM_001042396,PTPN20A,7,6,90884,2233,88651,14775.16667,319,39.70040305
NM_001042392,PTPN20A,5,4,90541,2326,88215,22053.75,465.2,37.92562339
NM_001042391,PTPN20A,8,7,90541,2452,88089,12584.14286,306.5,35.92536705
NM_001042389,PTPN20A,10,9,69945,2975,66970,7441.111111,297.5,22.51092437
NM_001042390,PTPN20A,10,9,90541,2880,87661,9740.111111,288,30.43784722
NM_001042387,PTPN20A,9,8,90884,2487,88397,11049.625,276.3333333,35.54362686
NM_001042365,PTPN20B,4,3,90884,1889,88995,29665,472.25,47.11222869
NM_001042364,PTPN20B,7,6,90884,2233,88651,14775.16667,319,39.70040305
NM_001042363,PTPN20B,10,9,90884,2882,88002,9778,288.2,30.53504511
NM_001042361,PTPN20B,8,7,90541,2327,88214,12602,290.875,37.90889557
NM_001042357,PTPN20B,10,9,69945,2975,66970,7441.111111,297.5,22.51092437
NM_001042358,PTPN20B,10,9,90541,2880,87661,9740.111111,288,30.43784722
NM_001042359,PTPN20B,8,7,90541,2452,88089,12584.14286,306.5,35.92536705
NM_001042360,PTPN20B,5,4,90541,2326,88215,22053.75,465.2,37.92562339
NM_015605,PTPN20B,9,8,90884,2487,88397,11049.625,276.3333333,35.54362686
NM_001042394,PTPN20A,6,5,90541,2082,88459,17691.8,347,42.48751201
NM_001042362,PTPN20B,6,5,90541,2082,88459,17691.8,347,42.48751201
NM_153034,ZNF488,2,1,18779,3498,15281,15281,1749,4.368496284
NM_001278547,MAPK8,12,11,132722,5858,126864,11533.09091,488.1666667,21.65653807
NM_001018071,FRMPD2,29,28,118341,5053,113288,4046,174.2413793,22.41994855
NM_021226,ARHGAP22,10,9,159110,2808,156302,17366.88889,280.8,55.66310541
NM_001256026,ARHGAP22,8,7,47626,2360,45266,6466.571429,295,19.18050847
NM_001256025,ARHGAP22,10,9,206495,2722,203773,22641.44444,272.2,74.8614989
NM_001256024,ARHGAP22,10,9,159110,2856,156254,17361.55556,285.6,54.71078431
NM_020945,WDFY4,62,61,297485,10075,287410,4711.639344,162.5,28.52704715
NM_001276451,DRGX,7,6,29903,962,28941,4823.5,137.4285714,30.08419958
NM_001277059,ERCC6-PGBD3,6,5,24435,3541,20894,4178.8,590.1666667,5.900593053
NM_001277058,ERCC6-PGBD3,6,5,24020,3596,20424,4084.8,599.3333333,5.679644049
NM_001142934,CHAT,16,15,51069,2544,48525,3235,159,19.07429245
NM_001142933,CHAT,16,15,51069,2544,48525,3235,159,19.07429245
NM_020986,CHAT,15,14,51998,2129,49869,3562.071429,141.9333333,23.42367309
NM_003631,PARG,18,17,345008,4271,340737,20043.35294,237.2777778,79.77920862
NM_020985,CHAT,16,15,51998,2302,49696,3313.066667,143.875,21.58818419
NM_020984,CHAT,15,14,56011,2139,53872,3848,142.6,25.18560075
NM_020549,CHAT,15,14,51069,2473,48596,3471.142857,164.8666667,19.65062677
NM_000124,ERCC6,21,20,84645,9014,75631,3781.55,429.2380952,8.390392722
NM_170753,PGBD3,2,1,9178,2268,6910,6910,1134,3.046737213
NM_001142929,CHAT,15,14,51069,2473,48596,3471.142857,164.8666667,19.65062677
NM_147156,SGMS1,11,10,318394,3764,314630,31463,342.1818182,83.58926674
NM_001198819,A1CF,15,14,86268,9544,76724,5480.285714,636.2666667,8.038977368
NM_001198820,A1CF,14,13,86268,9426,76842,5910.923077,673.2857143,8.1521324
NM_001198818,A1CF,14,13,86268,9376,76892,5914.769231,669.7142857,8.200938567
NM_014576,A1CF,13,12,86268,9282,76986,6415.5,714,8.294117647
NM_138933,A1CF,13,12,86268,9377,76891,6407.583333,721.3076923,8.199957342
NM_138932,A1CF,13,12,86268,9306,76962,6413.5,715.8461538,8.270148291
NM_001142773,PCDH15,32,31,980193,6984,973209,31393.83871,218.25,139.3483677
NM_033056,PCDH15,33,32,980193,7054,973139,30410.59375,213.7575758,137.955628
NM_001142767,PCDH15,31,30,980193,6932,973261,32442.03333,223.6129032,140.4011829
NM_001142768,PCDH15,33,32,980193,6994,973199,30412.46875,211.9393939,139.147698
NM_001142766,PCDH15,32,31,980193,7044,973149,31391.90323,220.125,138.1528961
NM_001142765,PCDH15,32,31,980193,6846,973347,31398.29032,213.9375,142.1774759
NM_001142764,PCDH15,34,33,980193,7061,973132,29488.84848,207.6764706,137.8178728
NM_001142763,PCDH15,35,34,980193,7077,973116,28621.05882,202.2,137.5040271
NM_001080512,BICC1,21,20,315943,3140,312803,15640.15,149.5238095,99.61878981
NM_018464,CISD1,3,2,20159,2111,18048,9024,703.6666667,8.549502605
NM_032439,PHYHIPL,5,4,71188,3585,67603,16900.75,717,18.85718271
NM_198215,FAM13C,14,13,116465,3389,113076,8698.153846,242.0714286,33.36559457
NM_005436,CCDC6,9,8,117910,5835,112075,14009.375,648.3333333,19.20736932
NM_001143773,FAM13C,15,14,116774,3563,113211,8086.5,237.5333333,31.7740668
NM_001143774,PHYHIPL,5,4,70309,3365,66944,16736,673,19.89420505
NM_001166698,FAM13C,15,14,116465,3472,112993,8070.928571,231.4666667,32.54406682
NM_001001971,FAM13C,12,11,116465,3093,113372,10306.54545,257.75,36.65438086
NM_001242359,RHOBTB1,12,11,74837,4583,70254,6386.727273,381.9166667,15.32926031
NM_014836,RHOBTB1,11,10,74837,4510,70327,7032.7,410,15.59356984
NM_032199,ARID5B,10,9,195696,7951,187745,20860.55556,795.1,23.61275311
NM_178505,TMEM26,6,5,46809,5161,41648,8329.6,860.1666667,8.069753924
NM_001244638,ARID5B,7,6,47739,7032,40707,6784.5,1004.571429,5.788822526
NM_173554,C10orf107,7,6,103374,1259,102115,17019.16667,179.8571429,81.10802224
NM_199451,ZNF365,8,7,297857,3422,294435,42062.14286,427.75,86.04178843
NM_199450,ZNF365,5,4,106134,1715,104419,26104.75,343,60.88571429
NM_199452,ZNF365,7,6,151566,2702,148864,24810.66667,386,55.09400444
NM_178011,LRRTM3,3,2,175077,5612,169465,84732.5,1870.666667,30.1968995
NM_015601,HERC4,25,24,153449,4518,148931,6205.458333,180.72,32.96392209
NM_022079,HERC4,26,25,153449,4543,148906,5956.24,174.7307692,32.77701959
NM_017987,RUFY2,18,17,63673,4521,59152,3479.529412,251.1666667,13.08383101
NM_001278186,HERC4,23,22,153449,4264,149185,6781.136364,185.3913043,34.98710131
NM_001278185,HERC4,24,23,153449,4307,149142,6484.434783,179.4583333,34.62781518
NM_001035260,VPS26A,8,7,48710,2566,46144,6592,320.75,17.98285269
NM_030625,TET1,12,11,134124,9596,124528,11320.72727,799.6666667,12.97707378
NM_152709,STOX1,4,3,65524,3385,62139,20713,846.25,18.35716396
NM_001057,TACR2,5,4,12718,2421,10297,2574.25,484.2,4.253201157
NM_018237,CCAR1,25,24,71235,4778,66457,2769.041667,191.12,13.90895772
NM_033498,HK1,21,20,131883,3891,127992,6399.6,185.2857143,32.89437163
NM_033500,HK1,22,21,131883,3985,127898,6090.380952,181.1363636,32.09485571
NM_001130162,STOX1,4,3,65255,3116,62139,20713,779,19.94191271
NM_001130161,STOX1,5,4,67917,3311,64606,16151.5,662.2,19.51253398
NM_001130160,STOX1,3,2,65524,1025,64499,32249.5,341.6666667,62.92585366
NM_001130159,STOX1,4,3,65524,1226,64298,21432.66667,306.5,52.44535073
NM_001282959,CCAR1,24,23,71235,4738,66497,2891.173913,197.4166667,14.03482482
NM_001282960,CCAR1,24,23,71235,4732,66503,2891.434783,197.1666667,14.05388842
NM_033497,HK1,21,20,131883,3837,128046,6402.3,182.7142857,33.37138389
NM_004896,VPS26A,9,8,48710,2710,46000,5750,301.1111111,16.97416974
NM_001278214,LRRC20,4,3,83682,2963,80719,26906.33333,740.75,27.24232197
NM_001278213,LRRC20,4,3,77811,2907,74904,24968,726.75,25.76676987
NM_001278212,LRRC20,5,4,83682,3109,80573,20143.25,621.8,25.91605018
NM_001278211,LRRC20,5,4,83682,3164,80518,20129.5,632.8,25.44816688
NM_001130103,COL13A1,40,39,157262,3177,154085,3950.897436,79.425,48.50015738
NM_080802,COL13A1,37,36,157262,3027,154235,4284.305556,81.81081081,50.95308887
NM_080801,COL13A1,39,38,157262,3110,154152,4056.631579,79.74358974,49.56655949
NM_080800,COL13A1,38,37,157262,3082,154180,4167.027027,81.10526316,50.02595717
NM_018649,H2AFY2,9,8,59685,2188,57497,7187.125,243.1111111,26.27833638
NM_018205,LRRC20,4,3,83682,2940,80742,26914,735,27.46326531
NM_018239,LRRC20,4,3,83682,2958,80724,26908,739.5,27.29006085
NM_080798,COL13A1,35,34,157262,2956,154306,4538.411765,84.45714286,52.20094723
NM_080805,COL13A1,34,33,157262,2850,154412,4679.151515,83.82352941,54.17964912
NM_207119,LRRC20,5,4,82946,3422,79524,19881,684.4,23.2390415
NM_080722,ADAMTS14,22,21,89638,5280,84358,4017.047619,240,15.97689394
NM_001244889,UNC5B,16,15,90345,6873,83472,5564.8,429.5625,12.14491488
NM_139155,ADAMTS14,22,21,89638,5289,84349,4016.619048,240.4090909,15.94800529
NM_001171932,CDH23,11,10,220673,1747,218926,21892.6,158.8181818,125.3153978
NM_003901,SGPL1,15,14,65230,5784,59446,4246.142857,385.6,10.27766252
NM_170744,UNC5B,17,16,90345,6907,83438,5214.875,406.2941176,12.08020848
NM_001198799,ASCC1,13,12,120411,2938,117473,9789.416667,226,39.98400272
NM_001198798,ASCC1,10,9,120079,2693,117386,13042.88889,269.3,43.58930561
NM_001195519,MICU1,7,6,156662,1840,154822,25803.66667,262.8571429,84.1423913
NM_001195518,MICU1,12,11,258867,2495,256372,23306.54545,207.9166667,102.7543086
NM_001198800,ASCC1,10,9,120411,2654,117757,13084.11111,265.4,44.36963075
NM_006077,MICU1,12,11,258867,2501,256366,23306,208.4166667,102.5053978
NM_022153,C10orf54,7,6,26025,4780,21245,3540.833333,682.8571429,4.444560669
NM_021132,PPP3CB,14,13,59221,3161,56060,4312.307692,225.7857143,17.73489402
NM_138357,MCU,8,7,195565,2957,192608,27515.42857,369.625,65.13628678
NM_001142596,P4HA1,14,13,89754,2806,86948,6688.307692,200.4285714,30.98645759
NM_001142595,P4HA1,16,15,89754,2955,86799,5786.6,184.6875,29.37360406
NM_145170,TTC18,28,27,105103,3732,101371,3754.481481,133.2857143,27.16264737
NM_001142354,PPP3CB,13,12,59221,3133,56088,4674,241,17.90233004
NM_001142353,PPP3CB,14,13,59221,3164,56057,4312.076923,226,17.71713021
NM_001270680,MCU,8,7,195077,3234,191843,27406.14286,404.25,59.32065553
NM_001270679,MCU,8,7,195565,2894,192671,27524.42857,361.75,66.57601935
NM_032562,PLA2G12B,4,3,19574,1096,18478,6159.333333,274,16.85948905
NM_000917,P4HA1,15,14,89754,2861,86893,6206.642857,190.7333333,30.37154841
NM_001017962,P4HA1,15,14,89754,2861,86893,6206.642857,190.7333333,30.37154841
NM_173348,FAM149B1,14,13,74064,3146,70918,5455.230769,224.7142857,22.54227591
NM_001289968,PPP3CB,13,12,52246,2513,49733,4144.416667,193.3076923,19.79029049
NM_014000,VCL,22,21,122044,5508,116536,5549.333333,250.3636364,21.15758896
NM_006721,ADK,11,10,558120,2052,556068,55606.8,186.5454545,270.9883041
NM_001204492,CAMK2G,21,20,62092,3788,58304,2915.2,180.3809524,15.39176346
NM_003373,VCL,21,20,122044,5303,116741,5837.05,252.5238095,22.01414294
NM_012095,AP3M1,9,8,30813,5136,25677,3209.625,570.6666667,4.999415888
NM_001222,CAMK2G,19,18,62092,3654,58438,3246.555556,192.3157895,15.99288451
NM_001123,ADK,11,10,532816,2291,530525,53052.5,208.2727273,231.5691838
NM_207012,AP3M1,10,9,30813,5263,25550,2838.888889,526.3,4.854645639
NM_001202449,ADK,10,9,532816,2236,530580,58953.33333,223.6,237.2898032
NM_001202450,ADK,10,9,558120,1880,556240,61804.44444,188,295.8723404
NM_172173,CAMK2G,20,19,62092,3682,58410,3074.210526,184.1,15.86366105
NM_172171,CAMK2G,21,20,62092,3839,58253,2912.65,182.8095238,15.17400365
NM_172170,CAMK2G,20,19,62092,3724,58368,3072,186.2,15.67346939
NM_172169,CAMK2G,21,20,62092,3752,58340,2917,178.6666667,15.54904051
NM_001174156,SAMD8,6,5,70490,6788,63702,12740.4,1131.333333,9.384502062
NM_001256469,KAT6B,18,17,206211,7641,198570,11680.58824,424.5,25.9874362
NM_001256468,KAT6B,18,17,206211,7968,198243,11661.35294,442.6666667,24.87989458
NM_144660,SAMD8,5,4,70490,7014,63476,15869,1402.8,9.0499002
NM_012330,KAT6B,18,17,206211,8517,197694,11629.05882,473.1666667,23.21169426
NM_001003892,DUPD1,3,2,20680,666,20014,10007,222,30.05105105
NM_001161353,KCNMA1,28,27,752944,6254,746690,27655.18519,223.3571429,119.3939878
NM_001161352,KCNMA1,28,27,752944,6305,746639,27653.2963,225.1785714,118.4201427
NM_002247,KCNMA1,27,26,752944,6130,746814,28723.61538,227.037037,121.8293638
NM_001271519,KCNMA1,29,28,752944,6222,746722,26668.64286,214.5517241,120.013179
NM_004747,DLG5,32,31,135801,7511,128290,4138.387097,234.71875,17.08028225
NM_020338,ZMIZ1,25,24,247495,7580,239915,9996.458333,303.2,31.65105541
NM_032333,FAM213A,6,5,24513,1754,22759,4551.8,292.3333333,12.97548461
NM_001243781,FAM213A,6,5,24513,1737,22776,4555.2,289.5,13.11226252
NM_001243780,FAM213A,6,5,24513,2220,22293,4458.6,370,10.04189189
NM_001145719,SH2D4B,7,6,105743,3494,102249,17041.5,499.1428571,29.26416714
NM_145868,ANXA11,16,15,50450,2550,47900,3193.333333,159.375,18.78431373
NM_145869,ANXA11,17,16,50450,2747,47703,2981.4375,161.5882353,17.36548963
NM_001243782,FAM213A,6,5,19180,1637,17543,3508.6,272.8333333,10.71655467
NM_001243779,FAM213A,6,5,25170,1724,23446,4689.2,287.3333333,13.59976798
NM_001243778,FAM213A,6,5,19180,1654,17526,3505.2,275.6666667,10.59613059
NM_001157,ANXA11,15,14,50450,2500,47950,3425,166.6666667,19.18
NM_001278409,ANXA11,17,16,50450,2820,47630,2976.875,165.8823529,16.89007092
NM_001278408,ANXA11,17,16,49369,3089,46280,2892.5,181.7058824,14.98219489
NM_001278407,ANXA11,17,16,50555,2481,48074,3004.625,145.9411765,19.37686417
NM_207372,SH2D4B,7,6,108660,3990,104670,17445,570,26.23308271
NM_018999,CCSER2,11,10,189934,7753,182181,18218.1,704.8181818,23.49812976
NM_001284242,CCSER2,7,6,93341,5745,87596,14599.33333,820.7142857,15.24734552
NM_001284240,CCSER2,10,9,189934,7667,182267,20251.88889,766.7,23.77292292
NM_001284243,CCSER2,8,7,93584,5896,87688,12526.85714,737,14.8724559
NM_001284241,CCSER2,3,2,45431,2079,43352,21676,693,20.85233285
NM_007078,LDB3,13,12,67400,5311,62089,5174.083333,408.5384615,11.69064206
NM_001171610,LDB3,14,13,67620,5449,62171,4782.384615,389.2142857,11.40961644
NM_133447,AGAP11,12,11,39464,3167,36297,3299.727273,263.9166667,11.4610041
NM_015045,WAPAL,19,18,86530,6321,80209,4456.055556,332.6842105,12.68928967
NM_019054,FAM35A,9,8,96271,3413,92858,11607.25,379.2222222,27.20714914
NM_001080114,LDB3,13,12,67400,4981,62419,5201.583333,383.1538462,12.53141939
NM_004329,BMPR1A,13,12,168551,3629,164922,13743.5,279.1538462,45.44557729
NM_032810,ATAD1,10,9,65044,3044,62000,6888.888889,304.4,20.36793693
NM_000314,PTEN,9,8,105339,5556,99783,12472.875,617.3333333,17.95950324
NM_001128215,LIPM,9,8,17818,1493,16325,2040.625,165.8888889,10.93436035
NM_001613,ACTA2,9,8,17751,1408,16343,2042.875,156.4444444,11.60724432
NM_001141945,ACTA2,9,8,56318,1767,54551,6818.875,196.3333333,30.8720996
NM_001289758,IFIT3,3,2,13151,2689,10462,5231,896.3333333,3.890665675
NM_001549,IFIT3,2,1,13151,2570,10581,10581,1285,4.117120623
NM_001031683,IFIT3,2,1,8491,2459,6032,6032,1229.5,2.453029687
NM_001289759,IFIT3,3,2,8491,2582,5909,2954.5,860.6666667,2.288536019
NM_001284259,KIF20B,33,32,73355,6483,66872,2089.75,196.4545455,10.31497763
NM_138316,PANK1,6,5,64396,6027,58369,11673.8,1004.5,9.68458603
NM_148978,PANK1,7,6,64396,6205,58191,9698.5,886.4285714,9.378082192
NM_148977,PANK1,7,6,66077,6983,59094,9849,997.5714286,8.462551912
NM_016195,KIF20B,33,32,73355,6363,66992,2093.5,192.8181818,10.52836712
NM_019860,HTR7,3,2,117097,3256,113841,56920.5,1085.333333,34.96345209
NM_019859,HTR7,4,3,117097,3350,113747,37915.66667,837.5,33.95432836
NM_001284274,HECTD2,22,21,104545,4963,99582,4742,225.5909091,20.06488011
NM_000872,HTR7,3,2,117097,3251,113846,56923,1083.666667,35.01876346
NM_001257101,PCGF5,10,9,121321,7049,114272,12696.88889,704.9,16.21109377
NM_001104546,RPP30,14,13,36605,4286,32319,2486.076923,306.1428571,7.540597294
NM_182765,HECTD2,21,20,104545,4950,99595,4979.75,235.7142857,20.12020202
NM_173497,HECTD2,5,4,53381,2239,51142,12785.5,447.8,22.84144707
NM_017824,Mar-05,6,5,62803,3932,58871,11774.2,655.3333333,14.97227874
NM_001178137,CPEB3,10,9,194641,5759,188882,20986.88889,575.9,32.79770794
NM_025235,TNKS2,27,26,67083,6301,60782,2337.769231,233.3703704,9.646405332
NM_014912,CPEB3,10,9,242480,5883,236597,26288.55556,588.3,40.21706612
NM_001165946,IDE,15,14,46079,4495,41584,2970.285714,299.6666667,9.251167964
NM_004969,IDE,25,24,122413,5921,116492,4853.833333,236.84,19.67437933
NM_003972,BTAF1,38,37,106346,7076,99270,2682.972973,186.2105263,14.02911249
NM_001013848,EXOC6,22,21,224783,3587,221196,10533.14286,163.0454545,61.66601617
NM_133337,MYOF,53,52,175890,6857,169033,3250.634615,129.3773585,24.6511594
NM_013451,MYOF,54,53,175890,6897,168993,3188.54717,127.7222222,24.50239234
NM_019053,EXOC6,22,21,211028,3642,207386,9875.52381,165.5454545,56.94288852
NM_001289071,HELLS,23,22,56334,3216,53118,2414.454545,139.826087,16.51679104
NM_001289070,HELLS,20,19,56334,2875,53459,2813.631579,143.75,18.59443478
NM_018063,HELLS,22,21,56334,3171,53163,2531.571429,144.1363636,16.7653737
NM_001289075,HELLS,21,20,56334,2973,53361,2668.05,141.5714286,17.94853683
NM_001289067,HELLS,23,22,56334,3310,53024,2410.181818,143.9130435,16.01933535
NM_016341,PLCE1,33,32,334404,8024,326380,10199.375,243.1515152,40.67547358
NM_001289068,HELLS,22,21,56334,3126,53208,2533.714286,142.0909091,17.02111324
NM_015188,TBC1D12,13,12,133905,5762,128143,10678.58333,443.2307692,22.23932662
NM_001289069,HELLS,22,21,56334,3075,53259,2536.142857,139.7727273,17.32
NM_001165979,PLCE1,32,31,239367,6534,232833,7510.741935,204.1875,35.63406795
NM_005097,LGI1,8,7,40352,2374,37978,5425.428571,296.75,15.99747262
NM_001289073,HELLS,21,20,56334,3105,53229,2661.45,147.8571429,17.14299517
NM_001289072,HELLS,20,19,56334,2779,53555,2818.684211,138.95,19.27132062
NM_001289074,HELLS,23,22,56334,3091,53243,2420.136364,134.3913043,17.22516985
NM_001288989,PLCE1,33,32,334404,7976,326428,10200.875,241.6969697,40.92627884
NM_002860,ALDH18A1,18,17,50883,3481,47402,2788.352941,193.3888889,13.61735134
NM_006434,SORBS1,21,20,129409,5407,124002,6200.1,257.4761905,22.93360459
NM_000771,CYP2C9,9,8,50735,1870,48865,6108.125,207.7777778,26.13101604
NM_001034954,SORBS1,31,30,129409,7241,122168,4072.266667,233.5806452,16.8717028
NM_024991,SORBS1,26,25,249643,5884,243759,9750.36,226.3076923,41.42743032
NM_000769,CYP2C19,9,8,90210,1482,88728,11091,164.6666667,59.87044534
NM_015385,SORBS1,25,24,249643,5988,243655,10152.29167,239.52,40.69054776
NM_001017423,ALDH18A1,18,17,50883,3475,47408,2788.705882,193.0555556,13.64258993
NM_001034956,SORBS1,28,27,129409,6077,123332,4567.851852,217.0357143,20.29488234
NM_001034955,SORBS1,31,30,129409,6818,122591,4086.366667,219.9354839,17.98049281
NM_001034957,SORBS1,22,21,129409,5576,123833,5896.809524,253.4545455,22.20821377
NM_001278526,ZNF518A,7,6,34047,6633,27414,4569,947.5714286,4.132971506
NM_001278525,ZNF518A,6,5,33706,8008,25698,5139.6,1334.666667,3.209040959
NM_012465,TLL2,21,20,149322,6792,142530,7126.5,323.4285714,20.98498233
NM_001278524,ZNF518A,7,6,34047,8348,25699,4283.166667,1192.571429,3.078461907
NM_014803,ZNF518A,6,5,34047,8301,25746,5149.2,1383.5,3.10155403
NM_020123,TM9SF3,15,14,68944,6155,62789,4484.928571,410.3333333,10.20129976
NM_152309,PIK3AP1,17,16,127212,4828,122384,7649,284,25.34879867
NM_001159747,CC2D2B,12,11,32595,2126,30469,2769.909091,177.1666667,14.33160865
NM_001001732,CC2D2B,9,8,32595,1853,30742,3842.75,205.8888889,16.59039396
NM_032440,LCOR,8,7,131488,10392,121096,17299.42857,1299,11.65280985
NM_001170766,LCOR,9,8,132183,7796,124387,15548.375,866.2222222,15.95523345
NM_001170765,LCOR,8,7,132183,10372,121811,17401.57143,1296.5,11.74421519
NM_138413,HOGA1,7,6,28455,2489,25966,4327.666667,355.5714286,10.43230213
NM_003061,SLIT1,37,36,187890,7968,179922,4997.833333,215.3513514,22.58057229
NM_022362,MMS19,31,30,40287,3717,36570,1219,119.9032258,9.8385795
NM_001289403,MMS19,30,29,40287,3587,36700,1265.517241,119.5666667,10.23139113
NM_001289405,MMS19,32,31,40472,3600,36872,1189.419355,112.5,10.24222222
NM_001134670,HOGA1,3,2,28455,1996,26459,13229.5,665.3333333,13.25601202
NM_001289404,MMS19,30,29,40287,3652,36635,1263.275862,121.7333333,10.03148959
NM_032211,LOXL4,15,14,20566,3672,16894,1206.714286,244.8,4.600762527
NM_001206528,CRTAC1,15,14,151204,2366,148838,10631.28571,157.7333333,62.90701606
NM_018058,CRTAC1,15,14,165830,2905,162925,11637.5,193.6666667,56.08433735
NM_002079,GOT1,9,8,33905,2136,31769,3971.125,237.3333333,14.87312734
NM_000392,ABCC2,32,31,69201,5083,64118,2068.322581,158.84375,12.61420421
NM_020354,ENTPD7,13,12,51741,8568,43173,3597.75,659.0769231,5.038865546
NM_003393,WNT8B,6,5,20589,2002,18587,3717.4,333.6666667,9.284215784
NM_001278,CHUK,21,20,41222,3545,37677,1883.85,168.8095238,10.62820874
NM_001195517,TLX1,3,2,6487,2133,4354,2177,711,2.041256446
NM_012215,MGEA5,16,15,34024,5218,28806,1920.4,326.125,5.520505941
NM_005521,TLX1,3,2,6487,2110,4377,2188.5,703.3333333,2.074407583
NM_001256856,BTRC,14,13,203290,6100,197190,15168.46154,435.7142857,32.32622951
NM_022039,FBXW4,9,8,84324,2221,82103,10262.875,246.7777778,36.96668167
NM_001142434,MGEA5,15,14,34024,5058,28966,2069,337.2,5.726769474
NM_033637,BTRC,15,14,203290,6179,197111,14079.35714,411.9333333,31.90014565
NM_003939,BTRC,14,13,203290,6070,197220,15170.76923,433.5714286,32.49093904
NM_016169,SUFU,12,11,129497,4960,124537,11321.54545,413.3333333,25.10826613
NM_001199378,GBF1,40,39,137403,6468,130935,3357.307692,161.7,20.24350649
NM_001199379,GBF1,40,39,137403,6465,130938,3357.384615,161.625,20.25336427
NM_000102,CYP17A1,8,7,7004,1878,5126,732.2857143,234.75,2.729499468
NM_199076,CNNM2,7,6,160271,4139,156132,26022,591.2857143,37.72215511
NM_017649,CNNM2,8,7,160271,4206,156065,22295,525.75,37.10532573
NM_001178133,SUFU,11,10,115503,1896,113607,11360.7,172.3636364,59.9193038
NM_004193,GBF1,40,39,137403,6477,130926,3357.076923,161.925,20.21398796
NM_004311,ARL3,6,5,40708,3880,36828,7365.6,646.6666667,9.491752577
NM_024928,OBFC1,10,9,40729,6491,34238,3804.222222,649.1,5.27468803
NM_014631,SH3PXD2A,14,13,261382,11261,250121,19240.07692,804.3571429,22.2112601
NM_014720,SLK,19,18,59874,5625,54249,3013.833333,296.0526316,9.644266667
NM_001191015,GSTO2,4,3,24291,831,23460,7820,207.75,28.23104693
NM_001191014,GSTO2,5,4,24291,934,23357,5839.25,186.8,25.00749465
NM_001191013,GSTO2,6,5,30547,1398,29149,5829.8,233,20.85050072
NM_183239,GSTO2,7,6,30547,1501,29046,4841,214.4285714,19.35109927
NM_001008723,CCDC147,18,17,101328,3331,97997,5764.529412,185.0555556,29.41969379
NM_001013031,SORCS1,27,26,591047,7364,583683,22449.34615,272.7407407,79.26167844
NM_001206569,SORCS1,26,25,586047,4168,581879,23275.16,160.3076923,139.606286
NM_001206572,SORCS1,27,26,591047,7634,583413,22438.96154,282.7407407,76.42297616
NM_001206571,SORCS1,25,24,586047,4284,581763,24240.125,171.36,135.7990196
NM_052918,SORCS1,26,25,591047,7472,583575,23343,287.3846154,78.10157923
NM_001206570,SORCS1,26,25,591047,7202,583845,23353.8,277,81.0670647
NM_019903,ADD3,14,13,129599,4199,125400,9646.153846,299.9285714,29.86425339
NM_020383,XPNPEP1,21,20,58789,2560,56229,2811.45,121.9047619,21.96445313
NM_001167604,XPNPEP1,20,19,58789,2487,56302,2963.263158,124.35,22.63852031
NM_016824,ADD3,15,14,127614,4459,123155,8796.785714,297.2666667,27.61942139
NM_001121,ADD3,14,13,127614,4362,123252,9480.923077,311.5714286,28.25584594
NM_007373,SHOC2,9,8,94126,3956,90170,11271.25,439.5555556,22.79322548
NM_005445,SMC3,29,28,36945,4141,32804,1171.571429,142.7931034,7.921758029
NM_001134363,RBM20,14,13,195074,7247,187827,14448.23077,517.6428571,25.91789706
NM_016234,ACSL5,21,20,52184,3375,48809,2440.45,160.7142857,14.46192593
NM_203380,ACSL5,21,20,53117,3402,49715,2485.75,162,14.61346267
NM_203379,ACSL5,21,20,54224,3236,50988,2549.4,154.0952381,15.75648949
NM_001146286,TCF7L2,12,11,217429,3891,213538,19412.54545,324.25,54.87997944
NM_001146285,TCF7L2,13,12,217429,3965,213464,17788.66667,305,53.8370744
NM_001146284,TCF7L2,13,12,217429,3931,213498,17791.5,302.3846154,54.31137115
NM_001146283,TCF7L2,13,12,217429,4033,213396,17783,310.2307692,52.91247211
NM_001146274,TCF7L2,14,13,217429,4035,213394,16414.92308,288.2142857,52.88574969
NM_001198530,TCF7L2,11,10,217429,3788,213641,21364.1,344.3636364,56.39941922
NM_001198527,TCF7L2,15,14,217429,4031,213398,15242.71429,268.7333333,52.93922104
NM_001198529,TCF7L2,13,12,217429,3943,213486,17790.5,303.3076923,54.1430383
NM_030756,TCF7L2,14,13,217429,4017,213412,16416.30769,286.9285714,53.12720936
NM_001198531,TCF7L2,13,12,217429,3961,213468,17789,304.6923077,53.8924514
NM_001198528,TCF7L2,15,14,217429,4043,213386,15241.85714,269.5333333,52.77912441
NM_001198525,TCF7L2,15,14,217429,4106,213323,15237.35714,273.7333333,51.9539698
NM_001198526,TCF7L2,13,12,217429,3965,213464,17788.66667,305,53.8370744
NM_001287824,AFAP1L2,20,19,109956,4177,105779,5567.315789,208.85,25.32415609
NM_032550,AFAP1L2,19,18,109956,4005,105951,5886.166667,210.7894737,26.45468165
NM_006720,ABLIM1,17,16,95818,6856,88962,5560.125,403.2941176,12.97578763
NM_014881,DCLRE1A,9,8,19494,4594,14900,1862.5,510.4444444,3.243360906
NM_001227,CASP7,7,6,51242,2598,48644,8107.333333,371.1428571,18.72363356
NM_001267058,CASP7,6,5,21566,2279,19287,3857.4,379.8333333,8.462922334
NM_001267057,CASP7,7,6,51242,2629,48613,8102.166667,375.5714286,18.49106124
NM_001267056,CASP7,7,6,51749,2476,49273,8212.166667,353.7142857,19.90024233
NM_033339,CASP7,8,7,51242,2673,48569,6938.428571,334.125,18.17022073
NM_033340,CASP7,8,7,51749,2443,49306,7043.714286,305.375,20.18256242
NM_033338,CASP7,8,7,51242,2706,48536,6933.714286,338.25,17.93643755
NM_001271816,DCLRE1A,10,9,19682,4277,15405,1711.666667,427.7,3.601823708
NM_001001936,AFAP1L2,19,18,109956,4017,105939,5885.5,211.4210526,26.37266617
NM_001276282,ATRNL1,8,7,78003,1817,76186,10883.71429,227.125,41.92955421
NM_001135051,FAM160B1,17,16,78085,2882,75203,4700.1875,169.5294118,26.09403192
NM_198515,CCDC172,9,8,55603,1708,53895,6736.875,189.7777778,31.55444965
NM_001011709,PNLIPRP3,12,11,50046,2320,47726,4338.727273,193.3333333,20.57155172
NM_006229,PNLIPRP1,13,12,18198,1493,16705,1392.083333,114.8461538,11.18888145
NM_145793,GFRA1,9,8,215379,9137,206242,25780.25,1015.222222,22.57217905
NM_001145453,GFRA1,10,9,216356,9228,207128,23014.22222,922.8,22.44560035
NM_005264,GFRA1,11,10,216686,9574,207112,20711.2,870.3636364,21.63275538
NM_001127211,KIAA1598,17,16,122202,5378,116824,7301.5,316.3529412,21.72257345
NM_003054,SLC18A2,16,15,38359,3888,34471,2298.066667,243,8.865997942
NM_001258299,KIAA1598,17,16,105267,2417,102850,6428.125,142.1764706,42.55275134
NM_001258300,KIAA1598,18,17,226276,2208,224068,13180.47059,122.6666667,101.4800725
NM_018330,KIAA1598,15,14,122202,5062,117140,8367.142857,337.4666667,23.14105097
NM_001242699,ENO4,14,13,33091,2879,30212,2324,205.6428571,10.4939215
NM_001258298,KIAA1598,16,15,122202,5324,116878,7791.866667,332.75,21.95304282
NM_014904,RAB11FIP2,5,4,41689,6066,35623,8905.75,1213.2,5.872568414
NM_153810,CACUL1,9,8,74266,6749,67517,8439.625,749.8888889,10.00400059
NM_005308,GRK5,16,15,247936,2574,245362,16357.46667,160.875,95.32323232
NM_001243195,INPP5F,5,4,66163,1005,65158,16289.5,201,64.83383085
NM_014937,INPP5F,20,19,103105,5005,98100,5163.157895,250.25,19.6003996
NM_001030059,PPAPDC1A,7,6,132903,1528,131375,21895.83333,218.2857143,85.97840314
NM_007041,ATE1,12,11,187644,4942,182702,16609.27273,411.8333333,36.96924322
NM_001144917,FGFR2,16,15,120130,4308,115822,7721.466667,269.25,26.88532962
NM_001144916,FGFR2,15,14,115930,4104,111826,7987.571429,273.6,27.24805068
NM_001144915,FGFR2,17,16,118317,3711,114606,7162.875,218.2941176,30.88278092
NM_001144914,FGFR2,15,14,115639,3822,111817,7986.928571,254.8,29.25614861
NM_001144913,FGFR2,17,16,112116,2796,109320,6832.5,164.4705882,39.09871245
NM_000141,FGFR2,18,17,120130,4658,115472,6792.470588,258.7777778,24.79003864
NM_022970,FGFR2,18,17,120130,4661,115469,6792.294118,258.9444444,24.77343918
NM_001144919,FGFR2,17,16,116607,3026,113581,7098.8125,178,37.53502974
NM_001144918,FGFR2,16,15,120130,4305,115825,7721.666667,269.0625,26.9047619
NM_023029,FGFR2,16,15,115639,3892,111747,7449.8,243.25,28.71197328
NM_001288734,ATE1,11,10,187644,4837,182807,18280.7,439.7272727,37.79346703
NM_001288736,ATE1,12,11,188382,5177,183205,16655,431.4166667,35.38825575
NM_001288735,ATE1,10,9,187644,4813,182831,20314.55556,481.3,37.98691045
NM_001001976,ATE1,12,11,187644,4942,182702,16609.27273,411.8333333,36.96924322
NM_006997,TACC2,17,16,90954,3919,87035,5439.6875,230.5294118,22.20847155
NM_206860,TACC2,16,15,90954,3828,87126,5808.4,239.25,22.76018809
NM_007329,DMBT1,53,52,83073,7739,75334,1448.730769,146.0188679,9.734332601
NM_017579,DMBT1,52,51,83073,7708,75365,1477.745098,148.2307692,9.777503892
NM_206862,TACC2,23,22,265370,9716,255654,11620.63636,422.4347826,26.31268012
NM_206861,TACC2,20,19,265370,4151,261219,13748.36842,207.55,62.92917369
NM_002775,HTRA1,9,8,53385,2129,51256,6407,236.5555556,24.07515265
NM_004406,DMBT1,40,39,83073,5842,77231,1980.282051,146.05,13.21995892
NM_198148,CPXM2,14,13,146350,3738,142612,10970.15385,267,38.15195292
NM_153442,GPR26,3,2,31044,10307,20737,10368.5,3435.666667,2.011933637
NM_001171814,OAT,9,8,21675,1873,19802,2475.25,208.1111111,10.57234383
NM_022126,LHPP,7,6,152371,1692,150679,25113.16667,241.7142857,89.05378251
NM_000274,OAT,10,9,21675,2102,19573,2174.777778,210.2,9.311607992
NM_001167880,LHPP,6,5,152371,1599,150772,30154.4,266.5,94.29143215
NM_014661,FAM53B,5,4,125069,5745,119324,29831,1149,20.77006092
NM_001329,CTBP2,11,10,172687,3439,169248,16924.8,312.6363636,49.21430648
NM_001083914,CTBP2,11,10,173208,3452,169756,16975.6,313.8181818,49.17612978
NM_016567,BCCIP,8,7,30162,1452,28710,4101.428571,181.5,19.77272727
NM_145235,FANK1,11,10,113055,1307,111748,11174.8,118.8181818,85.49961744
NM_018180,DHX32,11,10,44977,3081,41896,4189.6,280.0909091,13.59818241
NM_001004298,C10orf90,9,8,96438,3089,93349,11668.625,343.2222222,30.21981224
NM_006504,PTPRE,21,20,178841,5397,173444,8672.2,257,32.13711321
NM_001005463,EBF3,16,15,128597,4428,124169,8277.933333,276.75,28.04177958
NM_002412,MGMT,5,4,300331,1270,299061,74765.25,254,235.4811024
NM_174937,TCERG1L,12,11,219331,2629,216702,19700.18182,219.0833333,82.42753899
NM_001105521,JAKMIP3,24,23,80002,6512,73490,3195.217391,271.3333333,11.28531941
NM_173575,STK32C,12,11,100483,2131,98352,8941.090909,177.5833333,46.15297982
NM_001200049,TTC40,58,57,134195,8336,125859,2208.052632,143.7241379,15.09824856
NM_152643,KNDC1,30,29,65947,6803,59144,2039.448276,226.7666667,8.693811554
NM_005539,INPP5A,16,15,245633,2954,242679,16178.6,184.625,82.15267434
NM_177987,TUBB8,4,3,2352,1508,844,281.3333333,377,0.559681698
NM_014023,WDR37,14,13,75463,4625,70838,5449.076923,330.3571429,15.31632432
NM_033261,IDI2,5,4,6954,1364,5590,1397.5,272.8,4.098240469
NM_004508,IDI1,5,4,9099,2141,6958,1739.5,428.2,3.249883232
NM_014889,PITRM1,27,26,35116,3514,31602,1215.461538,130.1481481,8.993170176
NM_001242309,PITRM1,24,23,35115,3209,31906,1387.217391,133.7083333,9.942661265
NM_001242307,PITRM1,27,26,35116,3517,31599,1215.346154,130.2592593,8.984646005
NM_001160125,KLF6,3,2,9287,4541,4746,2373,1513.666667,1.045144241
NM_001300,KLF6,4,3,9287,4666,4621,1540.333333,1166.5,0.990355765
NM_001160124,KLF6,4,3,9287,4540,4747,1582.333333,1135,1.045594714
NM_001271025,AKR1E2,7,6,21884,1353,20531,3421.833333,193.2857143,15.1744272
NM_001271021,AKR1E2,8,7,21884,1477,20407,2915.285714,184.625,13.81651997
NM_001040177,AKR1E2,10,9,21884,1650,20234,2248.222222,165,12.2630303
NM_205845,AKR1C2,10,9,30259,3515,26744,2971.555556,351.5,7.608534851
NM_001353,AKR1C1,9,8,14706,1388,13318,1664.75,154.2222222,9.595100865
NM_001135241,AKR1C2,4,3,4105,1102,3003,1001,275.5,2.725045372
NM_001354,AKR1C2,11,10,30259,3616,26643,2664.3,328.7272727,7.368086283
NM_003739,AKR1C3,9,8,13312,1233,12079,1509.875,137,9.796431468
NM_001253909,AKR1C3,3,2,3802,1067,2735,1367.5,355.6666667,2.563261481
NM_024803,TUBAL3,4,3,11734,1802,9932,3310.666667,450.5,5.511653718
NM_001047160,NET1,12,11,46507,4007,42500,3863.636364,333.9166667,10.60643873
NM_001171864,TUBAL3,4,3,11734,1682,10052,3350.666667,420.5,5.976218787
NM_053049,UCN3,2,1,9195,712,8483,8483,356,11.91432584
NM_005863,NET1,10,9,12507,3916,8591,954.5555556,391.6,2.193820225
NM_017422,CALML5,1,0,877,877,NA,NA,877,NA
NM_005185,CALML3,1,0,1303,1303,NA,NA,1303,NA
NM_024701,ASB13,6,5,27740,2733,25007,5001.4,455.5,9.150018295
NM_001115156,GDI2,10,9,48328,2287,46041,5115.666667,228.7,20.13161347
NM_001494,GDI2,11,10,48328,2423,45905,4590.5,220.2727273,18.94552208
NM_002189,IL15RA,7,6,25242,1654,23588,3931.333333,236.2857143,14.26118501
NM_032807,FBXO18,22,21,43211,3726,39485,1880.238095,169.3636364,10.59715513
NM_001009943,ANKRD16,6,5,11812,1599,10213,2042.6,266.5,6.387116948
NM_001009941,ANKRD16,7,6,11812,1679,10133,1688.833333,239.8571429,6.035139964
NM_001256765,IL15RA,8,7,25242,1808,23434,3347.714286,226,12.96128319
NM_001243539,IL15RA,7,6,25818,1858,23960,3993.333333,265.4285714,12.89558665
NM_019046,ANKRD16,8,7,28173,2636,25537,3648.142857,329.5,9.687784522
NM_001258453,FBXO18,22,21,47394,3710,43684,2080.190476,168.6363636,11.77466307
NM_001258452,FBXO18,22,21,48025,3689,44336,2111.238095,167.6818182,12.01843318
NM_178150,FBXO18,21,20,47394,3611,43783,2189.15,171.952381,12.12489615
NM_172200,IL15RA,6,5,25242,1554,23688,4737.6,259,15.24324324
NM_032905,RBM17,12,11,28475,3347,25128,2284.363636,278.9166667,7.507618763
NM_001145547,RBM17,12,11,28115,3765,24350,2213.636364,313.75,6.467463479
NM_000417,IL2RA,8,7,51678,3224,48454,6922,403,15.02915633
NM_001282630,PFKFB3,15,14,89230,4285,84945,6067.5,285.6666667,19.82380397
NM_001145443,PFKFB3,15,14,90666,4238,86428,6173.428571,282.5333333,20.39358188
NM_004566,PFKFB3,15,14,32669,4564,28105,2007.5,304.2666667,6.15797546
NM_001001851,ITIH5,12,11,95595,3144,92451,8404.636364,262,29.40553435
NM_002216,ITIH2,21,20,46249,3210,43039,2151.95,152.8571429,13.40778816
NM_012311,KIN,13,12,37067,6407,30660,2555,492.8461538,4.785390979
NM_001001973,ATP5C1,10,9,19671,1156,18515,2057.222222,115.6,16.01643599
NM_005174,ATP5C1,9,8,19671,1118,18553,2319.125,124.2222222,16.59481216
NM_002051,GATA3,6,5,20499,3073,17426,3485.2,512.1666667,5.670680117
NM_001002295,GATA3,6,5,20499,3076,17423,3484.6,512.6666667,5.664174252
NM_153256,PROSER2,4,3,48881,3337,45544,15181.33333,834.25,13.64818699
NM_018706,DHTKD1,17,16,54313,5234,49079,3067.4375,307.8823529,9.376958349
NM_006023,CDC123,13,12,54630,1561,53069,4422.416667,120.0769231,33.99679693
NM_014142,NUDT5,10,9,28572,1214,27358,3039.777778,121.4,22.5354201
NM_021980,OPTN,14,13,38196,3390,34806,2677.384615,242.1428571,10.26725664
NM_001008213,OPTN,16,15,38196,3598,34598,2306.533333,224.875,9.615897721
NM_001008211,OPTN,16,15,38196,3613,34583,2305.533333,225.8125,9.571823969
NM_001008212,OPTN,15,14,38196,3543,34653,2475.214286,236.2,9.780694327
NM_145314,UCMA,5,4,12563,828,11735,2933.75,165.6,14.17270531
NM_001037537,PHYH,8,7,21952,1723,20229,2889.857143,215.375,11.74056878
NM_006214,PHYH,9,8,22336,1619,20717,2589.625,179.8888889,12.79617048
NM_001282703,FAM107B,4,3,53634,3288,50346,16782,822,15.3120438
NM_001282702,FAM107B,5,4,53634,3422,50212,12553,684.4,14.67329047
NM_001282697,FAM107B,4,3,85863,3268,82595,27531.66667,817,25.27386781
NM_001282696,FAM107B,5,4,85863,3335,82528,20632,667,24.74602699
NM_001282698,FAM107B,5,4,53634,3583,50051,12512.75,716.6,13.96902037
NM_001282700,FAM107B,4,3,53818,3234,50584,16861.33333,808.5,15.64131107
NM_001282699,FAM107B,4,3,53634,3516,50118,16706,879,14.25426621
NM_001282701,FAM107B,4,3,53634,3355,50279,16759.66667,838.75,14.98628912
NM_016299,HSPA14,14,13,33583,1922,31661,2435.461538,137.2857143,16.47294485
NM_001278205,HSPA14,4,3,8841,4097,4744,1581.333333,1024.25,1.15792043
NM_001029954,CDNF,4,3,18734,1334,17400,5800,333.5,13.04347826
NM_001289078,DCLRE1C,12,11,49823,6202,43621,3965.545455,516.8333333,7.03337633
NM_001033858,DCLRE1C,16,15,49823,6721,43102,2873.466667,420.0625,6.413033775
NM_001289079,DCLRE1C,16,15,49823,6767,43056,2870.4,422.9375,6.362642234
NM_022487,DCLRE1C,13,12,49823,6255,43568,3630.666667,481.1538462,6.965307754
NM_001080836,MEIG1,3,2,13414,628,12786,6393,209.3333333,20.35987261
NM_001289076,DCLRE1C,12,11,49823,6169,43654,3968.545455,514.0833333,7.076349489
NM_001289077,DCLRE1C,15,14,49823,6444,43379,3098.5,429.6,6.731688392
NM_001033855,DCLRE1C,14,13,49823,6312,43511,3347,450.8571429,6.893377693
NM_001033857,DCLRE1C,15,14,49823,6398,43425,3101.785714,426.5333333,6.787277274
NM_001265601,RPP38,2,1,7079,1542,5537,5537,771,3.59079118
NM_183005,RPP38,3,2,7079,1662,5417,2708.5,554,3.259326113
NM_001039844,ACBD7,4,3,13303,3374,9929,3309.666667,843.5,2.942797866
NM_001039702,OLAH,8,7,29958,1683,28275,4039.285714,210.375,16.80035651
NM_006414,RPP38,2,1,7079,1185,5894,5894,592.5,4.973839662
NM_018324,OLAH,9,8,29958,1843,28115,3514.375,204.7777778,15.25501899
NM_001097590,RPP38,3,2,7079,1305,5774,2887,435,4.424521073
NM_153244,C10orf111,2,1,1936,1716,220,220,858,0.128205128
NM_001010908,C1QL3,2,1,8264,2495,5769,5769,1247.5,2.312224449
NM_003380,VIM,10,9,9336,2146,7190,798.8888889,214.6,3.350419385
NM_004412,TRDMT1,11,10,59090,7681,51409,5140.9,698.2727273,6.693008723
NM_014241,PTPLA,7,6,27417,1314,26103,4350.5,187.7142857,19.8652968
NM_001282734,SLC39A12,12,11,91455,2473,88982,8089.272727,206.0833333,35.98139911
NM_152725,SLC39A12,12,11,91455,2709,88746,8067.818182,225.75,32.75968992
NM_001145195,SLC39A12,13,12,91455,2821,88634,7386.166667,217,31.41935484
NM_001282733,SLC39A12,13,12,91455,2818,88637,7386.416667,216.7692308,31.45386799
NM_178815,ARL5B,6,5,18629,3595,15034,3006.8,599.1666667,4.181919332
NM_001010896,C10orf113,2,1,20798,581,20217,20217,290.5,34.79690189
NM_001177483,C10orf113,2,1,20798,616,20182,20182,308,32.76298701
NM_001195627,MLLT10,5,4,23015,1243,21772,5443,248.6,17.51568785
NM_001010911,CASC10,2,1,2794,1991,803,803,995.5,0.403314917
NM_001195630,MLLT10,4,3,23015,1136,21879,7293,284,19.2596831
NM_001195628,MLLT10,4,3,23015,1110,21905,7301.666667,277.5,19.73423423
NM_207371,SKIDA1,4,3,12204,6600,5604,1868,1650,0.849090909
NM_001199938,EBLN1,1,0,1171,1171,NA,NA,1171,NA
NM_012071,COMMD3,8,7,3936,950,2986,426.5714286,118.75,3.143157895
NM_001204062,COMMD3-BMI1,14,13,15104,3402,11702,900.1538462,243,3.439741329
NM_005180,BMI1,10,9,10277,3440,6837,759.6666667,344,1.9875
NM_173081,ARMC3,19,18,110501,3766,106735,5929.722222,198.2105263,28.3417419
NM_001282747,ARMC3,16,15,110501,3274,107227,7148.466667,204.625,32.75106903
NM_001282746,ARMC3,17,16,86465,2534,83931,5245.6875,149.0588235,33.12194159
NM_001282745,ARMC3,19,18,110501,3745,106756,5930.888889,197.1052632,28.50627503
NM_012228,MSRB2,5,4,26517,1816,24701,6175.25,363.2,13.60187225
NM_178161,PTF1A,2,1,1723,1335,388,388,667.5,0.290636704
NM_153714,C10orf67,5,4,28254,2948,25306,6326.5,589.6,8.58412483
NM_001145373,OTUD1,1,0,3114,3114,NA,NA,3114,NA
NM_024838,THNSL1,3,2,10087,3773,6314,3157,1257.666667,1.673469388
NM_000818,GAD2,17,16,88257,2841,85416,5338.5,167.1176471,30.0654699
NM_001134366,GAD2,16,15,84814,2435,82379,5491.933333,152.1875,33.8312115
NM_014915,ANKRD26,34,33,96384,6813,89571,2714.272727,200.3823529,13.14707177
NM_001256053,ANKRD26,34,33,96384,6810,89574,2714.363636,200.2941176,13.15330396
NM_139312,YME1L1,20,19,44311,4418,39893,2099.631579,220.9,9.029651426
NM_032844,MASTL,12,11,32097,3635,28462,2587.454545,302.9166667,7.829986245
NM_001172304,MASTL,11,10,32097,3520,28577,2857.7,320,8.118465909
NM_001172303,MASTL,12,11,32097,3638,28459,2587.181818,303.1666667,7.822704783
NM_001253866,YME1L1,18,17,44311,4146,40165,2362.647059,230.3333333,9.687650748
NM_014263,YME1L1,19,18,44311,4246,40065,2225.833333,223.4736842,9.435939708
NM_001034842,PTCHD3,4,3,16182,2532,13650,4550,633,5.390995261
NM_001256412,RAB18,5,4,38065,4816,33249,8312.25,963.2,6.903862126
NM_001256411,RAB18,6,5,38065,4942,33123,6624.6,823.6666667,6.702347228
NM_001256410,RAB18,8,7,38065,5098,32967,4709.571429,637.25,6.46665359
NM_001256415,RAB18,6,5,38065,4937,33128,6625.6,822.8333333,6.710147863
NM_021252,RAB18,7,6,38065,5010,33055,5509.166667,715.7142857,6.597804391
NM_001242702,MKX,7,6,72977,3643,69334,11555.66667,520.4285714,19.03211639
NM_173576,MKX,7,6,72977,3646,69331,11555.16667,520.8571429,19.01563357
NM_001278522,C10orf126,5,4,35491,2153,33338,8334.5,430.6,15.48444032
NM_032517,LYZL1,5,4,22170,817,21353,5338.25,163.4,26.13586291
NM_020848,KIAA1462,4,3,46761,9304,37457,12485.66667,2326,4.025902837
NM_018109,MTPAP,9,8,39539,5629,33910,4238.75,625.4444444,6.024160597
NM_001244134,MAP3K8,8,7,27814,2790,25024,3574.857143,348.75,8.969175627
NM_005204,MAP3K8,9,8,27814,3022,24792,3099,335.7777778,8.203838518
NM_183058,LYZL2,5,4,17941,779,17162,4290.5,155.8,22.03080873
NM_004521,KIF5B,26,25,47435,5915,41520,1660.8,227.5,7.019442096
NM_025209,EPC1,15,14,79504,4176,75328,5380.571429,278.4,18.03831418
NM_001272019,EPC1,14,13,79334,3712,75622,5817.076923,265.1428571,20.37230603
NM_001272004,EPC1,14,13,79504,4106,75398,5799.846154,293.2857143,18.36288358
NM_002211,ITGB1,16,15,58049,3886,54163,3610.866667,242.875,13.9379825
NM_033668,ITGB1,16,15,35242,3746,31496,2099.733333,234.125,8.407901762
NM_133376,ITGB1,16,15,57578,3801,53777,3585.133333,237.5625,14.14811892
NM_001198779,CUL2,21,20,65781,4293,61488,3074.4,204.4285714,14.32285115
NM_001198778,CUL2,21,20,65781,4180,61601,3080.05,199.047619,14.73708134
NM_001198777,CUL2,21,20,82093,4254,77839,3891.95,202.5714286,18.29783733
NM_003591,CUL2,21,20,81834,4246,77588,3879.4,202.1904762,18.2731983
NM_182724,CREM,3,2,17058,1661,15397,7698.5,553.6666667,9.269717038
NM_182772,CREM,5,4,45421,1971,43450,10862.5,394.2,22.04464739
NM_182771,CREM,6,5,45421,2161,43260,8652,360.1666667,20.01850995
NM_182770,CREM,5,4,37373,1825,35548,8887,365,19.47835616
NM_182769,CREM,6,5,37373,2015,35358,7071.6,335.8333333,17.54739454
NM_183012,CREM,6,5,75178,2331,72847,14569.4,388.5,31.25139425
NM_183011,CREM,7,6,75178,2521,72657,12109.5,360.1428571,28.82070607
NM_182723,CREM,4,3,17058,2143,14915,4971.666667,535.75,6.959869342
NM_182720,CREM,3,2,17833,1953,15880,7940,651,8.131080389
NM_182719,CREM,4,3,17833,1588,16245,5415,397,10.22984887
NM_182718,CREM,3,2,17833,1551,16282,8141,517,10.49774339
NM_182717,CREM,4,3,17833,1990,15843,5281,497.5,7.961306533
NM_183060,CREM,6,5,85503,1942,83561,16712.2,323.6666667,43.02832132
NM_001267567,CREM,4,3,37373,1772,35601,11867,443,20.09085779
NM_001267565,CREM,3,2,12310,1104,11206,5603,368,10.15036232
NM_001881,CREM,4,3,53008,1293,51715,17238.33333,323.25,39.99613302
NM_001267566,CREM,3,2,4262,934,3328,1664,311.3333333,3.563169165
NM_001267564,CREM,7,6,45421,2198,43223,7203.833333,314,19.66469518
NM_001267563,CREM,5,4,86119,2059,84060,21015,411.8,40.82564352
NM_001267570,CREM,4,3,17058,1698,15360,5120,424.5,9.045936396
NM_001267569,CREM,4,3,15625,1724,13901,4633.666667,431,8.063225058
NM_001267568,CREM,3,2,15625,1687,13938,6969,562.3333333,8.262003557
NM_001267562,CREM,7,6,86119,2391,83728,13954.66667,341.5714286,35.01798411
NM_183013,CREM,8,7,86119,2722,83397,11913.85714,340.25,30.63813373
NM_181571,CREM,8,7,85503,2231,83272,11896,278.875,37.32496638
NM_182721,CREM,3,2,17058,2063,14995,7497.5,687.6666667,7.26854096
NM_153368,GJD4,2,1,3527,1582,1945,1945,791,1.229456384
NM_031866,FZD8,1,0,3187,3187,NA,NA,3187,NA
NM_001190489,MTRNR2L7,1,0,1495,1495,NA,NA,1495,NA
NM_145011,ZNF25,6,5,26660,3742,22918,4583.6,623.6666667,6.124532336
NM_001278179,ZNF33A,6,5,49419,6247,43172,8634.4,1041.166667,6.910837202
NM_001278178,ZNF33A,5,4,49419,6131,43288,10822,1226.2,7.060512151
NM_001278177,ZNF33A,5,4,49419,6122,43297,10824.25,1224.4,7.072361973
NM_001278175,ZNF33A,6,5,49419,6191,43228,8645.6,1031.833333,6.982393797
NM_001278174,ZNF33A,6,5,49419,6202,43217,8643.4,1033.666667,6.968236053
NM_001278171,ZNF33A,6,5,49419,6250,43169,8633.8,1041.666667,6.90704
NM_001278170,ZNF33A,4,3,49419,6069,43350,14450,1517.25,7.142857143
NM_006974,ZNF33A,5,4,49419,6123,43296,10824,1224.6,7.071043606
NM_006954,ZNF33A,5,4,49419,6126,43293,10823.25,1225.2,7.067091087
NM_001278176,ZNF33A,6,5,49419,6207,43212,8642.4,1034.5,6.961817303
NM_001278173,ZNF33A,6,5,49419,6206,43213,8642.6,1034.333333,6.963100226
NM_014753,BMS1,23,22,52433,8071,44362,2016.454545,350.9130435,5.496468839
NM_020630,RET,19,18,50437,4178,46259,2569.944444,219.8947368,11.07204404
NM_020975,RET,20,19,53282,5635,47647,2507.736842,281.75,8.455545697
NM_001282862,RASGEF1A,13,12,35208,3279,31929,2660.75,252.2307692,9.737419945
NM_145313,RASGEF1A,13,12,72388,3251,69137,5761.416667,250.0769231,21.26637958
NM_001184963,FXYD4,9,8,4693,644,4049,506.125,71.55555556,6.287267081
NM_001098205,HNRNPF,4,3,23269,2676,20593,6864.333333,669,7.695440957
NM_001098204,HNRNPF,4,3,23633,2636,20997,6999,659,7.965477997
NM_001098208,HNRNPF,3,2,11216,2758,8458,4229,919.3333333,3.066715011
NM_001098207,HNRNPF,4,3,11731,2680,9051,3017,670,3.377238806
NM_001098206,HNRNPF,4,3,22236,2653,19583,6527.666667,663.25,7.381454957
NM_004966,HNRNPF,4,3,23593,2637,20956,6985.333333,659.25,7.946909367
NM_173160,FXYD4,9,8,4693,780,3913,489.125,86.66666667,5.016666667
NM_006973,ZNF32,3,2,5021,1162,3859,1929.5,387.3333333,3.320998279
NM_005674,ZNF239,2,1,12116,2390,9726,9726,1195,4.069456067
NM_001005368,ZNF32,3,2,4847,1205,3642,1821,401.6666667,3.022406639
NM_145312,ZNF485,5,4,11499,2060,9439,2359.75,412,4.582038835
NM_001099284,ZNF239,3,2,18275,2032,16243,8121.5,677.3333333,7.993602362
NM_001099283,ZNF239,2,1,18275,1908,16367,16367,954,8.578092243
NM_001099282,ZNF239,4,3,18274,2073,16201,5400.333333,518.25,7.815243608
NM_001258000,LOC100130539,3,2,1901,1113,788,394,371,0.707996406
NM_199168,CXCL12,3,2,8037,1936,6101,3050.5,645.3333333,3.151342975
NM_001277990,CXCL12,3,2,14946,3142,11804,5902,1047.333333,3.756842775
NM_001033886,CXCL12,4,3,9232,528,8704,2901.333333,132,16.48484848
NM_000609,CXCL12,4,3,14946,3553,11393,3797.666667,888.25,3.206585984
NM_001178134,CXCL12,4,3,8037,1206,6831,2277,301.5,5.664179104
NM_007021,C10orf10,2,1,2623,2062,561,561,1031,0.272065955
NM_001123376,TMEM72,5,4,23880,1090,22790,5697.5,218,20.90825688
NM_006963,ZNF22,2,1,4506,2206,2300,2300,1103,1.042611061
NM_001039380,C10orf25,2,1,3326,3214,112,112,1607,0.034847542
NM_001004297,OR13A1,4,3,12956,2082,10874,3624.666667,520.5,5.222862632
NM_133446,AGAP4,7,6,21873,2438,19435,3239.166667,348.2857143,7.971698113
NM_001042395,PTPN20A,10,9,90882,2882,88000,9777.777778,288.2,30.53435115
NM_001042393,PTPN20A,8,7,90539,2327,88212,12601.71429,290.875,37.9080361
NM_001042396,PTPN20A,7,6,90882,2233,88649,14774.83333,319,39.69950739
NM_001042389,PTPN20A,10,9,69937,2975,66962,7440.222222,297.5,22.50823529
NM_001042392,PTPN20A,5,4,90539,2326,88213,22053.25,465.2,37.92476354
NM_001042391,PTPN20A,8,7,90539,2452,88087,12583.85714,306.5,35.92455139
NM_001042390,PTPN20A,10,9,90539,2880,87659,9739.888889,288,30.43715278
NM_001042387,PTPN20A,9,8,90882,2487,88395,11049.375,276.3333333,35.54282268
NM_001042365,PTPN20B,4,3,90882,1889,88993,29664.33333,472.25,47.11116993
NM_001042364,PTPN20B,7,6,90882,2233,88649,14774.83333,319,39.69950739
NM_001042363,PTPN20B,10,9,90882,2882,88000,9777.777778,288.2,30.53435115
NM_001042361,PTPN20B,8,7,90539,2327,88212,12601.71429,290.875,37.9080361
NM_001042358,PTPN20B,10,9,90539,2880,87659,9739.888889,288,30.43715278
NM_001042357,PTPN20B,10,9,69937,2975,66962,7440.222222,297.5,22.50823529
NM_001042359,PTPN20B,8,7,90539,2452,88087,12583.85714,306.5,35.92455139
NM_001042360,PTPN20B,5,4,90539,2326,88213,22053.25,465.2,37.92476354
NM_015605,PTPN20B,9,8,90882,2487,88395,11049.375,276.3333333,35.54282268
NM_001042397,PTPN20A,4,3,90882,1889,88993,29664.33333,472.25,47.11116993
NM_001042394,PTPN20A,6,5,90539,2082,88457,17691.4,347,42.48655139
NM_001042362,PTPN20B,6,5,90539,2082,88457,17691.4,347,42.48655139
NM_031912,SYT15,8,7,12722,5516,7206,1029.428571,689.5,1.306381436
NM_014696,GPRIN2,3,2,7024,1826,5198,2599,608.6666667,2.846659365
NM_181519,SYT15,9,8,15159,1545,13614,1701.75,171.6666667,8.811650485
NM_001137549,FAM25G,3,2,4468,337,4131,2065.5,112.3333333,12.25816024
NM_001278795,LOC100996758,1,0,1450,1450,NA,NA,1450,NA
NM_001278794,NPY4R,2,1,4788,1802,2986,2986,901,1.657047725
NM_001137548,FAM25C,3,2,4468,337,4131,2065.5,112.3333333,12.25816024
NM_001271702,ANXA8,12,11,16161,2188,13973,1270.272727,182.3333333,6.386197441
NM_001271703,ANXA8,10,9,16161,1886,14275,1586.111111,188.6,7.56892895
NM_001040084,ANXA8,12,11,16161,2074,14087,1280.636364,172.8333333,6.792189007
NM_005972,NPY4R,3,2,4788,1959,2829,1414.5,653,1.444104135
NM_001190810,AGAP9,8,7,21784,2395,19389,2769.857143,299.375,8.095615866
NM_001278688,ANTXRL,17,16,43212,2302,40910,2556.875,135.4117647,17.77150304
NM_001278923,ANXA8L1,10,9,16192,1938,14254,1583.777778,193.8,7.35500516
NM_001278924,ANXA8L1,9,8,16192,1955,14237,1779.625,217.2222222,7.282352941
NM_001630,ANXA8L2,12,11,16122,2041,14081,1280.090909,170.0833333,6.899069084
NM_001098845,ANXA8L1,12,11,16192,2111,14081,1280.090909,175.9166667,6.670298437
NM_018232,FAM21B,29,28,55396,4355,51041,1822.892857,150.1724138,11.72009185
NM_001137549,FAM25G,3,2,4465,337,4128,2064,112.3333333,12.24925816
NM_001137548,FAM25C,3,2,4465,337,4128,2064,112.3333333,12.24925816
NM_001271702,ANXA8,12,11,16166,2188,13978,1270.727273,182.3333333,6.388482633
NM_001271703,ANXA8,10,9,16166,1886,14280,1586.666667,188.6,7.571580064
NM_001040084,ANXA8,12,11,16166,2074,14092,1281.090909,172.8333333,6.794599807
NM_002900,RBP3,4,3,9506,4280,5226,1742,1070,1.221028037
NM_004962,GDF10,3,2,13352,2650,10702,5351,883.3333333,4.038490566
NM_016204,GDF2,2,1,3782,1957,1825,1825,978.5,0.932549821
NM_001137549,FAM25G,3,2,4454,337,4117,2058.5,112.3333333,12.21661721
NM_001137548,FAM25C,3,2,4454,337,4117,2058.5,112.3333333,12.21661721
NM_001042512,FRMPD2,6,5,18586,1898,16688,3337.6,316.3333333,8.792413066
NM_139049,MAPK8,11,10,37749,5674,32075,3207.5,515.8181818,5.652978498
NM_002750,MAPK8,11,10,37749,5679,32070,3207,516.2727273,5.647120972
NM_139046,MAPK8,11,10,37749,5679,32070,3207,516.2727273,5.647120972
NM_001278548,MAPK8,10,9,37749,5450,32299,3588.777778,545,5.926422018
NM_001006939,LRRC18,2,1,4753,1621,3132,3132,810.5,1.932140654
NM_001031746,VSTM4,8,7,101289,6423,94866,13552.28571,802.875,14.76973377
NM_144984,VSTM4,3,2,13362,2196,11166,5583,732,5.084699454
NM_001164484,FAM170B,2,1,2866,1413,1453,1453,706.5,1.028308563
NM_001010863,C10orf128,6,5,33678,1549,32129,6425.8,258.1666667,20.74176888
NM_001288743,C10orf128,7,6,33678,2057,31621,5270.166667,293.8571429,15.37238697
NM_001288741,C10orf128,5,4,33678,1517,32161,8040.25,303.4,21.20039552
NM_001288740,C10orf128,7,6,33678,1629,32049,5341.5,232.7142857,19.67403315
NM_001288742,C10orf128,5,4,33678,1867,31811,7952.75,373.4,17.03856454
NM_001135196,C10orf71,3,2,28352,5289,23063,11531.5,1763,4.360559652
NM_003055,SLC18A3,1,0,2421,2421,NA,NA,2421,NA
NM_001143997,OGDHL,21,20,27740,3407,24333,1216.65,162.2380952,7.142060464
NM_001143996,OGDHL,22,21,27740,3613,24127,1148.904762,164.2272727,6.677830058
NM_001042427,C10orf53,3,2,15266,645,14621,7310.5,215,22.66821705
NM_018245,OGDHL,23,22,27740,3785,23955,1088.863636,164.5652174,6.328929987
NM_182554,C10orf53,3,2,29274,830,28444,14222,276.6666667,34.26987952
NM_001276344,AGAP8,7,6,21730,2308,19422,3237,329.7142857,8.41507799
NM_001276343,AGAP8,8,7,21730,2378,19352,2764.571429,297.25,8.137931034
NM_001077686,AGAP8,7,6,21730,2308,19422,3237,329.7142857,8.41507799
NM_001077685,AGAP7,7,6,22178,2438,19740,3290,348.2857143,8.096800656
NM_002443,MSMB,4,3,12967,499,12468,4156,124.75,24.98597194
NM_001145263,NCOA4,10,9,25628,3562,22066,2451.777778,356.2,6.194834363
NM_006327,TIMM23,7,6,31307,1232,30075,5012.5,176,24.41152597
NM_005437,NCOA4,10,9,18372,3502,14870,1652.222222,350.2,4.24614506
NM_001145262,NCOA4,10,9,14451,3588,10863,1207,358.8,3.027591973
NM_001145261,NCOA4,11,10,25628,3660,21968,2196.8,332.7272727,6.002185792
NM_001145260,NCOA4,12,11,25628,3750,21878,1988.909091,312.5,5.834133333
NM_138634,MSMB,3,2,12967,392,12575,6287.5,130.6666667,32.07908163
NM_001077665,AGAP6,8,7,22183,2780,19403,2771.857143,347.5,6.979496403
NM_018232,FAM21B,29,28,55385,4355,51030,1822.5,150.1724138,11.71756602
NM_001005751,FAM21A,31,30,65587,4703,60884,2029.466667,151.7096774,12.94577929
NM_019893,ASAH2,20,19,61372,2438,58934,3101.789474,121.9,24.1730927
NM_001143974,ASAH2,19,18,61372,2332,59040,3280,122.7368421,25.31732419
NM_001079516,ASAH2B,6,5,14883,658,14225,2845,109.6666667,21.61854103
NM_015235,CSTF2T,1,0,4111,4111,NA,NA,4111,NA
NM_012242,DKK1,4,3,3378,1809,1569,523,452.25,0.867330017
NM_001190478,MTRNR2L5,1,0,1739,1739,NA,NA,1739,NA
NM_001005413,ZWINT,9,8,3837,1528,2309,288.625,169.7777778,1.511125654
NM_007057,ZWINT,9,8,3837,1669,2168,271,185.4444444,1.298981426
NM_032997,ZWINT,8,7,3837,1859,1978,282.5714286,232.375,1.06401291
NM_152230,IPMK,6,5,76418,6139,70279,14055.8,1023.166667,11.44795569
NM_003338,UBE2D1,7,6,35776,2662,33114,5519,380.2857143,12.43951916
NM_001204880,UBE2D1,6,5,35776,2629,33147,6629.4,438.1666667,12.60821605
NM_001270782,TFAM,6,5,14089,5212,8877,1775.4,868.6666667,1.703184958
NM_003201,TFAM,7,6,14089,5309,8780,1463.333333,758.4285714,1.653795442
NM_194298,SLC16A9,6,5,59129,3993,55136,11027.2,665.5,13.80816429
NM_001170407,CDK1,4,3,8617,1746,6871,2290.333333,436.5,3.935280641
NM_001170406,CDK1,4,3,8740,1758,6982,2327.333333,439.5,3.971558589
NM_001786,CDK1,8,7,16400,1921,14479,2068.428571,240.125,7.537220198
NM_033379,CDK1,7,6,16400,1749,14651,2441.833333,249.8571429,8.376786735
NM_001282941,RTKN2,5,4,30715,2244,28471,7117.75,448.8,12.68761141
NM_014951,ZNF365,5,4,28303,4213,24090,6022.5,842.6,5.718015666
NM_001136179,EGR2,3,2,4372,2882,1490,745,960.6666667,0.517002082
NM_001136178,EGR2,4,3,7173,2855,4318,1439.333333,713.75,1.512434326
NM_001136177,EGR2,3,2,4372,2799,1573,786.5,933,0.561986424
NM_032804,ADO,1,0,3725,3725,NA,NA,3725,NA
NM_000399,EGR2,2,1,4372,2981,1391,1391,1490.5,0.466621939
NM_030759,NRBF2,4,3,21786,1905,19881,6627,476.25,10.43622047
NM_001282405,NRBF2,3,2,21786,1819,19967,9983.5,606.3333333,10.97691039
NM_001001330,REEP3,8,7,103762,5213,98549,14078.42857,651.625,18.9044696
NM_201262,DNAJC12,3,2,26973,784,26189,13094.5,261.3333333,33.40433673
NM_021800,DNAJC12,5,4,41512,1217,40295,10073.75,243.4,33.11010682
NM_012238,SIRT1,9,8,33722,4103,29619,3702.375,455.8888889,7.218864246
NM_001142498,SIRT1,8,7,33210,3596,29614,4230.571429,449.5,8.235261402
NM_001278187,HERC4,4,3,6346,2139,4207,1402.333333,534.75,1.966806919
NM_145178,ATOH7,1,0,1520,1520,NA,NA,1520,NA
NM_032578,MYPN,20,19,102585,5836,96749,5092.052632,291.8,16.57796436
NM_001256268,MYPN,24,23,102585,6144,96441,4193.086957,256,15.69677734
NM_001256267,MYPN,21,20,105901,5732,100169,5008.45,272.952381,17.47540126
NM_021644,HNRNPH3,10,9,11187,2377,8810,978.8888889,237.7,3.706352545
NM_022129,PBLD,10,9,50269,2597,47672,5296.888889,259.7,18.35656527
NM_001033083,PBLD,9,8,47848,1233,46615,5826.875,137,37.80616383
NM_012207,HNRNPH3,10,9,11187,2422,8765,973.8888889,242.2,3.618909992
NM_001278225,RUFY2,12,11,30103,2626,27477,2497.909091,218.8333333,10.4634425
NM_001042417,RUFY2,12,11,30103,2698,27405,2491.363636,224.8333333,10.15752409
NM_001080449,DNA2,21,20,57911,4288,53623,2681.15,204.1904762,12.50536381
NM_015634,KIAA1279,7,6,28264,2552,25712,4285.333333,364.5714286,10.07523511
NM_001256910,DDX21,15,14,28631,4846,23785,1698.928571,323.0666667,4.908171688
NM_024045,DDX50,15,14,45571,2553,43018,3072.714286,170.2,16.84998042
NM_004728,DDX21,15,14,28948,4727,24221,1730.071429,315.1333333,5.123968691
NM_002727,SRGN,3,2,16741,1257,15484,7742,419,12.31821798
NM_025130,HKDC1,18,17,47258,3707,43551,2561.823529,205.9444444,11.748314
NM_003171,SUPV3L1,15,14,28858,2489,26369,1883.5,165.9333333,10.59421454
NM_000188,HK1,18,17,83036,3619,79417,4671.588235,201.0555556,21.9444598
NM_033496,HK1,18,17,86029,3616,82413,4847.823529,200.8888889,22.79120575
NM_012339,TSPAN15,8,7,56199,1707,54492,7784.571429,213.375,31.92267135
NM_145306,C10orf35,4,3,3354,1080,2274,758,270,2.105555556
NM_020999,NEUROG3,2,1,1421,1257,164,164,628.5,0.130469372
NM_001142648,SAR1A,8,7,20326,3079,17247,2463.857143,384.875,5.601493992
NM_032797,AIFM2,9,8,20669,3256,17413,2176.625,361.7777778,5.347972973
NM_001198696,AIFM2,9,8,20669,3259,17410,2176.25,362.1111111,5.342129488
NM_020150,SAR1A,7,6,20326,3008,17318,2886.333333,429.7142857,5.75731383
NM_001040273,TYSND1,2,1,8761,3483,5278,5278,1741.5,1.515360322
NM_173555,TYSND1,4,3,8761,3802,4959,1653,950.5,1.304313519
NM_021129,PPA1,11,10,30606,1313,29293,2929.3,119.3636364,22.30997715
NM_022146,NPFFR1,4,3,28739,1315,27424,9141.333333,328.75,20.85475285
NM_018055,NODAL,3,2,9775,2089,7686,3843,696.3333333,3.679272379
NM_004096,EIF4EBP2,3,2,24515,7534,16981,8490.5,2511.333333,2.253915583
NM_014431,PALD1,20,19,89644,4589,85055,4476.578947,229.45,18.53453912
NM_001083116,PRF1,3,2,5429,2537,2892,1446,845.6666667,1.13992905
NM_005041,PRF1,3,2,5429,2511,2918,1459,837,1.162086818
NM_152710,TBATA,11,10,14164,1594,12570,1257,144.9090909,7.885821832
NM_000281,PCBD1,4,3,5280,1014,4266,1422,253.5,4.207100592
NM_001289797,PCBD1,4,3,4748,1160,3588,1196,290,3.093103448
NM_001174098,SLC29A3,6,5,44139,2279,41860,8372,379.8333333,18.36770513
NM_018344,SLC29A3,6,5,44139,2273,41866,8373.2,378.8333333,18.41882974
NM_001164375,C10orf105,2,1,8122,4839,3283,3283,2419.5,0.67844596
NM_001168390,C10orf105,2,1,26125,4741,21384,21384,2370.5,4.510440835
NM_001042466,PSAP,14,13,35029,2842,32187,2475.923077,203,11.32547502
NM_001042465,PSAP,15,14,35029,2846,32183,2298.785714,189.7333333,11.30815179
NM_001171933,CDH23,23,22,20178,4354,15824,719.2727273,189.3043478,3.63435921
NM_001171936,CDH23,4,3,4066,1733,2333,777.6666667,433.25,1.346220427
NM_001171934,CDH23,22,21,20178,4248,15930,758.5714286,193.0909091,3.75
NM_002778,PSAP,14,13,35029,2836,32193,2476.384615,202.5714286,11.35155148
NM_001171935,CDH23,5,4,4066,1839,2227,556.75,367.8,1.210984231
NM_004273,CHST3,3,2,49204,6976,42228,21114,2325.333333,6.053325688
NM_001244950,SPOCK2,11,10,29741,5457,24284,2428.4,496.0909091,4.450064138
NM_001134434,SPOCK2,3,2,2808,1287,1521,760.5,429,1.181818182
NM_014767,SPOCK2,12,11,30000,5341,24659,2241.727273,445.0833333,4.616925669
NM_173473,ANAPC16,4,3,19862,3247,16615,5538.333333,811.75,5.117031106
NM_001242548,ANAPC16,3,2,19862,3105,16757,8378.5,1035,5.396779388
NM_001242547,ANAPC16,4,3,19862,3181,16681,5560.333333,795.25,5.243948444
NM_019058,DDIT4,3,2,2122,1755,367,183.5,585,0.209116809
NM_001242546,ANAPC16,5,4,19862,3574,16288,4072,714.8,4.557358702
NM_017626,DNAJB12,9,8,22321,3207,19114,2389.25,356.3333333,5.960087309
NM_001002762,DNAJB12,8,7,22321,4368,17953,2564.714286,546,4.110119048
NM_152635,OIT3,9,8,39450,2370,37080,4635,263.3333333,15.64556962
NM_001283019,NUDT13,8,7,21455,2087,19368,2766.857143,260.875,9.28030666
NM_001283017,NUDT13,9,8,21455,2160,19295,2411.875,240,8.93287037
NM_015901,NUDT13,9,8,21455,2195,19260,2407.5,243.8888889,8.774487472
NM_001283016,NUDT13,10,9,21455,2268,19187,2131.888889,226.8,8.459876543
NM_007265,ECD,14,13,33573,2251,31322,2409.384615,160.7857143,13.91470458
NM_001283014,NUDT13,7,6,21455,1926,19529,3254.833333,275.1428571,10.13966771
NM_001283015,NUDT13,8,7,21455,2082,19373,2767.571429,260.25,9.304995197
NM_001135753,ECD,13,12,33573,2121,31452,2621,163.1538462,14.82885431
NM_001135752,ECD,15,14,33573,2351,31222,2230.142857,156.7333333,13.28030625
NM_015190,DNAJC9,5,4,4445,1442,3003,750.75,288.4,2.082524272
NM_016065,MRPS16,3,2,3852,2637,1215,607.5,879,0.460750853
NM_001024593,MSS51,7,6,9984,2430,7554,1259,347.1428571,3.108641975
NM_001156,ANXA7,13,12,38654,2151,36503,3041.916667,165.4615385,16.9702464
NM_004034,ANXA7,14,13,38654,2218,36436,2802.769231,158.4285714,16.42741208
NM_152586,USP54,22,21,78139,6185,71954,3426.380952,281.1363636,11.63362975
NM_024875,SYNPO2L,2,1,6160,4133,2027,2027,2066.5,0.490442778
NM_001114133,SYNPO2L,4,3,11226,4958,6268,2089.333333,1239.5,1.264219443
NM_021245,MYOZ1,6,5,10147,1589,8558,1711.6,264.8333333,5.385777218
NM_001144000,AGAP5,8,7,23523,2434,21089,3012.714286,304.25,8.664338537
NM_198597,SEC24C,23,22,27804,4481,23323,1060.136364,194.826087,5.204864985
NM_001284194,FUT11,3,2,3929,2180,1749,874.5,726.6666667,0.802293578
NM_173540,FUT11,3,2,3929,2058,1871,935.5,686,0.909135083
NM_001242488,ZSWIM8,26,25,16176,5982,10194,407.76,230.0769231,1.704112337
NM_001242487,ZSWIM8,26,25,16176,6074,10102,404.08,233.6153846,1.663154429
NM_015037,ZSWIM8,26,25,16176,6089,10087,403.48,234.1923077,1.656593858
NM_004922,SEC24C,24,23,27804,4569,23235,1010.217391,190.375,5.085357846
NM_003635,NDST2,15,14,9922,4011,5911,422.2142857,267.4,1.473697332
NM_203298,CHCHD1,3,2,1600,847,753,376.5,282.3333333,0.889020071
NM_001001791,C10orf55,5,4,12810,2518,10292,2573,503.6,4.087370929
NM_002658,PLAU,11,10,6398,2388,4010,401,217.0909091,1.679229481
NM_001145031,PLAU,10,9,6398,2672,3726,414,267.2,1.394461078
NM_016364,DUSP13,4,3,5058,906,4152,1384,226.5,4.582781457
NM_001007273,DUSP13,6,5,14782,1351,13431,2686.2,225.1666667,9.941524796
NM_001007272,DUSP13,4,3,14782,1050,13732,4577.333333,262.5,13.07809524
NM_001007271,DUSP13,8,7,14782,1779,13003,1857.571429,222.375,7.309162451
NM_001184783,VDAC2,11,10,20909,1956,18953,1895.3,177.8181818,9.689672802
NM_003375,VDAC2,10,9,20909,1777,19132,2125.777778,177.7,10.76646033
NM_144589,COMTD1,7,6,2043,982,1061,176.8333333,140.2857143,1.080448065
NM_001184823,VDAC2,10,9,21297,1439,19858,2206.444444,143.9,13.79986101
NM_032772,ZNF503,2,1,3912,3183,729,729,1591.5,0.229029218
NM_001271522,KCNMA1,2,1,1618,870,748,748,435,0.859770115
NM_001271521,KCNMA1,2,1,1618,924,694,694,462,0.751082251
NM_001271520,KCNMA1,2,1,1618,1361,257,257,680.5,0.188831741
NM_033022,RPS24,6,5,6957,661,6296,1259.2,110.1666667,9.524962179
NM_001142284,RPS24,7,6,6957,680,6277,1046.166667,97.14285714,9.230882353
NM_001142283,RPS24,7,6,6957,683,6274,1045.666667,97.57142857,9.185944363
NM_001142282,RPS24,6,5,6957,664,6293,1258.6,110.6666667,9.477409639
NM_001142285,RPS24,5,4,23055,2820,20235,5058.75,564,7.175531915
NM_007055,POLR3A,31,30,54393,6666,47727,1590.9,215.0322581,7.159765977
NM_001026,RPS24,5,4,6957,638,6319,1579.75,127.6,9.904388715
NM_005729,PPIF,6,5,7871,2206,5665,1133,367.6666667,2.567996374
NM_153367,ZCCHC24,4,3,63302,4935,58367,19455.66667,1233.75,11.82715299
NM_001164647,SFTPA1,5,4,4506,2149,2357,589.25,429.8,1.096789204
NM_001164646,SFTPA1,6,5,4506,2074,2432,486.4,345.6666667,1.172613308
NM_001164645,SFTPA1,6,5,4506,2066,2440,488,344.3333333,1.181026137
NM_001164644,SFTPA1,6,5,4506,2180,2326,465.2,363.3333333,1.066972477
NM_005411,SFTPA1,6,5,4506,2221,2285,457,370.1666667,1.028815849
NM_001099692,EIF5AL1,1,0,3837,3837,NA,NA,3837,NA
NM_001098668,SFTPA2,6,5,4557,2207,2350,470,367.8333333,1.064793838
NM_001093770,SFTPA1,6,5,4506,2210,2296,459.2,368.3333333,1.038914027
NM_001278495,NUTM2B,7,6,9532,3299,6233,1038.833333,471.2857143,1.889360412
NM_003019,SFTPD,8,7,11367,1291,10076,1439.428571,161.375,7.804802479
NM_025125,TMEM254,4,3,13907,2064,11843,3947.666667,516,5.737887597
NM_001012973,PLAC9,4,3,12528,677,11851,3950.333333,169.25,17.50516987
NM_001270371,TMEM254,5,4,13907,2160,11747,2936.75,432,5.438425926
NM_001270374,TMEM254,5,4,13308,2467,10841,2710.25,493.4,4.394406161
NM_001270373,TMEM254,5,4,13907,2117,11790,2947.5,423.4,5.569201701
NM_001270372,TMEM254,4,3,13907,2077,11830,3943.333333,519.25,5.695714974
NM_001270370,TMEM254,6,5,13907,2146,11761,2352.2,357.6666667,5.480428705
NM_001270369,TMEM254,5,4,13530,2138,11392,2848,427.6,5.328344247
NM_001270368,TMEM254,4,3,13530,2098,11432,3810.666667,524.5,5.448999047
NM_001270367,TMEM254,4,3,13530,2085,11445,3815,521.25,5.489208633
NM_000429,MAT1A,9,8,17860,3413,14447,1805.875,379.2222222,4.232932904
NM_032372,DYDC2,5,4,11307,1881,9426,2356.5,376.2,5.011164274
NM_001269053,DYDC1,7,6,20655,648,20007,3334.5,92.57142857,30.875
NM_001270041,DYDC2,4,3,11307,1727,9580,3193.333333,431.75,5.547191662
NM_001270042,DYDC2,4,3,23330,1740,21590,7196.666667,435,12.40804598
NM_138812,DYDC1,8,7,20655,772,19883,2840.428571,96.5,25.75518135
NM_001128309,TSPAN14,6,5,68355,5216,63139,12627.8,869.3333333,12.10486963
NM_030927,TSPAN14,9,8,68355,5588,62767,7845.875,620.8888889,11.23246242
NM_014394,GHITM,9,8,14128,2458,11670,1458.75,273.1111111,4.747762408
NM_033100,CDHR1,17,16,24063,6798,17265,1079.0625,399.8823529,2.539717564
NM_207373,C10orf99,3,2,11498,831,10667,5333.5,277,12.83634176
NM_001171971,CDHR1,17,16,24987,2725,22262,1391.375,160.2941176,8.169541284
NM_015613,LRIT1,4,3,9943,2305,7638,2546,576.25,3.313665944
NM_001012722,RGR,6,5,14137,1355,12782,2556.4,225.8333333,9.433210332
NM_001012720,RGR,7,6,14137,1470,12667,2111.166667,210,8.617006803
NM_002921,RGR,7,6,14137,1482,12655,2109.166667,211.7142857,8.539136302
NM_001030015,OPN4,11,10,11904,2416,9488,948.8,219.6363636,3.927152318
NM_001171611,LDB3,8,7,31386,1907,29479,4211.285714,238.375,15.45831148
NM_033282,OPN4,10,9,11904,2382,9522,1058,238.2,3.997481108
NM_001080116,LDB3,8,7,31491,1667,29824,4260.571429,208.375,17.89082184
NM_001080115,LDB3,7,6,31386,1702,29684,4947.333333,243.1428571,17.44065805
NM_006829,ADIRF,3,2,2480,675,1805,902.5,225,2.674074074
NM_024756,MMRN2,7,6,22129,4186,17943,2990.5,598,4.28643096
NM_003087,SNCG,5,4,4731,831,3900,975,166.2,4.693140794
NM_005271,GLUD1,13,12,44819,3489,41330,3444.166667,268.3846154,11.84580109
NM_001146157,FAM25A,3,2,4443,365,4078,2039,121.6666667,11.17260274
NM_001099338,NUTM2A,7,6,9530,3295,6235,1039.166667,470.7142857,1.892261002
NM_001178118,MINPP1,5,4,45630,2221,43409,10852.25,444.2,19.54479964
NM_001178117,MINPP1,3,2,48997,2668,46329,23164.5,889.3333333,17.36469265
NM_004897,MINPP1,5,4,48997,2902,46095,11523.75,580.4,15.88387319
NM_001015880,PAPSS2,13,12,87988,3871,84117,7009.75,297.7692308,21.73004392
NM_004670,PAPSS2,12,11,87988,3855,84133,7648.454545,321.25,21.82438392
NM_001126049,KLLN,1,0,4278,4278,NA,NA,4278,NA
NM_001010939,LIPJ,11,10,20216,1495,18721,1872.1,135.9090909,12.52240803
NM_001198829,LIPF,11,10,14428,1537,12891,1289.1,139.7272727,8.387117762
NM_001198828,LIPF,10,9,14428,1356,13072,1452.444444,135.6,9.640117994
NM_004190,LIPF,10,9,14428,1455,12973,1441.444444,145.5,8.916151203
NM_001198830,LIPF,11,10,14428,1438,12990,1299,130.7272727,9.033379694
NM_001102469,LIPN,9,8,16838,1206,15632,1954,134,12.96185738
NM_001080518,LIPK,9,8,28214,1209,27005,3375.625,134.3333333,22.33664185
NM_020799,STAMBPL1,11,10,43317,2105,41212,4121.2,191.3636364,19.57814727
NM_144590,ANKRD22,6,5,32075,3989,28086,5617.2,664.8333333,7.040862372
NM_000043,FAS,9,8,25256,2698,22558,2819.75,299.7777778,8.361008154
NM_152871,FAS,8,7,25256,2634,22622,3231.714286,329.25,8.588458618
NM_152872,FAS,8,7,25256,2672,22584,3226.285714,334,8.452095808
NM_000235,LIPA,10,9,38472,2773,35699,3966.555556,277.3,12.87378291
NM_001547,IFIT2,2,1,7329,3497,3832,3832,1748.5,1.095796397
NM_001127605,LIPA,10,9,38341,2672,35669,3963.222222,267.2,13.34917665
NM_003956,CH25H,1,0,1379,1379,NA,NA,1379,NA
NM_001288979,LIPA,8,7,38472,2541,35931,5133,317.625,14.14049587
NM_001010987,IFIT1B,2,1,7151,1974,5177,5177,987,2.622593718
NM_012420,IFIT5,2,1,6436,4036,2400,2400,2018,0.594648167
NM_001548,IFIT1,2,1,13943,4381,9562,9562,2190.5,2.182606711
NM_001270930,IFIT1,3,2,13943,4617,9326,4663,1539,2.019926359
NM_001270929,IFIT1,3,2,13943,4491,9452,4726,1497,2.104653752
NM_001270927,IFIT1,3,2,13943,4479,9464,4732,1493,2.112971645
NM_001270928,IFIT1,3,2,13943,4496,9447,4723.5,1498.666667,2.101201068
NM_006413,RPP30,11,10,30240,2364,27876,2787.6,214.9090909,11.79187817
NM_014391,ANKRD1,9,8,9177,1983,7194,899.25,220.3333333,3.627836611
NM_032373,PCGF5,10,9,63731,7214,56517,6279.666667,721.4,7.834349875
NM_001256549,PCGF5,10,9,64182,7156,57026,6336.222222,715.6,7.968977082
NM_005398,PPP1R3C,2,1,4663,2575,2088,2088,1287.5,0.810873786
NM_152429,FGFBP3,2,1,2915,2566,349,349,1283,0.136009353
NM_002729,HHEX,4,3,5729,1763,3966,1322,440.75,2.249574589
NM_000783,CYP26A1,7,6,3996,2126,1870,311.6666667,303.7142857,0.879586077
NM_183374,CYP26C1,6,5,7435,1575,5860,1172,262.5,3.720634921
NM_057157,CYP26A1,7,6,4411,2252,2159,359.8333333,321.7142857,0.958703375
NM_018131,CEP55,9,8,32462,2647,29815,3726.875,294.1111111,11.26369475
NM_001127182,CEP55,9,8,32482,2525,29957,3744.625,280.5555556,11.86415842
NM_006744,RBP4,6,5,9402,935,8467,1693.4,155.8333333,9.055614973
NM_181745,FFAR4,4,3,23409,3657,19752,6584,914.25,5.401148482
NM_001195755,FFAR4,3,2,23409,3608,19801,9900.5,1202.666667,5.48808204
NM_145246,FRA10AC1,14,13,34691,3103,31588,2429.846154,221.6428571,10.17982597
NM_153226,SLC35G1,3,2,8763,2403,6360,3180,801,2.646691635
NM_001134658,SLC35G1,3,2,8763,2406,6357,3178.5,802,2.642144638
NM_022451,NOC3L,21,20,29696,3457,26239,1311.95,164.6190476,7.590107029
NM_001198853,CYP2C8,9,8,32727,1971,30756,3844.5,219,15.6042618
NM_001198855,CYP2C8,10,9,32727,2034,30693,3410.333333,203.4,15.0899705
NM_001198854,CYP2C8,8,7,32727,1807,30920,4417.142857,225.875,17.11123409
NM_000770,CYP2C8,9,8,32727,1933,30794,3849.25,214.7777778,15.9306777
NM_207321,C10orf129,11,10,34731,1724,33007,3300.7,156.7272727,19.14559165
NM_020992,PDLIM1,7,6,53582,1587,51995,8665.833333,226.7142857,32.76307498
NM_015631,TCTN3,14,13,30749,2753,27996,2153.538462,196.6428571,10.16926989
NM_001143973,TCTN3,10,9,30749,2305,28444,3160.444444,230.5,12.34013015
NM_001130446,C10orf131,8,7,30695,1184,29511,4215.857143,148,24.92483108
NM_019084,CCNJ,6,5,17468,4111,13357,2671.4,685.1666667,3.249087813
NM_001134376,CCNJ,6,5,17468,4108,13360,2672,684.6666667,3.252190847
NM_001134375,CCNJ,6,5,17468,4144,13324,2664.8,690.6666667,3.215250965
NM_001258440,BLNK,16,15,79820,1623,78197,5213.133333,101.4375,48.18052988
NM_001258442,BLNK,14,13,79820,1306,78514,6039.538462,93.28571429,60.1179173
NM_001258441,BLNK,15,14,79820,1553,78267,5590.5,103.5333333,50.39729556
NM_013314,BLNK,17,16,79880,1840,78040,4877.5,108.2352941,42.41304348
NM_001114094,BLNK,16,15,79880,1770,78110,5207.333333,110.625,44.1299435
NM_001284322,OPALIN,7,6,16149,3707,12442,2073.666667,529.5714286,3.356352846
NM_001284323,OPALIN,7,6,13943,3442,10501,1750.166667,491.7142857,3.050842533
NM_001284327,OPALIN,6,5,13943,3295,10648,2129.6,549.1666667,3.231562974
NM_001284326,OPALIN,6,5,13943,3402,10541,2108.2,567,3.098471487
NM_001284324,OPALIN,7,6,13943,3335,10608,1768,476.4285714,3.180809595
NM_001284321,OPALIN,5,4,16149,3587,12562,3140.5,717.4,3.502090884
NM_001284320,OPALIN,5,4,16149,3590,12559,3139.75,718,3.498328691
NM_001040102,OPALIN,4,3,16149,3553,12596,4198.666667,888.25,3.545173093
NM_033207,OPALIN,6,5,16149,3624,12525,2505,604,3.456125828
NM_001017520,DNTT,11,10,34238,2048,32190,3219,186.1818182,15.71777344
NM_001040103,OPALIN,7,6,16149,3664,12485,2080.833333,523.4285714,3.407478166
NM_004088,DNTT,11,10,34238,2051,32187,3218.7,186.4545455,15.69332033
NM_015652,C10orf12,1,0,4546,4546,NA,NA,4546,NA
NM_001204300,ARHGAP19,11,10,70502,5404,65098,6509.8,491.2727273,12.04626203
NM_032900,ARHGAP19,12,11,70502,5492,65010,5910,457.6666667,11.83721777
NM_001256423,ARHGAP19,12,11,48519,5475,43044,3913.090909,456.25,7.861917808
NM_005479,FRAT1,1,0,2652,2652,NA,NA,2652,NA
NM_016046,EXOSC1,8,7,10104,1158,8946,1278,144.75,7.725388601
NM_002629,PGAM1,4,3,7173,1724,5449,1816.333333,431,3.160672854
NM_012083,FRAT2,1,0,2206,2206,NA,NA,2206,NA
NM_015179,RRP12,34,33,44671,4460,40211,1218.515152,131.1764706,9.015919283
NM_001287804,ZDHHC16,8,7,11241,1639,9602,1371.714286,204.875,5.858450275
NM_001287803,ZDHHC16,12,11,11241,1979,9262,842,164.9166667,4.680141486
NM_001284337,RRP12,31,30,44671,4157,40514,1350.466667,134.0967742,9.745970652
NM_198046,ZDHHC16,12,11,11241,2033,9208,837.0909091,169.4166667,4.529267093
NM_198045,ZDHHC16,9,8,11241,1607,9634,1204.25,178.5555556,5.99502178
NM_198043,ZDHHC16,10,9,11241,1803,9438,1048.666667,180.3,5.234608985
NM_001145114,RRP12,32,31,44671,4275,40396,1303.096774,133.59375,9.449356725
NM_032327,ZDHHC16,11,10,11241,1852,9389,938.9,168.3636364,5.069654428
NM_198044,ZDHHC16,10,9,11241,1734,9507,1056.333333,173.4,5.482698962
NM_001129981,ANKRD2,8,7,11387,1360,10027,1432.428571,170,7.372794118
NM_001009997,C10orf62,1,0,1243,1243,NA,NA,1243,NA
NM_024954,UBTD1,3,2,72194,1560,70634,35317,520,45.27820513
NM_020349,ANKRD2,9,8,11387,1460,9927,1240.875,162.2222222,6.799315068
NM_021732,AVPI1,3,2,9836,1395,8441,4220.5,465,6.050896057
NM_031484,MARVELD1,2,1,4446,3239,1207,1207,1619.5,0.372645878
NM_178832,MORN4,5,4,19036,2427,16609,4152.25,485.4,6.843428101
NM_018425,PI4K2A,9,8,35746,4194,31552,3944,466,7.523128278
NM_001098831,MORN4,5,4,19605,2338,17267,4316.75,467.6,7.385372113
NM_001174121,ZFYVE27,10,9,23788,2780,21008,2334.222222,278,7.556834532
NM_001174122,ZFYVE27,9,8,23788,2679,21109,2638.625,297.6666667,7.879432624
NM_001174120,ZFYVE27,10,9,23788,2776,21012,2334.666667,277.6,7.569164265
NM_001174119,ZFYVE27,11,10,23788,2939,20849,2084.9,267.1818182,7.093909493
NM_144588,ZFYVE27,13,12,23788,3062,20726,1727.166667,235.5384615,6.768778576
NM_003015,SFRP5,3,2,5250,1886,3364,1682,628.6666667,1.783669141
NM_001002262,ZFYVE27,12,11,23788,3040,20748,1886.181818,253.3333333,6.825
NM_001002261,ZFYVE27,12,11,22432,2871,19561,1778.272727,239.25,6.813305468
NM_014472,R3HCC1L,9,8,110275,3380,106895,13361.875,375.5555556,31.62573964
NM_001256619,R3HCC1L,11,10,110275,3479,106796,10679.6,316.2727273,30.69732682
NM_001256621,R3HCC1L,8,7,110275,1580,108695,15527.85714,197.5,68.7943038
NM_001256620,R3HCC1L,9,8,110275,3384,106891,13361.375,376,31.58717494
NM_138469,R3HCC1L,10,9,110275,3478,106797,11866.33333,347.8,30.70644048
NM_032709,PYROXD2,16,15,31658,2081,29577,1971.8,130.0625,14.21287842
NM_000195,HPS1,20,19,30751,3735,27016,1421.894737,186.75,7.233199465
NM_182639,HPS1,10,9,17803,1629,16174,1797.111111,162.9,9.928790669
NM_020348,CNNM1,11,10,65233,5970,59263,5926.3,542.7272727,9.92680067
NM_145285,NKX2-3,2,1,3592,2098,1494,1494,1049,0.712106768
NM_031212,SLC25A28,4,3,9948,1559,8389,2796.333333,389.75,5.38101347
NM_015960,CUTC,9,8,23938,1377,22561,2820.125,153,16.38416848
NM_078470,COX15,9,8,23920,7698,16222,2027.75,855.3333333,2.107300598
NM_004376,COX15,9,8,23920,6459,17461,2182.625,717.6666667,2.703359653
NM_001308,CPN1,9,8,39579,1765,37814,4726.75,196.1111111,21.42436261
NM_006459,ERLIN1,11,10,35889,3450,32439,3243.9,313.6363636,9.402608696
NM_001100626,ERLIN1,12,11,35969,3207,32762,2978.363636,267.25,10.21577799
NM_001282436,BLOC1S2,6,5,13436,2780,10656,2131.2,463.3333333,3.833093525
NM_001001342,BLOC1S2,4,3,13088,2713,10375,3458.333333,678.25,3.824179875
NM_016112,PKD2L1,16,15,42342,3067,39275,2618.333333,191.6875,12.8056733
NM_001253837,PKD2L1,16,15,42342,3089,39253,2616.866667,193.0625,12.70734866
NM_018294,CWF19L1,14,13,35384,2647,32737,2518.230769,189.0714286,12.36758595
NM_001282437,BLOC1S2,5,4,13436,2790,10646,2661.5,558,3.815770609
NM_173809,BLOC1S2,5,4,13436,2671,10765,2691.25,534.2,4.030325721
NM_001282438,BLOC1S2,5,4,13102,2641,10461,2615.25,528.2,3.960999621
NM_001282439,BLOC1S2,5,4,13436,2668,10768,2692,533.6,4.035982009
NM_005063,SCD,6,5,17818,5474,12344,2468.8,912.3333333,2.255023749
NM_017902,HIF1AN,8,7,18042,6920,11122,1588.857143,865,1.607225434
NM_015490,SEC31B,26,25,33194,4638,28556,1142.24,178.3846154,6.156964209
NM_005004,NDUFB8,5,4,6196,746,5450,1362.5,149.2,7.305630027
NM_001284368,NDUFB8,5,4,6196,655,5541,1385.25,131,8.459541985
NM_001284367,NDUFB8,5,4,6196,956,5240,1310,191.2,5.481171548
NM_000278,PAX2,10,9,84232,4067,80165,8907.222222,406.7,19.71108925
NM_003987,PAX2,11,10,84232,4137,80095,8009.5,376.0909091,19.36064781
NM_003990,PAX2,11,10,84232,4118,80114,8011.4,374.3636364,19.45458961
NM_003989,PAX2,10,9,84232,4048,80184,8909.333333,404.8,19.8083004
NM_003988,PAX2,11,10,84232,4151,80081,8008.1,377.3636364,19.29197784
NM_032112,MRPL43,3,2,1247,1019,228,114,339.6666667,0.223748773
NM_001163813,C10orf2,5,4,6867,1786,5081,1270.25,357.2,2.844904815
NM_001163812,C10orf2,5,4,6867,3670,3197,799.25,734,0.871117166
NM_001203244,SEMA4G,14,13,13089,3230,9859,758.3846154,230.7142857,3.052321981
NM_001243770,FAM178A,1,0,1319,1319,NA,NA,1319,NA
NM_017893,SEMA4G,14,13,13089,4415,8674,667.2307692,315.3571429,1.964665912
NM_018121,FAM178A,20,19,52567,7306,45261,2382.157895,365.3,6.195045168
NM_021830,C10orf2,5,4,6867,3626,3241,810.25,725.2,0.893822394
NM_001136123,FAM178A,19,18,47023,4141,42882,2382.333333,217.9473684,10.35546969
NM_001163814,C10orf2,5,4,6867,1830,5037,1259.25,366,2.752459016
NM_176794,MRPL43,6,5,6140,900,5240,1048,150,5.822222222
NM_176792,MRPL43,5,4,9695,2156,7539,1884.75,431.2,3.496753247
NM_176793,MRPL43,5,4,6140,772,5368,1342,154.4,6.953367876
NM_024895,PDZD7,10,9,13827,2066,11761,1306.777778,206.6,5.692642788
NM_030929,KAZALD1,5,4,4354,2519,1835,458.75,503.8,0.728463676
NM_030971,SFXN3,12,11,10004,3102,6902,627.4545455,258.5,2.225016119
NM_001195263,PDZD7,17,16,23476,4153,19323,1207.6875,244.2941176,4.652781122
NM_001085398,TLX1NB,3,2,41827,1885,39942,19971,628.3333333,21.18938992
NM_006562,LBX1,2,1,1986,1287,699,699,643.5,0.543123543
NM_015448,DPCD,6,5,21323,805,20518,4103.6,134.1666667,25.48819876
NM_013274,POLL,9,8,9390,2740,6650,831.25,304.4444444,2.427007299
NM_001174084,POLL,9,8,9390,2803,6587,823.375,311.4444444,2.349982162
NM_001174085,POLL,9,8,9390,2464,6926,865.75,273.7777778,2.810876623
NM_006993,NPM3,6,5,2090,883,1207,241.4,147.1666667,1.366930917
NM_033163,FGF8,6,5,5874,1042,4832,966.4,173.6666667,4.637236084
NM_033165,FGF8,5,4,5874,921,4953,1238.25,184.2,5.377850163
NM_033164,FGF8,6,5,5874,1009,4865,973,168.1666667,4.82160555
NM_001206389,FGF8,5,4,10241,861,9380,2345,172.2,10.89430894
NM_006119,FGF8,5,4,5874,954,4920,1230,190.8,5.157232704
NM_173195,KCNIP2,8,7,17948,2402,15546,2220.857143,300.25,6.472106578
NM_173194,KCNIP2,8,7,13882,2079,11803,1686.142857,259.875,5.677248677
NM_173193,KCNIP2,8,7,17948,2423,15525,2217.857143,302.875,6.407346265
NM_173192,KCNIP2,9,8,17948,2499,15449,1931.125,277.6666667,6.182072829
NM_173191,KCNIP2,10,9,17948,2554,15394,1710.444444,255.4,6.027407987
NM_173197,KCNIP2,6,5,16281,913,15368,3073.6,152.1666667,16.83242059
NM_014591,KCNIP2,10,9,17948,2599,15349,1705.444444,259.9,5.905732974
NM_001113407,LDB1,11,10,12887,2115,10772,1077.2,192.2727273,5.093144208
NM_024747,HPS6,1,0,2673,2673,NA,NA,2673,NA
NM_003893,LDB1,11,10,7400,2308,5092,509.2,209.8181818,2.206239168
NM_004741,NOLC1,13,12,11697,3950,7747,645.5833333,303.8461538,1.961265823
NM_015062,PPRC1,14,13,17341,5388,11953,919.4615385,384.8571429,2.218448404
NM_001288728,PPRC1,14,13,17341,5281,12060,927.6923077,377.2142857,2.283658398
NM_001288727,PPRC1,12,11,17341,4594,12747,1158.818182,382.8333333,2.774706138
NM_001284388,NOLC1,13,12,11697,3980,7717,643.0833333,306.1538462,1.938944724
NM_001284389,NOLC1,13,12,11697,3953,7744,645.3333333,304.0769231,1.959018467
NM_152310,ELOVL3,4,3,3311,1423,1888,629.3333333,355.75,1.32677442
NM_005029,PITX3,4,3,11287,1392,9895,3298.333333,348,7.108477011
NM_001270965,PSD,18,17,17319,3879,13440,790.5882353,215.5,3.464810518
NM_024040,CUEDC2,9,8,9423,1205,8218,1027.25,133.8888889,6.819917012
NM_024326,FBXL15,4,3,3324,2366,958,319.3333333,591.5,0.40490279
NM_002502,NFKB2,23,22,6935,3149,3786,172.0909091,136.9130435,1.20228644
NM_002779,PSD,17,16,16529,4202,12327,770.4375,247.1764706,2.933603046
NM_001270966,PSD,18,17,17112,3400,13712,806.5882353,188.8888889,4.032941176
NM_001288724,NFKB2,23,22,8421,3439,4982,226.4545455,149.5217391,1.448676941
NM_001261403,NFKB2,22,21,6935,3239,3696,176,147.2272727,1.14109293
NM_001077494,NFKB2,23,22,7953,3148,4805,218.4090909,136.8695652,1.526365947
NM_024886,C10orf95,2,1,1708,1471,237,237,735.5,0.161114888
NM_005736,ACTR1A,11,10,23528,2884,20644,2064.4,262.1818182,7.158113731
NM_024789,TMEM180,10,9,15634,2844,12790,1421.111111,284.4,4.49718706
NM_030912,TRIM8,6,5,13826,2750,11076,2215.2,458.3333333,4.027636364
NM_001083913,WBP1L,4,3,72296,4113,68183,22727.66667,1028.25,16.57743739
NM_017787,WBP1L,4,3,40135,4226,35909,11969.66667,1056.5,8.497160435
NM_178858,SFXN2,12,11,24650,2574,22076,2006.909091,214.5,8.576534577
NM_020682,AS3MT,11,10,32447,2477,29970,2997,225.1818182,12.09931369
NM_001136200,C10orf32,5,4,10753,2440,8313,2078.25,488,3.406967213
NM_199077,CNNM2,2,1,9302,2060,7242,7242,1030,3.515533981
NM_144591,C10orf32,6,5,10753,1644,9109,1821.8,274,5.540754258
NM_032154,PCGF6,7,6,48340,2012,46328,7721.333333,287.4285714,23.02584493
NM_001011663,PCGF6,10,9,48340,2240,46100,5122.222222,224,20.58035714
NM_032727,INA,3,2,13190,3234,9956,4978,1078,3.078540507
NM_001143909,RPEL1,1,0,2131,2131,NA,NA,2131,NA
NM_015916,CALHM2,4,3,5621,1953,3668,1222.666667,488.25,1.878136201
NM_006951,TAF5,11,10,21100,3279,17821,1782.1,298.0909091,5.434888686
NM_014976,PDCD11,36,35,49609,6452,43157,1233.057143,179.2222222,6.688933664
NM_032747,USMG5,5,4,7463,610,6853,1713.25,122,11.23442623
NM_001206427,USMG5,5,4,7463,701,6762,1690.5,140.2,9.646219686
NM_001206426,USMG5,4,3,7463,413,7050,2350,103.25,17.07021792
NM_001129742,CALHM3,3,2,6438,1655,4783,2391.5,551.6666667,2.890030211
NM_001001412,CALHM1,2,1,5506,3058,2448,2448,1529,0.800523218
NM_004210,NEURL1,6,5,98576,4321,94255,18851,720.1666667,21.81323768
NM_145247,SFR1,4,3,4329,1507,2822,940.6666667,376.75,1.872594559
NM_000494,COL17A1,56,55,54594,5666,48928,889.6,101.1785714,8.635368867
NM_001002759,SFR1,4,3,4216,1436,2780,926.6666667,359,1.935933148
NM_001191002,GSTO1,5,4,12756,910,11846,2961.5,182,13.01758242
NM_001191003,GSTO1,6,5,13272,1063,12209,2441.8,177.1666667,11.48541863
NM_004832,GSTO1,6,5,12756,1010,11746,2349.2,168.3333333,11.62970297
NM_001272012,ITPRIP,2,1,19298,6499,12799,12799,3249.5,1.969379905
NM_001272013,ITPRIP,2,1,28799,6619,22180,22180,3309.5,3.350959359
NM_033397,ITPRIP,3,2,24211,6812,17399,8699.5,2270.666667,2.554169113
NM_001008541,MXI1,5,4,77136,3052,74084,18521,610.4,24.27391874
NM_130439,MXI1,6,5,79762,3476,76286,15257.2,579.3333333,21.94649022
NM_005871,SMNDC1,6,5,11911,2035,9876,1975.2,339.1666667,4.853071253
NM_005962,MXI1,6,5,61363,3278,58085,11617,546.3333333,17.71964613
NM_004419,DUSP5,4,3,13679,2532,11147,3715.666667,633,4.402448657
NM_001195306,BBIP1,4,3,20208,2061,18147,6049,515.25,8.804949054
NM_001195305,BBIP1,4,3,20638,2215,18423,6141,553.75,8.31738149
NM_001195304,BBIP1,5,4,20638,2373,18265,4566.25,474.6,7.697008007
NM_001199492,PDCD4,12,11,28213,3584,24629,2239,298.6666667,6.871930804
NM_014456,PDCD4,12,11,28213,3626,24587,2235.181818,302.1666667,6.780750138
NM_145341,PDCD4,13,12,28213,3711,24502,2041.833333,285.4615385,6.60253301
NM_001243783,BBIP1,3,2,20638,2121,18517,9258.5,707,8.730315889
NM_001195307,BBIP1,3,2,20638,2139,18499,9249.5,713,8.648433848
NM_001269039,SHOC2,7,6,49544,3701,45843,7640.5,528.7142857,12.38665226
NM_000681,ADRA2A,1,0,3874,3874,NA,NA,3874,NA
NM_020918,GPAM,22,21,33917,6405,27512,1310.095238,291.1363636,4.295394223
NM_001244949,GPAM,22,21,33917,6409,27508,1309.904762,291.3181818,4.292089249
NM_058222,TECTB,10,9,21380,2801,18579,2064.333333,280.1,6.632988218
NM_022494,ZDHHC6,11,10,16616,2181,14435,1443.5,198.2727273,6.618523613
NM_006175,NRAP,41,40,75248,5468,69780,1744.5,133.3658537,12.76152158
NM_198060,NRAP,42,41,75248,5574,69674,1699.365854,132.7142857,12.4998206
NM_001261463,NRAP,42,41,75248,5577,69671,1699.292683,132.7857143,12.49255872
NM_024889,PLEKHS1,12,11,30981,3262,27719,2519.909091,271.8333333,8.497547517
NM_001193435,PLEKHS1,11,10,30981,3259,27722,2772.2,296.2727273,8.506290273
NM_001193434,PLEKHS1,13,12,30981,3457,27524,2293.666667,265.9230769,7.961816604
NM_182601,PLEKHS1,12,11,12913,2062,10851,986.4545455,171.8333333,5.262366634
NM_198514,NHLRC2,11,10,57876,6403,51473,5147.3,582.0909091,8.038888021
NM_000684,ADRB1,1,0,2863,2863,NA,NA,2863,NA
NM_198795,TDRD1,26,25,53036,4536,48500,1940,174.4615385,10.69223986
NM_018017,C10orf118,16,15,52392,6293,46099,3073.266667,393.3125,7.325440966
NM_001272046,VWA2,14,13,55248,5871,49377,3798.230769,419.3571429,8.410321921
NM_020940,FAM160B1,17,16,42973,5825,37148,2321.75,342.6470588,6.377339056
NM_139169,TRUB1,8,7,39489,3420,36069,5152.714286,427.5,10.54649123
NM_000936,PNLIP,13,12,21941,1511,20430,1702.5,116.2307692,13.52084712
NM_144661,C10orf82,5,4,6276,999,5277,1319.25,199.8,5.282282282
NM_005396,PNLIPRP2,13,12,24191,1494,22697,1891.416667,114.9230769,15.19210174
NM_199131,VAX1,4,3,9782,4498,5284,1761.333333,1124.5,1.174744331
NM_001112704,VAX1,3,2,5013,1971,3042,1521,657,1.543378995
NM_181840,KCNK18,3,2,12812,1158,11654,5827,386,10.06390328
NM_173791,PDZD8,5,4,92333,3842,88491,22122.75,768.4,23.03253514
NM_001165924,EMX2,2,1,7103,2713,4390,4390,1356.5,1.618134906
NM_004098,EMX2,3,2,7103,2899,4204,2102,966.3333333,1.450155226
NM_001134672,FAM204A,8,7,33269,2573,30696,4385.142857,321.625,11.93004275
NM_022063,FAM204A,9,8,33269,2775,30494,3811.75,308.3333333,10.98882883
NM_004248,PRLHR,2,1,2246,1982,264,264,991,0.133198789
NM_199461,NANOS1,1,0,4628,4628,NA,NA,4628,NA
NM_003750,EIF3A,22,21,45795,5327,40468,1927.047619,242.1363636,7.596771166
NM_006793,PRDX3,7,6,11164,1630,9534,1589,232.8571429,5.849079755
NM_014098,PRDX3,7,6,11164,1576,9588,1598,225.1428571,6.083756345
NM_213649,SFXN4,14,13,24781,1402,23379,1798.384615,100.1428571,16.67546362
NM_207009,FAM45A,9,8,33614,2191,31423,3927.875,243.4444444,14.34185304
NM_001005339,RGS10,5,4,42885,909,41976,10494,181.8,46.17821782
NM_002925,RGS10,5,4,36708,858,35850,8962.5,171.6,41.78321678
NM_001033925,TIAL1,12,11,23565,3954,19611,1782.818182,329.5,4.959787557
NM_003252,TIAL1,12,11,23565,3903,19662,1787.454545,325.25,5.037663336
NM_004281,BAG3,4,3,26449,2573,23876,7958.666667,643.25,9.279440342
NM_024834,MCMBP,16,15,43481,4314,39167,2611.133333,269.625,9.07904497
NM_001243194,INPP5F,6,5,9895,3172,6723,1344.6,528.6666667,2.119482976
NM_001256379,MCMBP,16,15,44226,4118,40108,2673.866667,257.375,9.739679456
NM_001256378,MCMBP,16,15,43481,4308,39173,2611.533333,269.25,9.093082637
NM_007190,SEC23IP,19,18,52087,7325,44762,2486.777778,385.5263158,6.110853242
NM_018117,WDR11,29,28,58353,4763,53590,1913.928571,164.2413793,11.2513122
NM_144587,BTBD16,16,15,66857,1864,64993,4332.866667,116.5,34.86748927
NM_001099667,ARMS2,2,1,2691,810,1881,1881,405,2.322222222
NM_021622,PLEKHA1,12,11,40054,3734,36320,3301.818182,311.1666667,9.726834494
NM_001195608,PLEKHA1,14,13,46288,4000,42288,3252.923077,285.7142857,10.572
NM_001001974,PLEKHA1,12,11,57779,3893,53886,4898.727273,324.4166667,13.84176727
NM_001010912,C10orf120,3,2,2115,1067,1048,524,355.6666667,0.982193065
NM_001204364,FAM24B,4,3,30549,746,29803,9934.333333,186.5,39.95040214
NM_152644,FAM24B,4,3,30549,776,29773,9924.333333,194,38.36726804
NM_022034,CUZD1,9,8,14022,2288,11734,1466.75,254.2222222,5.128496503
NM_024942,C10orf88,6,5,23502,3093,20409,4081.8,515.5,6.598448109
NM_001029888,FAM24A,3,2,2412,599,1813,906.5,199.6666667,3.026711185
NM_001271840,IKZF5,5,4,17883,4549,13334,3333.5,909.8,2.931193669
NM_153336,PSTK,7,6,10353,1713,8640,1440,244.7142857,5.043782837
NM_005519,HMX2,2,1,2552,1630,922,922,815,0.565644172
NM_001105574,HMX3,2,1,1682,1076,606,606,538,0.563197026
NM_001007793,BUB3,8,7,11128,1545,9583,1369,193.125,6.202588997
NM_004725,BUB3,8,7,11128,2772,8356,1193.714286,346.5,3.014430014
NM_001146340,NKX1-2,2,1,2554,973,1581,1581,486.5,1.624871531
NM_212554,METTL10,7,6,33035,2586,30449,5074.833333,369.4285714,11.7745553
NM_032182,FAM175B,9,8,34887,3001,31886,3985.75,333.4444444,10.62512496
NM_022802,CTBP2,9,8,40037,4761,35276,4409.5,529,7.40936778
NM_017580,ZRANB1,9,8,45315,4951,40364,5045.5,550.1111111,8.152696425
NM_001128202,TEX36,4,3,27452,926,26526,8842,231.5,28.64578834
NM_015608,EDRF1,24,23,44630,4603,40027,1740.304348,191.7916667,8.695850532
NM_078469,BCCIP,7,6,19274,2357,16917,2819.5,336.7142857,7.177344081
NM_078468,BCCIP,7,6,13022,1256,11766,1961,179.4285714,9.367834395
NM_147191,MMP21,7,6,9365,1921,7444,1240.666667,274.4285714,3.87506507
NM_000375,UROS,10,9,34692,1364,33328,3703.111111,136.4,24.4340176
NM_001202438,EDRF1,25,24,44630,4706,39924,1663.5,188.24,8.483637909
NM_001030013,NPS,3,2,3324,325,2999,1499.5,108.3333333,9.227692308
NM_207426,FOXI2,2,1,3914,3180,734,734,1590,0.23081761
NM_152311,CLRN3,3,2,15099,1146,13953,6976.5,382,12.17539267
NM_130435,PTPRE,18,17,38353,5041,33312,1959.529412,280.0555556,6.608212656
NM_002417,MKI67,15,14,29545,12510,17035,1216.785714,834,1.361710631
NM_001145966,MKI67,14,13,29545,11429,18116,1393.538462,816.3571429,1.585090559
NM_006541,GLRX3,11,10,43295,1341,41954,4195.4,121.9090909,31.28560776
NM_001199868,GLRX3,12,11,44009,1364,42645,3876.818182,113.6666667,31.26466276
NM_018461,PPP2R2D,7,6,22095,1857,20238,3373,265.2857143,10.89822294
NM_004052,BNIP3,6,5,14233,1540,12693,2538.6,256.6666667,8.242207792
NM_006426,DPYSL4,14,13,18868,2733,16135,1241.153846,195.2142857,5.903768752
NM_001143759,LRRC27,9,8,21289,1864,19425,2428.125,207.1111111,10.42113734
NM_001143758,LRRC27,8,7,21289,1792,19497,2785.285714,224,10.88002232
NM_001143757,LRRC27,11,10,49271,8216,41055,4105.5,746.9090909,4.996957157
NM_030626,LRRC27,11,10,49398,8063,41335,4133.5,733,5.126503783
NM_173541,C10orf91,3,2,3113,741,2372,1186,247,3.201079622
NM_177400,NKX6-2,3,2,1219,1022,197,98.5,340.6666667,0.192759295
NM_001083909,GPR123,7,6,43772,4290,39482,6580.333333,612.8571429,9.203263403
NM_001164489,ADAM8,22,21,14489,3156,11333,539.6666667,143.4545455,3.590937896
NM_001164490,ADAM8,20,19,14489,3048,11441,602.1578947,152.4,3.753608924
NM_003577,UTF1,2,1,1286,1159,127,127,579.5,0.109577222
NM_006659,TUBGCP2,18,17,30528,4236,26292,1546.588235,235.3333333,6.206798867
NM_145806,ZNF511,6,5,4245,1086,3159,631.8,181,2.908839779
NM_014468,VENTX,3,2,4028,2415,1613,806.5,805,0.667908903
NM_001256618,TUBGCP2,17,16,30528,4046,26482,1655.125,238,6.545229857
NM_001109,ADAM8,23,22,14489,3324,11165,507.5,144.5217391,3.358904934
NM_001256617,TUBGCP2,19,18,30528,4321,26207,1455.944444,227.4210526,6.065031243
NM_015722,CALY,6,5,11549,989,10560,2112,164.8333333,10.67745197
NM_001098483,FUOM,6,5,2736,568,2168,433.6,94.66666667,3.816901408
NM_001145201,PRAP1,5,4,5345,755,4590,1147.5,151,6.079470199
NM_198472,FUOM,6,5,2873,774,2099,419.8,129,2.711886305
NM_138384,MTG1,11,10,26555,1625,24930,2493,147.7272727,15.34153846
NM_145202,PRAP1,5,4,5345,782,4563,1140.75,156.4,5.835038363
NM_001012508,SPRN,2,1,3953,3175,778,778,1587.5,0.24503937
NM_207128,PAOX,6,5,12461,1705,10756,2151.2,284.1666667,6.308504399
NM_004092,ECHS1,8,7,10923,1337,9586,1369.428571,167.125,7.169783096
NM_152911,PAOX,7,6,12461,1864,10597,1766.166667,266.2857143,5.685085837
NM_207127,PAOX,5,4,12461,1451,11010,2752.5,290.2,7.587870434
NM_130784,SYCE1,14,13,15474,1389,14085,1083.461538,99.21428571,10.14038877
NM_000773,CYP2E1,9,8,11755,1676,10079,1259.875,186.2222222,6.01372315
NM_001143764,SYCE1,13,12,10792,1322,9470,789.1666667,101.6923077,7.163388805
NM_001143763,SYCE1,13,12,11736,1465,10271,855.9166667,112.6923077,7.010921502
NM_012147,DUX2,2,1,4685,1382,3303,3303,691,2.390014472
NM_012147,DUX2,2,1,4674,1382,3292,3292,691,2.382054993
NM_001127389,DUX4L5,2,1,4685,1382,3303,3303,691,2.390014472
NM_001127389,DUX4L5,2,1,4674,1382,3292,3292,691,2.382054993
NM_001127389,DUX4L5,2,1,4674,1382,3292,3292,691,2.382054993
NM_001127388,DUX4L6,2,1,4685,1382,3303,3303,691,2.390014472
NM_001127388,DUX4L6,2,1,4674,1382,3292,3292,691,2.382054993
NM_001127388,DUX4L6,2,1,4674,1382,3292,3292,691,2.382054993
NM_001127386,DUX4L2,2,1,4674,1382,3292,3292,691,2.382054993
NM_001127386,DUX4L2,2,1,4674,1382,3292,3292,691,2.382054993
NM_001127386,DUX4L2,2,1,4685,1382,3303,3303,691,2.390014472
NM_033178,DUX4,2,1,4674,1382,3292,3292,691,2.382054993
NM_033178,DUX4,2,1,4674,1382,3292,3292,691,2.382054993
NM_001278056,LOC100653046,2,1,4685,1382,3303,3303,691,2.390014472
NM_001278056,LOC100653046,2,1,4674,1382,3292,3292,691,2.382054993
NM_001278056,LOC100653046,2,1,4674,1382,3292,3292,691,2.382054993
NM_001127387,DUX4L7,2,1,4674,1382,3292,3292,691,2.382054993
NM_001127387,DUX4L7,2,1,4674,1382,3292,3292,691,2.382054993
NM_001127387,DUX4L7,2,1,4685,1382,3303,3303,691,2.390014472
NM_033178,DUX4,2,1,4685,1382,3303,3303,691,2.390014472
NM_001080998,FRG2B,4,3,1698,894,804,268,223.5,0.899328859
NM_001164467,DUX4L3,2,1,4674,1382,3292,3292,691,2.382054993
NM_001164467,DUX4L3,2,1,4674,1382,3292,3292,691,2.382054993
NM_001164467,DUX4L3,2,1,4685,1382,3303,3303,691,2.390014472
NM_138342,GLB1L2,20,19,44452,3175,41277,2172.473684,158.75,13.00062992
NM_080661,GLYATL1,7,6,13823,2102,11721,1953.5,300.2857143,5.576117983
NM_014267,C11orf58,5,4,19755,3985,15770,3942.5,797,3.957340025
NM_001220496,GLYATL1,7,6,13823,2199,11624,1937.333333,314.1428571,5.286039109
NM_001220494,GLYATL1,8,7,29443,2372,27071,3867.285714,296.5,11.41273187
NM_001142700,DLG2,20,19,818269,7100,811169,42693.10526,355,114.2491549
NM_152432,ARHGAP42,24,23,303251,4776,298475,12977.17391,199,62.49476549
NM_001008781,FAT3,25,24,544375,19072,525303,21887.625,762.88,27.54315227
NM_020693,DSCAML1,33,32,369489,6932,362557,11329.90625,210.0606061,52.30193306
NM_032564,DGAT2,8,7,32805,2462,30343,4334.714286,307.75,12.3245329
NM_016952,CDON,20,19,106476,8067,98409,5179.421053,403.35,12.19895872
NM_001243597,CDON,20,19,106476,8136,98340,5175.789474,406.8,12.08702065
NM_001206769,DLG2,22,21,862328,7751,854577,40694.14286,352.3181818,110.2537737
NM_001364,DLG2,23,22,1468411,7744,1460667,66393.95455,336.6956522,188.619189
NM_001253891,DGAT2,7,6,32805,2332,30473,5078.833333,333.1428571,13.06732419
NM_001142699,DLG2,28,27,2172260,8073,2164187,80155.07407,288.3214286,268.0771708
NM_020896,OSBPL5,22,21,78238,3909,74329,3539.47619,177.6818182,19.01483755
NM_145638,OSBPL5,21,20,78238,3697,74541,3727.05,176.047619,20.16256424
NM_001144063,OSBPL5,21,20,78238,3704,74534,3726.7,176.3809524,20.12257019
NM_176875,CCKBR,5,4,12455,2188,10267,2566.75,437.6,4.692413163
NM_175733,SYT9,7,6,217097,3965,213132,35522,566.4285714,53.75334174
NM_198516,GALNT18,11,10,351142,2526,348616,34861.6,229.6363636,138.0110847
NM_001025389,AMPD3,15,14,52462,4349,48113,3436.642857,289.9333333,11.06300299
NM_001025390,AMPD3,15,14,51647,4488,47159,3368.5,299.2,10.50779857
NM_006391,IPO7,25,24,63507,6217,57290,2387.083333,248.68,9.215055493
NM_001172430,AMPD3,15,14,46450,4313,42137,3009.785714,287.5333333,9.769765824
NM_001172431,AMPD3,14,13,57260,4008,53252,4096.307692,286.2857143,13.28642715
NM_000480,AMPD3,15,14,56904,4386,52518,3751.285714,292.4,11.97400821
NM_000922,PDE3B,16,15,228337,6106,222231,14815.4,381.625,36.39551261
NM_001288714,NELL1,19,18,906134,3115,903019,50167.72222,163.9473684,289.89374
NM_145117,NAV2,38,37,408268,11032,397236,10736.10811,290.3157895,36.00761421
NM_012139,SERGEF,11,10,225115,1576,223539,22353.9,143.2727273,141.839467
NM_001244963,NAV2,40,39,408268,11211,397057,10180.94872,280.275,35.41673357
NM_001111018,NAV2,38,37,770878,10708,760170,20545.13514,281.7894737,70.99084796
NM_182964,NAV2,38,37,408268,11041,397227,10735.86486,290.5526316,35.97744769
NM_006157,NELL1,20,19,906134,3287,902847,47518.26316,164.35,274.6720414
NM_001288713,NELL1,21,20,906134,3372,902762,45138.1,160.5714286,267.723013
NM_201551,NELL1,19,18,906134,3145,902989,50166.05556,165.5263158,287.1189189
NM_001145399,MPPED2,7,6,201892,5700,196192,32698.66667,814.2857143,34.41964912
NM_001113528,METTL15,7,6,225258,4352,220906,36817.66667,621.7142857,50.75965074
NM_144981,IMMP1L,7,6,77222,802,76420,12736.66667,114.5714286,95.28678304
NM_152636,METTL15,8,7,225258,4424,220834,31547.71429,553,49.91726944
NM_020929,LRRC4C,5,4,1345437,2629,1342808,335702,525.8,510.7675922
NM_001258419,LRRC4C,7,6,1345437,2800,1342637,223772.8333,400,479.5132143
NM_001101802,PHF21A,18,17,192117,7334,184783,10869.58824,407.4444444,25.19539133
NM_001242832,ARFGAP2,15,14,12829,2953,9876,705.4285714,196.8666667,3.34439553
NM_032389,ARFGAP2,16,15,12829,3038,9791,652.7333333,189.875,3.222843976
NM_016621,PHF21A,18,17,192117,7196,184921,10877.70588,399.7777778,25.69774875
NM_001003678,C11orf49,9,8,227693,1235,226458,28307.25,137.2222222,183.3668016
NM_006819,STIP1,14,13,18435,2215,16220,1247.692308,158.2142857,7.322799097
NM_001282652,STIP1,14,13,19278,2762,16516,1270.461538,197.2857143,5.979724837
NM_001282653,STIP1,14,13,18435,2143,16292,1253.230769,153.0714286,7.602426505
NM_153266,TMEM151A,2,1,4764,2532,2232,2232,1266,0.881516588
NM_001146209,PDE2A,32,31,92926,4215,88711,2861.645161,131.71875,21.04650059
NM_002869,RAB6A,8,7,85520,3416,82104,11729.14286,427,24.03512881
NM_002335,LRP5,23,22,136637,5151,131486,5976.636364,223.9565217,25.52630557
NM_198896,RAB6A,8,7,85520,3416,82104,11729.14286,427,24.03512881
NM_138565,CTTN,17,16,38080,3187,34893,2180.8125,187.4705882,10.94854095
NM_002599,PDE2A,31,30,98315,4347,93968,3132.266667,140.2258065,21.61674718
NM_001243719,RAB6A,8,7,84457,2871,81586,11655.14286,358.875,28.41727621
NM_001243718,RAB6A,5,4,85520,3101,82419,20604.75,620.2,26.57820058
NM_001243784,PDE2A,31,30,66322,4226,62096,2069.866667,136.3225806,14.69380028
NM_001143839,PDE2A,30,29,66322,4163,62159,2143.413793,138.7666667,14.93129954
NM_001184740,CTTN,19,18,38080,2306,35774,1987.444444,121.3684211,15.51344319
NM_005231,CTTN,18,17,38080,3299,34781,2045.941176,183.2777778,10.54289179
NM_033547,INTS4,23,22,115953,3172,112781,5126.409091,137.9130435,35.55517024
NM_001098816,TENM4,34,33,787369,13582,773787,23448.09091,399.4705882,56.97150641
NM_022918,TMEM135,15,14,290992,9095,281897,20135.5,606.3333333,30.99472237
NM_001168724,TMEM135,14,13,290992,9028,281964,21689.53846,644.8571429,31.23216659
NM_003797,EED,12,11,33981,2022,31959,2905.363636,168.5,15.80563798
NM_016931,NOX4,18,17,167133,4396,162737,9572.764706,244.2222222,37.01933576
NM_001143837,NOX4,21,20,265259,4624,260635,13031.75,220.1904762,56.36570069
NM_001143836,NOX4,17,16,167133,4275,162858,10178.625,251.4705882,38.0954386
NM_152991,EED,11,10,33981,2428,31553,3155.3,220.7272727,12.99546952
NM_001243271,CNTN5,21,20,1288729,4488,1284241,64212.05,213.7142857,286.1499554
NM_001243270,CNTN5,24,23,1337912,6357,1331555,57893.69565,264.875,209.4627969
NM_014361,CNTN5,25,24,1337912,6497,1331415,55475.625,259.88,204.9276589
NM_175566,CNTN5,22,21,802742,5838,796904,37947.80952,265.3636364,136.502912
NM_025208,PDGFD,7,6,257115,4000,253115,42185.83333,571.4285714,63.27875
NM_033135,PDGFD,7,6,257115,3982,253133,42188.83333,568.8571429,63.5693119
NM_000019,ACAT1,12,11,26635,2146,24489,2226.272727,178.8333333,11.41146319
NM_198498,C11orf53,4,3,30267,1055,29212,9737.333333,263.75,27.68909953
NM_001098517,CADM1,9,8,330898,4232,326666,40833.25,470.2222222,77.18950851
NM_014333,CADM1,10,9,330898,4317,326581,36286.77778,431.7,75.64998842
NM_001260496,RDX,8,7,101153,1557,99596,14228,194.625,63.96660244
NM_002906,RDX,14,13,67273,4504,62769,4828.384615,321.7142857,13.93627886
NM_001260494,RDX,12,11,67273,4131,63142,5740.181818,344.25,15.28491891
NM_001260493,RDX,16,15,121834,2527,119307,7953.8,157.9375,47.21290067
NM_001260492,RDX,16,15,101153,2777,98376,6558.4,173.5625,35.42527908
NM_001260495,RDX,9,8,101153,1823,99330,12416.25,202.5555556,54.48710916
NM_002855,PVRL1,6,5,67734,5486,62248,12449.6,914.3333333,11.34670069
NM_001282470,GRIK4,20,19,424370,5775,418595,22031.31579,288.75,72.48398268
NM_001282473,GRIK4,18,17,398494,2979,395515,23265.58824,165.5,132.7677073
NM_032873,UBASH3B,14,13,158791,6917,151874,11682.61538,494.0714286,21.9566286
NM_014619,GRIK4,21,20,477050,5726,471324,23566.2,272.6666667,82.31295844
NM_203285,PVRL1,8,7,90629,1557,89072,12724.57143,194.625,57.20745022
NM_001144759,PHLDB1,21,20,50444,5326,45118,2255.9,253.6190476,8.471273
NM_001144758,PHLDB1,23,22,50444,5502,44942,2042.818182,239.2173913,8.168302435
NM_015157,PHLDB1,24,23,51537,5726,45811,1991.782609,238.5833333,8.000523926
NM_001142685,ARHGAP32,22,21,227140,10133,217007,10333.66667,460.5909091,21.41586894
NM_001012393,OPCML,8,7,1117530,6421,1111109,158729.8571,802.625,173.042984
NM_001144058,NTM,8,7,426006,3416,422590,60370,427,123.7090164
NM_016522,NTM,7,6,426006,3382,422624,70437.33333,483.1428571,124.9627439
NM_001144059,NTM,6,5,404251,1968,402283,80456.6,328,204.4120935
NM_001048209,NTM,8,7,966347,3050,963297,137613.8571,381.25,315.835082
NM_021008,DEAF1,12,11,51517,2728,48789,4435.363636,227.3333333,17.88453079
NM_001282218,BRSK2,20,19,52248,4147,48101,2531.631579,207.35,11.59898722
NM_053005,MOB2,6,5,294818,1458,293360,58672,243,201.2071331
NM_001256630,BRSK2,20,19,51539,4540,46999,2473.631579,227,10.35220264
NM_001256629,BRSK2,20,19,72792,4160,68632,3612.210526,208,16.49807692
NM_001256627,BRSK2,20,19,72792,4583,68209,3589.947368,229.15,14.88304604
NM_019009,TOLLIP,6,5,35296,3666,31630,6326,611,8.627932351
NM_003957,BRSK2,20,19,72792,4113,68679,3614.684211,205.65,16.69803063
NM_000218,KCNQ1,16,15,404121,3262,400859,26723.93333,203.875,122.8874923
NM_181798,KCNQ1,16,15,387658,3029,384629,25641.93333,189.3125,126.9821723
NM_016320,NUP98,33,32,122784,7006,115778,3618.0625,212.3030303,16.52554953
NM_003156,STIM1,12,11,237509,4050,233459,21223.54545,337.5,57.64419753
NM_001277961,STIM1,12,11,237509,4368,233141,21194.63636,364,53.37477106
NM_001277962,STIM1,13,12,237509,4088,233421,19451.75,314.4615385,57.09907045
NM_139132,NUP98,32,31,122784,6783,116001,3741.967742,211.96875,17.1017249
NM_139131,NUP98,20,19,85965,3918,82047,4318.263158,195.9,20.94104135
NM_005387,NUP98,20,19,85965,3969,81996,4315.578947,198.45,20.65910809
NM_004314,ART1,5,4,19287,1317,17970,4492.5,263.4,13.64464692
NM_030774,OR51E2,2,1,17677,2787,14890,14890,1393.5,5.342662361
NM_001005567,OR51B5,5,4,163140,1459,161681,40420.25,291.8,110.8163125
NM_001003819,TRIM6-TRIM34,14,13,47762,3492,44270,3405.384615,249.4285714,12.67754868
NM_145689,APBB1,14,13,24350,2692,21658,1666,192.2857143,8.045319465
NM_001164,APBB1,14,13,23989,2698,21291,1637.769231,192.7142857,7.891401038
NM_001257323,APBB1,13,12,9811,2018,7793,649.4166667,155.2307692,3.861744301
NM_001257326,APBB1,13,12,10295,2120,8175,681.25,163.0769231,3.856132075
NM_001257325,APBB1,13,12,9569,1920,7649,637.4166667,147.6923077,3.983854167
NM_001257321,APBB1,14,13,10295,2161,8134,625.6923077,154.3571429,3.763998149
NM_001257320,APBB1,13,12,10541,2112,8429,702.4166667,162.4615385,3.991003788
NM_001257319,APBB1,13,12,9811,2024,7787,648.9166667,155.6923077,3.847332016
NM_144666,DNHD1,43,42,74730,14907,59823,1424.357143,346.6744186,4.013081103
NM_176822,NLRP14,12,11,51059,3835,47224,4293.090909,319.5833333,12.31395046
NM_002315,LMO1,4,3,39576,1303,38273,12757.66667,325.75,29.37298542
NM_003320,TUB,13,12,67476,6428,61048,5087.333333,494.4615385,9.497199751
NM_001270428,LMO1,4,3,44333,971,43362,14454,242.75,44.65705458
NM_003621,PPFIBP2,24,23,140002,3595,136407,5930.73913,149.7916667,37.94353268
NM_177972,TUB,12,11,24747,6170,18577,1688.818182,514.1666667,3.010858995
NM_005418,ST5,23,22,217601,4567,213034,9683.363636,198.5652174,46.64637618
NM_213618,ST5,20,19,117327,4364,112963,5945.421053,218.2,25.88519707
NM_015213,DENND5A,23,22,126500,4987,121513,5523.318182,216.826087,24.36595147
NM_001243254,DENND5A,23,22,126500,4953,121547,5524.863636,215.3478261,24.54007672
NM_014818,TRIM66,20,19,46801,9773,37028,1948.842105,488.65,3.788805894
NM_015012,TMEM41B,7,6,34116,3980,30136,5022.666667,568.5714286,7.571859296
NM_020974,SCUBE2,22,21,72105,4558,67547,3216.52381,207.1818182,14.81943835
NM_139157,ST5,19,18,117985,3031,114954,6386.333333,159.5263158,37.926097
NM_001170690,SCUBE2,18,17,72105,4062,68043,4002.529412,225.6666667,16.75110783
NM_001289061,STK33,13,12,202144,2628,199516,16626.33333,202.1538462,75.91933029
NM_030906,STK33,14,13,202144,2778,199366,15335.84615,198.4285714,71.76601872
NM_001289058,STK33,14,13,202425,2364,200061,15389.30769,168.8571429,84.62817259
NM_001289059,STK33,11,10,202425,2068,200357,20035.7,188,96.8844294
NM_030962,SBF2,40,39,515542,7479,508063,13027.25641,186.975,67.93194277
NM_015055,SWAP70,12,11,88881,4859,84022,7638.363636,404.9166667,17.2920354
NM_001100163,MRVI1,21,20,120899,6334,114565,5728.25,301.6190476,18.0873066
NM_021211,ZBED5,3,2,5371,2744,2627,1313.5,914.6666667,0.957361516
NM_130385,MRVI1,21,20,120899,6387,114512,5725.6,304.1428571,17.92891811
NM_001206881,MRVI1,19,18,120899,6174,114725,6373.611111,324.9473684,18.58195659
NM_001100167,MRVI1,21,20,120485,6051,114434,5721.7,288.1428571,18.91158486
NM_001098579,MRVI1,20,19,79212,6055,73157,3850.368421,302.75,12.08208092
NM_001143667,ZBED5,3,2,5371,2712,2659,1329.5,904,0.980457227
NM_001206880,MRVI1,20,19,120899,5768,115131,6059.526316,288.4,19.9602982
NM_001282668,MICAL2,5,4,97795,1123,96672,24168,224.6,86.08370436
NM_032867,MICALCL,9,8,72246,3053,69193,8649.125,339.2222222,22.66393711
NM_014632,MICAL2,28,27,153216,3954,149262,5528.222222,141.2142857,37.74962064
NM_001282667,MICAL2,18,17,101713,6581,95132,5596,365.6111111,14.45555387
NM_001282666,MICAL2,19,18,101713,6645,95068,5281.555556,349.7368421,14.30669676
NM_001282665,MICAL2,22,21,125402,4249,121153,5769.190476,193.1363636,28.51329725
NM_001282664,MICAL2,26,25,125402,3738,121664,4866.56,143.7692308,32.54788657
NM_001282663,MICAL2,28,27,153216,3950,149266,5528.37037,141.0714286,37.78886076
NM_001282659,USP47,28,27,117904,8009,109895,4070.185185,286.0357143,13.72143838
NM_018222,PARVA,13,12,157879,8732,149147,12428.91667,671.6923077,17.08050847
NM_017944,USP47,27,26,117904,7804,110100,4234.615385,289.037037,14.10814967
NM_001030273,ARNTL,20,19,109489,2831,106658,5613.578947,141.55,37.67502649
NM_021961,TEAD1,13,12,270317,9429,260888,21740.66667,725.3076923,27.66868173
NM_001178,ARNTL,20,19,109489,2815,106674,5614.421053,140.75,37.89484902
NM_001030272,ARNTL,19,18,109489,2759,106730,5929.444444,145.2105263,38.68430591
NM_006108,SPON1,16,15,305497,5153,300344,20022.93333,322.0625,58.28527072
NM_148976,PSMA1,11,10,138760,1482,137278,13727.8,134.7272727,92.63022942
NM_001278315,INSC,13,12,98110,2934,95176,7931.333333,225.6923077,32.43899114
NM_001278313,INSC,12,11,98110,2854,95256,8659.636364,237.8333333,33.37631395
NM_001278314,INSC,13,12,98110,2960,95150,7929.166667,227.6923077,32.14527027
NM_001278316,INSC,11,10,98110,2727,95383,9538.3,247.9090909,34.97726439
NM_001042536,INSC,13,12,132274,2893,129381,10781.75,222.5384615,44.7220878
NM_001031853,INSC,13,12,134788,2969,131819,10984.91667,228.3846154,44.39845066
NM_017508,SOX6,15,14,436420,8994,427426,30530.42857,599.6,47.52346008
NM_033326,SOX6,16,15,509942,8881,501061,33404.06667,555.0625,56.41943475
NM_001145819,SOX6,16,15,436420,8935,427485,28499,558.4375,47.84387241
NM_001145811,SOX6,15,14,442437,8972,433465,30961.78571,598.1333333,48.31308515
NM_153676,USH1C,27,26,50523,3273,47250,1817.307692,121.2222222,14.43629698
NM_002645,PIK3C2A,32,31,83232,8320,74912,2416.516129,260,9.003846154
NM_000352,ABCC8,39,38,83962,4960,79002,2079,127.1794872,15.92782258
NM_005709,USH1C,21,20,50523,2258,48265,2413.25,107.5238095,21.37511072
NM_005013,NUCB2,14,13,54786,1626,53160,4089.230769,116.1428571,32.69372694
NM_175058,PLEKHA7,23,22,226758,4831,221927,10087.59091,210.0434783,45.93810805
NM_001287174,ABCC8,39,38,83962,4963,78999,2078.921053,127.2564103,15.91759017
NM_144972,LDHAL6A,7,6,23775,2590,21185,3530.833333,370,8.17953668
NM_001142307,GTF2H1,16,15,44776,3531,41245,2749.666667,220.6875,11.68082696
NM_001144071,LDHAL6A,8,7,23775,1998,21777,3111,249.75,10.8993994
NM_005316,GTF2H1,15,14,44776,3323,41453,2960.928571,221.5333333,12.47457117
NM_173588,IGSF22,23,22,21927,4357,17570,798.6363636,189.4347826,4.032591232
NM_001111019,NAV2,28,27,99047,8110,90937,3368.037037,289.6428571,11.21294698
NM_005788,PRMT3,16,15,121805,2749,119056,7937.066667,171.8125,43.30883958
NM_001145167,PRMT3,15,14,121805,2612,119193,8513.785714,174.1333333,45.63284839
NM_001145166,PRMT3,14,13,121805,2561,119244,9172.615385,182.9285714,46.56149941
NM_001143830,GAS2,8,7,146389,2241,144148,20592.57143,280.125,64.32307006
NM_001142649,ANO5,22,21,90193,6680,83513,3976.809524,303.6363636,12.50194611
NM_213599,ANO5,22,21,90193,6683,83510,3976.666667,303.7727273,12.49588508
NM_005256,GAS2,7,6,138230,2031,136199,22699.83333,290.1428571,67.06006893
NM_177553,GAS2,8,7,144895,2183,142712,20387.42857,272.875,65.37425561
NM_001252010,LUZP2,10,9,585672,5181,580491,64499,518.1,112.0422698
NM_001252008,LUZP2,12,11,585672,5305,580367,52760.63636,442.0833333,109.4
NM_001009909,LUZP2,12,11,585672,5309,580363,52760.27273,442.4166667,109.3168205
NM_031418,ANO3,27,26,331160,5963,325197,12507.57692,220.8518519,54.53580413
NM_178498,SLC5A12,15,14,55010,6268,48742,3481.571429,417.8666667,7.776324186
NM_003986,BBOX1,9,8,86847,1895,84952,10619,210.5555556,44.82955145
NM_031217,KIF18A,17,16,87585,3480,84105,5256.5625,204.7058824,24.16810345
NM_018490,LGR4,18,17,106828,5265,101563,5974.294118,292.5,19.29021842
NM_018362,LIN7C,5,4,12363,4857,7506,1876.5,971.4,1.545398394
NM_001584,MPPED2,6,5,170424,2408,168016,33603.2,401.3333333,69.77408638
NM_020869,DCDC5,20,19,129085,4779,124306,6542.421053,238.95,26.01088094
NM_181807,DCDC1,9,8,107188,1751,105437,13179.625,194.5555556,60.21530554
NM_002901,RCN1,6,5,14797,2522,12275,2455,420.3333333,4.867168914
NM_001288726,ELP4,12,11,274799,2772,272027,24729.72727,231,98.13383838
NM_019040,ELP4,10,9,274799,2342,272457,30273,234.2,116.3351836
NM_001288725,ELP4,11,10,274799,2485,272314,27231.4,225.9090909,109.5830986
NM_001278163,HIPK3,16,15,100352,7138,93214,6214.266667,446.125,13.05884001
NM_001278162,HIPK3,16,15,98693,7417,91276,6085.066667,463.5625,12.30632331
NM_001048200,HIPK3,16,15,99702,7625,92077,6138.466667,476.5625,12.07567213
NM_005734,HIPK3,17,16,99702,7689,92013,5750.8125,452.2941176,11.96683574
NM_001326,CSTF3,21,20,76909,2844,74065,3703.25,135.4285714,26.04254571
NM_001008391,CCDC73,18,17,192580,4050,188530,11090,225,46.55061728
NM_012194,KIAA1549L,20,19,131771,11640,120131,6322.684211,582,10.32053265
NM_001752,CAT,13,12,33137,2313,30824,2568.666667,177.9230769,13.32641591
NM_145804,ABTB2,17,16,207023,4920,202103,12631.4375,289.4117647,41.07784553
NM_203364,CAPRIN1,18,17,47379,3571,43808,2576.941176,198.3888889,12.26771213
NM_005898,CAPRIN1,19,18,50929,5581,45348,2519.333333,293.7368421,8.125425551
NM_015430,PAMR1,12,11,94205,3200,91005,8273.181818,266.6666667,28.4390625
NM_003477,PDHX,11,10,80000,2999,77001,7700.1,272.6363636,25.67555852
NM_001252652,SLC1A2,12,11,168860,11721,157139,14285.36364,976.75,13.4066206
NM_001282675,PAMR1,13,12,98474,3140,95334,7944.5,241.5384615,30.3611465
NM_001195728,SLC1A2,12,11,168860,11656,157204,14291.27273,971.3333333,13.48695951
NM_001135024,PDHX,11,10,80000,2670,77330,7733,242.7272727,28.96254682
NM_001166158,PDHX,6,5,80000,2313,77687,15537.4,385.5,33.5871163
NM_004171,SLC1A2,11,10,168355,12017,156338,15633.8,1092.454545,13.00973621
NM_001282676,PAMR1,9,8,94205,2813,91392,11424,312.5555556,32.48915748
NM_001001991,PAMR1,11,10,94205,3148,91057,9105.7,286.1818182,28.92534943
NM_024841,PRR5L,10,9,89221,3960,85261,9473.444444,396,21.53055556
NM_001101653,COMMD9,5,4,17159,2853,14306,3576.5,570.6,5.014370838
NM_001160169,PRR5L,7,6,64209,3580,60629,10104.83333,511.4285714,16.93547486
NM_001160167,PRR5L,9,8,169031,3973,165058,20632.25,441.4444444,41.54492827
NM_014186,COMMD9,6,5,17159,2980,14179,2835.8,496.6666667,4.758053691
NM_017583,TRIM44,5,4,146579,4342,142237,35559.25,868.4,32.75840626
NM_001160168,PRR5L,6,5,89221,3369,85852,17170.4,561.5,25.48293262
NM_174902,LDLRAD3,6,5,287231,2975,284256,56851.2,495.8333333,95.54823529
NM_139178,ALKBH3,10,9,39470,1579,37891,4210.111111,157.9,23.99683344
NM_016142,HSD17B12,11,10,176028,2556,173472,17347.2,232.3636364,67.8685446
NM_018259,TTC17,24,23,136050,4549,131501,5717.434783,189.5416667,28.90767202
NM_001178083,EXT2,15,14,149883,3679,146204,10443.14286,245.2666667,39.74014678
NM_130783,TSPAN18,9,8,168003,4243,163760,20470,471.4444444,38.59533349
NM_207122,EXT2,14,13,149883,3648,146235,11248.84615,260.5714286,40.08634868
NM_021926,ALX4,4,3,49440,5470,43970,14656.66667,1367.5,8.038391225
NM_006034,TP53I11,7,6,18711,3525,15186,2531,503.5714286,4.308085106
NM_001258324,TP53I11,7,6,18960,3574,15386,2564.333333,510.5714286,4.304980414
NM_001258323,TP53I11,8,7,18711,3601,15110,2158.571429,450.125,4.196056651
NM_001258322,TP53I11,8,7,18960,3621,15339,2191.285714,452.625,4.236122618
NM_001258321,TP53I11,8,7,18960,3691,15269,2181.285714,461.375,4.13681929
NM_001258320,TP53I11,10,9,17862,3769,14093,1565.888889,376.9,3.739188114
NM_000401,EXT2,14,13,149235,3469,145766,11212.76923,247.7857143,42.01960219
NM_001256696,PRDM11,7,6,77747,1866,75881,12646.83333,266.5714286,40.66505895
NM_001256695,PRDM11,8,7,87783,10752,77031,11004.42857,1344,7.164341518
NM_021117,CRY2,12,11,35844,4216,31628,2875.272727,351.3333333,7.501897533
NM_001127457,CRY2,12,11,36132,4080,32052,2913.818182,340,7.855882353
NM_001003677,C11orf49,9,8,225560,1749,223811,27976.375,194.3333333,127.9651229
NM_001142673,ATG13,18,17,58744,5942,52802,3106,330.1111111,8.886233591
NM_014756,CKAP5,43,42,102777,6577,96200,2290.47619,152.9534884,14.62672951
NM_001278222,C11orf49,8,7,225560,1627,223933,31990.42857,203.375,137.6355255
NM_201533,DGKZ,31,30,35289,3583,31706,1056.866667,115.5806452,8.84900921
NM_201532,DGKZ,31,30,47651,3847,43804,1460.133333,124.0967742,11.38653496
NM_001205122,ATG13,15,14,58744,5690,53054,3789.571429,379.3333333,9.324077329
NM_001205121,ATG13,17,16,58744,5825,52919,3307.4375,342.6470588,9.084806867
NM_001205119,ATG13,18,17,58744,5985,52759,3103.470588,332.5,8.815204678
NM_001205120,ATG13,17,16,58744,5885,52859,3303.6875,346.1764706,8.981988105
NM_001008938,CKAP5,44,43,102777,6758,96019,2233,153.5909091,14.20819769
NM_001199268,DGKZ,30,29,33150,3612,29538,1018.551724,120.4,8.177740864
NM_001199266,DGKZ,31,30,33150,3697,29453,981.7666667,119.2580645,7.966729781
NM_024113,C11orf49,9,8,225560,1731,223829,27978.625,192.3333333,129.3061814
NM_003646,DGKZ,31,30,33150,3682,29468,982.2666667,118.7741935,8.003259098
NM_017749,AMBRA1,19,18,194954,5044,189910,10550.55556,265.4736842,37.65067407
NM_001267783,AMBRA1,18,17,197659,4958,192701,11335.35294,275.4444444,38.86668011
NM_001267782,AMBRA1,20,19,197659,5326,192333,10122.78947,266.3,36.11209163
NM_001199267,DGKZ,31,30,33150,3679,29471,982.3666667,118.6774194,8.010600707
NM_001105540,DGKZ,32,31,18961,4118,14843,478.8064516,128.6875,3.604419621
NM_014741,ATG13,17,16,58744,5830,52914,3307.125,342.9411765,9.076157804
NM_002334,LRP4,38,37,61907,8265,53642,1449.783784,217.5,6.490260133
NM_001003676,C11orf49,8,7,225560,2003,223557,31936.71429,250.375,111.6110834
NM_001098503,PTPRJ,9,8,152158,3183,148975,18621.875,353.6666667,46.80333019
NM_024783,AGBL2,19,18,55787,3612,52175,2898.611111,190.1052632,14.44490587
NM_002843,PTPRJ,25,24,190286,7874,182412,7600.5,314.96,23.16637033
NM_130476,MADD,33,32,59913,5893,54020,1688.125,178.5757576,9.166808077
NM_130475,MADD,35,34,59913,6005,53908,1585.529412,171.5714286,8.977185679
NM_130474,MADD,32,31,60385,5672,54713,1764.935484,177.25,9.646156559
NM_130473,MADD,34,33,60385,5933,54452,1650.060606,174.5,9.177818979
NM_130472,MADD,33,32,60385,5743,54642,1707.5625,174.030303,9.514539439
NM_130471,MADD,34,33,60385,5804,54581,1653.969697,170.7058824,9.404031702
NM_130470,MADD,33,32,60657,6038,54619,1706.84375,182.969697,9.045876118
NM_015231,NUP160,36,35,70389,5419,64970,1856.285714,150.5277778,11.98929692
NM_001135944,MADD,33,32,60385,5731,54654,1707.9375,173.6666667,9.536555575
NM_001135943,MADD,33,32,59913,5764,54149,1692.15625,174.6666667,9.394344205
NM_003682,MADD,36,35,60385,6052,54333,1552.371429,168.1111111,8.977693325
NM_006093,PRG3,6,5,4383,875,3508,701.6,145.8333333,4.009142857
NM_001085468,CTNND1,17,16,57420,5781,51639,3227.4375,340.0588235,8.932537623
NM_001085460,CTNND1,19,18,57420,6191,51229,2846.055556,325.8421053,8.274753675
NM_001085464,CTNND1,18,17,57420,5869,51551,3032.411765,326.0555556,8.783608792
NM_001206887,CTNND1,18,17,57420,5986,51434,3025.529412,332.5555556,8.592382225
NM_001206889,CTNND1,19,18,57420,6082,51338,2852.111111,320.1052632,8.440973364
NM_001331,CTNND1,19,18,57420,6288,51132,2840.666667,330.9473684,8.131679389
NM_001206888,CTNND1,18,17,57420,5962,51458,3026.941176,331.2222222,8.63099631
NM_001198810,SLC43A1,15,14,30356,2378,27978,1998.428571,158.5333333,11.76534903
NM_001085463,CTNND1,19,18,57420,5888,51532,2862.888889,309.8947368,8.752038043
NM_001085461,CTNND1,19,18,57420,6264,51156,2842,329.6842105,8.166666667
NM_001085459,CTNND1,20,19,57420,6352,51068,2687.789474,317.6,8.039672544
NM_001085458,CTNND1,21,20,57420,6371,51049,2552.45,303.3809524,8.01271386
NM_001085466,CTNND1,18,17,57420,5800,51620,3036.470588,322.2222222,8.9
NM_001085469,CTNND1,16,15,57420,5708,51712,3447.466667,356.75,9.059565522
NM_001085467,CTNND1,17,16,57420,5854,51566,3222.875,344.3529412,8.808677827
NM_001085465,CTNND1,17,16,57420,5805,51615,3225.9375,341.4705882,8.891472868
NM_001206890,CTNND1,17,16,57420,5803,51617,3226.0625,341.3529412,8.894881958
NM_001206891,CTNND1,19,18,57420,6155,51265,2848.055556,323.9473684,8.329000812
NM_001206883,CTNND1,20,19,57420,6069,51351,2702.684211,303.45,8.461196243
NM_001206884,CTNND1,19,18,57420,5981,51439,2857.722222,314.7894737,8.600401271
NM_001206886,CTNND1,19,18,57420,6050,51370,2853.888889,318.4210526,8.490909091
NM_001206885,CTNND1,20,19,57420,6283,51137,2691.421053,314.15,8.138946363
NM_001085462,CTNND1,18,17,57420,6071,51349,3020.529412,337.2777778,8.458079394
NM_003627,SLC43A1,15,14,31190,2549,28641,2045.785714,169.9333333,11.23617105
NM_001143995,LPXN,9,8,51297,1888,49409,6176.125,209.7777778,26.17002119
NM_001005212,OR9Q1,3,2,157687,2441,155246,77623,813.6666667,63.59934453
NM_004811,LPXN,9,8,49048,1898,47150,5893.75,210.8888889,24.84193888
NM_002556,OSBP,14,13,41748,5097,36651,2819.307692,364.0714286,7.190700412
NM_001278320,MS4A13,5,4,27307,753,26554,6638.5,150.6,35.26427623
NM_021201,MS4A7,7,6,17470,3015,14455,2409.166667,430.7142857,4.794361526
NM_001012417,MS4A13,7,6,27307,932,26375,4395.833333,133.1428571,28.29935622
NM_024092,TMEM109,4,3,9546,2392,7154,2384.666667,598,2.990802676
NM_001100909,MS4A13,6,5,27307,811,26496,5299.2,135.1666667,32.67077682
NM_206940,MS4A7,6,5,17470,2831,14639,2927.8,471.8333333,5.170964324
NM_206939,MS4A7,7,6,17470,2967,14503,2417.166667,423.8571429,4.88810246
NM_206938,MS4A7,6,5,17470,2879,14591,2918.2,479.8333333,5.068079194
NM_206893,MS4A10,8,7,15959,2304,13655,1950.714286,288,5.926649306
NM_006133,DAGLA,20,19,66571,5778,60793,3199.631579,288.9,10.52146071
NM_001281502,FADS2,12,11,50952,3098,47854,4350.363636,258.1666667,15.44673983
NM_001281501,FADS2,12,11,51153,3029,48124,4374.909091,252.4166667,15.88775173
NM_002032,FTH1,4,3,3377,1233,2144,714.6666667,308.25,1.738848337
NM_001923,DDB1,27,26,33767,4383,29384,1130.153846,162.3333333,6.704083961
NM_017841,SDHAF2,4,3,16644,1223,15421,5140.333333,305.75,12.60915781
NM_001252065,SYT7,10,9,67158,6410,60748,6749.777778,641,9.477067083
NM_004200,SYT7,9,8,67158,6184,60974,7621.75,687.1111111,9.85996119
NM_004265,FADS2,12,11,39323,3370,35953,3268.454545,280.8333333,10.66854599
NM_025080,ASRGL1,7,6,56115,2349,53766,8961,335.5714286,22.88888889
NM_024784,ZBTB3,2,1,3223,2976,247,247,1488,0.082997312
NM_001083926,ASRGL1,7,6,56115,2426,53689,8948.166667,346.5714286,22.13066777
NM_024060,AHNAK,6,5,113320,1098,112222,22444.4,183,102.2058288
NM_001012664,SLC3A2,10,9,32873,2165,30708,3412,216.5,14.18383372
NM_001012662,SLC3A2,12,11,32873,2356,30517,2774.272727,196.3333333,12.95288625
NM_002394,SLC3A2,12,11,32873,2353,30520,2774.545455,196.0833333,12.97067573
NM_001013251,SLC3A2,9,8,8013,1941,6072,759,215.6666667,3.128284389
NM_080866,SLC22A9,10,9,40453,2318,38135,4237.222222,231.8,16.45168248
NM_004585,RARRES3,4,3,9659,769,8890,2963.333333,192.25,11.56046814
NM_014067,MACROD1,11,10,167557,1268,166289,16628.9,115.2727273,131.1427445
NM_015459,ATL3,13,12,42648,2269,40379,3364.916667,174.5384615,17.79594535
NM_001277233,TM7SF2,9,8,4383,1529,2854,356.75,169.8888889,1.866579464
NM_003273,TM7SF2,10,9,4383,1611,2772,308,161.1,1.720670391
NM_015080,NRXN2,23,22,117016,6646,110370,5016.818182,288.9565217,16.60698164
NM_138732,NRXN2,20,19,117016,6433,110583,5820.157895,321.65,17.18995803
NM_001278251,SLC25A45,10,9,8511,3101,5410,601.1111111,310.1,1.744598517
NM_001278250,SLC25A45,5,4,7196,2450,4746,1186.5,490,1.937142857
NM_018026,PACS1,24,23,174396,4517,169879,7386.043478,188.2083333,37.60881116
NM_005438,FOSL1,4,3,8307,1672,6635,2211.666667,418,3.968301435
NM_001077241,SLC25A45,6,5,7481,2237,5244,1048.8,372.8333333,2.344210997
NM_182556,SLC25A45,7,6,7481,2293,5188,864.6666667,327.5714286,2.26253816
NM_006946,SPTBN2,37,36,36152,7904,28248,784.6666667,213.6216216,3.57388664
NM_001040716,PC,23,22,109852,4215,105637,4801.681818,183.2608696,25.06215896
NM_000920,PC,22,21,109852,4026,105826,5039.333333,183,26.28564332
NM_012308,KDM2A,21,20,138812,7398,131414,6570.7,352.2857143,17.76344958
NM_178864,NPAS4,8,7,5704,3310,2394,342,413.75,0.72326284
NM_001104,ACTN3,21,20,16489,2959,13530,676.5,140.9047619,4.572490706
NM_024650,C11orf80,17,16,98782,2340,96442,6027.625,137.6470588,41.21452991
NM_001258371,ACTN3,21,20,16935,3107,13828,691.4,147.952381,4.45059543
NM_030930,UNC93B1,11,10,13020,2326,10694,1069.4,211.4545455,4.597592433
NM_002180,IGHMBP2,15,14,36752,3969,32783,2341.642857,264.6,8.259763165
NM_001031847,CPT1A,19,18,87313,2656,84657,4703.166667,139.7894737,31.87387048
NM_001876,CPT1A,19,18,87050,5272,81778,4543.222222,277.4736842,15.51176024
NM_018312,PPP6R3,23,22,154617,4993,149624,6801.090909,217.0869565,29.96675345
NM_001164164,PPP6R3,23,22,154617,3427,151190,6872.272727,149,44.11730376
NM_001164163,PPP6R3,23,22,154617,5041,149576,6798.909091,219.173913,29.6718905
NM_001164162,PPP6R3,24,23,154617,5111,149506,6500.26087,212.9583333,29.25180982
NM_001164161,PPP6R3,24,23,154617,5129,149488,6499.478261,213.7083333,29.14564243
NM_001164160,PPP6R3,25,24,154617,5148,149469,6227.875,205.92,29.03438228
NM_053056,CCND1,5,4,13371,4294,9077,2269.25,858.8,2.113879832
NM_018043,ANO1,26,25,111246,4834,106412,4256.48,185.9230769,22.01323955
NM_003626,PPFIA1,28,27,113803,5363,108440,4016.296296,191.5357143,20.2200261
NM_177423,PPFIA1,26,25,107794,4088,103706,4148.24,157.2307692,25.3683953
NM_133266,SHANK2,11,10,193964,8861,185103,18510.3,805.5454545,20.88962871
NM_012309,SHANK2,23,22,621849,10473,611376,27789.81818,455.3478261,58.37639645
NM_018161,NADSYN1,21,20,48366,2451,45915,2295.75,116.7142857,18.73317013
NM_018320,RNF121,9,8,68877,2615,66262,8282.75,290.5555556,25.33919694
NM_001258394,CLPB,18,17,142256,3396,138860,8168.235294,188.6666667,40.88928151
NM_001258393,CLPB,15,14,142256,3109,139147,9939.071429,207.2666667,44.7561917
NM_001258392,CLPB,16,15,142256,3197,139059,9270.6,199.8125,43.49671567
NM_030813,CLPB,17,16,142256,3288,138968,8685.5,193.4117647,42.26520681
NM_001277208,P2RY6,2,1,26485,2468,24017,24017,1234,9.731361426
NM_001277204,P2RY6,3,2,26485,2555,23930,11965,851.6666667,9.365949119
NM_001277205,P2RY6,4,3,34122,2503,31619,10539.66667,625.75,12.63244107
NM_001277207,P2RY6,3,2,34075,2402,31673,15836.5,800.6666667,13.18609492
NM_001286051,FAM168A,6,5,197713,6966,190747,38149.4,1161,27.38257249
NM_006645,STARD10,7,6,38978,1995,36983,6163.833333,285,18.53784461
NM_001286050,FAM168A,9,8,197713,7314,190399,23799.875,812.6666667,26.03213016
NM_001277206,P2RY6,3,2,33391,2460,30931,15465.5,820,12.57357724
NM_014824,FCHSD2,20,19,305355,4510,300845,15833.94737,225.5,66.70620843
NM_176796,P2RY6,4,3,34122,2536,31586,10528.66667,634,12.45504732
NM_176798,P2RY6,4,3,28733,2653,26080,8693.333333,663.25,9.830380701
NM_176797,P2RY6,3,2,34122,2375,31747,15873.5,791.6666667,13.36715789
NM_015159,FAM168A,8,7,197713,7286,190427,27203.85714,910.75,26.13601427
NM_006591,POLD3,12,11,50532,3836,46696,4245.090909,319.6666667,12.17309698
NM_016055,MRPL48,8,7,76741,988,75753,10821.85714,123.5,76.67307692
NM_001286577,C2CD3,33,32,158307,7993,150314,4697.3125,242.2121212,18.80570499
NM_015531,C2CD3,31,30,136589,6316,130273,4342.433333,203.7419355,20.6258708
NM_016147,PPME1,14,13,83642,2727,80915,6224.230769,194.7857143,29.67180051
NM_001271593,PPME1,14,13,83642,2769,80873,6221,197.7857143,29.20657277
NM_173582,PGM2L1,14,13,68143,8515,59628,4586.769231,608.2142857,7.002701116
NM_153614,DNAJB13,8,7,19970,1883,18087,2583.857143,235.375,9.605416888
NM_030792,GDPD5,17,16,90916,3191,87725,5482.8125,187.7058824,27.49138201
NM_006656,NEU3,3,2,18795,2751,16044,8022,917,5.832061069
NM_182969,XRRA1,19,18,108279,5020,103259,5736.611111,264.2105263,20.56952191
NM_033063,MAP6,4,3,81518,2652,78866,26288.66667,663,29.73831071
NM_020251,ARRB1,15,14,91711,7513,84198,6014.142857,500.8666667,11.20697458
NM_001270381,XRRA1,16,15,108279,4749,103530,6902,296.8125,21.80037903
NM_001270380,XRRA1,15,14,108279,4649,103630,7402.142857,309.9333333,22.29081523
NM_207577,MAP6,3,2,65576,4332,61244,30622,1444,14.13758079
NM_004041,ARRB1,16,15,91711,7538,84173,5611.533333,471.125,11.16648979
NM_003369,UVRAG,15,14,329072,5181,323891,23135.07143,345.4,62.51515152
NM_002576,PAK1,15,14,152050,3445,148605,10614.64286,229.6666667,43.13642961
NM_016578,RSF1,16,15,154608,5150,149458,9963.866667,321.875,29.02097087
NM_001293,CLNS1A,7,6,21657,1380,20277,3379.5,197.1428571,14.69347826
NM_018367,ACER3,11,10,162935,4398,158537,15853.7,399.8181818,36.0475216
NM_182833,GDPD4,16,15,70862,2549,68313,4554.2,159.3125,26.79992154
NM_001128620,PAK1,16,15,152050,3495,148555,9903.666667,218.4375,42.50500715
NM_004055,CAPN5,13,12,59208,4403,54805,4567.083333,338.6923077,12.44719509
NM_001243251,NARS2,14,13,138904,2052,136852,10527.07692,146.5714286,66.6920078
NM_024678,NARS2,14,13,138904,2533,136371,10490.07692,180.9285714,53.83774181
NM_012296,GAB2,10,9,126592,6069,120523,13391.44444,606.9,19.85879058
NM_080491,GAB2,10,9,202534,6125,196409,21823.22222,612.5,32.06677551
NM_199418,PRCP,10,9,76150,2216,73934,8214.888889,221.6,33.36371841
NM_014488,RAB30,6,5,98792,9992,88800,17760,1665.333333,8.887109688
NM_005040,PRCP,9,8,76150,2152,73998,9249.75,239.1111111,34.38568773
NM_175885,FAM181B,1,0,1862,1862,NA,NA,1862,NA
NM_001286061,RAB30,5,4,98331,9788,88543,22135.75,1957.6,9.046076829
NM_001286060,RAB30,5,4,98792,9890,88902,22225.5,1978,8.989079879
NM_001286059,RAB30,5,4,61438,10055,51383,12845.75,2011,5.110193933
NM_001142702,DLG2,11,10,227414,6133,221281,22128.1,557.5454545,36.0803848
NM_001206946,PICALM,20,19,111927,4150,107777,5672.473684,207.5,25.97036145
NM_001206947,PICALM,19,18,112711,3735,108976,6054.222222,196.5789474,29.17697456
NM_032943,SYTL2,19,18,116939,4320,112619,6256.611111,227.3684211,26.06921296
NM_001008660,PICALM,20,19,111927,4045,107882,5678,202.25,26.67045735
NM_007166,PICALM,20,19,111927,4171,107756,5671.368421,208.55,25.83457205
NM_001286159,CCDC83,11,10,64921,2275,62646,6264.6,206.8181818,27.5367033
NM_001162951,SYTL2,18,17,63849,4140,59709,3512.294118,230,14.42246377
NM_001162953,SYTL2,18,17,63849,4143,59706,3512.117647,230.1666667,14.41129616
NM_001289608,SYTL2,19,18,116939,3950,112989,6277.166667,207.8947368,28.60481013
NM_173556,CCDC83,12,11,64921,2369,62552,5686.545455,197.4166667,26.40439004
NM_001161586,ME3,15,14,231530,2328,229202,16371.57143,155.2,98.45446735
NM_001156474,CCDC81,15,14,48375,2796,45579,3255.642857,186.4,16.30150215
NM_021827,CCDC81,14,13,48375,2525,45850,3526.923077,180.3571429,18.15841584
NM_006680,ME3,15,14,231279,2103,229176,16369.71429,140.2,108.9757489
NM_001014811,ME3,14,13,231092,2254,228838,17602.92308,161,101.5252884
NM_001143831,GRM5,9,8,543498,7864,535634,66954.25,873.7777778,68.11215666
NM_000372,TYR,5,4,117889,2070,115819,28954.75,414,55.95120773
NM_000842,GRM5,9,8,559074,7936,551138,68892.25,881.7777778,69.44783266
NM_005467,NAALAD2,19,18,57963,3215,54748,3041.555556,169.2105263,17.02892691
NM_001105522,TRIM49D2P,7,6,8999,1656,7343,1223.833333,236.5714286,4.434178744
NM_152313,SLC36A4,11,10,53806,6035,47771,4777.1,548.6363636,7.915658658
NM_001286139,SLC36A4,11,10,53286,6072,47214,4721.4,552,7.7756917
NM_033395,KIAA1731,30,29,68708,8074,60634,2090.827586,269.1333333,7.509784493
NM_130847,AMOTL1,13,12,108412,9012,99400,8283.333333,693.2307692,11.02973813
NM_001243776,CEP57,12,11,42234,3234,39000,3545.454545,269.5,12.0593692
NM_032427,MAML2,5,4,366589,7116,359473,89868.25,1423.2,50.51616076
NM_014679,CEP57,11,10,42234,3189,39045,3904.5,289.9090909,12.24365005
NM_001243777,CEP57,10,9,42234,3110,39124,4347.111111,311,12.58006431
NM_000926,PGR,8,7,100191,13045,87146,12449.42857,1630.625,6.680413952
NM_001271162,PGR,8,7,100105,10965,89140,12734.28571,1370.625,8.129502964
NM_001271161,PGR,7,6,99441,11988,87453,14575.5,1712.571429,7.295045045
NM_001202474,PGR,8,7,99441,12295,87146,12449.42857,1536.875,7.087921919
NM_004621,TRPC6,13,12,132366,4625,127741,10645.08333,355.7692308,27.61967568
NM_020802,KIAA1377,11,10,86049,7054,78995,7899.5,641.2727273,11.19861072
NM_001256166,BIRC2,9,8,31490,2402,29088,3636,266.8888889,12.10990841
NM_001166,BIRC2,9,8,31490,3805,27685,3460.625,422.7777778,7.275952694
NM_001256163,BIRC2,9,8,31298,4082,27216,3402,453.5555556,6.667319941
NM_001377,DYNC2H1,89,88,370433,13767,356666,4053.022727,154.6853933,25.90731459
NM_001080463,DYNC2H1,90,89,370433,13789,356644,4007.235955,153.2111111,25.86438465
NM_001112812,GRIA4,10,9,302822,3223,299599,33288.77778,322.3,92.95656221
NM_000829,GRIA4,17,16,372021,5525,366496,22906,325,66.33411765
NM_001077244,GRIA4,11,10,303433,3356,300077,30007.7,305.0909091,89.41507747
NM_001077243,GRIA4,17,16,372021,5638,366383,22898.9375,331.6470588,64.984569
NM_001256424,GUCY1A2,9,8,344435,16228,328207,41025.875,1803.111111,20.22473503
NM_000855,GUCY1A2,8,7,344435,16134,328301,46900.14286,2016.75,20.34839469
NM_152434,CWF19L2,18,17,131502,3297,128205,7541.470588,183.1666667,38.88535032
NM_018712,ELMOD1,12,11,75690,3003,72687,6607.909091,250.25,24.2047952
NM_001130037,ELMOD1,11,10,75690,2978,72712,7271.2,270.7272727,24.41638684
NM_152587,C11orf65,9,8,84533,1042,83491,10436.375,115.7777778,80.12571977
NM_015065,EXPH5,6,5,88218,10193,78025,15605,1698.833333,7.654763073
NM_000051,ATM,63,62,146269,13210,133059,2146.112903,209.6825397,10.07259652
NM_004398,DDX10,18,17,275907,3282,272625,16036.76471,182.3333333,83.06672761
NM_033390,ZC3H12C,6,5,78481,8813,69668,13933.6,1468.833333,7.905140134
NM_020809,ARHGAP20,16,15,135694,6212,129482,8632.133333,388.25,20.84385061
NM_001258418,ARHGAP20,15,14,136155,6032,130123,9294.5,402.1333333,21.57211538
NM_001258417,ARHGAP20,15,14,135694,5914,129780,9270,394.2666667,21.94453838
NM_001258416,ARHGAP20,16,15,136155,6101,130054,8670.266667,381.3125,21.31683331
NM_001258415,ARHGAP20,15,14,135016,6214,128802,9200.142857,414.2666667,20.72771162
NM_001256400,BCO2,11,10,42562,2603,39959,3995.9,236.6363636,15.35113331
NM_001256397,BCO2,12,11,42562,2791,39771,3615.545455,232.5833333,14.24973128
NM_001278542,DIXDC1,6,5,48853,1951,46902,9380.4,325.1666667,24.0399795
NM_001082619,PIH1D2,6,5,10163,1254,8909,1781.8,209,7.10446571
NM_031938,BCO2,12,11,43443,2921,40522,3683.818182,243.4166667,13.87264635
NM_001256398,BCO2,10,9,43443,2700,40743,4527,270,15.09
NM_001077690,ALG9,16,15,89388,6153,83237,5549.133333,384.5625,13.52787258
NM_015191,SIK2,15,14,124464,5693,118771,8483.642857,379.5333333,20.86263833
NM_001077692,ALG9,15,14,89087,6429,82658,5904.142857,428.6,12.85705397
NM_001077691,ALG9,15,14,89087,6450,82637,5902.642857,430,12.81193798
NM_001037290,BCO2,12,11,42562,2809,39753,3613.909091,234.0833333,14.15201139
NM_024740,ALG9,16,15,89388,6174,83216,5547.733333,385.875,13.47845805
NM_000615,NCAM1,19,18,317191,5980,311213,17289.61111,314.7368421,52.04230769
NM_181351,NCAM1,20,19,317191,6011,311182,16378,300.55,51.76875728
NM_001242608,NCAM1,17,16,303952,4835,299119,18694.9375,284.4117647,61.86535677
NM_001242607,NCAM1,21,20,317191,6090,311103,15555.15,290,51.08423645
NM_001076682,NCAM1,20,19,303952,4943,299011,15737.42105,247.15,60.4918066
NM_001018011,ZBTB16,7,6,190111,2258,187853,31308.83333,322.5714286,83.19441984
NM_006006,ZBTB16,7,6,190968,2413,188555,31425.83333,344.7142857,78.14131786
NM_004724,ZW10,16,15,40582,2964,37618,2507.866667,185.25,12.69163293
NM_152315,NXPE1,6,5,38182,1931,36251,7250.2,321.8333333,18.77317452
NM_182495,NXPE2,6,5,28454,1784,26670,5334,297.3333333,14.94955157
NM_025164,SIK3,24,23,255015,6231,248784,10816.69565,259.625,39.92681753
NM_138973,BACE1,9,8,30572,5649,24923,3115.375,627.6666667,4.411931315
NM_138972,BACE1,9,8,30572,5781,24791,3098.875,642.3333333,4.288358415
NM_138971,BACE1,9,8,30572,5724,24848,3106,636,4.341020266
NM_001281749,SIK3,24,23,255015,6051,248964,10824.52174,252.125,41.14427367
NM_001281748,SIK3,25,24,255015,6176,248839,10368.29167,247.04,40.29128886
NM_012104,BACE1,9,8,30572,5856,24716,3089.5,650.6666667,4.220628415
NM_001184748,PAFAH1B2,6,5,32594,2525,30069,6013.8,420.8333333,11.90851485
NM_003904,ZNF259,14,13,9465,1792,7673,590.2307692,128,4.281808036
NM_001204268,FXYD6-FXYD2,11,10,56958,1195,55763,5576.3,108.6363636,46.66359833
NM_001197104,KMT2A,36,35,90336,16630,73706,2105.885714,461.9444444,4.432110643
NM_019894,TMPRSS4,13,12,42831,3546,39285,3273.75,272.7692308,11.0786802
NM_001173552,TMPRSS4,12,11,42831,3425,39406,3582.363636,285.4166667,11.50540146
NM_001173551,TMPRSS4,13,12,42831,3540,39291,3274.25,272.3076923,11.09915254
NM_005933,KMT2A,36,35,90336,16621,73715,2106.142857,461.6944444,4.435052043
NM_001243598,FXYD6-FXYD2,10,9,56958,1132,55826,6202.888889,113.2,49.31625442
NM_001083947,TMPRSS4,13,12,42831,3531,39300,3275,271.6153846,11.1299915
NM_198489,CCDC84,11,10,17661,1269,16392,1639.2,115.3636364,12.91725768
NM_004397,DDX6,14,13,43501,6240,37261,2866.230769,445.7142857,5.971314103
NM_005188,CBL,16,15,101875,11247,90628,6041.866667,702.9375,8.057971014
NM_001257191,DDX6,14,13,43186,6168,37018,2847.538462,440.5714286,6.001621271
NM_015313,ARHGEF12,41,40,153029,9870,143159,3578.975,240.7317073,14.50445795
NM_001198665,ARHGEF12,40,39,153029,9812,143217,3672.230769,245.3,14.59610681
NM_005422,TECTA,23,22,88142,6491,81651,3711.409091,282.2173913,12.57910954
NM_003105,SORL1,48,47,181561,11021,170540,3628.510638,229.6041667,15.47409491
NM_003455,ZNF202,9,8,17368,4064,13304,1663,451.5555556,3.273622047
NM_024806,C11orf63,9,8,77196,3157,74039,9254.875,350.7777778,23.45232816
NM_024769,CLMP,7,6,122976,2637,120339,20056.5,376.7142857,45.63481229
NM_020716,GRAMD1B,20,19,102137,7926,94211,4958.473684,396.3,11.88632349
NM_001286563,GRAMD1B,21,20,102137,7948,94189,4709.45,378.4761905,11.85065425
NM_001286564,GRAMD1B,20,19,67511,7656,59855,3150.263158,382.8,7.818051202
NM_001130142,VWA5A,19,18,31509,3555,27954,1553,187.1052632,7.863291139
NM_024631,MSANTD2,4,3,33907,2229,31678,10559.33333,557.25,14.21175415
NM_001199922,SIAE,12,11,40516,3050,37466,3406,254.1666667,12.28393443
NM_014622,VWA5A,18,17,31509,3439,28070,1651.176471,191.0555556,8.16225647
NM_198315,VWA5A,10,9,9434,1868,7566,840.6666667,186.8,4.050321199
NM_170601,SIAE,10,9,38094,2917,35177,3908.555556,291.7,12.05930751
NM_001002905,OR8G1,2,1,15335,931,14404,14404,465.5,15.47153598
NM_022062,PKNOX2,13,12,268728,3743,264985,22082.08333,287.9230769,70.79481699
NM_001161707,KIRREL3,14,13,569931,2548,567383,43644.84615,182,222.6777865
NM_032531,KIRREL3,17,16,577372,3794,573578,35848.625,223.1764706,151.1802847
NM_024556,FAM118B,9,8,51262,2099,49163,6145.375,233.2222222,23.42210576
NM_001143820,ETS1,10,9,128799,5153,123646,13738.44444,515.3,23.9949544
NM_001167681,FLI1,10,9,119353,4045,115308,12812,404.5,28.50630408
NM_002017,FLI1,9,8,119353,3990,115363,14420.375,443.3333333,28.91303258
NM_001271012,FLI1,7,6,126734,3435,123299,20549.83333,490.7142857,35.89490539
NM_001271010,FLI1,10,9,119353,4162,115191,12799,416.2,27.67683806
NM_014715,ARHGAP32,13,12,59135,9456,49679,4139.916667,727.3846154,5.253701354
NM_153767,KCNJ1,4,3,29361,2759,26602,8867.333333,689.75,9.641899239
NM_153766,KCNJ1,3,2,29361,2625,26736,13368,875,10.18514286
NM_153765,KCNJ1,3,2,29361,2588,26773,13386.5,862.6666667,10.3450541
NM_153764,KCNJ1,2,1,29361,2454,26907,26907,1227,10.96454768
NM_006165,NFRKB,25,24,29236,5071,24165,1006.875,202.84,4.765332282
NM_001143835,NFRKB,27,26,31822,5078,26744,1028.615385,188.0740741,5.26664041
NM_007037,ADAMTS8,9,8,23723,3672,20051,2506.375,408,5.460511983
NM_014155,ZBTB44,6,5,88035,9346,78689,15737.8,1557.666667,8.41953777
NM_001271983,C11orf44,3,2,44398,3550,40848,20424,1183.333333,11.50647887
NM_002545,OPCML,7,6,528164,6307,521857,86976.16667,901,82.74250832
NM_015261,NCAPD3,35,34,72091,5640,66451,1954.441176,161.1428571,11.7820922
NM_032801,JAM3,9,8,82834,3677,79157,9894.625,408.5555556,21.52760403
NM_001205329,JAM3,8,7,82834,3523,79311,11330.14286,440.375,22.51234743
NM_001277285,IGSF9B,20,19,48131,4778,43353,2281.736842,238.9,9.073461699
NM_012239,SIRT3,7,6,21334,2909,18425,3070.833333,415.5714286,6.333791681
NM_001097610,LOC653486,3,2,1422,361,1061,530.5,120.3333333,2.939058172
NM_145651,SCGB1C1,3,2,1495,434,1061,530.5,144.6666667,2.444700461
NM_002817,PSMD13,13,12,16178,1770,14408,1200.666667,136.1538462,8.140112994
NM_016526,BET1L,3,2,4500,2959,1541,770.5,986.3333333,0.520784049
NM_001286134,RIC8A,10,9,7666,3775,3891,432.3333333,377.5,1.030728477
NM_021932,RIC8A,10,9,7666,3793,3873,430.3333333,379.3,1.021091484
NM_053280,ODF3,7,6,3499,1291,2208,368,184.4285714,1.710302091
NM_001098787,BET1L,4,3,4500,2819,1681,560.3333333,704.75,0.596310748
NM_001017524,SIRT3,7,6,21334,2763,18571,3095.166667,394.7142857,6.721317409
NM_175932,PSMD13,11,10,16178,1774,14404,1440.4,161.2727273,8.119503946
NM_001286136,ODF3,6,5,3499,1149,2350,470,191.5,2.045256745
NM_025092,ATHL1,14,13,6552,3282,3270,251.5384615,234.4285714,0.996343693
NM_006435,IFITM2,2,1,1305,732,573,573,366,0.782786885
NM_021034,IFITM3,2,1,1243,670,573,573,335,0.855223881
NM_003641,IFITM1,2,1,1283,719,564,564,359.5,0.784422809
NM_178537,B4GALNT4,20,19,12324,3474,8850,465.7894737,173.7,2.547495682
NM_001276700,NLRP6,8,7,6820,2768,4052,578.8571429,346,1.463872832
NM_001025295,IFITM5,2,1,1327,737,590,590,368.5,0.800542741
NM_138329,NLRP6,8,7,6820,2771,4049,578.4285714,346.375,1.461205341
NM_203389,RNH1,10,9,12773,1833,10940,1215.555556,183.3,5.968357883
NM_203388,RNH1,10,9,12773,1765,11008,1223.111111,176.5,6.236827195
NM_203387,RNH1,11,10,12773,2007,10766,1076.6,182.4545455,5.364225212
NM_203386,RNH1,11,10,12773,1939,10834,1083.4,176.2727273,5.587416194
NM_203385,RNH1,10,9,12311,1875,10436,1159.555556,187.5,5.565866667
NM_203384,RNH1,10,9,12311,1807,10504,1167.111111,180.7,5.81294964
NM_203383,RNH1,11,10,12311,1981,10330,1033,180.0909091,5.214538112
NM_007183,PKP3,13,12,10693,2822,7871,655.9166667,217.0769231,2.789156627
NM_001135053,SIGIRR,10,9,11683,1680,10003,1111.444444,168,5.954166667
NM_030783,PTDSS2,12,11,41109,2457,38652,3513.818182,204.75,15.73137973
NM_001012302,ANO9,23,22,24083,2898,21185,962.9545455,126,7.310213941
NM_001135054,SIGIRR,10,9,9285,1753,7532,836.8888889,175.3,4.296634341
NM_021805,SIGIRR,10,9,11683,1649,10034,1114.888889,164.9,6.084899939
NM_002939,RNH1,11,10,12311,2049,10262,1026.2,186.2727273,5.00829673
NM_173573,C11orf35,14,13,5931,2112,3819,293.7692308,150.8571429,1.808238636
NM_031264,CDHR5,14,13,8504,2921,5583,429.4615385,208.6428571,1.911331736
NM_003475,RASSF7,6,5,2577,1543,1034,206.8,257.1666667,0.670123137
NM_000797,DRD4,4,3,3402,1366,2036,678.6666667,341.5,1.490483163
NM_198075,LRRC56,14,13,17396,2788,14608,1123.692308,199.1428571,5.239598278
NM_001572,IRF7,11,10,3446,1983,1463,146.3,180.2727273,0.737771054
NM_020901,PHRF1,18,17,35778,5578,30200,1776.470588,309.8888889,5.414126927
NM_021924,CDHR5,15,14,8504,3504,5000,357.1428571,233.6,1.426940639
NM_021920,SCT,4,3,862,518,344,114.6666667,129.5,0.664092664
NM_001143994,RASSF7,5,4,2577,1459,1118,279.5,291.8,0.766278273
NM_001143993,RASSF7,4,3,3056,1733,1323,441,433.25,0.763416042
NM_001171968,CDHR5,15,14,8504,3486,5018,358.4285714,232.4,1.439472174
NM_001130442,HRAS,5,4,3310,1157,2153,538.25,231.4,1.860847018
NM_005343,HRAS,6,5,3310,1050,2260,452,175,2.152380952
NM_004031,IRF7,9,8,3175,2060,1115,139.375,228.8888889,0.541262136
NM_004029,IRF7,10,9,3446,1895,1551,172.3333333,189.5,0.818469657
NM_176795,HRAS,6,5,3310,1240,2070,414,206.6666667,1.669354839
NM_001286583,PHRF1,18,17,35778,5569,30209,1777,309.3888889,5.424492728
NM_001286582,PHRF1,18,17,35778,5575,30203,1776.647059,309.7222222,5.417578475
NM_001286581,PHRF1,18,17,35778,5581,30197,1776.294118,310.0555556,5.41067909
NM_001042463,TMEM80,5,4,8542,1655,6887,1721.75,331,4.161329305
NM_001276274,TMEM80,6,5,9439,1258,8181,1636.2,209.6666667,6.50317965
NM_001276253,TMEM80,4,3,8542,808,7734,2578,202,9.571782178
NM_006755,TALDO1,8,7,17594,1251,16343,2334.714286,156.375,13.06394884
NM_022772,EPS8L2,21,20,21609,3162,18447,922.35,150.5714286,5.833965844
NM_182612,PDDC1,8,7,10266,4370,5896,842.2857143,546.25,1.349199085
NM_174940,TMEM80,5,4,8542,1631,6911,1727.75,326.2,4.237277744
NM_021128,POLR2L,2,1,2810,878,1932,1932,439,2.200455581
NM_001142677,CHID1,12,11,43017,3243,39774,3615.818182,270.25,12.26456984
NM_001142676,CHID1,14,13,43017,3413,39604,3046.461538,243.7857143,11.60386757
NM_001142675,CHID1,13,12,47201,3551,43650,3637.5,273.1538462,12.29231202
NM_001142674,CHID1,14,13,43017,3442,39575,3044.230769,245.8571429,11.49767577
NM_001191060,SLC25A22,10,9,7522,2969,4553,505.8888889,296.9,1.533512967
NM_001191061,SLC25A22,10,9,7796,2638,5158,573.1111111,263.8,1.955269143
NM_020376,PNPLA2,10,9,6672,2437,4235,470.5555556,243.7,1.737792368
NM_024698,SLC25A22,10,9,5790,2806,2984,331.5555556,280.6,1.063435495
NM_023947,CHID1,13,12,43017,3337,39680,3306.666667,256.6923077,11.89091999
NM_001039490,CD151,8,7,5885,1491,4394,627.7142857,186.375,2.947015426
NM_145887,PIDD,16,15,6073,2973,3100,206.6666667,185.8125,1.042717793
NM_145886,PIDD,16,15,6073,3024,3049,203.2666667,189,1.008267196
NM_004357,CD151,9,8,5885,1558,4327,540.875,173.1111111,2.777278562
NM_003271,TSPAN4,9,8,24294,1421,22873,2859.125,157.8888889,16.09641098
NM_016564,CEND1,2,1,3018,1648,1370,1370,824,0.83131068
NM_139030,CD151,8,7,5885,1495,4390,627.1428571,186.875,2.936454849
NM_139029,CD151,9,8,5885,1554,4331,541.375,172.6666667,2.787001287
NM_001004,RPLP2,5,4,2942,498,2444,611,99.6,4.907630522
NM_001025239,TSPAN4,8,7,24294,1340,22954,3279.142857,167.5,17.12985075
NM_001025238,TSPAN4,8,7,24294,1320,22974,3282,165,17.40454545
NM_001025237,TSPAN4,9,8,22672,1471,21201,2650.125,163.4444444,14.41264446
NM_001025236,TSPAN4,9,8,24177,1439,22738,2842.25,159.8888889,15.80125087
NM_001025235,TSPAN4,9,8,24177,1434,22743,2842.875,159.3333333,15.85983264
NM_001025234,TSPAN4,9,8,23037,1435,21602,2700.25,159.4444444,15.05365854
NM_173584,EFCAB4A,8,7,3733,1671,2062,294.5714286,208.875,1.233991622
NM_001286606,EFCAB4A,9,8,3733,1839,1894,236.75,204.3333333,1.029907558
NM_012305,AP2A2,22,21,86438,4675,81763,3893.47619,212.5,17.48941176
NM_001242837,AP2A2,22,21,86438,4678,81760,3893.333333,212.6363636,17.47755451
NM_005961,MUC6,33,32,23884,8036,15848,495.25,243.5151515,1.972125436
NM_002457,MUC2,50,49,29543,8672,20871,425.9387755,173.44,2.406711255
NM_002458,MUC5B,49,48,39113,17965,21148,440.5833333,366.6326531,1.177177846
NM_001172223,MOB2,5,4,17265,1691,15574,3893.5,338.2,9.20993495
NM_001005922,KRTAP5-1,1,0,943,943,NA,NA,943,NA
NM_001012709,KRTAP5-4,1,0,1182,1182,NA,NA,1182,NA
NM_001012708,KRTAP5-3,1,0,900,900,NA,NA,900,NA
NM_001004325,KRTAP5-2,1,0,1119,1119,NA,NA,1119,NA
NM_001001480,KRTAP5-5,1,0,1128,1128,NA,NA,1128,NA
NM_004420,DUSP8,7,6,17871,4480,13391,2231.833333,640,2.9890625
NM_001012416,KRTAP5-6,1,0,562,562,NA,NA,562,NA
NM_001170820,IFITM10,3,2,18186,3712,14474,7237,1237.333333,3.89924569
NM_001909,CTSD,9,8,11242,2132,9110,1138.75,236.8888889,4.272983114
NM_006757,TNNT3,16,15,19139,1219,17920,1194.666667,76.1875,14.70057424
NM_002339,LSP1,11,10,39295,1710,37585,3758.5,155.4545455,21.97953216
NM_001145829,TNNI2,7,6,2193,746,1447,241.1666667,106.5714286,1.939678284
NM_003282,TNNI2,7,6,2679,738,1941,323.5,105.4285714,2.630081301
NM_001013255,LSP1,11,10,21341,1532,19809,1980.9,139.2727273,12.93015666
NM_001013253,LSP1,11,10,23592,1796,21796,2179.6,163.2727273,12.13585746
NM_138567,SYT8,9,8,3078,1432,1646,205.75,159.1111111,1.149441341
NM_001042782,TNNT3,15,14,19139,1194,17945,1281.785714,79.6,15.02931323
NM_001042781,TNNT3,16,15,19139,1213,17926,1195.066667,75.8125,14.77823578
NM_001042780,TNNT3,15,14,19139,1194,17945,1281.785714,79.6,15.02931323
NM_001013254,LSP1,11,10,21396,2026,19370,1937,184.1818182,9.56071076
NM_001145841,TNNI2,6,5,1480,706,774,154.8,117.6666667,1.09631728
NM_001289005,LSP1,11,10,22013,1892,20121,2012.1,172,10.63477801
NM_001242932,LSP1,12,11,27100,2028,25072,2279.272727,169,12.36291913
NM_021134,MRPL23,5,4,9339,747,8592,2148,149.4,11.50200803
NM_001185098,INS,2,1,1432,646,786,786,323,1.216718266
NM_001127598,IGF2,5,4,11996,4844,7152,1788,968.8,1.476465731
NM_199292,TH,14,13,7878,1924,5954,458,137.4285714,3.094594595
NM_001042376,INS-IGF2,5,4,14588,836,13752,3438,167.2,16.44976077
NM_000612,IGF2,4,3,9859,5169,4690,1563.333333,1292.25,0.907332173
NM_199293,TH,14,13,7878,1912,5966,458.9230769,136.5714286,3.120292887
NM_001007139,IGF2,5,4,20488,5144,15344,3836,1028.8,2.982892691
NM_000360,TH,13,12,7878,1830,6048,504,140.7692308,3.304918033
NM_001185097,INS,3,2,1432,494,938,469,164.6666667,1.898785425
NM_000207,INS,3,2,1432,468,964,482,156,2.05982906
NM_001142946,C11orf21,5,4,5638,2267,3371,842.75,453.4,1.486987208
NM_139022,TSPAN32,10,9,16189,1386,14803,1644.777778,138.6,10.68037518
NM_005170,ASCL2,2,1,2456,1851,605,605,925.5,0.326850351
NM_005706,TSSC4,2,1,1585,1426,159,159,713,0.111500701
NM_014555,TRPM5,24,23,18531,3952,14579,633.8695652,164.6666667,3.689018219
NM_004356,CD81,8,7,20104,1505,18599,2657,188.125,12.35813953
NM_007105,SLC22A18AS,4,3,15850,1551,14299,4766.333333,387.75,9.219213411
NM_183233,SLC22A18,11,10,25527,1553,23974,2397.4,141.1818182,15.43721829
NM_005969,NAP1L4,16,15,47949,2534,45415,3027.666667,158.375,17.9222573
NM_003311,PHLDA2,2,1,1149,922,227,227,461,0.246203905
NM_002555,SLC22A18,11,10,22966,1550,21416,2141.6,140.9090909,13.81677419
NM_000076,CDKN1C,3,2,2549,1933,616,308,644.3333333,0.318675634
NM_001122631,CDKN1C,4,3,2549,1762,787,262.3333333,440.5,0.446651532
NM_001122630,CDKN1C,4,3,2549,1767,782,260.6666667,441.75,0.442558008
NM_001014437,CARS,23,22,56531,2795,53736,2442.545455,121.5217391,19.22576029
NM_001194997,CARS,23,22,56531,2803,53728,2442.181818,121.8695652,19.16803425
NM_001751,CARS,22,21,56531,2545,53986,2570.761905,115.6818182,21.21257367
NM_139273,CARS,22,21,56531,2553,53978,2570.380952,116.0454545,21.14296906
NM_001164377,MRGPRG,1,0,871,871,NA,NA,871,NA
NM_001039165,MRGPRE,2,1,4577,1298,3279,3279,649,2.526194145
NM_007152,ZNF195,4,3,21297,3051,18246,6082,762.75,5.980334317
NM_001256825,ZNF195,5,4,21297,3151,18146,4536.5,630.2,5.758806728
NM_001256824,ZNF195,6,5,21297,3226,18071,3614.2,537.6666667,5.6016739
NM_001256823,ZNF195,6,5,21297,3190,18107,3621.4,531.6666667,5.676175549
NM_001242841,ZNF195,6,5,21297,3280,18017,3603.4,546.6666667,5.492987805
NM_001242843,ZNF195,5,4,21297,3132,18165,4541.25,626.4,5.799808429
NM_001242842,ZNF195,6,5,21297,3202,18095,3619,533.6666667,5.651155528
NM_001130520,ZNF195,6,5,21297,3269,18028,3605.6,544.8333333,5.514836341
NM_001130519,ZNF195,5,4,21297,3199,18098,4524.5,639.8,5.657392935
NM_001079536,ART5,5,4,3812,1254,2558,639.5,250.8,2.039872408
NM_053017,ART5,4,3,3751,1505,2246,748.6666667,376.25,1.492358804
NM_020402,CHRNA10,5,4,5799,1950,3849,962.25,390,1.973846154
NM_001256240,PGAP2,6,5,17837,1810,16027,3205.4,301.6666667,8.854696133
NM_014489,PGAP2,7,6,17837,1994,15843,2640.5,284.8571429,7.945336008
NM_001283040,PGAP2,5,4,28554,1451,27103,6775.75,290.2,18.67884218
NM_001283039,PGAP2,7,6,28554,1834,26720,4453.333333,262,14.56924755
NM_001665,RHOG,2,1,14007,1321,12686,12686,660.5,9.60333081
NM_001256235,PGAP2,8,7,28649,1823,26826,3832.285714,227.875,14.71530444
NM_001145438,PGAP2,7,6,28554,1869,26685,4447.5,267,14.2776886
NM_001256237,PGAP2,7,6,28554,1960,26594,4432.333333,280,13.56836735
NM_001256238,PGAP2,7,6,18363,1868,16495,2749.166667,266.8571429,8.830299786
NM_001256239,PGAP2,6,5,17837,1798,16039,3207.8,299.6666667,8.920467186
NM_001283038,PGAP2,7,6,28554,1881,26673,4445.5,268.7142857,14.18022329
NM_001256236,PGAP2,8,7,28554,2065,26489,3784.142857,258.125,12.82760291
NM_001033,RRM1,19,18,44184,3210,40974,2276.333333,168.9473684,12.76448598
NM_003141,TRIM21,7,6,8801,1936,6865,1144.166667,276.5714286,3.545971074
NM_001005161,OR52B4,1,0,1125,1125,NA,NA,1125,NA
NM_001005172,OR52K2,1,0,1068,1068,NA,NA,1068,NA
NM_001005171,OR52K1,1,0,1031,1031,NA,NA,1031,NA
NM_001004137,OR52M1,1,0,955,955,NA,NA,955,NA
NM_144663,C11orf40,4,3,6399,658,5741,1913.666667,164.5,8.724924012
NM_152430,OR51E1,2,1,11562,3106,8456,8456,1553,2.722472634
NM_018073,TRIM68,7,6,9589,3359,6230,1038.333333,479.8571429,1.854718666
NM_001005169,OR52I1,1,0,976,976,NA,NA,976,NA
NM_001005170,OR52I2,1,0,1116,1116,NA,NA,1116,NA
NM_001004751,OR51D1,1,0,1125,1125,NA,NA,1125,NA
NM_001005177,OR52R1,1,0,949,949,NA,NA,949,NA
NM_001004753,OR51F2,1,0,1030,1030,NA,NA,1030,NA
NM_001004752,OR51F1,1,0,940,940,NA,NA,940,NA
NM_001004748,OR51A2,1,0,943,943,NA,NA,943,NA
NM_001005329,OR51A4,1,0,943,943,NA,NA,943,NA
NM_001005238,OR51G2,1,0,946,946,NA,NA,946,NA
NM_001005237,OR51G1,1,0,967,967,NA,NA,967,NA
NM_001004759,OR51T1,1,0,1066,1066,NA,NA,1066,NA
NM_001004758,OR51S1,1,0,973,973,NA,NA,973,NA
NM_001004749,OR51A7,1,0,940,940,NA,NA,940,NA
NM_021801,MMP26,6,5,4237,997,3240,648,166.1666667,3.249749248
NM_001005164,OR52E2,1,0,979,979,NA,NA,979,NA
NM_001004755,OR51L1,1,0,949,949,NA,NA,949,NA
NM_001001916,OR52J3,1,0,937,937,NA,NA,937,NA
NM_012375,OR52A1,1,0,940,940,NA,NA,940,NA
NM_001005160,OR52A5,1,0,952,952,NA,NA,952,NA
NM_001004760,OR51V1,1,0,967,967,NA,NA,967,NA
NM_005330,HBE1,3,2,1795,819,976,488,273,1.191697192
NM_000519,HBD,3,2,1801,777,1024,512,259,1.317889318
NM_000184,HBG2,3,2,1592,586,1006,503,195.3333333,1.716723549
NM_033179,OR51B4,1,0,934,934,NA,NA,934,NA
NM_033180,OR51B2,1,0,1056,1056,NA,NA,1056,NA
NM_000518,HBB,3,2,1607,629,978,489,209.6666667,1.554848967
NM_000559,HBG1,3,2,1587,587,1000,500,195.6666667,1.703577513
NM_001004750,OR51B6,1,0,940,940,NA,NA,940,NA
NM_001005288,OR51I1,1,0,1013,1013,NA,NA,1013,NA
NM_001004757,OR51Q1,1,0,1097,1097,NA,NA,1097,NA
NM_001004756,OR51M1,1,0,1059,1059,NA,NA,1059,NA
NM_001004754,OR51I2,1,0,1071,1071,NA,NA,1071,NA
NM_001005289,OR52H1,1,0,964,964,NA,NA,964,NA
NM_145053,UBQLNL,1,0,2335,2335,NA,NA,2335,NA
NM_001198645,TRIM6,6,5,16325,2850,13475,2695,475,4.728070175
NM_058166,TRIM6,8,7,16859,3239,13620,1945.714286,404.875,4.205001544
NM_017481,UBQLN3,2,1,2625,2347,278,278,1173.5,0.118449084
NM_001198644,TRIM6,7,6,16325,2947,13378,2229.666667,421,4.539531727
NM_001003818,TRIM6,8,7,16325,3438,12887,1841,429.75,3.748400233
NM_001005163,OR52D1,1,0,1065,1065,NA,NA,1065,NA
NM_001005162,OR52B6,1,0,1009,1009,NA,NA,1009,NA
NM_130390,TRIM34,4,3,9043,961,8082,2694,240.25,8.409989594
NM_033034,TRIM5,8,7,21916,3407,18509,2644.142857,425.875,5.432638685
NM_001199573,TRIM22,8,7,21278,3087,18191,2598.714286,385.875,5.892776158
NM_006074,TRIM22,8,7,21278,3099,18179,2597,387.375,5.866085834
NM_021616,TRIM34,8,7,19420,2322,17098,2442.571429,290.25,7.363479759
NM_033093,TRIM5,8,7,21916,2037,19879,2839.857143,254.625,9.758959254
NM_033092,TRIM5,7,6,21916,3666,18250,3041.666667,523.7142857,4.978177851
NM_001003827,TRIM34,8,7,24453,2318,22135,3162.142857,289.75,9.549180328
NM_001005180,OR56B1,1,0,1092,1092,NA,NA,1092,NA
NM_001005175,OR52N4,1,0,1038,1038,NA,NA,1038,NA
NM_001005174,OR52N2,1,0,967,967,NA,NA,967,NA
NM_001005168,OR52E8,1,0,955,955,NA,NA,955,NA
NM_001005167,OR52E6,1,0,943,943,NA,NA,943,NA
NM_001001922,OR52N5,1,0,1035,1035,NA,NA,1035,NA
NM_001001913,OR52N1,1,0,964,964,NA,NA,964,NA
NM_001146033,OR56A5,1,0,943,943,NA,NA,943,NA
NM_001005179,OR56A4,1,0,1099,1099,NA,NA,1099,NA
NM_001005173,OR52L1,1,0,1095,1095,NA,NA,1095,NA
NM_001005165,OR52E4,1,0,940,940,NA,NA,940,NA
NM_001003443,OR56A3,1,0,949,949,NA,NA,949,NA
NM_001005181,OR56B4,1,0,961,961,NA,NA,961,NA
NM_001001917,OR56A1,1,0,1072,1072,NA,NA,1072,NA
NM_032127,FAM160A2,12,11,23379,3504,19875,1806.818182,292,5.672089041
NM_001037329,CNGA4,6,5,5387,1917,3470,694,319.5,1.810119979
NM_001098794,FAM160A2,12,11,23379,3462,19917,1810.636364,288.5,5.753032929
NM_173525,C11orf42,3,2,5569,1146,4423,2211.5,382,3.859511344
NM_001005178,OR52W1,1,0,964,964,NA,NA,964,NA
NM_001004052,OR52B2,1,0,973,973,NA,NA,973,NA
NM_000543,SMPD1,6,5,4586,2478,2108,421.6,413,0.850686037
NM_001007593,SMPD1,6,5,4586,2475,2111,422.2,412.5,0.852929293
NM_145040,PRKCDBP,2,1,1566,1039,527,527,519.5,0.507218479
NM_033278,TRIM3,12,11,25373,2893,22480,2043.636364,241.0833333,7.77048047
NM_006458,TRIM3,13,12,25373,3059,22314,1859.5,235.3076923,7.2945407
NM_012192,TIMM10B,3,2,3236,2845,391,195.5,948.3333333,0.137434095
NM_012402,ARFIP2,8,7,6798,3715,3083,440.4285714,464.375,0.829878869
NM_001242856,ARFIP2,6,5,6798,3493,3305,661,582.1666667,0.94617807
NM_001242855,ARFIP2,7,6,6798,3613,3185,530.8333333,516.1428571,0.881538887
NM_001242854,ARFIP2,8,7,6798,3854,2944,420.5714286,481.75,0.763881681
NM_001248007,TRIM3,11,10,25373,2719,22654,2265.4,247.1818182,8.33173961
NM_001248006,TRIM3,12,11,25848,3057,22791,2071.909091,254.75,7.455348381
NM_000613,HPX,10,9,9988,1633,8355,928.3333333,163.3,5.116350276
NM_173589,DNHD1,8,7,23573,3225,20348,2906.857143,403.125,6.309457364
NM_001278442,ILK,12,11,7169,1629,5540,503.6363636,135.75,3.400859423
NM_001278441,ILK,11,10,7169,1657,5512,551.2,150.6363636,3.326493663
NM_006284,TAF10,5,4,1429,822,607,151.75,164.4,0.738442822
NM_015324,RRP8,7,6,3738,1758,1980,330,251.1428571,1.126279863
NM_003737,DCHS1,21,20,34527,10780,23747,1187.35,513.3333333,2.202875696
NM_001014795,ILK,12,11,7067,2096,4971,451.9090909,174.6666667,2.371660305
NM_000391,TPP1,13,12,6697,3546,3151,262.5833333,272.7692308,0.888606881
NM_001014794,ILK,13,12,7169,1796,5373,447.75,138.1538462,2.991648107
NM_004517,ILK,13,12,7169,1842,5327,443.9166667,141.6923077,2.891965255
NM_022061,MRPL17,3,2,3018,2369,649,324.5,789.6666667,0.273955255
NM_001004490,OR2AG2,1,0,952,952,NA,NA,952,NA
NM_001004489,OR2AG1,1,0,999,999,NA,NA,999,NA
NM_207186,OR10A4,1,0,996,996,NA,NA,996,NA
NM_003696,OR6A2,1,0,1385,1385,NA,NA,1385,NA
NM_003700,OR2D2,1,0,928,928,NA,NA,928,NA
NM_178168,OR10A5,1,0,955,955,NA,NA,955,NA
NM_001004684,OR2D3,1,0,994,994,NA,NA,994,NA
NM_001004460,OR10A2,1,0,913,913,NA,NA,913,NA
NM_013250,ZNF215,7,6,31626,3665,27961,4660.166667,523.5714286,7.629195089
NM_013249,ZNF214,3,2,21039,2671,18368,9184,890.3333333,6.876825159
NM_014469,RBMXL2,1,0,2216,2216,NA,NA,2216,NA
NM_198474,OLFML1,3,2,26008,2906,23102,11551,968.6666667,7.949759119
NM_016229,CYB5R2,9,8,8497,1357,7140,892.5,150.7777778,5.261606485
NM_001256569,PPFIBP2,20,19,48033,2994,45039,2370.473684,149.7,15.04308617
NM_198185,OVCH2,17,16,17274,1911,15363,960.1875,112.4117647,8.039246468
NM_001256568,PPFIBP2,21,20,56581,3015,53566,2678.3,143.5714286,17.76650083
NM_153444,OR5P2,1,0,970,970,NA,NA,970,NA
NM_153445,OR5P3,1,0,937,937,NA,NA,937,NA
NM_176821,NLRP10,2,1,3905,2022,1883,1883,1011,0.931256182
NM_001004461,OR10A6,1,0,946,946,NA,NA,946,NA
NM_001003745,OR10A3,1,0,946,946,NA,NA,946,NA
NM_003754,EIF3F,8,7,8854,1265,7589,1084.142857,158.125,5.999209486
NM_024557,RIC3,6,5,62995,5815,57180,11436,969.1666667,9.833190026
NM_001206671,RIC3,6,5,62995,5818,57177,11435.4,969.6666667,9.827603988
NM_001135109,RIC3,2,1,62995,5268,57727,57727,2634,10.9580486
NM_001206672,RIC3,4,3,62995,5573,57422,19140.66667,1393.25,10.30360668
NM_000990,RPL27A,5,4,7426,4884,2542,635.5,976.8,0.52047502
NM_001286094,TMEM9B,4,3,17574,2088,15486,5162,522,7.416666667
NM_001286095,TMEM9B,5,4,17812,1738,16074,4018.5,347.6,9.248561565
NM_020645,NRIP3,7,6,23475,3816,19659,3276.5,545.1428571,5.15172956
NM_020643,C11orf16,7,6,12932,1932,11000,1833.333333,276,5.693581781
NM_020642,AKIP1,6,5,8927,1314,7613,1522.6,219,5.793759513
NM_001206648,AKIP1,4,3,8927,1150,7777,2592.333333,287.5,6.762608696
NM_001206647,AKIP1,5,4,8927,1232,7695,1923.75,246.4,6.245941558
NM_001206646,AKIP1,5,4,8927,1232,7695,1923.75,246.4,6.245941558
NM_020646,ASCL3,2,1,5463,652,4811,4811,326,7.378834356
NM_020644,TMEM9B,5,4,17574,2181,15393,3848.25,436.2,7.057771664
NM_001165030,TMEM41B,3,2,19678,865,18813,9406.5,288.3333333,21.74913295
NM_003442,ZNF143,16,15,67561,2963,64598,4306.533333,185.1875,21.80155248
NM_001282656,ZNF143,16,15,67561,2960,64601,4306.733333,185,21.82466216
NM_001282657,ZNF143,15,14,67561,2869,64692,4620.857143,191.2666667,22.54862321
NM_003390,WEE1,11,10,16087,3369,12718,1271.8,306.2727273,3.775007421
NM_001143976,WEE1,11,10,15081,3229,11852,1185.2,293.5454545,3.670486219
NM_001124,ADM,4,3,2283,1453,830,276.6666667,363.25,0.571231934
NM_016422,RNF141,6,5,29551,4090,25461,5092.2,681.6666667,6.225183374
NM_001190702,MTRNR2L8,1,0,1291,1291,NA,NA,1291,NA
NM_006691,LYVE1,6,5,10954,2506,8448,1689.6,417.6666667,3.371109338
NM_001172705,EIF4G2,22,21,10952,4050,6902,328.6666667,184.0909091,1.704197531
NM_014633,CTR9,25,24,28481,4334,24147,1006.125,173.36,5.571527457
NM_001418,EIF4G2,22,21,11991,3933,8058,383.7142857,178.7727273,2.048817696
NM_001042559,EIF4G2,21,20,11991,3818,8173,408.65,181.8095238,2.140649555
NM_001256686,CSNK2A3,1,0,1417,1417,NA,NA,1417,NA
NM_015881,DKK3,8,7,46088,2768,43320,6188.571429,346,15.65028902
NM_013253,DKK3,8,7,46376,2754,43622,6231.714286,344.25,15.83950617
NM_001018057,DKK3,7,6,45645,2585,43060,7176.666667,369.2857143,16.65764023
NM_001080521,RASSF10,1,0,2685,2685,NA,NA,2685,NA
NM_032320,BTBD10,9,8,75284,2516,72768,9096,279.5555556,28.92209857
NM_000315,PTH,3,2,3968,817,3151,1575.5,272.3333333,3.856793146
NM_032228,FAR1,12,11,63689,5287,58402,5309.272727,440.5833333,11.04634008
NM_001177315,RRAS2,6,5,80567,2178,78389,15677.8,363,35.9912764
NM_001177314,RRAS2,6,5,86588,2046,84542,16908.4,341,41.32062561
NM_012250,RRAS2,6,5,81266,2352,78914,15782.8,392,33.55187075
NM_001102669,RRAS2,6,5,80609,2201,78408,15681.6,366.8333333,35.62380736
NM_016451,COPB1,22,21,42357,3512,38845,1849.761905,159.6363636,11.0606492
NM_002786,PSMA1,10,9,15571,1264,14307,1589.666667,126.4,11.31882911
NM_001143937,PSMA1,5,4,6481,931,5550,1387.5,186.2,5.961331901
NM_001144061,COPB1,22,21,42394,3451,38943,1854.428571,156.8636364,11.2845552
NM_001144062,COPB1,22,21,42368,3390,38978,1856.095238,154.0909091,11.4979351
NM_024514,CYP2R1,5,4,14197,1623,12574,3143.5,324.6,7.747381392
NM_001033953,CALCA,5,4,5619,921,4698,1174.5,184.2,5.100977199
NM_001033952,CALCA,4,3,3786,802,2984,994.6666667,200.5,3.720698254
NM_001741,CALCA,4,3,3786,778,3008,1002.666667,194.5,3.866323907
NM_000728,CALCB,5,4,5033,1036,3997,999.25,207.2,3.858108108
NM_001017,RPS13,6,5,3283,535,2748,549.6,89.16666667,5.136448598
NM_000525,KCNJ11,1,0,3412,3412,NA,NA,3412,NA
NM_001166290,KCNJ11,2,1,4084,2758,1326,1326,1379,0.480783176
NM_001202439,NCR3LG1,5,4,25561,6387,19174,4793.5,1277.4,3.002035384
NM_001277269,OTOG,55,54,98573,8833,89740,1661.851852,160.6,10.15962867
NM_001112741,KCNC1,4,3,47109,3138,43971,14657,784.5,14.0124283
NM_004976,KCNC1,2,1,41884,6793,35091,35091,3396.5,5.165758869
NM_002478,MYOD1,3,2,2570,1809,761,380.5,603,0.420674406
NM_004179,TPH1,10,9,20253,1825,18428,2047.555556,182.5,10.09753425
NM_054032,MRGPRX4,1,0,1445,1445,NA,NA,1445,NA
NM_054031,MRGPRX3,3,2,17527,1642,15885,7942.5,547.3333333,9.674177832
NM_138421,SAAL1,12,11,25750,1543,24207,2200.636364,128.5833333,15.6882696
NM_001199744,SAA2-SAA4,6,5,17321,856,16465,3293,142.6666667,19.23481308
NM_030754,SAA2,4,3,3448,598,2850,950,149.5,4.765886288
NM_001127380,SAA2,4,3,10443,2047,8396,2798.666667,511.75,4.101612115
NM_001178006,SAA1,5,4,3717,596,3121,780.25,119.2,5.236577181
NM_007216,HPS5,22,21,43506,4745,38761,1845.761905,215.6818182,8.168809273
NM_000331,SAA1,4,3,3717,681,3036,1012,170.25,4.45814978
NM_006512,SAA4,4,3,5484,669,4815,1605,167.25,7.197309417
NM_199161,SAA1,4,3,3717,534,3183,1061,133.5,5.960674157
NM_181508,HPS5,22,21,43506,4558,38948,1854.666667,207.1818182,8.544975867
NM_181507,HPS5,23,22,43506,4903,38603,1754.681818,213.173913,7.873342851
NM_002301,LDHC,8,7,38942,1292,37650,5378.571429,161.5,29.14086687
NM_001165415,LDHA,7,6,13831,1946,11885,1980.833333,278,6.107399794
NM_001165416,LDHA,7,6,13831,2091,11740,1956.666667,298.7142857,5.614538498
NM_001165414,LDHA,8,7,11954,2313,9641,1377.285714,289.125,4.168179853
NM_001135239,LDHA,7,6,13831,2041,11790,1965,291.5714286,5.776580108
NM_017448,LDHC,8,7,38942,1238,37704,5386.285714,154.75,30.45557351
NM_005566,LDHA,8,7,13831,2216,11615,1659.285714,277,5.241425993
NM_001261382,UEVLD,11,10,57345,2370,54975,5497.5,215.4545455,23.19620253
NM_001261385,UEVLD,11,10,48117,2269,45848,4584.8,206.2727273,20.20625826
NM_001261386,UEVLD,7,6,57345,1773,55572,9262,253.2857143,31.34348562
NM_001040697,UEVLD,12,11,57345,2437,54908,4991.636364,203.0833333,22.53098071
NM_006292,TSG101,10,9,46647,1558,45089,5009.888889,155.8,28.94030809
NM_018314,UEVLD,11,10,57345,2312,55033,5503.3,210.1818182,23.80320069
NM_001261383,UEVLD,10,9,57345,2245,55100,6122.222222,224.5,24.54342984
NM_001261384,UEVLD,10,9,57345,2186,55159,6128.777778,218.6,25.23284538
NM_194285,SPTY2D1,6,5,28074,5740,22334,4466.8,956.6666667,3.890940767
NM_153347,TMEM86A,3,2,5983,3585,2398,1199,1195,0.668898187
NM_001039970,PTPN5,15,14,63916,3054,60862,4347.285714,203.6,19.92861821
NM_032781,PTPN5,15,14,63916,3105,60811,4343.642857,207,19.58486312
NM_001278236,PTPN5,15,14,64795,3888,60907,4350.5,259.2,15.66538066
NM_001278239,PTPN5,14,13,63916,2920,60996,4692,208.5714286,20.8890411
NM_006906,PTPN5,15,14,63916,3150,60766,4340.428571,210,19.29079365
NM_001278238,PTPN5,14,13,63916,3016,60900,4684.615385,215.4285714,20.19230769
NM_147199,MRGPRX1,1,0,1191,1191,NA,NA,1191,NA
NM_054030,MRGPRX2,2,1,6227,2037,4190,4190,1018.5,2.05694649
NM_024680,E2F8,13,12,16899,3734,13165,1097.083333,287.2307692,3.525709695
NM_003476,CSRP3,7,6,28543,1471,27072,4512,210.1428571,18.40380693
NM_019028,ZDHHC13,17,16,59277,2451,56826,3551.625,144.1764706,23.18482252
NM_001256372,E2F8,13,12,17594,3480,14114,1176.166667,267.6923077,4.055747126
NM_001256371,E2F8,13,12,17559,3535,14024,1168.666667,271.9230769,3.96718529
NM_001001483,ZDHHC13,16,15,59277,2304,56973,3798.2,144,24.72786458
NM_001029865,DBX1,4,3,4112,1036,3076,1025.333333,259,2.969111969
NM_006410,HTATIP2,6,5,20100,1379,18721,3744.2,229.8333333,13.57577955
NM_001098523,HTATIP2,2,1,3515,775,2740,2740,387.5,3.535483871
NM_001098522,HTATIP2,5,4,19928,1693,18235,4558.75,338.6,10.77082103
NM_001098520,HTATIP2,6,5,20042,1484,18558,3711.6,247.3333333,12.50539084
NM_001098521,HTATIP2,6,5,20084,1412,18672,3734.4,235.3333333,13.22379603
NM_004211,SLC6A5,16,15,55666,2879,52787,3519.133333,179.9375,18.33518583
NM_020346,SLC17A6,12,11,41381,3934,37447,3404.272727,327.8333333,9.518810371
NM_022725,FANCF,1,0,3310,3310,NA,NA,3310,NA
NM_148893,SVIP,4,3,7786,1393,6393,2131,348.25,4.589375449
NM_001195637,CCDC179,4,3,13506,804,12702,4234,201,15.79850746
NM_001135092,MUC15,4,3,13238,3246,9992,3330.666667,811.5,3.078250154
NM_001135091,MUC15,5,4,13238,3397,9841,2460.25,679.4,2.896967913
NM_145650,MUC15,4,3,13238,3308,9930,3310,827,3.001813785
NM_203371,FIBIN,1,0,3006,3006,NA,NA,3006,NA
NM_080654,CCDC34,3,2,14378,2123,12255,6127.5,707.6666667,5.772491757
NM_030771,CCDC34,6,5,24736,1489,23247,4649.4,248.1666667,15.61249161
NM_001143816,BDNF,2,1,4756,4523,233,233,2261.5,0.051514482
NM_001143814,BDNF,3,2,45595,4126,41469,20734.5,1375.333333,10.05065439
NM_001709,BDNF,2,1,45595,4018,41577,41577,2009,10.34768542
NM_001143813,BDNF,2,1,45595,4000,41595,41595,2000,10.39875
NM_001143812,BDNF,2,1,46007,3918,42089,42089,1959,10.74247065
NM_001143811,BDNF,4,3,46160,4178,41982,13994,1044.5,10.04834849
NM_001143810,BDNF,3,2,46160,4060,42100,21050,1353.333333,10.36945813
NM_001143809,BDNF,2,1,46160,3776,42384,42384,1888,11.22457627
NM_001143808,BDNF,2,1,46160,3766,42394,42394,1883,11.25703664
NM_001143807,BDNF,2,1,64854,3930,60924,60924,1965,15.50229008
NM_001143806,BDNF,2,1,65886,4044,61842,61842,2022,15.29228487
NM_001143805,BDNF,2,1,65886,3829,62057,62057,1914.5,16.20710368
NM_170733,BDNF,2,1,46740,4030,42710,42710,2015,10.59801489
NM_170731,BDNF,2,1,67165,4340,62825,62825,2170,14.47580645
NM_170735,BDNF,1,0,4756,4756,NA,NA,4756,NA
NM_170734,BDNF,2,1,44774,3979,40795,40795,1989.5,10.25257602
NM_170732,BDNF,2,1,65886,4127,61759,61759,2063.5,14.96462321
NM_002233,KCNA4,2,1,7291,4181,3110,3110,2090.5,0.743841186
NM_000510,FSHB,3,2,4263,1939,2324,1162,646.3333333,1.198555957
NM_001018080,FSHB,3,2,4263,1909,2354,1177,636.3333333,1.233106338
NM_152316,ARL14EP,4,3,14518,1774,12744,4248,443.5,7.183765502
NM_181706,DNAJC24,5,4,63007,3005,60002,15000.5,601,19.96738769
NM_001258464,PAX6,13,12,26563,6881,19682,1640.166667,529.3076923,2.860340067
NM_001258465,PAX6,12,11,26352,6866,19486,1771.454545,572.1666667,2.838042528
NM_000280,PAX6,13,12,26563,6979,19584,1632,536.8461538,2.806132684
NM_001127612,PAX6,13,12,33171,6893,26278,2189.833333,530.2307692,3.812273321
NM_001258463,PAX6,14,13,27393,6874,20519,1578.384615,491,2.985016002
NM_001604,PAX6,14,13,26563,6924,19639,1510.692308,494.5714286,2.836366262
NM_001258462,PAX6,14,13,33171,6936,26235,2018.076923,495.4285714,3.782439446
NM_024424,WT1,10,9,47761,3027,44734,4970.444444,302.7,14.77832838
NM_000378,WT1,9,8,47761,2975,44786,5598.25,330.5555556,15.05411765
NM_001198552,WT1,9,8,43043,2436,40607,5075.875,270.6666667,16.66954023
NM_001198551,WT1,10,9,43043,2479,40564,4507.111111,247.9,16.36304962
NM_024426,WT1,10,9,47761,3036,44725,4969.444444,303.6,14.73155468
NM_006360,EIF3M,11,10,18726,1349,17377,1737.7,122.6363636,12.88139362
NM_024081,PRRG4,6,5,28190,5544,22646,4529.2,924,4.084776335
NM_001076786,QSER1,13,12,87024,9282,77742,6478.5,714,8.375565611
NM_018393,TCP11L1,10,9,34148,2827,31321,3480.111111,282.7,11.07923594
NM_001145541,TCP11L1,10,9,33550,2643,30907,3434.111111,264.3,11.69390844
NM_001077242,DEPDC7,9,8,17720,1764,15956,1994.5,196,9.045351474
NM_139160,DEPDC7,9,8,17402,2003,15399,1924.875,222.5555556,7.687968048
NM_001033506,CSTF3,2,1,20062,751,19311,19311,375.5,25.71371505
NM_001033505,CSTF3,3,2,20062,630,19432,9716,210,30.84444444
NM_203331,CD59,5,4,33471,7669,25802,6450.5,1533.8,3.364454297
NM_203330,CD59,6,5,33471,7786,25685,5137,1297.666667,3.298869766
NM_203329,CD59,5,4,33471,7740,25731,6432.75,1548,3.324418605
NM_012175,FBXO3,11,10,33583,2419,31164,3116.4,219.9090909,12.88300951
NM_001127223,CD59,3,2,19719,7788,11931,5965.5,2596,1.531972265
NM_000611,CD59,4,3,33471,7623,25848,8616,1905.75,3.390791027
NM_033406,FBXO3,10,9,27782,1662,26120,2902.222222,166.2,15.71600481
NM_001166692,C11orf91,2,1,2634,905,1729,1729,452.5,1.910497238
NM_001127227,CD59,4,3,19944,7561,12383,4127.666667,1890.25,1.63774633
NM_001127226,CD59,4,3,19719,7617,12102,4034,1904.25,1.588814494
NM_001127225,CD59,4,3,19719,7682,12037,4012.333333,1920.5,1.566909659
NM_001142316,LMO2,3,2,11250,1698,9552,4776,566,5.625441696
NM_001142315,LMO2,4,3,11388,1599,9789,3263,399.75,6.12195122
NM_005574,LMO2,6,5,33715,2299,31416,6283.2,383.1666667,13.66507177
NM_024662,NAT10,29,28,41349,4070,37279,1331.392857,140.3448276,9.159459459
NM_001144030,NAT10,27,26,41349,3853,37496,1442.153846,142.7037037,9.731637685
NM_198381,ELF5,7,6,33006,2458,30548,5091.333333,351.1428571,12.42799024
NM_001422,ELF5,7,6,35007,2326,32681,5446.833333,332.2857143,14.05030095
NM_001243080,ELF5,5,4,35007,2039,32968,8242,407.8,16.16871015
NM_001243081,ELF5,6,5,33006,2223,30783,6156.6,370.5,13.84750337
NM_012153,EHF,9,8,42248,5459,36789,4598.625,606.5555556,6.739146364
NM_001206616,EHF,9,8,30825,5460,25365,3170.625,606.6666667,4.645604396
NM_001206615,EHF,8,7,42248,5389,36859,5265.571429,673.625,6.839673409
NM_015957,APIP,7,6,34117,1284,32833,5472.166667,183.4285714,25.57087227
NM_001202556,CD44,8,7,93534,4534,89000,12714.28571,566.75,19.62946625
NM_001202557,CD44,9,8,84452,2270,82182,10272.75,252.2222222,36.20352423
NM_001202555,CD44,10,9,93534,4803,88731,9859,480.3,18.4740787
NM_000610,CD44,18,17,93534,5750,87784,5163.764706,319.4444444,15.26678261
NM_001001389,CD44,17,16,93534,5620,87914,5494.625,330.5882353,15.6430605
NM_001001392,CD44,4,3,93534,3973,89561,29853.66667,993.25,22.54241128
NM_001001391,CD44,9,8,93534,4598,88936,11117,510.8888889,19.34232275
NM_001001390,CD44,12,11,93534,4997,88537,8048.818182,416.4166667,17.71803082
NM_014344,FJX1,1,0,2688,2688,NA,NA,2688,NA
NM_145803,TRAF6,8,7,26548,8029,18519,2645.571429,1003.625,2.306513887
NM_004620,TRAF6,7,6,26548,7935,18613,3102.166667,1133.571429,2.34568368
NM_001276727,C11orf74,4,3,64800,676,64124,21374.66667,169,94.85798817
NM_001276725,C11orf74,4,3,64800,845,63955,21318.33333,211.25,75.68639053
NM_001276724,C11orf74,6,5,64521,944,63577,12715.4,157.3333333,67.34851695
NM_001276722,C11orf74,6,5,64800,1069,63731,12746.2,178.1666667,59.61739944
NM_001243786,RAG2,3,2,6338,2823,3515,1757.5,941,1.245129295
NM_001243785,RAG2,3,2,6338,2629,3709,1854.5,876.3333333,1.410802587
NM_000536,RAG2,2,1,6338,2433,3905,3905,1216.5,1.605014386
NM_001276723,C11orf74,6,5,64800,949,63851,12770.2,158.1666667,67.28240253
NM_001276726,C11orf74,4,3,64800,725,64075,21358.33333,181.25,88.37931034
NM_138787,C11orf74,6,5,64800,900,63900,12780,150,71
NM_000448,RAG1,2,1,11749,6582,5167,5167,3291,0.785019751
NM_001243747,API5,11,10,32577,3255,29322,2932.2,295.9090909,9.008294931
NM_006595,API5,14,13,32577,3777,28800,2215.384615,269.7857143,7.625099285
NM_001142931,API5,13,12,32577,3614,28963,2413.583333,278,8.014111787
NM_001142930,API5,14,13,32577,3782,28795,2215,270.1428571,7.613696457
NM_001145033,C11orf96,1,0,1329,1329,NA,NA,1329,NA
NM_001031854,ACCSL,14,13,11998,1834,10164,781.8461538,131,5.541984733
NM_032592,ACCS,15,14,17759,2188,15571,1112.214286,145.8666667,7.11654479
NM_001127219,ACCS,15,14,17842,1892,15950,1139.285714,126.1333333,8.430232558
NM_001024844,CD82,9,8,54176,1625,52551,6568.875,180.5555556,32.33907692
NM_002231,CD82,10,9,54176,1701,52475,5830.555556,170.1,30.84950029
NM_020826,SYT13,6,5,46033,5163,40870,8174,860.5,7.915940345
NM_001247987,SYT13,8,7,46033,5383,40650,5807.142857,672.875,7.55155118
NM_003654,CHST1,4,3,17969,3944,14025,4675,986,3.556034483
NM_018389,SLC35C1,2,1,7928,3490,4438,4438,1745,1.271633238
NM_001145266,SLC35C1,3,2,8946,3120,5826,2913,1040,1.867307692
NM_001145265,SLC35C1,3,2,8946,3217,5729,2864.5,1072.333333,1.780851725
NM_057174,PEX16,11,10,8456,1784,6672,667.2,162.1818182,3.739910314
NM_001080446,C11orf94,3,2,749,371,378,189,123.6666667,1.018867925
NM_005456,MAPK8IP1,12,11,20971,3217,17754,1614,268.0833333,5.518806341
NM_152312,GYLTL1B,14,13,7453,2542,4911,377.7692308,181.5714286,1.931943352
NM_004813,PEX16,11,10,8456,1919,6537,653.7,174.4545455,3.406461699
NM_052854,CREB3L1,12,11,43785,2722,41063,3733,226.8333333,15.08559882
NM_002391,MDK,5,4,2184,885,1299,324.75,177,1.46779661
NM_001012334,MDK,5,4,2771,1002,1769,442.25,200.4,1.765469062
NM_001012333,MDK,5,4,2128,956,1172,293,191.2,1.225941423
NM_001270552,MDK,4,3,2184,716,1468,489.3333333,179,2.05027933
NM_001270551,MDK,4,3,2128,1126,1002,334,281.5,0.889875666
NM_001270550,MDK,5,4,3055,1181,1874,468.5,236.2,1.586790855
NM_000741,CHRM4,1,0,1469,1469,NA,NA,1469,NA
NM_173811,HARBI1,3,2,13923,1525,12398,6199,508.3333333,8.129836066
NM_024741,ZNF408,5,4,5151,2502,2649,662.25,500.4,1.058752998
NM_000506,F2,14,13,20315,2024,18291,1407,144.5714286,9.037055336
NM_001184751,ZNF408,5,4,4824,2217,2607,651.75,443.4,1.175913396
NM_004308,ARHGAP1,13,12,23592,3459,20133,1677.75,266.0769231,5.820468343
NM_016223,PACSIN3,11,10,8939,1909,7030,703,173.5454545,3.682556312
NM_005693,NR1H3,10,9,11118,1941,9177,1019.666667,194.1,4.72797527
NM_000107,DDB2,10,9,24278,1858,22420,2491.111111,185.8,12.06673843
NM_001251935,NR1H3,10,9,20735,1930,18805,2089.444444,193,9.743523316
NM_001251934,NR1H3,10,9,20735,1889,18846,2094,188.9,9.976707253
NM_001610,ACP2,11,10,9606,2214,7392,739.2,201.2727273,3.338753388
NM_001131064,ACP2,4,3,3389,734,2655,885,183.5,3.617166213
NM_001130102,NR1H3,9,8,20137,1749,18388,2298.5,194.3333333,10.51343625
NM_001130101,NR1H3,9,8,11118,1760,9358,1169.75,195.5555556,5.317045455
NM_001184975,PACSIN3,11,10,8361,2038,6323,632.3,185.2727273,3.102551521
NM_001184974,PACSIN3,11,10,8939,1905,7034,703.4,173.1818182,3.692388451
NM_003120,SPI1,5,4,23720,1410,22310,5577.5,282,15.82269504
NM_001128225,SLC39A13,10,9,8007,2439,5568,618.6666667,243.9,2.282902829
NM_001080547,SPI1,5,4,23720,1413,22307,5576.75,282.6,15.78697806
NM_002804,PSMC3,12,11,7706,1592,6114,555.8181818,132.6666667,3.840452261
NM_152264,SLC39A13,10,9,8007,2439,5568,618.6666667,243.9,2.282902829
NM_000256,MYBPC3,34,33,21298,4251,17049,516.6363636,125.0294118,4.010585745
NM_001025596,CELF1,13,12,23089,4478,18611,1550.916667,344.4615385,4.156096472
NM_032645,RAPSN,6,5,11424,1500,9924,1984.8,250,6.616
NM_006560,CELF1,14,13,87305,4716,82589,6353,336.8571429,17.5125106
NM_198700,CELF1,14,13,28586,4661,23925,1840.384615,332.9285714,5.133018666
NM_001172640,CELF1,13,12,23089,7686,15403,1283.583333,591.2307692,2.004033307
NM_001172639,CELF1,16,15,58053,7441,50612,3374.133333,465.0625,6.801773955
NM_005055,RAPSN,8,7,11424,1679,9745,1392.142857,209.875,5.80405003
NM_016506,KBTBD4,4,3,6774,2465,4309,1436.333333,616.25,1.748073022
NM_001164379,FAM180B,3,2,2518,1406,1112,556,468.6666667,0.790896159
NM_031909,C1QTNF4,2,1,4747,1416,3331,3331,708,2.35240113
NM_014342,MTCH2,13,12,25350,2641,22709,1892.416667,203.1538462,8.59863688
NM_018095,KBTBD4,4,3,6820,2406,4414,1471.333333,601.5,1.834580216
NM_001143984,PTPMT1,2,1,8033,2550,5483,5483,1275,2.150196078
NM_004551,NDUFS3,7,6,5555,966,4589,764.8333333,138,4.750517598
NM_175732,PTPMT1,4,3,8033,2635,5398,1799.333333,658.75,2.04857685
NM_015308,FNBP4,17,16,50926,4129,46797,2924.8125,242.8823529,11.33373698
NM_001005470,OR4B1,1,0,931,931,NA,NA,931,NA
NM_001004727,OR4X2,1,0,913,913,NA,NA,913,NA
NM_001004726,OR4X1,1,0,919,919,NA,NA,919,NA
NM_001004725,OR4S1,1,0,931,931,NA,NA,931,NA
NM_001004702,OR4C3,1,0,991,991,NA,NA,991,NA
NM_001005513,OR4C45,2,1,7101,921,6180,6180,460.5,6.71009772
NM_001005512,OR4A47,1,0,931,931,NA,NA,931,NA
NM_001206626,TRIM49B,6,5,6379,1365,5014,1002.8,227.5,3.673260073
NM_001206631,TRIM64C,6,5,5400,1359,4041,808.2,226.5,2.973509934
NM_001014986,FOLH1,18,17,62037,2560,59477,3498.647059,142.2222222,23.23320313
NM_001193472,FOLH1,19,18,62037,2658,59379,3298.833333,139.8947368,22.33972912
NM_001193471,FOLH1,20,19,62037,2752,59285,3120.263158,137.6,21.54251453
NM_001193473,FOLH1,17,16,62037,2278,59759,3734.9375,134,26.23309921
NM_004476,FOLH1,19,18,62037,2654,59383,3299.055556,139.6842105,22.3749058
NM_001005270,OR4C12,1,0,1064,1064,NA,NA,1064,NA
NM_001001955,OR4C13,1,0,1030,1030,NA,NA,1030,NA
NM_001005272,OR4A5,1,0,1072,1072,NA,NA,1072,NA
NM_001004703,OR4C46,1,0,931,931,NA,NA,931,NA
NM_024114,TRIM48,6,5,8939,1451,7488,1497.6,241.8333333,5.160578911
NM_001005275,OR4A15,1,0,1036,1036,NA,NA,1036,NA
NM_001005274,OR4A16,1,0,988,988,NA,NA,988,NA
NM_001004124,OR4P4,1,0,940,940,NA,NA,940,NA
NM_001004704,OR4C6,1,0,931,931,NA,NA,931,NA
NM_001004701,OR4C16,1,0,934,934,NA,NA,934,NA
NM_001004700,OR4C11,1,0,1046,1046,NA,NA,1046,NA
NM_001004059,OR4S2,1,0,937,937,NA,NA,937,NA
NM_001001920,OR4C15,1,0,1114,1114,NA,NA,1114,NA
NM_001004735,OR5D14,1,0,946,946,NA,NA,946,NA
NM_001001967,OR5D13,1,0,946,946,NA,NA,946,NA
NM_001005496,OR5D16,1,0,988,988,NA,NA,988,NA
NM_006637,OR5I1,1,0,946,946,NA,NA,946,NA
NM_032681,TRIM51,7,6,8513,1634,6879,1146.5,233.4285714,4.209914321
NM_001004739,OR5L2,1,0,937,937,NA,NA,937,NA
NM_001004738,OR5L1,1,0,937,937,NA,NA,937,NA
NM_001001960,OR5W2,1,0,934,934,NA,NA,934,NA
NM_001001952,OR5D18,1,0,943,943,NA,NA,943,NA
NM_001005491,OR10AG1,1,0,907,907,NA,NA,907,NA
NM_003697,OR5F1,1,0,946,946,NA,NA,946,NA
NM_001001921,OR5AS1,1,0,976,976,NA,NA,976,NA
NM_001005492,OR5J2,1,0,940,940,NA,NA,940,NA
NM_001005201,OR8H3,1,0,940,940,NA,NA,940,NA
NM_001005200,OR8H2,1,0,940,940,NA,NA,940,NA
NM_001004064,OR8J3,1,0,949,949,NA,NA,949,NA
NM_001004058,OR8K5,1,0,925,925,NA,NA,925,NA
NM_001003750,OR8I2,1,0,934,934,NA,NA,934,NA
NM_001005199,OR8H1,1,0,937,937,NA,NA,937,NA
NM_001005202,OR8K3,1,0,940,940,NA,NA,940,NA
NM_001004747,OR5T3,1,0,1024,1024,NA,NA,1024,NA
NM_001004746,OR5T2,1,0,1081,1081,NA,NA,1081,NA
NM_001004745,OR5T1,1,0,982,982,NA,NA,982,NA
NM_001013356,OR8U8,2,1,877,868,9,9,434,0.010368664
NM_001005204,OR8U1,1,0,931,931,NA,NA,931,NA
NM_001005205,OR8J1,1,0,1075,1075,NA,NA,1075,NA
NM_001004744,OR5R1,1,0,976,976,NA,NA,976,NA
NM_001002907,OR8K1,1,0,961,961,NA,NA,961,NA
NM_001005245,OR5M11,1,0,919,919,NA,NA,919,NA
NM_001005282,OR5M8,1,0,937,937,NA,NA,937,NA
NM_001004743,OR5M9,1,0,934,934,NA,NA,934,NA
NM_001004742,OR5M3,1,0,1052,1052,NA,NA,1052,NA
NM_001004741,OR5M10,1,0,949,949,NA,NA,949,NA
NM_001002925,OR5AP2,1,0,952,952,NA,NA,952,NA
NM_001013358,OR9G9,1,0,919,919,NA,NA,919,NA
NM_001005213,OR9G1,1,0,919,919,NA,NA,919,NA
NM_001004740,OR5M1,1,0,949,949,NA,NA,949,NA
NM_001004730,OR5AR1,1,0,934,934,NA,NA,934,NA
NM_001005284,OR9G4,1,0,985,985,NA,NA,985,NA
NM_001005323,OR5AK2,1,0,931,931,NA,NA,931,NA
NM_001005210,LRRC55,2,1,9969,5409,4560,4560,2704.5,0.843039379
NM_005161,APLNR,1,0,3877,3877,NA,NA,3877,NA
NM_003146,SSRP1,17,16,9894,2836,7058,441.125,166.8235294,2.488716502
NM_002559,P2RX3,12,11,31710,1469,30241,2749.181818,122.4166667,20.586113
NM_033396,TNKS1BP1,12,11,25312,5832,19480,1770.909091,486,3.340192044
NM_001278201,SLC43A3,14,13,20196,2693,17503,1346.384615,192.3571429,6.499443
NM_001278206,SLC43A3,14,13,20196,2736,17460,1343.076923,195.4285714,6.381578947
NM_014096,SLC43A3,14,13,20135,2775,17360,1335.384615,198.2142857,6.255855856
NM_178570,RTN4RL2,3,2,17004,2223,14781,7390.5,741,6.649122807
NM_002728,PRG2,6,5,3298,863,2435,487,143.8333333,2.821552723
NM_017611,SLC43A3,14,13,20628,2611,18017,1385.923077,186.5,6.900421295
NM_001243245,PRG2,6,5,3298,830,2468,493.6,138.3333333,2.973493976
NM_199329,SLC43A3,14,13,20196,2660,17536,1348.923077,190,6.592481203
NM_001032295,SERPING1,7,6,16623,1821,14802,2467,260.1428571,8.128500824
NM_000062,SERPING1,8,7,17301,1974,15327,2189.571429,246.75,7.76443769
NM_012456,TIMM10,3,2,2298,677,1621,810.5,225.6666667,2.394387001
NM_001105565,SMTNL1,7,6,7635,1656,5979,996.5,236.5714286,3.610507246
NM_004223,UBE2L6,4,3,16054,1265,14789,4929.666667,316.25,11.69090909
NM_198183,UBE2L6,4,3,16677,1624,15053,5017.666667,406,9.26908867
NM_006831,CLP1,3,2,4123,1849,2274,1137,616.3333333,1.229853975
NM_170746,C11orf31,4,3,2163,1298,865,288.3333333,324.5,0.666409861
NM_145008,YPEL4,5,4,4859,1727,3132,783,345.4,1.813549508
NM_015457,ZDHHC5,12,11,33187,4572,28615,2601.363636,381,6.258748906
NM_015959,TMX2,8,7,28452,1723,26729,3818.428571,215.375,15.51305862
NM_001144012,TMX2,7,6,28452,1608,26844,4474,229.7142857,16.69402985
NM_001142597,CLP1,3,2,4123,1657,2466,1233,552.3333333,1.488231744
NM_001145101,BTBD18,3,2,8269,3051,5218,2609,1017,1.710258931
NM_153450,MED19,4,3,8488,1518,6970,2323.333333,379.5,4.591567852
NM_001005186,OR6Q1,1,0,955,955,NA,NA,955,NA
NM_001005211,OR9I1,1,0,946,946,NA,NA,946,NA
NM_207374,OR10W1,1,0,1470,1470,NA,NA,1470,NA
NM_001005283,OR9Q2,1,0,1086,1086,NA,NA,1086,NA
NM_001004471,OR10Q1,1,0,1038,1038,NA,NA,1038,NA
NM_001004459,OR1S2,1,0,979,979,NA,NA,979,NA
NM_001004458,OR1S1,1,0,979,979,NA,NA,979,NA
NM_001005489,OR5B17,1,0,946,946,NA,NA,946,NA
NM_001005566,OR5B2,1,0,1050,1050,NA,NA,1050,NA
NM_001005469,OR5B3,1,0,946,946,NA,NA,946,NA
NM_001005218,OR5B21,1,0,931,931,NA,NA,931,NA
NM_001004733,OR5B12,1,0,1055,1055,NA,NA,1055,NA
NM_001197051,ZFP91,11,10,42438,5733,36705,3670.5,521.1818182,6.402407117
NM_053023,ZFP91,11,10,42438,5736,36702,3670.2,521.4545455,6.398535565
NM_000614,CNTF,2,1,3061,1895,1166,1166,947.5,0.61530343
NM_005838,GLYAT,5,4,21888,1150,20738,5184.5,230,18.03304348
NM_201648,GLYAT,6,5,23219,2061,21158,4231.6,343.5,10.26589034
NM_145016,GLYATL2,6,5,10459,1384,9075,1815,230.6666667,6.557080925
NM_198847,FAM111A,4,3,10261,3559,6702,2234,889.75,1.883113234
NM_001142704,FAM111B,2,1,20232,3351,16881,16881,1675.5,5.037600716
NM_001142703,FAM111B,3,2,20232,3397,16835,8417.5,1132.333333,4.955843391
NM_022074,FAM111A,4,3,10261,3598,6663,2221,899.5,1.851862146
NM_015177,DTX4,9,8,36250,5804,30446,3805.75,644.8888889,5.245692626
NM_198947,FAM111B,4,3,20232,3565,16667,5555.666667,891.25,4.675175316
NM_001142521,FAM111A,5,4,12195,3602,8593,2148.25,720.4,2.3856191
NM_001142520,FAM111A,5,4,12195,3789,8406,2101.5,757.8,2.218527316
NM_001142519,FAM111A,5,4,12195,3766,8429,2107.25,753.2,2.238183749
NM_001039396,MPEG1,1,0,4513,4513,NA,NA,4513,NA
NM_001004729,OR5AN1,1,0,937,937,NA,NA,937,NA
NM_001004728,OR5A1,1,0,949,949,NA,NA,949,NA
NM_001004708,OR4D6,1,0,946,946,NA,NA,946,NA
NM_001001954,OR5A2,1,0,976,976,NA,NA,976,NA
NM_001004706,OR4D11,1,0,937,937,NA,NA,937,NA
NM_001004711,OR4D9,1,0,946,946,NA,NA,946,NA
NM_001004705,OR4D10,1,0,937,937,NA,NA,937,NA
NM_001005324,OR10V1,1,0,931,931,NA,NA,931,NA
NM_152716,PATL1,19,18,32321,4146,28175,1565.277778,218.2105263,6.795706705
NM_001178040,STX3,10,9,50825,6371,44454,4939.333333,637.1,6.977554544
NM_001062,TCN1,9,8,13762,1576,12186,1523.25,175.1111111,7.732233503
NM_017840,MRPL16,4,3,4739,1186,3553,1184.333333,296.5,2.995784148
NM_005142,GIF,9,8,16230,1522,14708,1838.5,169.1111111,9.663600526
NM_004177,STX3,11,10,50825,6486,44339,4433.9,589.6363636,6.836108541
NM_001031666,MS4A3,5,4,14489,1351,13138,3284.5,270.2,9.724648409
NM_000139,MS4A2,7,6,9805,3655,6150,1025,522.1428571,1.682626539
NM_006138,MS4A3,7,6,14489,1662,12827,2137.833333,237.4285714,7.717809868
NM_001031809,MS4A3,6,5,14489,1523,12966,2593.2,253.8333333,8.513460276
NM_001256916,MS4A2,6,5,9805,3519,6286,1257.2,586.5,1.786302927
NM_173801,OOSP2,4,3,7770,1636,6134,2044.666667,409,3.749388753
NM_152852,MS4A6A,8,7,13061,1799,11262,1608.857143,224.875,6.260144525
NM_152851,MS4A6A,7,6,11726,1569,10157,1692.833333,224.1428571,6.473550032
NM_001247999,MS4A6A,7,6,12170,1745,10425,1737.5,249.2857143,5.974212034
NM_022349,MS4A6A,6,5,10835,1555,9280,1856,259.1666667,5.967845659
NM_024021,MS4A4A,8,7,28433,1803,26630,3804.285714,225.375,14.76982806
NM_148975,MS4A4A,7,6,28433,1656,26777,4462.833333,236.5714286,16.16968599
NM_001243266,MS4A4A,6,5,28433,1496,26937,5387.4,249.3333333,18.00601604
NM_139249,MS4A6E,4,3,6088,664,5424,1808,166,8.168674699
NM_001164470,MS4A12,6,5,14652,1033,13619,2723.8,172.1666667,13.1839303
NM_001261828,MS4A14,6,5,21743,3457,18286,3657.2,576.1666667,5.28955742
NM_001261827,MS4A14,5,4,21743,3405,18338,4584.5,681,5.385609398
NM_021950,MS4A1,7,6,14945,3338,11607,1934.5,476.8571429,3.477231875
NM_001079692,MS4A14,4,3,21743,3305,18438,6146,826.25,5.57881997
NM_023945,MS4A5,5,4,18205,727,17478,4369.5,145.4,24.04126547
NM_032597,MS4A14,5,4,21743,3357,18386,4596.5,671.4,5.476913911
NM_152866,MS4A1,8,7,14945,3602,11343,1620.428571,450.25,3.149083842
NM_017716,MS4A12,7,6,14652,1172,13480,2246.666667,167.4285714,11.50170648
NM_001278242,MS4A15,6,5,19866,1842,18024,3604.8,307,9.785016287
NM_031457,MS4A8,7,6,16240,1361,14879,2479.833333,194.4285714,10.93240265
NM_152717,MS4A15,6,5,19866,1678,18188,3637.6,279.6666667,10.83909416
NM_001098835,MS4A15,7,6,19866,1966,17900,2983.333333,280.8571429,9.104781282
NM_024098,CCDC86,4,3,9134,2019,7115,2371.666667,504.75,3.524021793
NM_014502,PRPF19,16,15,16043,2356,13687,912.4666667,147.25,5.80942275
NM_004778,PTGDR2,2,1,5048,2912,2136,2136,1456,0.733516484
NM_207341,ZP1,12,11,8151,1984,6167,560.6363636,165.3333333,3.108366935
NM_006725,CD6,13,12,48737,3303,45434,3786.166667,254.0769231,13.7553739
NM_017870,TMEM132A,11,10,12720,3531,9189,918.9,321,2.602378929
NM_016582,SLC15A3,8,7,14704,2124,12580,1797.142857,265.5,5.922787194
NM_001254751,CD6,11,10,48737,3073,45664,4566.4,279.3636364,14.85974618
NM_001254750,CD6,11,10,48737,3100,45637,4563.7,281.8181818,14.7216129
NM_178031,TMEM132A,11,10,12720,3528,9192,919.2,320.7272727,2.605442177
NM_014207,CD5,11,10,25395,3168,22227,2222.7,288,7.016098485
NM_017966,VPS37C,5,4,31190,2697,28493,7123.25,539.4,10.56470152
NM_014224,PGA5,9,8,10287,1407,8880,1110,156.3333333,6.31130064
NM_001079808,PGA4,9,8,9360,1404,7956,994.5,156,5.666666667
NM_001079807,PGA3,9,8,9368,1405,7963,995.375,156.1111111,5.667615658
NM_152718,VWCE,20,19,37032,3556,33476,1761.894737,177.8,9.413948256
NM_024811,CPSF7,10,9,27265,3698,23567,2618.555556,369.8,6.372904273
NM_001161454,CYB561A3,8,7,13537,3219,10318,1474,402.375,3.205343274
NM_001161452,CYB561A3,5,4,8143,2561,5582,1395.5,512.2,2.179617337
NM_001173991,TMEM216,5,4,6505,1311,5194,1298.5,262.2,3.961861175
NM_001173990,TMEM216,5,4,6505,1302,5203,1300.75,260.4,3.996159754
NM_001142565,CPSF7,10,9,27346,3595,23751,2639,359.5,6.606675939
NM_016499,TMEM216,5,4,6472,1292,5180,1295,258.4,4.009287926
NM_015533,DAK,18,17,15579,4259,11320,665.8823529,236.6111111,2.657900916
NM_001136040,CPSF7,10,9,27346,3622,23724,2636,362.2,6.549972391
NM_016464,TMEM138,5,4,7504,1847,5657,1414.25,369.4,3.062804548
NM_153611,CYB561A3,7,6,13537,3049,10488,1748,435.5714286,3.439816333
NM_001145077,LRRC10B,1,0,2220,2220,NA,NA,2220,NA
NM_001170753,PPP1R32,13,12,9817,1492,8325,693.75,114.7692308,5.579758713
NM_145017,PPP1R32,14,13,9817,1553,8264,635.6923077,110.9285714,5.321313587
NM_001127392,MYRF,27,26,35870,5953,29917,1150.653846,220.4814815,5.025533345
NM_013279,MYRF,26,25,33130,5771,27359,1094.36,221.9615385,4.74077283
NM_014206,TMEM258,4,3,3485,415,3070,1023.333333,103.75,7.397590361
NM_013402,FADS1,12,11,17434,4432,13002,1182,369.3333333,2.93366426
NM_004111,FEN1,2,1,4607,2296,2311,2311,1148,1.006533101
NM_013401,RAB3IL1,10,9,20315,2383,17932,1992.444444,238.3,7.524968527
NM_021727,FADS3,12,11,18024,1805,16219,1474.454545,150.4166667,8.985595568
NM_001139443,BEST1,9,8,13712,2841,10871,1358.875,315.6666667,3.826469553
NM_001271686,RAB3IL1,9,8,22975,2139,20836,2604.5,237.6666667,9.741000468
NM_004183,BEST1,11,10,14581,2690,11891,1189.1,244.5454545,4.420446097
NM_020238,INCENP,18,17,29192,4152,25040,1472.941176,230.6666667,6.030828516
NM_001040694,INCENP,19,18,29192,4165,25027,1390.388889,219.2105263,6.008883553
NM_002407,SCGB2A1,3,2,5273,524,4749,2374.5,174.6666667,9.062977099
NM_006552,SCGB1D1,3,2,3301,432,2869,1434.5,144,6.641203704
NM_006551,SCGB1D2,3,2,2558,441,2117,1058.5,147,4.800453515
NM_206998,SCGB1D4,3,2,2784,437,2347,1173.5,145.6666667,5.370709382
NM_002411,SCGB2A2,3,2,3004,509,2495,1247.5,169.6666667,4.901768173
NM_003357,SCGB1A1,3,2,4173,455,3718,1859,151.6666667,8.171428571
NM_012200,B3GAT3,5,4,6881,1646,5235,1308.75,329.2,3.180437424
NM_022830,TUT1,9,8,16594,2835,13759,1719.875,315,4.853262787
NM_004739,MTA2,18,17,8639,3087,5552,326.5882353,171.5,1.79850988
NM_001404,EEF1G,10,9,14389,1548,12841,1426.777778,154.8,8.295219638
NM_001620,AHNAK,5,4,30960,18820,12140,3035,3764,0.645058448
NM_000327,ROM1,3,2,2381,1881,500,250,627,0.265816055
NM_153265,EML3,22,21,10548,3277,7271,346.2380952,148.9545455,2.218797681
NM_015853,UBXN1,8,7,2621,1361,1260,180,170.125,0.92578986
NM_203422,LRRN4CL,2,1,3499,2587,912,912,1293.5,0.35253189
NM_030628,INTS5,2,1,6456,3287,3169,3169,1643.5,0.964101004
NM_001122955,BSCL2,11,10,17447,2017,15430,1543,183.3636364,7.649975211
NM_032667,BSCL2,11,10,16055,1531,14524,1452.4,139.1818182,9.486610059
NM_024099,C11orf48,7,6,8954,1327,7627,1271.166667,189.5714286,5.747550867
NM_012202,GNG3,3,2,1614,954,660,330,318,0.691823899
NM_198335,GANAB,25,24,21902,4042,17860,744.1666667,161.68,4.418604651
NM_198334,GANAB,24,23,21902,3975,17927,779.4347826,165.625,4.509937107
NM_001130702,BSCL2,10,9,16055,1388,14667,1629.666667,138.8,10.56700288
NM_001043229,METTL12,3,2,2146,1385,761,380.5,461.6666667,0.549458484
NM_001278194,GANAB,23,22,21902,3865,18037,819.8636364,168.0434783,4.666752911
NM_001278193,GANAB,21,20,21902,3630,18272,913.6,172.8571429,5.033608815
NM_001278192,GANAB,22,21,21902,3697,18205,866.9047619,168.0454545,4.924262916
NM_001286077,UBXN1,9,8,2621,1189,1432,179,132.1111111,1.204373423
NM_001085372,C11orf83,2,1,2038,1952,86,86,976,0.044057377
NM_001079559,HNRNPUL2,14,13,14762,5161,9601,738.5384615,368.6428571,1.860298392
NM_173810,TTC9C,3,2,10158,1142,9016,4508,380.6666667,7.894921191
NM_001286078,UBXN1,7,6,2621,1010,1611,268.5,144.2857143,1.595049505
NM_001286086,LOC102288414,4,3,2401,656,1745,581.6666667,164,2.660060976
NM_199337,TMEM179B,5,4,3000,1048,1952,488,209.6,1.86259542
NM_001081491,NXF1,20,19,13368,4167,9201,484.2631579,208.35,2.208063355
NM_006473,TAF6L,11,10,16040,2126,13914,1391.4,193.2727273,6.544684854
NM_006362,NXF1,21,20,13368,2367,11001,550.05,112.7142857,4.64765526
NM_003164,STX5,11,10,25233,1845,23388,2338.8,167.7272727,12.67642276
NM_002696,POLR2G,8,7,5178,845,4333,619,105.625,5.127810651
NM_001244666,STX5,11,10,25233,1883,23350,2335,171.1818182,12.40042485
NM_018093,WDR74,12,11,7247,1379,5868,533.4545455,114.9166667,4.255257433
NM_001080501,TMEM223,2,1,1701,939,762,762,469.5,0.811501597
NM_000738,CHRM1,2,1,12863,2825,10038,10038,1412.5,3.553274336
NM_001184736,SLC22A8,10,9,23023,1836,21187,2354.111111,183.6,11.53976035
NM_001184733,SLC22A8,11,10,23023,1922,21101,2110.1,174.7272727,10.97866805
NM_001184732,SLC22A8,11,10,23023,2174,20849,2084.9,197.6363636,9.590156394
NM_004790,SLC22A6,10,9,8428,2232,6196,688.4444444,223.2,2.775985663
NM_004254,SLC22A8,11,10,23023,2195,20828,2082.8,199.5454545,9.488838269
NM_153278,SLC22A6,10,9,8428,2100,6328,703.1111111,210,3.013333333
NM_153277,SLC22A6,10,9,8428,2061,6367,707.4444444,206.1,3.08927705
NM_153276,SLC22A6,10,9,8428,2193,6235,692.7777778,219.3,2.843137255
NM_001136506,SLC22A24,10,9,64283,2111,62172,6908,211.1,29.45144481
NM_199352,SLC22A25,9,8,65830,1653,64177,8022.125,183.6666667,38.8245614
NM_001039752,SLC22A10,10,9,21818,2584,19234,2137.111111,258.4,7.443498452
NM_001146729,HRASLS5,6,5,29806,3089,26717,5343.4,514.8333333,8.649077371
NM_001146728,HRASLS5,6,5,29806,3069,26737,5347.4,511.5,8.711958293
NM_033101,LGALS12,9,8,10724,1742,8982,1122.75,193.5555556,5.156142365
NM_001142538,LGALS12,7,6,8789,1803,6986,1164.333333,257.5714286,3.874653356
NM_001142537,LGALS12,8,7,8789,1831,6958,994,228.875,3.80010923
NM_001142536,LGALS12,8,7,10724,1714,9010,1287.142857,214.25,5.256709452
NM_001142535,LGALS12,9,8,10724,1745,8979,1122.375,193.8888889,5.145558739
NM_054108,HRASLS5,6,5,29806,3119,26687,5337.4,519.8333333,8.556268035
NM_007069,PLA2G16,4,3,39967,1389,38578,12859.33333,347.25,27.77393808
NM_017878,HRASLS2,4,3,10615,746,9869,3289.666667,186.5,13.22922252
NM_001128203,PLA2G16,5,4,39999,1106,38893,9723.25,221.2,35.16546112
NM_001265591,RTN3,4,3,78443,2336,76107,25369,584,32.58005137
NM_001265589,RTN3,9,8,78443,4985,73458,9182.25,553.8888889,14.73580742
NM_201430,RTN3,6,5,78443,2535,75908,15181.6,422.5,29.94398422
NM_201429,RTN3,8,7,78443,2653,75790,10827.14286,331.625,28.56765925
NM_001265590,RTN3,8,7,78443,4648,73795,10542.14286,581,15.87672117
NM_006054,RTN3,7,6,78443,2595,75848,12641.33333,370.7142857,29.22851638
NM_001144936,C11orf95,5,4,8751,5587,3164,791,1117.4,0.566314659
NM_201428,RTN3,8,7,78443,4927,73516,10502.28571,615.875,14.92104729
NM_001039469,MARK2,19,18,72094,4748,67346,3741.444444,249.8947368,14.18407751
NM_017490,MARK2,18,17,22507,4534,17973,1057.235294,251.8888889,3.964049404
NM_138471,C11orf84,6,5,14269,1967,12302,2460.4,327.8333333,6.254194204
NM_001163297,MARK2,16,15,72094,4508,67586,4505.733333,281.75,14.99245785
NM_001163296,MARK2,17,16,72094,4539,67555,4222.1875,267,14.88323419
NM_004954,MARK2,17,16,72094,4554,67540,4221.25,267.8823529,14.83091787
NM_173587,RCOR2,12,11,5625,2616,3009,273.5454545,218,1.150229358
NM_017670,OTUB1,7,6,12569,2301,10268,1711.333333,328.7142857,4.462407649
NM_024771,NAA40,8,7,18006,3344,14662,2094.571429,418,4.384569378
NM_004074,COX8A,2,1,1938,509,1429,1429,254.5,2.807465619
NM_013280,FLRT1,2,1,15285,3249,12036,12036,1624.5,3.704524469
NM_001286084,TRMT112,3,2,1594,1397,197,98.5,465.6666667,0.141016464
NM_032344,NUDT22,6,5,3744,1116,2628,525.6,186,2.35483871
NM_001160393,TRPT1,7,6,2072,858,1214,202.3333333,122.5714286,1.414918415
NM_001160392,TRPT1,7,6,2457,949,1508,251.3333333,135.5714286,1.589041096
NM_001271831,NUDT22,5,4,3760,902,2858,714.5,180.4,3.168514412
NM_016404,TRMT112,4,3,1594,1309,285,95,327.25,0.217723453
NM_012094,PRDX5,6,5,3737,911,2826,565.2,151.8333333,3.10208562
NM_001282451,ESRRA,7,6,11214,2271,8943,1490.5,324.4285714,3.937912814
NM_001282450,ESRRA,7,6,10515,2287,8228,1371.333333,326.7142857,3.597726279
NM_001243733,VEGFB,7,6,4682,1711,2971,495.1666667,244.4285714,1.736411455
NM_001128613,NUDT22,5,4,3744,1016,2728,682,203.2,2.68503937
NM_001128612,NUDT22,6,5,3760,1002,2758,551.6,167,2.75249501
NM_001039496,TEX40,5,4,4378,749,3629,907.25,149.8,4.845126836
NM_032989,BAD,4,3,14878,974,13904,4634.666667,243.5,14.275154
NM_057092,FKBP2,6,5,2021,643,1378,275.6,107.1666667,2.143079316
NM_033310,KCNK4,7,6,8712,1817,6895,1149.166667,259.5714286,3.794716566
NM_031472,TRPT1,7,6,2457,976,1481,246.8333333,139.4285714,1.517418033
NM_031471,FERMT3,15,14,17213,2555,14658,1047,170.3333333,5.736986301
NM_001160389,TRPT1,8,7,2457,1067,1390,198.5714286,133.375,1.302717901
NM_001160390,TRPT1,8,7,2457,1049,1408,201.1428571,131.125,1.342230696
NM_001170726,GPR137,9,8,5163,1600,3563,445.375,177.7777778,2.226875
NM_001170881,GPR137,7,6,4689,1935,2754,459,276.4285714,1.423255814
NM_001184883,PLCB3,29,28,17931,5556,12375,441.9642857,191.5862069,2.227321814
NM_001177358,GPR137,7,6,4691,1850,2841,473.5,264.2857143,1.535675676
NM_000932,PLCB3,31,30,17931,5759,12172,405.7333333,185.7741935,2.113561382
NM_005528,DNAJC4,7,6,4002,1292,2710,451.6666667,184.5714286,2.09752322
NM_003377,VEGFB,7,6,4682,1812,2870,478.3333333,258.8571429,1.58388521
NM_178443,FERMT3,15,14,17213,2567,14646,1046.142857,171.1333333,5.705492793
NM_001033678,TRPT1,8,7,2457,1061,1396,199.4285714,132.625,1.315739868
NM_138689,PPP1R14B,4,3,2464,991,1473,491,247.75,1.486377397
NM_001170880,GPR137,7,6,3392,1917,1475,245.8333333,273.8571429,0.769431403
NM_001135208,FKBP2,6,5,3005,652,2353,470.6,108.6666667,3.608895706
NM_020155,GPR137,7,6,3392,1811,1581,263.5,258.7142857,0.872998343
NM_001286082,TRMT112,4,3,1594,1294,300,100,323.5,0.231839258
NM_004451,ESRRA,7,6,11214,2274,8940,1490,324.8571429,3.931398417
NM_004322,BAD,3,2,14878,1227,13651,6825.5,409,11.12550937
NM_004470,FKBP2,6,5,3196,737,2459,491.8,122.8333333,3.336499322
NM_181652,PRDX5,4,3,3737,642,3095,1031.666667,160.5,4.820872274
NM_181651,PRDX5,5,4,3737,778,2959,739.75,155.6,3.803341902
NM_001006944,RPS6KA4,17,16,13064,3136,9928,620.5,184.4705882,3.165816327
NM_032251,CCDC88B,27,26,17318,4947,12371,475.8076923,183.2222222,2.500707499
NM_003942,RPS6KA4,17,16,13064,3154,9910,619.375,185.5294118,3.142041852
NM_018484,SLC22A11,10,9,15903,2522,13381,1486.777778,252.2,5.305709754
NM_153378,SLC22A12,10,9,11545,2955,8590,954.4444444,295.5,2.906937394
NM_001276327,SLC22A12,8,7,11545,2895,8650,1235.714286,361.875,2.98791019
NM_001276326,SLC22A12,10,9,11545,3119,8426,936.2222222,311.9,2.701506893
NM_138734,NRXN2,7,6,37143,3542,33601,5600.166667,506,9.486448334
NM_144585,SLC22A12,10,9,11545,3221,8324,924.8888889,322.1,2.584290593
NM_001164716,PYGM,18,17,14328,3370,10958,644.5882353,187.2222222,3.251632047
NM_017525,CDC42BPG,37,36,20381,4976,15405,427.9166667,134.4864865,3.095860129
NM_001178031,SF1,13,12,13158,3378,9780,815,259.8461538,2.895204263
NM_001178030,SF1,13,12,13864,2959,10905,908.75,227.6153846,3.685366678
NM_005609,PYGM,20,19,14328,3636,10692,562.7368421,181.8,2.940594059
NM_201995,SF1,14,13,14242,3168,11074,851.8461538,226.2857143,3.495580808
NM_201998,SF1,13,12,14242,2962,11280,940,227.8461538,3.808237677
NM_201997,SF1,13,12,14242,2966,11276,939.6666667,228.1538462,3.801753203
NM_130800,MEN1,10,9,7051,2751,4300,477.7777778,275.1,1.563067975
NM_130799,MEN1,10,9,7204,2773,4431,492.3333333,277.3,1.597908402
NM_130804,MEN1,11,10,7782,3055,4727,472.7,277.7272727,1.547299509
NM_130803,MEN1,10,9,7782,3182,4600,511.1111111,318.2,1.445631678
NM_130802,MEN1,10,9,7229,3175,4054,450.4444444,317.5,1.276850394
NM_130801,MEN1,10,9,7051,2739,4312,479.1111111,273.9,1.574297189
NM_000244,MEN1,10,9,7204,2788,4416,490.6666667,278.8,1.583931133
NM_001098671,RASGRP2,17,16,17249,2301,14948,934.25,135.3529412,6.496305954
NM_001098670,RASGRP2,17,16,17948,2261,15687,980.4375,133,6.938080495
NM_004630,SF1,13,12,14242,3599,10643,886.9166667,276.8461538,2.957210336
NM_004579,MAP4K2,32,31,14106,2987,11119,358.6774194,93.34375,3.722464011
NM_153819,RASGRP2,17,16,18547,2327,16220,1013.75,136.8823529,6.970348088
NM_006244,PPP2R5B,14,13,9809,2764,7045,541.9230769,197.4285714,2.548842258
NM_015104,ATG2A,41,40,22720,6414,16306,407.65,156.4390244,2.542251325
NM_006795,EHD1,5,4,26043,3520,22523,5630.75,704,6.398579545
NM_130769,GPHA2,4,3,1419,751,668,222.6666667,187.75,0.889480692
NM_001037225,C11orf85,10,9,21682,845,20837,2315.222222,84.5,24.6591716
NM_001282445,EHD1,6,5,26988,3342,23646,4729.2,557,7.07540395
NM_001282444,EHD1,7,6,26988,3665,23323,3887.166667,523.5714286,6.363710778
NM_138456,BATF2,3,2,9102,2143,6959,3479.5,714.3333333,3.247316846
NM_013299,SAC3D1,2,1,3926,1569,2357,2357,784.5,1.50223072
NM_013306,SNX15,8,7,13166,1947,11219,1602.714286,243.375,5.762198254
NM_013265,VPS51,10,9,15747,2768,12979,1442.111111,276.8,4.688945087
NM_001199745,ARL2,4,3,8074,903,7171,2390.333333,225.75,7.941306755
NM_006782,ZFPL1,8,7,4182,1394,2788,398.2857143,174.25,2
NM_147777,SNX15,7,6,13166,1688,11478,1913,241.1428571,6.799763033
NM_001667,ARL2,5,4,8074,985,7089,1772.25,197,7.196954315
NM_001242631,TMEM262,3,2,739,483,256,128,161,0.530020704
NM_080668,CDCA5,6,5,6690,2582,4108,821.6,430.3333333,1.591014717
NM_001282448,TMEM262,3,2,739,515,224,112,171.6666667,0.434951456
NM_005468,NAALADL1,18,17,13716,2705,11011,647.7058824,150.2777778,4.070609982
NM_001997,FAU,5,4,1575,580,995,248.75,116,1.715517241
NM_001198868,CAPN1,22,21,30793,3084,27709,1319.47619,140.1818182,8.984760052
NM_001008778,SPDYC,7,6,2983,889,2094,349,127,2.355455568
NM_001198869,CAPN1,22,21,30329,3053,27276,1298.857143,138.7727273,8.934163118
NM_032431,SYVN1,16,15,7254,3064,4190,279.3333333,191.5,1.367493473
NM_014205,ZNHIT2,1,0,1297,1297,NA,NA,1297,NA
NM_001004326,SLC22A20,6,5,12202,1433,10769,2153.8,238.8333333,7.515003489
NM_005186,CAPN1,22,21,30175,3069,27106,1290.761905,139.5,8.832192897
NM_004927,MRPL49,4,3,5127,2105,3022,1007.333333,526.25,1.435629454
NM_172230,SYVN1,16,15,7254,3067,4187,279.1333333,191.6875,1.365177698
NM_006779,CDC42EP2,2,1,7613,2025,5588,5588,1012.5,2.759506173
NM_006268,DPF2,11,10,19228,2541,16687,1668.7,231,6.567099567
NM_145719,TIGD3,2,1,2802,1968,834,834,984,0.423780488
NM_002689,POLA2,18,17,35658,2495,33163,1950.764706,138.6111111,13.29178357
NM_031904,FRMD8,11,10,26956,3762,23194,2319.4,342,6.165337586
NM_001048218,SCYL1,18,17,13636,2616,11020,648.2352941,145.3333333,4.212538226
NM_001164266,LTBP3,27,26,19671,4584,15087,580.2692308,169.7777778,3.291230366
NM_002419,MAP3K11,10,9,16496,3583,12913,1434.777778,358.3,3.603963159
NM_021070,LTBP3,27,26,19671,4588,15083,580.1153846,169.9259259,3.287489102
NM_032223,PCNXL3,35,34,21129,6601,14528,427.2941176,188.6,2.200878655
NM_006396,SSSCA1,4,3,1298,658,640,213.3333333,164.5,0.972644377
NM_020680,SCYL1,18,17,13636,2667,10969,645.2352941,148.1666667,4.112860892
NM_033455,KCNK7,3,2,3143,1474,1669,834.5,491.3333333,1.13229308
NM_033348,KCNK7,4,3,3143,1376,1767,589,344,1.284156977
NM_033347,KCNK7,3,2,3143,1301,1842,921,433.6666667,1.415833974
NM_001130144,LTBP3,28,27,19671,4730,14941,553.3703704,168.9285714,3.158773784
NM_001098785,FAM89B,2,1,1851,1450,401,401,725,0.276551724
NM_001098784,FAM89B,2,1,1851,1460,391,391,730,0.267808219
NM_001099409,EHBP1L1,19,18,16609,5199,11410,633.8888889,273.6315789,2.194652818
NM_005714,KCNK7,2,1,3143,1565,1578,1578,782.5,1.008306709
NM_152832,FAM89B,2,1,1851,1411,440,440,705.5,0.311835578
NM_006747,SIPA1,16,15,12815,3517,9298,619.8666667,219.8125,2.643730452
NM_006388,KAT5,14,13,7606,2247,5359,412.2307692,160.5,2.384957721
NM_001243985,RELA,12,11,9378,2281,7097,645.1818182,190.0833333,3.111354669
NM_001243984,RELA,11,10,9378,2382,6996,699.6,216.5454545,2.937027708
NM_021975,RELA,11,10,9378,2589,6789,678.9,235.3636364,2.622247972
NM_032193,RNASEH2C,4,3,3267,2789,478,159.3333333,697.25,0.171387594
NM_001206833,KAT5,12,11,7606,2188,5418,492.5454545,182.3333333,2.476234004
NM_001145138,RELA,11,10,9378,2580,6798,679.8,234.5454545,2.634883721
NM_182710,KAT5,13,12,7606,2345,5261,438.4166667,180.3846154,2.243496802
NM_182709,KAT5,13,12,7606,2090,5516,459.6666667,160.7692308,2.63923445
NM_153253,SIPA1,16,15,10801,3646,7155,477,227.875,1.962424575
NM_025128,MUS81,16,15,6044,2416,3628,241.8666667,151,1.501655629
NM_006848,CCDC85B,1,0,1233,1233,NA,NA,1233,NA
NM_198897,FIBP,10,9,4801,1460,3341,371.2222222,146,2.288356164
NM_016938,EFEMP2,11,10,6495,2079,4416,441.6,189,2.124098124
NM_001335,CTSW,10,9,3930,1306,2624,291.5555556,130.6,2.009188361
NM_138368,AP5B1,2,1,6695,6597,98,98,3298.5,0.014855237
NM_152760,SNX32,13,12,19764,1718,18046,1503.833333,132.1538462,10.50407451
NM_005507,CFL1,4,3,3521,1261,2260,753.3333333,315.25,1.79222839
NM_004561,OVOL1,4,3,10187,3026,7161,2387,756.5,2.366490416
NM_004214,FIBP,10,9,4801,1439,3362,373.5555556,143.9,2.336344684
NM_001242486,EIF1AD,6,5,5623,2702,2921,584.2,450.3333333,1.081051073
NM_001242485,EIF1AD,6,5,5623,2777,2846,569.2,462.8333333,1.024846957
NM_001242484,EIF1AD,6,5,5623,2801,2822,564.4,466.8333333,1.007497322
NM_001242483,EIF1AD,6,5,5623,2832,2791,558.2,472,0.985522599
NM_001242482,EIF1AD,6,5,5623,2907,2716,543.2,484.5,0.934296526
NM_001242481,EIF1AD,6,5,5623,2931,2692,538.4,488.5,0.918457864
NM_001143985,BANF1,3,2,2069,1098,971,485.5,366,0.884335155
NM_003860,BANF1,3,2,2069,1155,914,457,385,0.791341991
NM_032325,EIF1AD,6,5,5623,2902,2721,544.2,483.6666667,0.937629221
NM_031450,C11orf68,2,1,2250,1557,693,693,778.5,0.445086705
NM_006442,DRAP1,7,6,2322,1012,1310,218.3333333,144.5714286,1.294466403
NM_053054,CATSPER1,12,11,9767,2631,7136,648.7272727,219.25,2.712276701
NM_001323,CST6,3,2,1516,612,904,452,204,1.477124183
NM_001135635,C11orf68,2,1,2250,1560,690,690,780,0.442307692
NM_152762,TSGA10IP,8,7,14321,1734,12587,1798.142857,216.75,7.25893887
NM_005146,SART1,20,19,18449,3621,14828,780.4210526,181.05,4.095001381
NM_033036,GAL3ST3,3,2,8417,3323,5094,2547,1107.666667,1.532952152
NM_006842,SF3B2,22,21,16568,2916,13652,650.0952381,132.5454545,4.68175583
NM_030981,RAB1B,6,5,8909,1961,6948,1389.6,326.8333333,3.54309026
NM_001134776,KLC2,16,15,10242,2911,7331,488.7333333,181.9375,2.518378564
NM_001134775,KLC2,16,15,10568,3032,7536,502.4,189.5,2.485488127
NM_001134774,KLC2,15,14,10160,2738,7422,530.1428571,182.5333333,2.710737765
NM_020470,YIF1A,8,7,4589,1129,3460,494.2857143,141.125,3.06465899
NM_022822,KLC2,16,15,10159,3006,7153,476.8666667,187.875,2.379574185
NM_182553,CNIH2,6,5,6015,1362,4653,930.6,227,3.416299559
NM_015399,BRMS1,10,9,7780,1447,6333,703.6666667,144.7,4.376641327
NM_001024957,BRMS1,10,9,7780,1365,6415,712.7777778,136.5,4.6996337
NM_006876,B3GNT1,2,1,2320,2072,248,248,1036,0.11969112
NM_001532,SLC29A2,12,11,9301,2527,6774,615.8181818,210.5833333,2.680648991
NM_020404,CD248,1,0,2559,2559,NA,NA,2559,NA
NM_004292,RIN1,10,9,4460,2694,1766,196.2222222,269.4,0.655530809
NM_016050,MRPL11,5,4,3762,1597,2165,541.25,319.4,1.355666875
NM_005700,DPP3,18,17,29648,3098,26550,1561.764706,172.1111111,8.57004519
NM_001243136,PELI3,6,5,10474,2525,7949,1589.8,420.8333333,3.148118812
NM_130443,DPP3,18,17,29648,3101,26547,1561.588235,172.2777778,8.560786843
NM_024649,BBS1,17,16,22967,3387,19580,1223.75,199.2352941,5.780927074
NM_001256670,DPP3,17,16,29648,3007,26641,1665.0625,176.8823529,8.859660791
NM_145065,PELI3,8,7,10474,2752,7722,1103.142857,344,2.805959302
NM_001243135,PELI3,7,6,11012,2518,8494,1415.666667,359.7142857,3.373312153
NM_001098510,PELI3,7,6,10474,2679,7795,1299.166667,382.7142857,2.909667786
NM_207340,ZDHHC24,3,2,6938,1320,5618,2809,440,4.256060606
NM_170738,MRPL11,5,4,3762,1519,2243,560.75,303.8,1.476629361
NM_170739,MRPL11,6,5,3762,1692,2070,414,282,1.223404255
NM_001198846,RBM14-RBM4,2,1,29893,925,28968,28968,462.5,31.31675676
NM_001198845,RBM14-RBM4,3,2,29893,1617,28276,14138,539,17.48670377
NM_001198837,RBM14,2,1,13346,3944,9402,9402,1972,2.383874239
NM_001198844,RBM4,3,2,29772,3095,26677,13338.5,1031.666667,8.619386107
NM_001198836,RBM14,3,2,13346,4056,9290,4645,1352,2.290433925
NM_006328,RBM14,3,2,13346,5410,7936,3968,1803.333333,1.466913124
NM_003793,CTSF,13,12,5114,2027,3087,257.25,155.9230769,1.522940306
NM_018219,CCDC87,1,0,2916,2916,NA,NA,2916,NA
NM_001286135,RBM4B,3,2,12929,1170,11759,5879.5,390,10.05042735
NM_001198843,RBM4,3,2,7858,1010,6848,3424,336.6666667,6.78019802
NM_002896,RBM4,4,3,7858,1702,6156,2052,425.5,3.616921269
NM_005125,CCS,8,7,12802,1040,11762,1680.285714,130,11.30961538
NM_031492,RBM4B,4,3,12929,1848,11081,3693.666667,462,5.996212121
NM_022172,PC,21,20,59345,3980,55365,2768.25,189.5238095,13.91080402
NM_024036,LRFN4,2,1,3072,2530,542,542,1265,0.214229249
NM_001032279,RCE1,8,7,3122,1475,1647,235.2857143,184.375,1.116610169
NM_005133,RCE1,8,7,3122,1479,1643,234.7142857,184.875,1.110885734
NM_014578,RHOD,5,4,15201,1138,14063,3515.75,227.6,12.35764499
NM_001136485,C11orf86,2,1,1727,1187,540,540,593.5,0.454928391
NM_001177880,SYT12,8,7,28146,3610,24536,3505.142857,451.25,6.7966759
NM_177963,SYT12,8,7,27520,3519,24001,3428.714286,439.875,6.820403524
NM_001256405,KDM2A,10,9,18046,5379,12667,1407.444444,537.9,2.35489868
NM_017857,SSH3,14,13,9161,2892,6269,482.2307692,206.5714286,2.167704011
NM_207354,ANKRD13D,15,14,13195,2155,11040,788.5714286,143.6666667,5.122969838
NM_001619,ADRBK1,21,20,20126,3465,16661,833.05,165,4.808369408
NM_025124,TMEM134,7,6,4931,946,3985,664.1666667,135.1428571,4.212473573
NM_206997,GPR152,1,0,1430,1430,NA,NA,1430,NA
NM_198517,TBC1D10C,10,9,6179,1744,4435,492.7777778,174.4,2.543004587
NM_206873,PPP1CA,6,5,3726,1344,2382,476.4,224,1.772321429
NM_001256870,POLD4,3,2,2833,1642,1191,595.5,547.3333333,0.725334957
NM_001256508,TBC1D10C,9,8,6179,1532,4647,580.875,170.2222222,3.033289817
NM_145200,CABP4,6,5,6429,4026,2403,480.6,671,0.596870343
NM_013246,CLCF1,3,2,9569,1845,7724,3862,615,4.186449864
NM_002708,PPP1CA,7,6,3726,1477,2249,374.8333333,211,1.52268111
NM_001243224,RAD9A,8,7,5109,1994,3115,445,249.25,1.56218656
NM_021173,POLD4,4,3,2833,1755,1078,359.3333333,438.75,0.614245014
NM_020441,CORO1B,11,10,5467,1921,3546,354.6,174.6363636,1.845913587
NM_020811,CARNS1,9,8,9931,3951,5980,747.5,439,1.513540876
NM_005608,PTPRCAP,2,1,2174,909,1265,1265,454.5,1.391639164
NM_001018070,CORO1B,12,11,5776,1944,3832,348.3636364,162,1.971193416
NM_001078651,TMEM134,7,6,4931,919,4012,668.6666667,131.2857143,4.365614799
NM_001078650,TMEM134,6,5,4931,900,4031,806.2,150,4.478888889
NM_001166222,CARNS1,10,9,9931,3979,5952,661.3333333,397.9,1.495853229
NM_001166212,CLCF1,3,2,10011,1764,8247,4123.5,588,4.675170068
NM_004584,RAD9A,11,10,6462,2133,4329,432.9,193.9090909,2.029535865
NM_003952,RPS6KB2,15,14,6946,1785,5161,368.6428571,119,2.891316527
NM_001008709,PPP1CA,7,6,3726,1510,2216,369.3333333,215.7142857,1.467549669
NM_016366,CABP2,7,6,4483,964,3519,586.5,137.7142857,3.650414938
NM_005851,CDK2AP2,4,3,2240,1486,754,251.3333333,371.5,0.507402423
NM_003977,AIP,6,5,8076,1239,6837,1367.4,206.5,5.518159806
NM_000852,GSTP1,7,6,3060,965,2095,349.1666667,137.8571429,2.170984456
NM_001271849,CDK2AP2,4,3,1699,1086,613,204.3333333,271.5,0.564456722
NM_001130848,PITPNM1,24,23,13606,4247,9359,406.9130435,176.9583333,2.203673181
NM_004910,PITPNM1,24,23,13606,4250,9356,406.7826087,177.0833333,2.201411765
NM_007103,NDUFV1,10,9,5691,1641,4050,450,164.1,2.468007313
NM_005995,TBX10,8,7,8259,1556,6703,957.5714286,194.5,4.307840617
NM_181843,NUDT8,3,2,2001,819,1182,591,273,1.443223443
NM_000695,ALDH3B2,10,9,12471,2660,9811,1090.111111,266,3.688345865
NM_001243750,NUDT8,4,3,2000,748,1252,417.3333333,187,1.673796791
NM_080658,ACY3,8,7,8106,1308,6798,971.1428571,163.5,5.197247706
NM_001166102,NDUFV1,10,9,5691,1614,4077,453,161.4,2.526022305
NM_001031615,ALDH3B2,10,9,19054,2504,16550,1838.888889,250.4,6.60942492
NM_001030010,ALDH3B1,9,8,18955,2714,16241,2030.125,301.5555556,5.984156227
NM_001161473,ALDH3B1,10,9,20697,2867,17830,1981.111111,286.7,6.219044297
NM_002496,NDUFS8,7,6,6032,811,5221,870.1666667,115.8571429,6.437731196
NM_006019,TCIRG1,20,19,11906,2722,9184,483.3684211,136.1,3.373989713
NM_212469,CHKA,11,10,68534,2674,65860,6586,243.0909091,24.62976814
NM_006053,TCIRG1,15,14,7921,2476,5445,388.9285714,165.0666667,2.19911147
NM_000694,ALDH3B1,10,9,18955,2825,16130,1792.222222,282.5,5.709734513
NM_001277,CHKA,12,11,68534,2729,65805,5982.272727,227.4166667,24.11322829
NM_016028,SUV420H1,10,9,47600,2703,44897,4988.555556,270.3,16.61006289
NM_017635,SUV420H1,11,10,57279,4573,52706,5270.6,415.7272727,11.52547562
NM_022338,C11orf24,4,3,10668,2106,8562,2854,526.5,4.065527066
NM_015973,GAL,6,5,6662,784,5878,1175.6,130.6666667,7.49744898
NM_001039656,MTL5,6,5,15390,3631,11759,2351.8,605.1666667,3.23850179
NM_004923,MTL5,10,9,44082,2545,41537,4615.222222,254.5,16.32102161
NM_181515,MRPL21,7,6,12559,716,11843,1973.833333,102.2857143,16.54050279
NM_181514,MRPL21,7,6,12559,703,11856,1976,100.4285714,16.86486486
NM_198923,MRGPRD,1,0,967,967,NA,NA,967,NA
NM_001098515,MRGPRF,3,2,8990,2286,6704,3352,762,2.932633421
NM_145015,MRGPRF,3,2,8990,2275,6715,3357.5,758.3333333,2.951648352
NM_139075,TPCN2,25,24,41724,5051,36673,1528.041667,202.04,7.260542467
NM_138768,MYEOV,3,2,3134,2290,844,422,763.3333333,0.368558952
NM_002007,FGF4,3,2,2376,1223,1153,576.5,407.6666667,0.942763696
NM_005117,FGF19,3,2,6102,2140,3962,1981,713.3333333,1.851401869
NM_153451,ORAOV1,5,4,9835,2532,7303,1825.75,506.4,2.884281201
NM_005247,FGF3,3,2,9458,1551,7907,3953.5,517,5.098001289
NM_003824,FADD,2,1,4241,1855,2386,2386,927.5,1.286253369
NM_001360,DHCR7,9,8,14022,2674,11348,1418.5,297.1111111,4.243829469
NM_001163817,DHCR7,9,8,14022,2651,11371,1421.375,294.5555556,4.289324783
NM_001005405,KRTAP5-11,1,0,1022,1022,NA,NA,1022,NA
NM_001012710,KRTAP5-10,1,0,1059,1059,NA,NA,1059,NA
NM_001012503,KRTAP5-7,1,0,899,899,NA,NA,899,NA
NM_021046,KRTAP5-8,1,0,1184,1184,NA,NA,1184,NA
NM_005553,KRTAP5-9,1,0,1189,1189,NA,NA,1189,NA
NM_152563,FAM86C1,4,3,13725,2013,11712,3904,503.25,5.818181818
NM_018172,FAM86C1,5,4,13725,2116,11609,2902.25,423.2,5.486294896
NM_001278713,ZNF705E,5,4,7504,3446,4058,1014.5,689.2,1.177597214
NM_001099653,FAM86C1,5,4,13725,2095,11630,2907.5,419,5.551312649
NM_001002035,DEFB108B,2,1,4364,224,4140,4140,112,18.48214286
NM_001242853,LOC100129216,2,1,6110,215,5895,5895,107.5,27.41860465
NM_001145055,IL18BP,3,2,2603,1041,1562,781,347,1.500480307
NM_001278494,ANAPC15,6,5,2647,1070,1577,315.4,178.3333333,1.473831776
NM_001278493,ANAPC15,6,5,2687,795,1892,378.4,132.5,2.379874214
NM_001278492,ANAPC15,6,5,2687,813,1874,374.8,135.5,2.30504305
NM_001278491,ANAPC15,6,5,2713,786,1927,385.4,131,2.451653944
NM_001278490,ANAPC15,5,4,3191,802,2389,597.25,160.4,2.978802993
NM_001278489,ANAPC15,6,5,3191,858,2333,466.6,143,2.719114219
NM_001278488,ANAPC15,6,5,3191,799,2392,478.4,133.1666667,2.993742178
NM_001278487,ANAPC15,6,5,3191,883,2308,461.6,147.1666667,2.613816535
NM_001278486,ANAPC15,6,5,3191,895,2296,459.2,149.1666667,2.565363128
NM_001278485,ANAPC15,6,5,3191,900,2291,458.2,150,2.545555556
NM_001205138,LRTOMT,5,4,16563,2513,14050,3512.5,502.6,5.590927179
NM_001039660,IL18BP,6,5,3618,1424,2194,438.8,237.3333333,1.540730337
NM_001039659,IL18BP,7,6,3618,1537,2081,346.8333333,219.5714286,1.353936239
NM_001145308,LRTOMT,7,6,30453,3616,26837,4472.833333,516.5714286,7.421736726
NM_001145307,LRTOMT,6,5,16563,1307,15256,3051.2,217.8333333,11.67253252
NM_006185,NUMA1,27,26,77831,7376,70455,2709.807692,273.1851852,9.551925163
NM_145309,LRTOMT,6,5,16563,2651,13912,2782.4,441.8333333,5.247831007
NM_014042,ANAPC15,6,5,3191,888,2303,460.6,148,2.593468468
NM_001286561,NUMA1,27,26,77831,7431,70400,2707.692308,275.2222222,9.473825865
NM_017907,LAMTOR1,5,4,6097,1184,4913,1228.25,236.8,4.149493243
NM_001271471,LRTOMT,5,4,16563,2932,13631,3407.75,586.4,4.64904502
NM_001145310,LRTOMT,9,8,30453,3719,26734,3341.75,413.2222222,7.18849153
NM_001145309,LRTOMT,9,8,30453,3839,26614,3326.75,426.5555556,6.932534514
NM_001145057,IL18BP,6,5,2913,1362,1551,310.2,227,1.13876652
NM_005699,IL18BP,4,3,3858,2800,1058,352.6666667,700,0.377857143
NM_173044,IL18BP,6,5,3894,1572,2322,464.4,262,1.477099237
NM_173042,IL18BP,5,4,3467,2179,1288,322,435.8,0.591096833
NM_001113535,FOLR2,5,4,5177,1124,4053,1013.25,224.8,3.605871886
NM_001113534,FOLR2,5,4,5177,1130,4047,1011.75,226,3.581415929
NM_016729,FOLR1,4,3,4196,969,3227,1075.666667,242.25,3.330237358
NM_016725,FOLR1,5,4,6767,1135,5632,1408,227,4.962114537
NM_016724,FOLR1,6,5,6767,1202,5565,1113,200.3333333,4.629783694
NM_001113536,FOLR2,5,4,5177,1118,4059,1014.75,223.6,3.63059034
NM_000804,FOLR3,5,4,4165,850,3315,828.75,170,3.9
NM_001567,INPPL1,28,27,14308,4743,9565,354.2592593,169.3928571,2.016656125
NM_000803,FOLR2,5,4,5177,1136,4041,1010.25,227.2,3.55721831
NM_000802,FOLR1,5,4,6410,950,5460,1365,190,5.747368421
NM_005169,PHOX2A,3,2,5101,1702,3399,1699.5,567.3333333,1.99706228
NM_001040118,ARAP1,35,34,67322,5172,62150,1827.941176,147.7714286,12.016628
NM_015242,ARAP1,33,32,37291,4981,32310,1009.6875,150.9393939,6.486649267
NM_001135190,ARAP1,31,30,37291,4763,32528,1084.266667,153.6451613,6.829309259
NM_033388,ATG16L2,18,17,15231,2163,13068,768.7058824,120.1666667,6.041608877
NM_002564,P2RY2,3,2,24131,8605,15526,7763,2868.333333,1.804299826
NM_176072,P2RY2,3,2,24131,8739,15392,7696,2913,1.76129992
NM_176071,P2RY2,3,2,23972,8670,15302,7651,2890,1.764936563
NM_032871,RELT,11,10,20808,3514,17294,1729.4,319.4545455,4.921457029
NM_152222,RELT,11,10,21116,3452,17664,1766.4,313.8181818,5.117033604
NM_014786,ARHGEF17,21,20,60764,7834,52930,2646.5,373.047619,6.75644626
NM_001130035,PLEKHB1,7,6,15272,2023,13249,2208.166667,289,6.54918438
NM_001130034,PLEKHB1,8,7,15272,2129,13143,1877.571429,266.125,6.173320808
NM_001130033,PLEKHB1,7,6,16643,2282,14361,2393.5,326,6.293163891
NM_021200,PLEKHB1,8,7,16643,2388,14255,2036.428571,298.5,5.969430486
NM_001130036,PLEKHB1,6,5,14131,2154,11977,2395.4,359,5.560352832
NM_001267806,PAAF1,12,11,51039,1561,49478,4498,130.0833333,31.69634849
NM_001267805,PAAF1,13,12,50769,1675,49094,4091.166667,128.8461538,29.30985075
NM_001267803,PAAF1,13,12,50769,1688,49081,4090.083333,129.8461538,29.0764218
NM_016565,COA4,2,1,4179,818,3361,3361,409,4.108801956
NM_001267804,PAAF1,13,12,50769,1679,49090,4090.833333,129.1538462,29.23764145
NM_025155,PAAF1,12,11,50769,1618,49151,4468.272727,134.8333333,30.3776267
NM_003356,UCP3,7,6,8958,2432,6526,1087.666667,347.4285714,2.683388158
NM_022803,UCP3,6,5,6472,2245,4227,845.4,374.1666667,1.88285078
NM_003355,UCP2,8,7,8175,1654,6521,931.5714286,206.75,3.942563482
NM_001288748,P4HA3,13,12,45029,2305,42724,3560.333333,177.3076923,18.53535792
NM_182904,P4HA3,13,12,45029,2312,42717,3559.75,177.8461538,18.47621107
NM_005472,KCNE3,3,2,12716,3073,9643,4821.5,1024.333333,3.137975919
NM_001144869,LIPT2,2,1,1834,962,872,872,481,0.906444906
NM_015424,CHRDL2,12,11,34755,1731,33024,3002.181818,144.25,19.0779896
NM_001278473,CHRDL2,11,10,34755,1675,33080,3308,152.2727273,19.74925373
NM_001098638,RNF169,6,5,93547,7829,85718,17143.6,1304.833333,10.94878018
NM_014752,SPCS2,5,4,29786,2713,27073,6768.25,542.6,9.978990048
NM_001005285,OR2AT4,1,0,964,964,NA,NA,964,NA
NM_007256,SLCO2B1,14,13,55415,4359,51056,3927.384615,311.3571429,11.71277816
NM_001145212,SLCO2B1,11,10,55415,3924,51491,5149.1,356.7272727,13.12206932
NM_001145211,SLCO2B1,14,13,46603,4054,42549,3273,289.5714286,10.49555994
NM_001195528,TPBGL,1,0,2801,2801,NA,NA,2801,NA
NM_001260507,RPS3,6,5,7424,1967,5457,1091.4,327.8333333,2.774275547
NM_001260506,RPS3,7,6,7424,2178,5246,874.3333333,311.1428571,2.408631772
NM_001256802,RPS3,7,6,22812,1374,21438,3573,196.2857143,15.60262009
NM_001039548,KLHL35,6,5,8238,1944,6294,1258.8,324,3.237654321
NM_001005,RPS3,7,6,7424,2099,5325,887.5,299.8571429,2.536922344
NM_001207014,SERPINH1,6,5,10750,2326,8424,1684.8,387.6666667,3.6216681
NM_001235,SERPINH1,5,4,10750,2281,8469,2117.25,456.2,3.712845243
NM_025098,MOGAT2,6,5,13399,1011,12388,2477.6,168.5,12.25321464
NM_004626,WNT11,5,4,20206,1932,18274,4568.5,386.4,9.458592133
NM_001282456,LOC100506127,2,1,26808,5360,21448,21448,2680,4.001492537
NM_004705,PRKRIR,5,4,30878,3195,27683,6920.75,639,8.664475743
NM_020193,C11orf30,21,20,106522,5532,100990,5049.5,263.4285714,18.25560376
NM_005512,LRRC32,3,2,12478,4315,8163,4081.5,1438.333333,1.891772885
NM_001128922,LRRC32,3,2,13225,4210,9015,4507.5,1403.333333,2.141330166
NM_015516,TSKU,2,1,14915,2712,12203,12203,1356,4.499631268
NM_001258210,TSKU,2,1,15843,2669,13174,13174,1334.5,4.93593106
NM_138706,B3GNT6,4,3,7622,2550,5076,1692,637.5,1.990588235
NM_000260,MYO7A,49,48,86978,7514,79464,1655.5,153.3469388,10.57545914
NM_006189,OMP,1,0,493,493,NA,NA,493,NA
NM_001127180,MYO7A,49,48,86972,7388,79584,1658,150.7755102,10.7720628
NM_001127179,MYO7A,27,26,56733,4083,52650,2025,151.2222222,12.8949302
NM_173039,AQP11,3,2,20723,2156,18567,9283.5,718.6666667,8.611781076
NM_024684,AAMDC,4,3,51192,508,50684,16894.66667,127,99.77165354
NM_001282406,KCTD14,3,2,30478,1785,28693,14346.5,595,16.0745098
NM_001204054,NDUFC2,3,2,11874,2271,9603,4801.5,757,4.228533686
NM_024079,ALG8,13,12,38713,1681,37032,3086,129.3076923,22.0297442
NM_023930,KCTD14,2,1,7561,1673,5888,5888,836.5,3.519426181
NM_003251,THRSP,2,1,4498,1182,3316,3316,591,2.805414552
NM_001204055,NDUFC2,3,2,11874,2409,9465,4732.5,803,3.929016189
NM_001203262,NDUFC2-KCTD14,3,2,64506,2295,62211,31105.5,765,27.10718954
NM_001203260,NDUFC2-KCTD14,4,3,64506,2440,62066,20688.66667,610,25.43688525
NM_001203261,NDUFC2-KCTD14,3,2,64506,2344,62162,31081,781.3333333,26.51962457
NM_004549,NDUFC2,3,2,11874,2478,9396,4698,826,3.791767554
NM_001007027,ALG8,14,13,38713,1757,36956,2842.769231,125.5,21.03357997
NM_020798,USP35,11,10,25901,4322,21579,2157.9,392.9090909,4.992827395
NM_001029859,KCTD21,2,1,17368,3380,13988,13988,1690,4.138461538
NM_145018,C11orf82,6,5,32964,3569,29395,5879,594.8333333,8.236200616
NM_015885,PCF11,16,15,28700,5928,22772,1518.133333,370.5,3.841430499
NM_182603,ANKRD42,10,9,54724,2572,52152,5794.666667,257.2,20.27682737
NM_021825,CCDC90B,9,8,27317,4027,23290,2911.25,447.4444444,5.783461634
NM_001286120,CCDC90B,7,6,27317,3801,23516,3919.333333,543,6.186792949
NM_001286118,CCDC90B,8,7,27317,3922,23395,3342.142857,490.25,5.965068842
NM_001286117,CCDC90B,9,8,27317,4347,22970,2871.25,483,5.28410398
NM_001286116,CCDC90B,9,8,27317,3800,23517,2939.625,422.2222222,6.188684211
NM_001286119,CCDC90B,9,8,27317,4008,23309,2913.625,445.3333333,5.815618762
NM_032273,TMEM126A,5,4,8636,823,7813,1953.25,164.6,9.493317132
NM_032379,SYTL2,9,8,20528,2413,18115,2264.375,268.1111111,7.507252383
NM_152723,CCDC89,1,0,2429,2429,NA,NA,2429,NA
NM_206929,SYTL2,12,11,24960,2468,22492,2044.727273,205.6666667,9.113452188
NM_001289610,SYTL2,11,10,24960,2347,22613,2261.3,213.3636364,9.634853004
NM_001244735,TMEM126A,4,3,8636,729,7907,2635.666667,182.25,10.84636488
NM_001256547,TMEM126B,4,3,7968,920,7048,2349.333333,230,7.660869565
NM_001256546,TMEM126B,6,5,7968,1116,6852,1370.4,186,6.139784946
NM_001162952,SYTL2,10,9,25130,2662,22468,2496.444444,266.2,8.440270473
NM_018480,TMEM126B,5,4,7968,1043,6925,1731.25,208.6,6.639501438
NM_206930,SYTL2,9,8,25130,2638,22492,2811.5,293.1111111,8.526156179
NM_001289609,SYTL2,11,10,25130,2776,22354,2235.4,252.3636364,8.05259366
NM_001193538,TMEM126B,6,5,7968,1216,6752,1350.4,202.6666667,5.552631579
NM_001193537,TMEM126B,6,5,7968,1175,6793,1358.6,195.8333333,5.781276596
NM_001039618,CREBZF,1,0,7576,7576,NA,NA,7576,NA
NM_206928,SYTL2,12,11,32248,4768,27480,2498.181818,397.3333333,5.763422819
NM_206927,SYTL2,13,12,32248,4817,27431,2285.916667,370.5384615,5.694623209
NM_016401,C11orf73,5,4,43734,1142,42592,10648,228.4,37.29597198
NM_007173,PRSS23,2,1,10784,3806,6978,6978,1903,1.833420914
NM_012193,FZD4,2,1,9725,7396,2329,2329,3698,0.314899946
NM_022337,RAB38,3,2,62222,1463,60759,30379.5,487.6666667,41.53041695
NM_001814,CTSC,7,6,44183,1914,42269,7044.833333,273.4285714,22.08411703
NM_148170,CTSC,4,3,16962,6139,10823,3607.666667,1534.75,1.762990715
NM_001114173,CTSC,4,3,16962,6095,10867,3622.333333,1523.75,1.782936833
NM_001271942,TRIM77,5,4,7575,1127,6448,1612,225.4,5.721384206
NM_001146162,TRIM77,6,5,7575,1359,6216,1243.2,226.5,4.573951435
NM_153696,FOLH1B,14,13,39423,1988,37435,2879.615385,142,18.8304829
NM_001164397,TRIM64B,6,5,5581,1539,4042,808.4,256.5,2.626380767
NM_020358,TRIM49,8,7,10922,2171,8751,1250.142857,271.375,4.030861354
NM_001206627,TRIM49D1,6,5,6240,1480,4760,952,246.6666667,3.216216216
NM_001136486,TRIM64,6,5,5570,1539,4031,806.2,256.5,2.619233268
NM_001195234,TRIM49C,8,7,10921,2171,8750,1250,271.375,4.030400737
NM_001105522,TRIM49D2P,7,6,8999,1656,7343,1223.833333,236.5714286,4.434178744
NM_001206627,TRIM49D1,6,5,6240,1480,4760,952,246.6666667,3.216216216
NM_001143975,UBTFL1,1,0,1183,1183,NA,NA,1183,NA
NM_012124,CHORDC1,11,10,22937,3396,19541,1954.1,308.7272727,5.754122497
NM_001144073,CHORDC1,10,9,22937,3338,19599,2177.666667,333.8,5.871479928
NM_005959,MTNR1B,2,1,13161,1664,11497,11497,832,6.909254808
NM_181645,CCDC67,14,13,107755,2680,105075,8082.692308,191.4285714,39.20708955
NM_020179,SMCO4,3,2,64909,978,63931,31965.5,326,65.36912065
NM_024116,TAF1D,6,5,5609,1317,4292,858.4,219.5,3.258921792
NM_001286068,C11orf54,9,8,21510,2598,18912,2364,288.6666667,7.279445727
NM_014039,C11orf54,8,7,21510,2452,19058,2722.571429,306.5,7.772430669
NM_001286071,C11orf54,8,7,21510,2425,19085,2726.428571,303.125,7.870103093
NM_001144871,VSTM5,4,3,29935,607,29328,9776,151.75,48.31630972
NM_004268,MED17,12,11,29093,3509,25584,2325.818182,292.4166667,7.290966087
NM_001286069,C11orf54,9,8,21510,2603,18907,2363.375,289.2222222,7.263542067
NM_001286067,C11orf54,10,9,21510,2736,18774,2086,273.6,6.861842105
NM_001286070,C11orf54,8,7,21510,2450,19060,2722.857143,306.25,7.779591837
NM_001098672,HEPHL1,20,19,92998,5971,87027,4580.368421,298.55,14.57494557
NM_015368,PANX1,5,4,53045,2773,50272,12568,554.6,18.12910206
NM_001199206,FOLR4,4,3,2057,757,1300,433.3333333,189.25,1.717305152
NM_005591,MRE11A,20,19,76573,5158,71415,3758.684211,257.9,13.84548275
NM_005590,MRE11A,19,18,76573,5180,71393,3966.277778,272.6315789,13.78243243
NM_017704,ANKRD49,3,2,5593,1908,3685,1842.5,636,1.931341719
NM_016540,GPR83,4,3,24110,4286,19824,6608,1071.5,4.625291647
NM_001190462,LINC01171,4,3,19596,608,18988,6329.333333,152,31.23026316
NM_152431,PIWIL4,20,19,54115,3219,50896,2678.736842,160.95,15.81112147
NM_002033,FUT4,1,0,6049,6049,NA,NA,6049,NA
NM_001161630,KDM4E,1,0,2340,2340,NA,NA,2340,NA
NM_016403,CWC15,7,6,10991,1582,9409,1568.166667,226,5.947534766
NM_018039,KDM4D,3,2,25833,2975,22858,11429,991.6666667,7.683361345
NM_032102,SRSF8,1,0,4348,4348,NA,NA,4348,NA
NM_015036,ENDOD1,2,1,42843,4695,38148,38148,2347.5,8.125239617
NM_001271594,SESN3,9,8,67030,9354,57676,7209.5,1039.333333,6.165918324
NM_144665,SESN3,10,9,65571,9453,56118,6235.333333,945.3,5.936528086
NM_144664,FAM76B,10,9,20850,3961,16889,1876.555556,396.1,4.263822267
NM_016156,MTMR2,15,14,91329,4610,86719,6194.214286,307.3333333,18.81106291
NM_201281,MTMR2,16,15,91329,4682,86647,5776.466667,292.625,18.50640752
NM_201278,MTMR2,17,16,91329,4806,86523,5407.6875,282.7058824,18.0031211
NM_001243571,MTMR2,18,17,91329,4880,86449,5085.235294,271.1111111,17.71495902
NM_024725,CCDC82,10,9,37156,2740,34416,3824,274,12.56058394
NM_001261833,JRKL,2,1,3571,3163,408,408,1581.5,0.128991464
NM_003772,JRKL,1,0,3571,3571,NA,NA,3571,NA
NM_032021,TMEM133,1,0,1857,1857,NA,NA,1857,NA
NM_178127,ANGPTL5,9,8,25850,2377,23473,2934.125,264.1111111,9.875052587
NM_001195005,C11orf70,4,3,28675,544,28131,9377,136,51.71139706
NM_032930,C11orf70,7,6,37124,2205,34919,5819.833333,315,15.83628118
NM_001282097,YAP1,8,7,122964,5280,117684,16812,660,22.28863636
NM_001282098,YAP1,7,6,122964,5243,117721,19620.16667,749,22.45298493
NM_001282100,YAP1,8,7,122964,5358,117606,16800.85714,669.75,21.94960806
NM_001195044,YAP1,8,7,122964,5346,117618,16802.57143,668.25,22.00112233
NM_001195045,YAP1,9,8,120985,4992,115993,14499.125,554.6666667,23.23577724
NM_001282099,YAP1,8,7,122964,5292,117672,16810.28571,661.5,22.23582766
NM_001282101,YAP1,9,8,122964,5407,117557,14694.625,600.7777778,21.74163122
NM_001130145,YAP1,9,8,122964,5395,117569,14696.125,599.4444444,21.79221501
NM_006106,YAP1,7,6,122964,5231,117733,19622.16667,747.2857143,22.50678647
NM_182962,BIRC3,10,9,21956,4362,17594,1954.888889,436.2,4.033470885
NM_001165,BIRC3,9,8,21956,6921,15035,1879.375,769,2.172373934
NM_052932,TMEM123,5,4,56721,3595,53126,13281.5,719,14.77774687
NM_002423,MMP7,6,5,10241,1125,9116,1823.2,187.5,8.103111111
NM_004771,MMP20,10,9,48499,1966,46533,5170.333333,196.6,23.6688708
NM_002424,MMP8,10,9,13161,3066,10095,1121.666667,306.6,3.292563601
NM_022122,MMP27,10,9,14055,1657,12398,1377.555556,165.7,7.482196741
NM_002422,MMP3,10,9,7816,1838,5978,664.2222222,183.8,3.252448313
NM_002426,MMP12,10,9,12302,1886,10416,1157.333333,188.6,5.522799576
NM_002425,MMP10,10,9,10128,1769,8359,928.7777778,176.9,4.725268513
NM_002421,MMP1,10,9,8327,2065,6262,695.7777778,206.5,3.032445521
NM_001145938,MMP1,10,9,8327,1913,6414,712.6666667,191.3,3.352848928
NM_002427,MMP13,10,9,12744,2729,10015,1112.777778,272.9,3.669842433
NM_032299,DCUN1D5,8,7,41533,12740,28793,4113.285714,1592.5,2.260047096
NM_001001711,DDI1,1,0,2616,2616,NA,NA,2616,NA
NM_001225,CASP4,9,8,25733,1328,24405,3050.625,147.5555556,18.37725904
NM_033306,CASP4,9,8,13830,1347,12483,1560.375,149.6666667,9.267260579
NM_001191016,CASP12,8,7,12954,1696,11258,1608.285714,212,6.637971698
NM_001136112,CASP5,10,9,28930,1498,27432,3048,149.8,18.31241656
NM_001136110,CASP5,8,7,28930,1031,27899,3985.571429,128.875,27.06013579
NM_001136109,CASP5,9,8,28930,1284,27646,3455.75,142.6666667,21.53115265
NM_001007232,CARD17,4,3,8964,470,8494,2831.333333,117.5,18.07234043
NM_001257118,CASP1,9,8,9649,2016,7633,954.125,224,3.786210317
NM_052889,CARD16,4,3,4000,762,3238,1079.333333,190.5,4.249343832
NM_001223,CASP1,9,8,9649,1328,8321,1040.125,147.5555556,6.265813253
NM_033294,CASP1,8,7,9649,967,8682,1240.285714,120.875,8.978283351
NM_033293,CASP1,9,8,9649,1112,8537,1067.125,123.5555556,7.677158273
NM_033292,CASP1,10,9,9649,1392,8257,917.4444444,139.2,5.931752874
NM_033295,CASP1,5,4,9649,439,9210,2302.5,87.8,20.97949886
NM_001017534,CARD16,3,2,4000,698,3302,1651,232.6666667,4.730659026
NM_004347,CASP5,10,9,28930,1459,27471,3052.333333,145.9,18.82864976
NM_001257119,CASP1,8,7,9649,1952,7697,1099.571429,244,3.943135246
NM_021571,CARD18,3,2,2015,663,1352,676,221,2.039215686
NM_032424,MSANTD4,3,2,14327,4090,10237,5118.5,1363.333333,2.502933985
NM_198439,KBTBD3,4,3,26642,4235,22407,7469,1058.75,5.290909091
NM_015423,AASDHPPT,6,5,21129,2867,18262,3652.4,477.8333333,6.369724451
NM_152433,KBTBD3,3,2,26642,4033,22609,11304.5,1344.333333,5.606000496
NM_138775,ALKBH8,12,11,63010,4079,58931,5357.363636,339.9166667,14.44741358
NM_003063,SLN,2,1,4688,732,3956,3956,366,5.404371585
NM_017515,SLC35F2,8,7,68199,3178,65021,9288.714286,397.25,20.4597231
NM_017516,RAB39A,2,1,34933,1784,33149,33149,892,18.58127803
NM_003478,CUL5,19,18,99082,6406,92676,5148.666667,337.1578947,14.46706213
NM_002519,NPAT,18,17,65248,5954,59294,3487.882353,330.7777778,9.958683238
NM_153705,KDELC2,8,7,26328,4319,22009,3144.142857,539.875,5.095855522
NM_207645,C11orf87,2,1,7049,5939,1110,1110,2969.5,0.186900152
NM_004109,FDX1,4,3,34949,3159,31790,10596.66667,789.75,10.06331117
NM_001271457,COLCA2,5,4,9897,1271,8626,2156.5,254.2,6.786782061
NM_001136105,COLCA2,5,4,9486,1526,7960,1990,305.2,5.216251638
NM_001271458,COLCA2,5,4,10191,1095,9096,2274,219,8.306849315
NM_006235,POU2AF1,5,4,27178,3036,24142,6035.5,607.2,7.951910408
NM_017589,BTG4,6,5,44825,1019,43806,8761.2,169.8333333,42.9892051
NM_001100388,C11orf88,6,5,22248,720,21528,4305.6,120,29.9
NM_207430,C11orf88,7,6,22248,802,21446,3574.333333,114.5714286,26.74064838
NM_001258391,LAYN,6,5,21239,2596,18643,3728.6,432.6666667,7.181432974
NM_001258390,LAYN,8,7,21239,2780,18459,2637,347.5,6.639928058
NM_178834,LAYN,7,6,21239,2755,18484,3080.666667,393.5714286,6.709255898
NM_002716,PPP2R1B,15,14,28566,5620,22946,1639,374.6666667,4.082918149
NM_181699,PPP2R1B,16,15,39539,2161,37378,2491.866667,135.0625,17.29662193
NM_001177563,PPP2R1B,13,12,28566,5237,23329,1944.083333,402.8461538,4.454649609
NM_001177562,PPP2R1B,14,13,28566,5484,23082,1775.538462,391.7142857,4.208971554
NM_181700,PPP2R1B,14,13,39539,1967,37572,2890.153846,140.5,19.10116929
NM_022761,C11orf1,4,3,4851,987,3864,1288,246.75,3.914893617
NM_001541,HSPB2,2,1,1359,843,516,516,421.5,0.612099644
NM_080659,C11orf52,4,3,7996,1144,6852,2284,286,5.98951049
NM_138378,FDXACB1,5,4,5403,3071,2332,583,614.2,0.759361771
NM_001289808,CRYAB,3,2,3408,977,2431,1215.5,325.6666667,2.488229273
NM_001289807,CRYAB,4,3,4595,949,3646,1215.333333,237.25,3.841938883
NM_001885,CRYAB,4,3,4595,983,3612,1204,245.75,3.674465921
NM_033425,DIXDC1,16,15,45343,5512,39831,2655.4,344.5,7.226233672
NM_001931,DLAT,14,13,39466,4360,35106,2700.461538,311.4285714,8.051834862
NM_001037954,DIXDC1,20,19,85449,5982,79467,4182.473684,299.1,13.28435306
NM_031275,TEX12,5,4,5186,1149,4037,1009.25,229.8,3.513489991
NM_003002,SDHD,4,3,8979,1399,7580,2526.666667,349.75,5.418155826
NM_001276504,SDHD,3,2,8979,1281,7698,3849,427,6.009367681
NM_001276503,SDHD,3,2,8979,1253,7726,3863,417.6666667,6.166001596
NM_012459,TIMM8B,2,1,1985,809,1176,1176,404.5,1.453646477
NM_001243211,IL18,5,4,20868,1140,19728,4932,228,17.30526316
NM_001562,IL18,6,5,20868,1153,19715,3943,192.1666667,17.09887251
NM_018195,C11orf57,6,5,10908,3747,7161,1432.2,624.5,1.911128903
NM_001082969,C11orf57,6,5,10908,3189,7719,1543.8,531.5,2.420507996
NM_001082970,C11orf57,6,5,10908,3744,7164,1432.8,624,1.913461538
NM_138789,PIH1D2,6,5,6374,1249,5125,1025,208.1666667,4.103282626
NM_001276506,SDHD,5,4,8979,1530,7449,1862.25,306,4.868627451
NM_001145024,PLET1,4,3,12709,1545,11164,3721.333333,386.25,7.225889968
NM_000317,PTS,6,5,7609,940,6669,1333.8,156.6666667,7.094680851
NM_017868,TTC12,22,21,51865,2337,49528,2358.47619,106.2272727,21.19298246
NM_178510,ANKK1,8,7,12629,2551,10078,1439.714286,318.875,3.950607605
NM_016574,DRD2,7,6,65686,2619,63067,10511.16667,374.1428571,24.0805651
NM_000795,DRD2,8,7,65686,2707,62979,8997,338.375,23.26523827
NM_030770,TMPRSS5,13,12,18829,2250,16579,1381.583333,173.0769231,7.368444444
NM_001288751,TMPRSS5,13,12,18829,2354,16475,1372.916667,181.0769231,6.998725573
NM_001288750,TMPRSS5,12,11,18829,2146,16683,1516.636364,178.8333333,7.773998136
NM_001288749,TMPRSS5,10,9,18829,1937,16892,1876.888889,193.7,8.720702117
NM_001288752,TMPRSS5,11,10,18829,2041,16788,1678.8,185.5454545,8.225379716
NM_020886,USP28,25,24,77661,4657,73004,3041.833333,186.28,15.67618639
NM_001101389,CLDN25,1,0,691,691,NA,NA,691,NA
NM_213621,HTR3A,8,7,15239,2341,12898,1842.571429,292.625,5.509611277
NM_000869,HTR3A,9,8,15239,2246,12993,1624.125,249.5555556,5.784951024
NM_001161772,HTR3A,9,8,12814,2005,10809,1351.125,222.7777778,5.391022444
NM_006028,HTR3B,9,8,41767,1897,39870,4983.75,210.7777778,21.01739589
NM_001286045,RBM7,5,4,10083,3755,6328,1582,751,1.685219707
NM_001286046,RBM7,5,4,10083,3751,6332,1583,750.2,1.688083178
NM_019021,C11orf71,2,1,9104,782,8322,8322,391,10.64194373
NM_001271562,C11orf71,1,0,2018,2018,NA,NA,2018,NA
NM_006169,NNMT,3,2,16705,1581,15124,7562,527,9.566097407
NM_016090,RBM7,5,4,10083,3752,6331,1582.75,750.4,1.687366738
NM_001286047,RBM7,4,3,10083,3591,6492,2164,897.75,1.807852966
NM_001286048,RBM7,3,2,10083,3502,6581,3290.5,1167.333333,1.879211879
NM_015523,REXO2,7,6,10894,1167,9727,1621.166667,166.7142857,8.335047129
NM_017678,NXPE4,6,5,25173,1705,23468,4693.6,284.1666667,13.76422287
NM_001077639,NXPE4,6,5,25173,2169,23004,4600.8,361.5,10.60580913
NM_001159736,BUD13,10,9,24830,1814,23016,2557.333333,181.4,12.68798236
NM_032725,BUD13,10,9,24830,2216,22614,2512.666667,221.6,10.20487365
NM_000040,APOC3,4,3,3165,537,2628,876,134.25,4.893854749
NM_052968,APOA5,4,3,3052,1936,1116,372,484,0.576446281
NM_000039,APOA1,4,3,1871,901,970,323.3333333,225.25,1.076581576
NM_000482,APOA4,3,2,2595,1463,1132,566,487.6666667,0.773752563
NM_001166598,APOA5,4,3,3052,1912,1140,380,478,0.59623431
NM_002572,PAFAH1B2,6,5,26763,4184,22579,4515.8,697.3333333,5.396510516
NM_001184747,PAFAH1B2,6,5,32133,1069,31064,6212.8,178.1666667,29.05893358
NM_001184746,PAFAH1B2,7,6,32133,1195,30938,5156.333333,170.7142857,25.88953975
NM_004716,PCSK7,17,16,27456,3932,23524,1470.25,231.2941176,5.982706002
NM_003186,TAGLN,5,4,5470,1165,4305,1076.25,233,3.69527897
NM_001278249,RNF214,15,14,52954,2245,50709,3622.071429,149.6666667,22.58752784
NM_001207049,BACE1,8,7,9986,5142,4844,692,642.75,0.942045897
NM_001040455,SIDT2,26,25,18224,3945,14279,571.16,151.7307692,3.619518378
NM_001207048,BACE1,8,7,9986,5217,4769,681.2857143,652.125,0.914126893
NM_001077239,RNF214,15,14,52954,2710,50244,3588.857143,180.6666667,18.5402214
NM_207343,RNF214,15,14,53065,2772,50293,3592.357143,184.8,18.14321789
NM_001001522,TAGLN,5,4,5470,1562,3908,977,312.4,2.501920615
NM_001271933,CEP164,32,31,91490,5579,85911,2771.322581,174.34375,15.39899624
NM_014956,CEP164,33,32,85413,5661,79752,2492.25,171.5454545,14.08797032
NM_001680,FXYD2,6,5,4671,577,4094,818.8,96.16666667,7.095320624
NM_021603,FXYD2,6,5,8019,584,7435,1487,97.33333333,12.73116438
NM_001164837,FXYD6,9,8,40057,2141,37916,4739.5,237.8888889,17.70948155
NM_001164836,FXYD6,10,9,40057,2239,37818,4202,223.9,16.89057615
NM_001164832,FXYD6,9,8,40057,2162,37895,4736.875,240.2222222,17.52775208
NM_001164831,FXYD6,8,7,40512,1812,38700,5528.571429,226.5,21.35761589
NM_001206789,TMPRSS13,12,11,28814,3355,25459,2314.454545,279.5833333,7.588375559
NM_022003,FXYD6,8,7,40057,2064,37993,5427.571429,258,18.40746124
NM_001244995,TMPRSS13,13,12,26413,2246,24167,2013.916667,172.7692308,10.76001781
NM_001206790,TMPRSS13,9,8,21660,2254,19406,2425.75,250.4444444,8.609582964
NM_001077263,TMPRSS13,13,12,28814,3461,25353,2112.75,266.2307692,7.325339497
NM_001558,IL10RA,7,6,15095,3664,11431,1905.166667,523.4285714,3.11981441
NM_174934,SCN4B,5,4,19540,4584,14956,3739,916.8,3.262652705
NM_153206,AMICA1,9,8,19634,2204,17430,2178.75,244.8888889,7.908348457
NM_001286571,AMICA1,9,8,19634,2194,17440,2180,243.7777778,7.948951686
NM_001286570,AMICA1,9,8,31369,1903,29466,3683.25,211.4444444,15.48397267
NM_001142349,SCN4B,4,3,12094,4520,7574,2524.666667,1130,1.675663717
NM_001142348,SCN4B,3,2,19540,4180,15360,7680,1393.333333,3.674641148
NM_001098526,AMICA1,10,9,31369,1967,29402,3266.888889,196.7,14.94763599
NM_004588,SCN2B,4,3,13820,4926,8894,2964.666667,1231.5,1.805521721
NM_005797,MPZL2,6,5,11122,2867,8255,1651,477.8333333,2.879316359
NM_001040651,CD3D,4,3,3672,613,3059,1019.666667,153.25,4.990212072
NM_000073,CD3G,7,6,9440,1318,8122,1353.666667,188.2857143,6.162367223
NM_000733,CD3E,9,8,11597,1522,10075,1259.375,169.1111111,6.619579501
NM_000732,CD3D,5,4,3672,746,2926,731.5,149.2,3.922252011
NM_144765,MPZL2,5,4,7625,1373,6252,1563,274.6,4.553532411
NM_198275,MPZL3,6,5,25680,3992,21688,4337.6,665.3333333,5.432865731
NM_001286152,MPZL3,6,5,25680,3956,21724,4344.8,659.3333333,5.49140546
NM_001204077,UBE4A,20,19,39632,6127,33505,1763.421053,306.35,5.468418476
NM_006476,ATP5L,3,2,8460,1341,7119,3559.5,447,5.308724832
NM_004788,UBE4A,20,19,39632,6148,33484,1762.315789,307.4,5.446324008
NM_032780,TMEM25,9,8,4749,2539,2210,276.25,282.1111111,0.870421426
NM_001080441,TTC36,3,2,3532,682,2850,1425,227.3333333,4.17888563
NM_001168618,IFT46,12,11,21550,1734,19816,1801.454545,144.5,11.42791234
NM_001655,ARCN1,10,9,30647,4025,26622,2958,402.5,6.614161491
NM_001144034,TMEM25,8,7,4749,2406,2343,334.7142857,300.75,0.973815461
NM_001144036,TMEM25,7,6,4749,2093,2656,442.6666667,299,1.268991878
NM_001142281,ARCN1,9,8,30647,3760,26887,3360.875,417.7777778,7.150797872
NM_001144038,TMEM25,8,7,15512,1554,13958,1994,194.25,8.981981982
NM_001144037,TMEM25,9,8,15512,1690,13822,1727.75,187.7777778,8.178698225
NM_001144035,TMEM25,8,7,4749,2403,2346,335.1428571,300.375,0.97627965
NM_020153,IFT46,13,12,21550,1888,19662,1638.5,145.2307692,10.41419492
NM_007180,TREH,15,14,21441,1868,19573,1398.071429,124.5333333,10.47805139
NM_032966,CXCR5,1,0,2881,2881,NA,NA,2881,NA
NM_006760,UPK2,5,4,2263,939,1324,331,187.8,1.41001065
NM_181721,FOXR1,6,5,9580,1159,8421,1684.2,193.1666667,7.265746333
NM_001716,CXCR5,2,1,12507,2905,9602,9602,1452.5,3.305335628
NM_182557,BCL9L,8,7,14764,7746,7018,1002.571429,968.25,0.906016008
NM_015517,HINFP,11,10,13534,2366,11168,1116.8,215.0909091,4.720202874
NM_001467,SLC37A4,10,9,6557,2112,4447,494.1111111,211.2,2.105587121
NM_001028,RPS25,5,4,2637,497,2140,535,99.4,4.30583501
NM_000190,HMBS,14,13,8674,1523,7151,550.0769231,108.7857143,4.695338148
NM_006389,HYOU1,26,25,13022,4628,8394,335.76,178,1.813742437
NM_016146,TRAPPC4,5,4,5146,1206,3940,985,241.2,3.266998342
NM_198971,HINFP,10,9,13534,2248,11286,1254,224.8,5.020462633
NM_001382,DPAGT1,9,8,5574,2151,3423,427.875,239,1.591352859
NM_001243259,HINFP,10,9,13534,2310,11224,1247.111111,231,4.858874459
NM_002105,H2AFX,1,0,1594,1594,NA,NA,1594,NA
NM_001164280,SLC37A4,9,8,5219,2057,3164,395.5,228.5555556,1.538162372
NM_001164279,SLC37A4,11,10,6557,2043,4516,451.6,185.7272727,2.210474792
NM_001164278,SLC37A4,12,11,6557,2368,4191,381,197.3333333,1.769847973
NM_001164277,SLC37A4,11,10,6557,2617,3942,394.2,237.9090909,1.506304929
NM_001130991,HYOU1,26,25,13031,4504,8527,341.08,173.2307692,1.893206039
NM_014807,C2CD2L,14,13,9736,3358,6378,490.6153846,239.8571429,1.899344848
NM_021729,VPS11,16,15,14197,3238,10959,730.6,202.375,3.384496603
NM_001258209,HMBS,13,12,8674,1493,7181,598.4166667,114.8461538,4.809778969
NM_001258208,HMBS,13,12,8674,1402,7272,606,107.8461538,5.186875892
NM_001024382,HMBS,14,13,5564,1425,4139,318.3846154,101.7857143,2.904561404
NM_024791,PDZD3,11,10,4768,2256,2512,251.2,205.0909091,1.113475177
NM_024618,NLRX1,10,9,15306,3773,11533,1281.444444,377.3,3.056718791
NM_022169,ABCG4,15,14,13626,3850,9776,698.2857143,256.6666667,2.539220779
NM_001145018,CCDC153,7,6,5623,774,4849,808.1666667,110.5714286,6.264857881
NM_001282358,NLRX1,10,9,15685,3678,12007,1334.111111,367.8,3.264545949
NM_001282144,NLRX1,10,9,15306,4154,11152,1239.111111,415.4,2.68464131
NM_001282143,NLRX1,10,9,15306,3746,11560,1284.444444,374.6,3.085958356
NM_001142505,ABCG4,15,14,13077,3626,9451,675.0714286,241.7333333,2.606453392
NM_001168468,PDZD3,11,10,4768,2298,2470,247,208.9090909,1.074847694
NM_032015,RNF26,1,0,2816,2816,NA,NA,2816,NA
NM_006500,MCAM,16,15,8608,3348,5260,350.6666667,209.25,1.571087216
NM_001278431,C1QTNF5,3,2,1951,1364,587,293.5,454.6666667,0.430351906
NM_031433,MFRP,15,14,7741,3940,3801,271.5,262.6666667,0.964720812
NM_001243759,USP2,12,11,26513,2930,23583,2143.909091,244.1666667,8.048805461
NM_015645,C1QTNF5,15,14,7741,3940,3801,271.5,262.6666667,0.964720812
NM_004205,USP2,13,12,26513,3746,22767,1897.25,288.1538462,6.077682862
NM_171997,USP2,12,11,8969,3010,5959,541.7272727,250.8333333,1.979734219
NM_006288,THY1,4,3,5593,2401,3192,1064,600.25,1.329446064
NM_203286,PVRL1,6,5,54338,1440,52898,10579.6,240,36.73472222
NM_012101,TRIM29,9,8,26871,3028,23843,2980.375,336.4444444,7.874174373
NM_001244682,POU2F3,13,12,83306,2916,80390,6699.166667,224.3076923,27.56858711
NM_014352,POU2F3,13,12,79752,3026,76726,6393.833333,232.7692308,25.35558493
NM_178507,OAF,4,3,18905,1866,17039,5679.666667,466.5,9.131296892
NM_174926,TMEM136,4,3,8552,4109,4443,1481,1027.25,1.081284984
NM_001198670,TMEM136,3,2,8552,4465,4087,2043.5,1488.333333,0.915341545
NM_001198675,TMEM136,2,1,8552,3945,4607,4607,1972.5,1.167807351
NM_001198674,TMEM136,4,3,8552,3790,4762,1587.333333,947.5,1.25646438
NM_001198673,TMEM136,3,2,8552,4121,4431,2215.5,1373.666667,1.07522446
NM_001198672,TMEM136,3,2,8552,4135,4417,2208.5,1378.333333,1.068198307
NM_001198671,TMEM136,3,2,8552,4146,4406,2203,1382,1.062711047
NM_152715,TBCEL,8,7,65543,4037,61506,8786.571429,504.625,15.23557097
NM_001130047,TBCEL,8,7,65553,3910,61643,8806.142857,488.75,15.76547315
NM_006918,SC5D,5,4,20733,6951,13782,3445.5,1390.2,1.982736297
NM_001024956,SC5D,5,4,20544,7024,13520,3380,1404.8,1.924829157
NM_001001786,BLID,1,0,863,863,NA,NA,863,NA
NM_199124,C11orf63,4,3,23361,2118,21243,7081,529.5,10.02974504
NM_019604,CRTAM,10,9,34094,2432,31662,3518,243.2,13.01891447
NM_001098169,BSX,3,2,4024,705,3319,1659.5,235,4.707801418
NM_006597,HSPA8,9,8,4845,2469,2376,297,274.3333333,0.962332928
NM_153201,HSPA8,8,7,4845,2009,2836,405.1428571,251.125,1.411647586
NM_018400,SCN3B,6,5,25422,6072,19350,3870,1012,3.186758893
NM_001040151,SCN3B,7,6,25422,5674,19748,3291.333333,810.5714286,3.480437081
NM_001005325,OR6M1,1,0,943,943,NA,NA,943,NA
NM_001005188,OR6X1,1,0,940,940,NA,NA,940,NA
NM_001013743,TMEM225,4,3,2709,1102,1607,535.6666667,275.5,1.458257713
NM_001005197,OR8D4,1,0,946,946,NA,NA,946,NA
NM_001005187,OR6T1,1,0,973,973,NA,NA,973,NA
NM_001004474,OR10S1,1,0,997,997,NA,NA,997,NA
NM_001001965,OR4D5,1,0,958,958,NA,NA,958,NA
NM_001001953,OR10G9,1,0,937,937,NA,NA,937,NA
NM_001004464,OR10G8,1,0,937,937,NA,NA,937,NA
NM_001004463,OR10G7,1,0,937,937,NA,NA,937,NA
NM_001004462,OR10G4,1,0,937,937,NA,NA,937,NA
NM_001007249,OR8G2,1,0,916,916,NA,NA,916,NA
NM_001005468,OR8B2,1,0,943,943,NA,NA,943,NA
NM_001005198,OR8G5,1,0,1042,1042,NA,NA,1042,NA
NM_001002918,OR8D2,1,0,937,937,NA,NA,937,NA
NM_001002917,OR8D1,1,0,928,928,NA,NA,928,NA
NM_001005467,OR8B3,1,0,943,943,NA,NA,943,NA
NM_012378,OR8B8,1,0,937,937,NA,NA,937,NA
NM_001005196,OR8B4,1,0,931,931,NA,NA,931,NA
NM_032811,TBRG1,9,8,13082,5171,7911,988.875,574.5555556,1.529878167
NM_052959,PANX3,4,3,8800,1603,7197,2399,400.75,4.4897068
NM_001005195,OR8B12,1,0,934,934,NA,NA,934,NA
NM_001005194,OR8A1,1,0,982,982,NA,NA,982,NA
NM_138961,ESAM,7,6,9206,1876,7330,1221.666667,268,3.907249467
NM_006176,NRGN,4,3,7275,1219,6056,2018.666667,304.75,4.968006563
NM_014312,VSIG2,7,6,4741,1128,3613,602.1666667,161.1428571,3.203014184
NM_017425,SPA17,5,4,20949,942,20007,5001.75,188.4,21.2388535
NM_001126181,NRGN,4,3,7275,1222,6053,2017.666667,305.5,4.953355155
NM_022370,ROBO3,28,27,16067,4582,11485,425.3703704,163.6428571,2.506547359
NM_019055,ROBO4,18,17,13719,3855,9864,580.2352941,214.1666667,2.558754864
NM_025004,CCDC15,16,15,87370,3909,83461,5564.066667,244.3125,21.35098491
NM_152722,HEPACAM,7,6,17164,3552,13612,2268.666667,507.4285714,3.832207207
NM_001037558,HEPN1,1,0,1429,1429,NA,NA,1429,NA
NM_001080546,TMEM218,5,4,17340,4042,13298,3324.5,808.4,3.289955468
NM_198277,SLC37A2,19,18,27401,4215,23186,1288.111111,221.8421053,5.500830368
NM_001258246,TMEM218,5,4,17340,3993,13347,3336.75,798.6,3.342599549
NM_001258242,TMEM218,5,4,17340,4008,13332,3333,801.6,3.326347305
NM_001145290,SLC37A2,18,17,27401,4157,23244,1367.294118,230.9444444,5.591532355
NM_001258244,TMEM218,5,4,17340,3911,13429,3357.25,782.2,3.433648683
NM_001258243,TMEM218,6,5,17340,4112,13228,2645.6,685.3333333,3.21692607
NM_001258241,TMEM218,6,5,17395,4022,13373,2674.6,670.3333333,3.324962705
NM_001258240,TMEM218,7,6,17395,4082,13313,2218.833333,583.1428571,3.261391475
NM_001258239,TMEM218,5,4,17395,4017,13378,3344.5,803.4,3.330346029
NM_001258238,TMEM218,5,4,17395,3920,13475,3368.75,784,3.4375
NM_001258247,TMEM218,5,4,17340,3896,13444,3361,779.2,3.450718686
NM_001258245,TMEM218,7,6,17340,4075,13265,2210.833333,582.1428571,3.255214724
NM_005103,FEZ1,10,9,50567,1774,48793,5421.444444,177.4,27.50450958
NM_022549,FEZ1,2,1,8112,1815,6297,6297,907.5,3.469421488
NM_001278504,STT3A,17,16,29966,4120,25846,1615.375,242.3529412,6.273300971
NM_001278503,STT3A,19,18,29966,4333,25633,1424.055556,228.0526316,5.915762751
NM_001114122,CHEK1,13,12,32013,4168,27845,2320.416667,320.6153846,6.680662188
NM_001114121,CHEK1,14,13,51121,2697,48424,3724.923077,192.6428571,17.95476455
NM_001007277,EI24,10,9,15279,2159,13120,1457.777778,215.9,6.076887448
NM_152713,STT3A,18,17,29966,4244,25722,1513.058824,235.7777778,6.060791706
NM_004879,EI24,11,10,15279,2272,13007,1300.7,206.5454545,5.724911972
NM_001244846,CHEK1,12,11,32013,4065,27948,2540.727273,338.75,6.875276753
NM_001612,ACRV1,4,3,8566,1179,7387,2462.333333,294.75,6.26547922
NM_001274,CHEK1,13,12,30793,3511,27282,2273.5,270.0769231,7.770435773
NM_020108,ACRV1,5,4,8566,970,7596,1899,194,7.830927835
NM_020107,ACRV1,5,4,8566,1015,7551,1887.75,203,7.439408867
NM_020069,ACRV1,4,3,8566,1122,7444,2481.333333,280.5,6.634581105
NM_212555,PATE2,4,3,2688,1641,1047,349,410.25,0.638025594
NM_138294,PATE1,5,4,3557,1513,2044,511,302.6,1.350958361
NM_001129883,PATE3,3,2,3491,1339,2152,1076,446.3333333,1.607169529
NM_001144874,PATE4,3,2,6758,1989,4769,2384.5,663,2.39768728
NM_145014,HYLS1,4,3,17034,1816,15218,5072.666667,454,8.379955947
NM_013264,DDX25,12,11,18747,1846,16901,1536.454545,153.8333333,9.155471289
NM_001271985,PUS3,3,2,9738,1423,8315,4157.5,474.3333333,5.843288826
NM_001134793,HYLS1,3,2,13588,2062,11526,5763,687.3333333,5.58971872
NM_031307,PUS3,4,3,9738,1848,7890,2630,462,4.269480519
NM_001144827,RPUSD4,7,6,9600,2426,7174,1195.666667,346.5714286,2.95713108
NM_032795,RPUSD4,7,6,9600,2519,7081,1180.166667,359.8571429,2.811036125
NM_001039661,TIRAP,6,5,11848,2354,9494,1898.8,392.3333333,4.033135089
NM_148910,TIRAP,5,4,10091,1224,8867,2216.75,244.8,7.244281046
NM_014026,DCPS,6,5,41999,1485,40514,8102.8,247.5,27.28215488
NM_003139,SRPR,14,13,6065,3106,2959,227.6153846,221.8571429,0.952672247
NM_017547,FOXRED1,11,10,9094,2082,7012,701.2,189.2727273,3.367915466
NM_001177842,SRPR,13,12,6065,3021,3044,253.6666667,232.3846154,1.007613373
NM_006278,ST3GAL4,11,10,58749,2064,56685,5668.5,187.6363636,27.46366279
NM_001254759,ST3GAL4,9,8,8461,1880,6581,822.625,208.8888889,3.500531915
NM_001254758,ST3GAL4,11,10,11227,1738,9489,948.9,158,5.45972382
NM_001254757,ST3GAL4,11,10,58998,1865,57133,5713.3,169.5454545,30.63431635
NM_005238,ETS1,8,7,63551,5250,58301,8328.714286,656.25,11.10495238
NM_001162422,ETS1,4,3,63551,4598,58953,19651,1149.5,12.82144411
NM_000220,KCNJ1,2,1,4522,2406,2116,2116,1203,0.879467997
NM_000890,KCNJ5,3,2,26640,2902,23738,11869,967.3333333,8.179875948
NM_001195195,TP53AIP1,4,3,8669,1252,7417,2472.333333,313,5.924121406
NM_145013,C11orf45,4,3,6134,3628,2506,835.3333333,907,0.690738699
NM_001256088,C11orf45,4,3,6506,3639,2867,955.6666667,909.75,0.787853806
NM_001251964,TP53AIP1,2,1,8026,3128,4898,4898,1564,1.565856777
NM_001195194,TP53AIP1,3,2,2461,598,1863,931.5,199.3333333,3.115384615
NM_022112,TP53AIP1,4,3,8026,1277,6749,2249.666667,319.25,5.28504307
NM_003658,BARX2,4,3,76295,1771,74524,24841.33333,442.75,42.08018069
NM_138788,TMEM45B,6,5,44159,2213,41946,8389.2,368.8333333,18.9543606
NM_199438,PRDM10,18,17,47918,6027,41891,2464.176471,334.8333333,6.950555832
NM_199439,PRDM10,16,15,47918,5911,42007,2800.466667,369.4375,7.106580951
NM_199437,PRDM10,21,20,103131,6331,96800,4840,301.4761905,15.28984363
NM_020228,PRDM10,22,21,103131,6344,96787,4608.904762,288.3636364,15.2564628
NM_001142278,APLP2,13,12,74992,3102,71890,5990.833333,238.6153846,23.17537073
NM_001142277,APLP2,16,15,74992,3624,71368,4757.866667,226.5,19.69315673
NM_001142276,APLP2,17,16,74992,3793,71199,4449.9375,223.1176471,18.7711574
NM_001642,APLP2,18,17,74992,3830,71162,4186,212.7777778,18.58015666
NM_001243299,APLP2,17,16,74245,3711,70534,4408.375,218.2941176,19.00673673
NM_021978,ST14,19,18,50577,3319,47258,2625.444444,174.6842105,14.23862609
NM_139055,ADAMTS15,8,7,27672,5684,21988,3141.142857,710.5,3.868402533
NM_014758,SNX19,11,10,40618,6089,34529,3452.9,553.5454545,5.670717688
NM_174927,SPATA19,7,6,4877,873,4004,667.3333333,124.7142857,4.586483391
NM_199297,THYN1,7,6,5089,867,4222,703.6666667,123.8571429,4.869665513
NM_001080407,GLB1L3,20,19,43185,2964,40221,2116.894737,148.2,13.56983806
NM_052875,VPS26B,6,5,23127,3675,19452,3890.4,612.5,5.293061224
NM_014384,ACAD8,11,10,12314,2212,10102,1010.2,201.0909091,4.566907776
NM_014174,THYN1,7,6,5089,1328,3761,626.8333333,189.7142857,2.832078313
NM_199298,THYN1,8,7,5089,1019,4070,581.4285714,127.375,3.994111874
NM_001037305,THYN1,8,7,5089,947,4142,591.7142857,118.375,4.373812038
NM_001037304,THYN1,7,6,5089,795,4294,715.6666667,113.5714286,5.401257862
NM_018644,B3GAT1,7,6,33416,3531,29885,4980.833333,504.4285714,8.463608043
NM_054025,B3GAT1,6,5,33416,3662,29754,5950.8,610.3333333,8.125068269
NM_001164595,PDZRN4,10,9,386144,3829,382315,42479.44444,382.9,99.84721859
NM_013377,PDZRN4,8,7,136853,3251,133602,19086,406.375,41.09566287
NM_198992,SYT10,7,6,64408,3293,61115,10185.83333,470.4285714,18.55906468
NM_001276471,CORO1C,11,10,85736,3956,81780,8178,359.6363636,20.67239636
NM_001260499,KCNC2,4,3,169672,5344,164328,54776,1336,30.75
NM_001260498,KCNC2,5,4,169672,3475,166197,41549.25,695,47.82647482
NM_001260497,KCNC2,5,4,169672,6082,163590,40897.5,1216.4,26.89740217
NM_014325,CORO1C,11,10,86443,3857,82586,8258.6,350.6363636,21.41197822
NM_012174,FBXW8,11,10,120194,4668,115526,11552.6,424.3636364,24.74850043
NM_017988,SCYL2,18,17,72367,3822,68545,4032.058824,212.3333333,17.93432758
NM_001105237,CORO1C,11,10,57891,3938,53953,5395.3,358,13.70060945
NM_139137,KCNC2,5,4,169672,5510,164162,41040.5,1102,29.79346642
NM_139136,KCNC2,6,5,169672,3571,166101,33220.2,595.1666667,46.51386166
NM_153748,KCNC2,5,4,169672,3405,166267,41566.75,681,48.83024963
NM_153348,FBXW8,11,10,120194,4866,115328,11532.8,442.3636364,23.70078093
NM_052907,TMEM132B,9,8,335763,10921,324842,40605.25,1213.444444,29.74471202
NM_201443,TEAD4,11,10,81096,1747,79349,7934.9,158.8181818,45.42014883
NM_134424,RAD52,12,11,37610,2685,34925,3175,223.75,13.00744879
NM_201441,TEAD4,12,11,81366,1678,79688,7244.363636,139.8333333,47.48986889
NM_003213,TEAD4,13,12,81366,1808,79558,6629.833333,139.0769231,44.00331858
NM_152640,DCP1B,9,8,58465,2101,56364,7045.5,233.4444444,26.82722513
NM_024829,PLBD1,11,10,64196,1943,62253,6225.3,176.6363636,32.03962944
NM_030669,PTPRO,15,14,51989,3985,48004,3428.857143,265.6666667,12.04617315
NM_030668,PTPRO,14,13,51989,3900,48089,3699.153846,278.5714286,12.33051282
NM_030667,PTPRO,27,26,276076,6406,269670,10371.92308,237.2592593,42.09647206
NM_002848,PTPRO,26,25,276076,6321,269755,10790.2,243.1153846,42.67600063
NM_030671,PTPRO,14,13,51989,5016,46973,3613.307692,358.2857143,9.364633174
NM_030670,PTPRO,13,12,51989,4931,47058,3921.5,379.3076923,9.543297506
NM_058169,LOH12CR1,4,3,109820,2089,107731,35910.33333,522.25,51.57060795
NM_020297,ABCC9,38,37,139306,8362,130944,3539.027027,220.0526316,15.65941162
NM_033123,PLCZ1,15,14,54885,2171,52714,3765.285714,144.7333333,24.28097651
NM_005691,ABCC9,38,37,131522,4708,126814,3427.405405,123.8947368,26.93585387
NM_001261414,SOX5,17,16,1030154,4317,1025837,64114.8125,253.9411765,237.6272875
NM_152989,SOX5,18,17,1030154,4567,1025587,60328.64706,253.7222222,224.5647033
NM_019844,SLCO1B3,16,15,106207,3028,103179,6878.6,189.25,34.07496697
NM_001164746,RASSF8,5,4,20318,5868,14450,3612.5,1173.6,2.462508521
NM_001714,BICD1,10,9,270958,3599,267359,29706.55556,359.9,74.28702417
NM_007211,RASSF8,6,5,120863,2324,118539,23707.8,387.3333333,51.00645439
NM_021238,FAM60A,7,6,45603,3121,42482,7080.333333,445.8571429,13.61166293
NM_001135811,FAM60A,7,6,45603,3125,42478,7079.666667,446.4285714,13.59296
NM_001271783,FAR2,12,11,186615,3825,182790,16617.27273,318.75,47.78823529
NM_001135812,FAM60A,6,5,45641,3020,42621,8524.2,503.3333333,14.11291391
NM_001164748,RASSF8,5,4,113845,5547,108298,27074.5,1109.4,19.52370651
NM_001164747,RASSF8,6,5,99121,5614,93507,18701.4,935.6666667,16.65603848
NM_001003398,BICD1,9,8,270958,3294,267664,33458,366,81.25804493
NM_173600,MUC19,173,172,177363,25004,152359,885.8081395,144.5317919,6.093385058
NM_001143824,SLC38A4,16,15,61238,3807,57431,3828.733333,237.9375,15.08563173
NM_001145110,NELL2,21,20,405655,3292,402363,20118.15,156.7619048,122.2244836
NM_001145109,NELL2,20,19,367388,3230,364158,19166.21053,161.5,112.7424149
NM_001145108,NELL2,20,19,368191,3725,364466,19182.42105,186.25,97.84322148
NM_001145107,NELL2,21,20,368577,3406,365171,18258.55,162.1904762,107.2140341
NM_006159,NELL2,21,20,368191,3333,364858,18242.9,158.7142857,109.4683468
NM_018018,SLC38A4,17,16,61238,4000,57238,3577.375,235.2941176,14.3095
NM_152641,ARID2,21,20,178201,8487,169714,8485.7,404.1428571,19.99693649
NM_001174127,SLC11A2,17,16,46635,3807,42828,2676.75,223.9411765,11.24980299
NM_001202233,NR4A1,8,7,36677,2598,34079,4868.428571,324.75,13.117398
NM_024068,NABP2,7,6,5515,1408,4107,684.5,201.1428571,2.916903409
NM_001174129,SLC11A2,16,15,40151,4440,35711,2380.733333,277.5,8.043018018
NM_001174126,SLC11A2,17,16,46635,3812,42823,2676.4375,224.2352941,11.23373557
NM_001174125,SLC11A2,16,15,42285,4172,38113,2540.866667,260.75,9.135426654
NM_014925,R3HDM2,22,21,56700,3996,52704,2509.714286,181.6363636,13.18918919
NM_000617,SLC11A2,16,15,40426,4180,36246,2416.4,261.25,8.671291866
NM_001174130,SLC11A2,15,14,23280,4154,19126,1366.142857,276.9333333,4.60423688
NM_001174128,SLC11A2,16,15,40426,4175,36251,2416.733333,260.9375,8.682874251
NM_001278472,MON2,36,35,130768,10493,120275,3436.428571,291.4722222,11.46240351
NM_001278469,MON2,36,35,130768,10476,120292,3436.914286,291,11.48262696
NM_015026,MON2,35,34,130768,10414,120354,3539.823529,297.5428571,11.55694258
NM_178169,RASSF3,5,4,87056,3497,83559,20889.75,699.4,23.89448098
NM_001278471,MON2,34,33,130768,10326,120442,3649.757576,303.7058824,11.66395506
NM_001278470,MON2,34,33,130768,10395,120373,3647.666667,305.7352941,11.57989418
NM_173812,DPY19L2,22,21,109663,4079,105584,5027.809524,185.4090909,25.88477568
NM_002392,MDM2,11,10,37374,7506,29868,2986.8,682.3636364,3.979216627
NM_001145340,MDM2,5,4,36529,6662,29867,7466.75,1332.4,4.483188232
NM_001145339,MDM2,9,8,37374,7339,30035,3754.375,815.4444444,4.092519417
NM_001145337,MDM2,11,10,36529,7115,29414,2941.4,646.8181818,4.134082923
NM_001278462,MDM2,6,5,36529,6741,29788,5957.6,1123.5,4.418928942
NM_002849,PTPRR,14,13,282733,3513,279220,21478.46154,250.9285714,79.48192428
NM_173353,TPH2,11,10,93597,2371,91226,9122.6,215.5454545,38.47574863
NM_001282536,PPFIA2,30,29,254418,5328,249090,8589.310345,177.6,46.75112613
NM_005639,SYT1,11,10,587341,4821,582520,58252,438.2727273,120.8297034
NM_001135805,SYT1,12,11,588017,4836,583181,53016.45455,403,120.5916046
NM_001220476,PPFIA2,32,31,500534,5617,494917,15965.06452,175.53125,88.11055724
NM_001220475,PPFIA2,31,30,500534,5571,494963,16498.76667,179.7096774,88.84634715
NM_032230,METTL25,12,11,120742,2106,118636,10785.09091,175.5,56.33238367
NM_003625,PPFIA2,33,32,501357,5687,495670,15489.6875,172.3333333,87.15843151
NM_001220478,PPFIA2,29,28,340398,5546,334852,11959,191.2413793,60.3772088
NM_001220477,PPFIA2,29,28,340398,5558,334840,11958.57143,191.6551724,60.24469234
NM_001220474,PPFIA2,31,30,500722,5685,495037,16501.23333,183.3870968,87.07774846
NM_001220473,PPFIA2,31,30,500722,5730,494992,16499.73333,184.8387097,86.38603839
NM_001135806,SYT1,10,9,406357,4420,401937,44659.66667,442,90.93597285
NM_173591,OTOGL,58,57,169639,8141,161498,2833.298246,140.362069,19.83761209
NM_013244,MGAT4C,7,6,859646,1941,857705,142950.8333,277.2857143,441.888202
NM_152788,ANKS1B,26,25,1249865,4959,1244906,49796.24,190.7307692,251.0397258
NM_003297,NR2C1,14,13,53401,4082,49319,3793.769231,291.5714286,12.08206761
NM_001173982,CHST11,3,2,305102,5756,299346,149673,1918.666667,52.00590688
NM_001278420,C12orf42,7,6,194071,1482,192589,32098.16667,211.7142857,129.9520918
NM_001278419,C12orf42,7,6,194071,1617,192454,32075.66667,231,119.0191713
NM_198521,C12orf42,6,5,194071,1386,192685,38537,231,139.0223665
NM_001018072,BTBD11,17,16,341224,5777,335447,20965.4375,339.8235294,58.06595119
NM_018413,CHST11,3,2,305102,5771,299331,149665.5,1923.666667,51.86813377
NM_001099336,C12orf42,6,5,194071,1521,192550,38510,253.5,126.5943458
NM_014503,UTP20,62,61,106494,9072,97422,1597.081967,146.3225806,10.73875661
NM_001017523,BTBD11,15,14,78787,3915,74872,5348,261,19.12439336
NM_001146699,RBM19,25,24,149635,4516,145119,6046.625,180.64,32.13441098
NM_016196,RBM19,24,23,144319,4221,140098,6091.217391,175.875,33.1907131
NM_001146698,RBM19,25,24,144319,3660,140659,5860.791667,146.4,38.43142077
NM_001143854,RPH3A,22,21,107137,4614,102523,4882.047619,209.7272727,22.21998266
NM_014954,RPH3A,21,20,107137,4601,102536,5126.8,219.0952381,22.28559009
NM_194286,SRRM4,13,12,181558,8490,173068,14422.33333,653.0769231,20.38492344
NM_018639,WSB2,9,8,28521,2891,25630,3203.75,321.2222222,8.865444483
NM_006836,GCN1L1,58,57,67501,8726,58775,1031.140351,150.4482759,6.735617694
NM_001278557,WSB2,9,8,29484,2791,26693,3336.625,310.1111111,9.563955571
NM_001194995,C12orf65,3,2,24480,1904,22576,11288,634.6666667,11.85714286
NM_152269,C12orf65,3,2,24664,1695,22969,11484.5,565,13.55103245
NM_001143905,C12orf65,3,2,24217,1611,22606,11303,537,14.03227809
NM_001278558,WSB2,7,6,28521,2512,26009,4334.833333,358.8571429,10.35390127
NM_152759,LRRC43,12,11,35754,1926,33828,3075.272727,160.5,17.56386293
NM_001204299,ZNF664-FAM101A,5,4,342810,2418,340392,85098,483.6,140.7741935
NM_001098519,LRRC43,12,11,20353,2037,18316,1665.090909,169.75,8.991654394
NM_181709,FAM101A,3,2,26862,2153,24709,12354.5,717.6666667,11.47654436
NM_133448,TMEM132D,9,8,831943,5786,826157,103269.625,642.8888889,142.7855168
NM_001136103,TMEM132C,9,8,440514,4956,435558,54444.75,550.6666667,87.88498789
NM_001042603,KDM5A,28,27,109400,10864,98536,3649.481481,388,9.069955817
NM_213655,WNK1,28,27,158531,11236,147295,5455.37037,401.2857143,13.10920256
NM_032358,CCDC77,13,12,41067,2380,38687,3223.916667,183.0769231,16.25504202
NM_001170738,IQSEC3,14,13,111578,6989,104589,8045.307692,499.2142857,14.96480183
NM_173593,B4GALNT3,20,19,101517,3458,98059,5161,172.9,28.35714286
NM_018979,WNK1,28,27,158531,10480,148051,5483.37037,374.2857143,14.12700382
NM_001130148,CCDC77,11,10,53292,2297,50995,5099.5,208.8181818,22.20069656
NM_001130147,CCDC77,12,11,53292,2352,50940,4630.909091,196,21.65816327
NM_001130146,CCDC77,12,11,41067,2325,38742,3522,193.75,16.66322581
NM_001184985,WNK1,28,27,158531,11260,147271,5454.481481,402.1428571,13.07912966
NM_015232,IQSEC3,13,12,93954,2712,91242,7603.5,208.6153846,33.64380531
NM_014823,WNK1,26,25,158531,9734,148797,5951.88,374.3846154,15.28631601
NM_024551,ADIPOR2,8,7,97600,3973,93627,13375.28571,496.625,23.56581928
NM_178040,ERC1,19,18,504697,9314,495383,27521.27778,490.2105263,53.18692291
NM_178039,ERC1,18,17,504697,9229,495468,29145.17647,512.7222222,53.68598981
NM_172364,CACNA2D4,38,37,126749,5381,121368,3280.216216,141.6052632,22.55491544
NM_001160408,TULP3,12,11,50275,2013,48262,4387.454545,167.75,23.97516145
NM_001129840,CACNA1C,47,46,644701,13527,631174,13721.17391,287.8085106,46.66030901
NM_001129831,CACNA1C,48,47,644701,13612,631089,13427.42553,283.5833333,46.36269468
NM_001129830,CACNA1C,48,47,644701,13633,631068,13426.97872,284.0208333,46.28973814
NM_001129841,CACNA1C,47,46,644701,13527,631174,13721.17391,287.8085106,46.66030901
NM_001129836,CACNA1C,47,46,644701,13578,631123,13720.06522,288.893617,46.48129327
NM_001129837,CACNA1C,46,45,644701,13550,631151,14025.57778,294.5652174,46.57940959
NM_199460,CACNA1C,50,49,644701,13779,630922,12875.95918,275.58,45.78866391
NM_001129833,CACNA1C,47,46,644701,13584,631117,13719.93478,289.0212766,46.46032097
NM_001129846,CACNA1C,46,45,644701,13493,631208,14026.84444,293.326087,46.78040465
NM_001129843,CACNA1C,47,46,644701,13527,631174,13721.17391,287.8085106,46.66030901
NM_001129832,CACNA1C,48,47,644701,13588,631113,13427.93617,283.0833333,46.44634972
NM_001129844,CACNA1C,47,46,644701,13518,631183,13721.36957,287.6170213,46.69204024
NM_001129842,CACNA1C,47,46,644701,13527,631174,13721.17391,287.8085106,46.66030901
NM_001129835,CACNA1C,47,46,644701,13584,631117,13719.93478,289.0212766,46.46032097
NM_003324,TULP3,11,10,50275,3117,47158,4715.8,283.3636364,15.12929098
NM_001167624,CACNA1C,48,47,644701,13633,631068,13426.97872,284.0208333,46.28973814
NM_001167623,CACNA1C,47,46,644701,13527,631174,13721.17391,287.8085106,46.66030901
NM_001129839,CACNA1C,46,45,644701,13544,631157,14025.71111,294.4347826,46.6004873
NM_001129838,CACNA1C,46,45,644701,13550,631151,14025.57778,294.5652174,46.57940959
NM_001129829,CACNA1C,47,46,644701,13650,631051,13718.5,290.4255319,46.23084249
NM_001129827,CACNA1C,49,48,644701,13673,631028,13146.41667,279.0408163,46.15139326
NM_001129834,CACNA1C,47,46,644701,13584,631117,13719.93478,289.0212766,46.46032097
NM_000719,CACNA1C,47,46,644701,13527,631174,13721.17391,287.8085106,46.66030901
NM_001167625,CACNA1C,47,46,644701,13707,630994,13717.26087,291.6382979,46.03443496
NM_006675,TSPAN9,9,8,209211,4360,204851,25606.375,484.4444444,46.98417431
NM_019854,PRMT8,10,9,102776,2413,100363,11151.44444,241.3,41.59262329
NM_032680,EFCAB4B,11,10,105259,2300,102959,10295.9,209.0909091,44.76478261
NM_001256536,PRMT8,10,9,212625,2004,210621,23402.33333,200.4,105.1002994
NM_001144958,EFCAB4B,20,19,137874,2815,135059,7108.368421,140.75,47.97833037
NM_001168320,TSPAN9,8,7,209211,4292,204919,29274.14286,536.5,47.7444082
NM_020367,PARP11,8,7,64589,4506,60083,8583.285714,563.25,13.33399911
NM_001286522,PARP11,8,7,64589,4507,60082,8583.142857,563.375,13.33081873
NM_001286521,PARP11,7,6,64589,4384,60205,10034.16667,626.2857143,13.73289234
NM_001282286,DYRK4,5,4,9027,970,8057,2014.25,194,8.306185567
NM_001282285,DYRK4,5,4,9027,973,8054,2013.5,194.6,8.277492292
NM_020375,C12orf5,6,5,38833,8231,30602,6120.4,1371.833333,3.71789576
NM_003845,DYRK4,13,12,23818,1877,21941,1828.416667,144.3846154,11.68939798
NM_017417,GALNT8,11,10,52142,2146,49996,4999.6,195.0909091,23.2972973
NM_001278597,ANO2,26,25,383583,3746,379837,15193.48,144.0769231,101.3980246
NM_001278596,ANO2,26,25,382610,3728,378882,15155.28,143.3846154,101.6314378
NM_000552,VWF,52,51,175798,8885,166913,3272.803922,170.8653846,18.78593134
NM_001144857,PLEKHG6,15,14,15857,3147,12710,907.8571429,209.8,4.03876708
NM_001267700,PHB2,8,7,5403,1337,4066,580.8571429,167.125,3.041136874
NM_001733,C1R,9,8,57530,2275,55255,6906.875,252.7777778,24.28791209
NM_001273,CHD4,40,39,37305,6537,30768,788.9230769,163.425,4.706746214
NM_018173,PLEKHG6,16,15,18072,2898,15174,1011.6,181.125,5.236024845
NM_001144856,PLEKHG6,16,15,17575,2980,14595,973,186.25,4.897651007
NM_001144831,PHB2,9,8,5403,1452,3951,493.875,161.3333333,2.72107438
NM_014262,LEPREL2,15,14,11482,2686,8796,628.2857143,179.0666667,3.274758004
NM_199286,DPPA3,4,3,6065,1041,5024,1674.666667,260.25,4.826128722
NM_001286237,SLC2A14,10,9,78686,3491,75195,8355,349.1,21.53967345
NM_001286236,SLC2A14,10,9,60529,3437,57092,6343.555556,343.7,16.61099796
NM_001286235,SLC2A14,13,12,60529,3899,56630,4719.166667,299.9230769,14.52423698
NM_001286234,SLC2A14,11,10,60529,3599,56930,5693,327.1818182,15.81828286
NM_001286233,SLC2A14,16,15,60529,4358,56171,3744.733333,272.375,12.88916934
NM_001080454,ACSM4,13,12,24043,1756,22287,1857.25,135.0769231,12.69191344
NM_153449,SLC2A14,12,11,60529,3636,56893,5172.090909,303,15.64713971
NM_020734,RIMKLB,7,6,79271,5837,73434,12239,833.8571429,12.5807778
NM_002864,PZP,36,35,59532,4646,54886,1568.171429,129.0555556,11.8136031
NM_001197317,CLEC2D,4,3,29849,5177,24672,8224,1294.25,4.765694418
NM_001004419,CLEC2D,6,5,29849,5372,24477,4895.4,895.3333333,4.556403574
NM_013269,CLEC2D,5,4,29849,5289,24560,6140,1057.8,4.643599924
NM_016511,CLEC1A,6,5,28527,1785,26742,5348.4,297.5,14.98151261
NM_001197319,CLEC2D,3,2,29849,5072,24777,12388.5,1690.666667,4.885055205
NM_001197318,CLEC2D,4,3,29849,5184,24665,8221.666667,1296,4.757908951
NM_002336,LRP6,23,22,150852,10106,140746,6397.545455,439.3913043,13.92697407
NM_001987,ETV6,8,7,245539,5986,239553,34221.85714,748.25,40.01887738
NM_016355,DDX47,12,11,16637,1829,14808,1346.181818,152.4166667,8.096227447
NM_001080555,GSG1,7,6,20161,2644,17517,2919.5,377.7142857,6.625189107
NM_001080554,GSG1,7,6,20161,2768,17393,2898.833333,395.4285714,6.283598266
NM_031289,GSG1,6,5,12271,2674,9597,1919.4,445.6666667,3.589005236
NM_201224,DDX47,11,10,16637,1681,14956,1495.6,152.8181818,8.897085068
NM_006143,GPR19,4,3,35128,1747,33381,11127,436.75,19.10761305
NM_001423,EMP1,5,4,20108,2809,17299,4324.75,561.8,6.158419366
NM_001206843,GSG1,6,5,12271,2466,9805,1961,411,3.976074615
NM_001206842,GSG1,6,5,20161,2574,17587,3517.4,429,6.832556333
NM_030640,DUSP16,7,6,89234,6319,82915,13819.16667,902.7142857,13.12153822
NM_001206845,GSG1,5,4,12271,2396,9875,2468.75,479.2,4.121452421
NM_153823,GSG1,6,5,12271,2550,9721,1944.2,425,3.812156863
NM_018179,ATF7IP,15,14,137305,8893,128412,9172.285714,592.8666667,14.43967165
NM_000834,GRIN2B,13,12,418614,5954,412660,34388.33333,458,69.30802822
NM_181352,ATF7IP,15,14,117873,9034,108839,7774.214286,602.2666667,12.04770866
NM_001286514,ATF7IP,15,14,137305,8890,128415,9172.5,592.6666667,14.44488189
NM_001286515,ATF7IP,13,12,116460,4398,112062,9338.5,338.3076923,25.48021828
NM_032918,RERG,5,4,113697,2330,111367,27841.75,466,47.79699571
NM_016312,WBP11,12,11,16991,2686,14305,1300.454545,223.8333333,5.325763217
NM_001190726,RERG,4,3,113697,2272,111425,37141.66667,568,49.04269366
NM_152321,ERP27,7,6,24489,1543,22946,3824.333333,220.4285714,14.87103046
NM_004963,GUCY2C,27,26,83953,3869,80084,3080.153846,143.2962963,20.6988886
NM_015954,DERA,9,8,126131,1733,124398,15549.75,192.5555556,71.78188113
NM_001170798,SLC15A5,9,8,89202,2932,86270,10783.75,325.7777778,29.42360164
NM_145792,MGST1,4,3,17270,906,16364,5454.666667,226.5,18.06181015
NM_145791,MGST1,4,3,16634,984,15650,5216.666667,246,15.90447154
NM_145764,MGST1,4,3,10995,914,10081,3360.333333,228.5,11.02954048
NM_020300,MGST1,4,3,16769,931,15838,5279.333333,232.75,17.01181525
NM_001267598,MGST1,4,3,29548,1383,28165,9388.333333,345.75,20.36514823
NM_001260511,MGST1,4,3,16769,924,15845,5281.666667,231,17.1482684
NM_001260512,MGST1,5,4,16769,1076,15693,3923.25,215.2,14.58457249
NM_004447,EPS8,21,20,169437,4103,165334,8266.7,195.3809524,40.29588106
NM_004570,PIK3C2G,32,31,386880,4876,382004,12322.70968,152.375,78.34372436
NM_001288774,PIK3C2G,33,32,386880,4993,381887,11933.96875,151.3030303,76.48447827
NM_001288772,PIK3C2G,33,32,386880,5000,381880,11933.75,151.5151515,76.376
NM_001267043,AEBP2,9,8,81660,4558,77102,9637.75,506.4444444,16.91575252
NM_001143821,PLEKHA5,28,27,243978,6619,237359,8791.074074,236.3928571,35.86025079
NM_001256470,PLEKHA5,32,31,246709,4869,241840,7801.290323,152.15625,49.66933662
NM_153207,AEBP2,8,7,82567,5668,76899,10985.57143,708.5,13.56721948
NM_019012,PLEKHA5,26,25,246709,4365,242344,9693.76,167.8846154,55.51981672
NM_001256787,PLEKHA5,26,25,171076,4419,166657,6666.28,169.9615385,37.71373614
NM_001114176,AEBP2,9,8,82567,5108,77459,9682.375,567.5555556,15.16425215
NM_000921,PDE3A,16,15,314864,7318,307546,20503.06667,457.375,42.02596338
NM_001009562,SLCO1B7,13,12,74412,1936,72476,6039.666667,148.9230769,37.43595041
NM_134431,SLCO1A2,16,15,130839,7698,123141,8209.4,481.125,15.9964926
NM_002907,RECQL,15,14,32761,3794,28967,2069.071429,252.9333333,7.634949921
NM_032941,RECQL,16,15,32761,3598,29163,1944.2,224.875,8.105336298
NM_006446,SLCO1B1,15,14,108604,2802,105802,7557.285714,186.8,37.75945753
NM_003034,ST8SIA1,5,4,141325,9719,131606,32901.5,1943.8,13.54110505
NM_018638,ETNK1,8,7,65534,7109,58425,8346.428571,888.625,8.218455479
NM_014802,C2CD5,25,24,96002,4498,91504,3812.666667,179.92,20.34326367
NM_001286177,C2CD5,27,26,96002,4626,91376,3514.461538,171.3333333,19.75270212
NM_001286176,C2CD5,27,26,96002,4653,91349,3513.423077,172.3333333,19.63228025
NM_001286175,C2CD5,28,27,96002,4663,91339,3382.925926,166.5357143,19.58803345
NM_001286174,C2CD5,26,25,96002,4792,91210,3648.4,184.3076923,19.03380634
NM_001286173,C2CD5,28,27,96002,4660,91342,3383.037037,166.4285714,19.60128755
NM_006940,SOX5,15,14,417408,4331,413077,29505.5,288.7333333,95.37681829
NM_001261415,SOX5,15,14,418737,4355,414382,29598.71429,290.3333333,95.15086108
NM_178010,SOX5,7,6,52317,3123,49194,8199,446.1428571,15.75216138
NM_005504,BCAT1,11,10,139437,9683,129754,12975.4,880.2727273,13.40018589
NM_001178094,BCAT1,11,10,92366,9576,82790,8279,870.5454545,8.645572264
NM_001178093,BCAT1,11,10,93053,9279,83774,8377.4,843.5454545,9.028343572
NM_001178092,BCAT1,9,8,139437,9498,129939,16242.375,1055.333333,13.68066961
NM_001178091,BCAT1,10,9,139437,9571,129866,14429.55556,957.1,13.56869711
NM_001204102,CASC1,17,16,86873,2565,84308,5269.25,150.8823529,32.86861598
NM_001204101,CASC1,13,12,86873,2328,84545,7045.416667,179.0769231,36.31658076
NM_001145729,IFLTD1,9,8,53433,1531,51902,6487.75,170.1111111,33.90071848
NM_001082972,CASC1,16,15,86873,2654,84219,5614.6,165.875,31.73285607
NM_001145728,IFLTD1,10,9,77203,1886,75317,8368.555556,188.6,39.93478261
NM_001145727,IFLTD1,8,7,152247,2497,149750,21392.85714,312.125,59.97196636
NM_018272,CASC1,16,15,86873,2526,84347,5623.133333,157.875,33.39152811
NM_001256266,IFLTD1,10,9,77203,1798,75405,8378.333333,179.8,41.93826474
NM_001082973,CASC1,15,14,86873,2507,84366,6026.142857,167.1333333,33.65217391
NM_152590,IFLTD1,9,8,77203,1766,75437,9429.625,196.2222222,42.71630804
NM_002223,ITPR2,57,56,497848,12625,485223,8664.696429,221.4912281,38.43350495
NM_016551,TM7SF3,12,11,42835,4355,38480,3498.181818,362.9166667,8.835820896
NM_001146221,MANSC4,3,2,8612,1098,7514,3757,366,6.843351548
NM_001198915,PPFIBP1,27,26,171454,5817,165637,6370.653846,215.4444444,28.47464329
NM_001198916,PPFIBP1,28,27,171454,6030,165424,6126.814815,215.3571429,27.43349917
NM_001248002,ARNTL2,16,15,92961,7385,85576,5705.066667,461.5625,11.58781313
NM_001248004,ARNTL2,15,14,92961,7282,85679,6119.928571,485.4666667,11.76586103
NM_001248005,ARNTL2,14,13,92961,7205,85756,6596.615385,514.6428571,11.90229008
NM_001248003,ARNTL2,15,14,92961,7315,85646,6117.571429,487.6666667,11.70827068
NM_020183,ARNTL2,17,16,92961,7428,85533,5345.8125,436.9411765,11.51494346
NM_003622,PPFIBP1,30,29,171454,6107,165347,5701.62069,203.5666667,27.07499591
NM_177444,PPFIBP1,29,28,171454,6124,165330,5904.642857,211.1724138,26.99706074
NM_018318,CCDC91,12,11,292968,2347,290621,26420.09091,195.5833333,123.8265871
NM_001193451,TMTC1,18,17,282999,8759,274240,16131.76471,486.6111111,31.30951022
NM_183378,OVCH1,28,27,70132,3448,66684,2469.777778,123.1428571,19.33990719
NM_175861,TMTC1,18,17,283948,8850,275098,16182.23529,491.6666667,31.08451977
NM_006390,IPO8,25,24,67016,5366,61650,2568.75,214.64,11.48900485
NM_001190995,IPO8,21,20,48265,4724,43541,2177.05,224.952381,9.216977138
NM_001278412,AMN1,9,8,58039,2328,55711,6963.875,258.6666667,23.93084192
NM_001278411,AMN1,7,6,58039,2097,55942,9323.666667,299.5714286,26.67715784
NM_001113402,AMN1,7,6,58039,2117,55922,9320.333333,302.4285714,26.41568257
NM_144973,DENND5B,21,20,208797,9412,199385,9969.25,448.1904762,21.18412665
NM_018169,KIAA1551,6,5,33692,6238,27454,5490.8,1039.666667,4.401090093
NM_001005242,PKP2,13,12,106102,4320,101782,8481.833333,332.3076923,23.56064815
NM_139241,FGD4,17,16,143945,8312,135633,8477.0625,488.9411765,16.3177334
NM_004572,PKP2,14,13,106102,4453,101649,7819.153846,318.0714286,22.82708287
NM_001173465,KIF21A,34,33,150164,6516,143648,4352.969697,191.6470588,22.04542664
NM_001173464,KIF21A,38,37,150164,6679,143485,3877.972973,175.7631579,21.48300644
NM_001173463,KIF21A,34,33,150164,6564,143600,4351.515152,193.0588235,21.87690433
NM_017641,KIF21A,37,36,150164,6639,143525,3986.805556,179.4324324,21.61846664
NM_153634,CPNE8,20,19,253420,3481,249939,13154.68421,174.05,71.80091928
NM_198578,LRRK2,51,50,144275,9275,135000,2700,181.8627451,14.55525606
NM_001031748,C12orf40,13,12,95750,2806,92944,7745.333333,215.8461538,33.1233072
NM_052885,SLC2A13,10,9,350840,7013,343827,38203,701.3,49.02709254
NM_005164,ABCD2,10,9,68823,5351,63472,7052.444444,535.1,11.86170809
NM_001843,CNTN1,24,23,379971,5684,374287,16273.34783,236.8333333,65.8492259
NM_001256064,CNTN1,16,15,144781,3544,141237,9415.8,221.5,39.85242664
NM_001256063,CNTN1,16,15,280277,3331,276946,18463.06667,208.1875,83.1419994
NM_175038,CNTN1,22,21,164056,5498,158558,7550.380952,249.9090909,28.83921426
NM_001143787,PPHLN1,12,11,122477,3424,119053,10823,285.3333333,34.77015187
NM_001190979,YAF2,5,4,81246,4273,76973,19243.25,854.6,18.01380763
NM_001190977,YAF2,3,2,81184,4011,77173,38586.5,1337,19.24033907
NM_201515,PPHLN1,11,10,115820,1717,114103,11410.3,156.0909091,66.45486313
NM_201440,PPHLN1,10,9,115820,1551,114269,12696.55556,155.1,73.67440361
NM_201438,PPHLN1,9,8,73282,1332,71950,8993.75,148,54.01651652
NM_005748,YAF2,4,3,81249,4203,77046,25682,1050.75,18.33119201
NM_153026,PRICKLE1,8,7,131434,4329,127105,18157.85714,541.125,29.36128436
NM_016488,PPHLN1,13,12,122477,3497,118980,9915,269,34.02344867
NM_001143789,PPHLN1,8,7,115820,1449,114371,16338.71429,181.125,78.93098689
NM_001143788,PPHLN1,9,8,115820,1615,114205,14275.625,179.4444444,70.71517028
NM_001144883,PRICKLE1,8,7,25659,4258,21401,3057.285714,532.25,5.026068577
NM_001144882,PRICKLE1,8,7,25659,4261,21398,3056.857143,532.625,5.021825862
NM_001144881,PRICKLE1,8,7,25278,4262,21016,3002.285714,532.75,4.931018301
NM_201439,PPHLN1,10,9,115820,1673,114147,12683,167.3,68.22893007
NM_025003,ADAMTS20,39,38,197714,5772,191942,5051.105263,148,33.25398475
NM_032256,TMEM117,8,7,553883,3007,550876,78696.57143,375.875,183.1978716
NM_001286213,TMEM117,7,6,553883,2873,551010,91835,410.4285714,191.7890707
NM_001145257,IRAK4,11,10,30601,4158,26443,2644.3,378,6.35954786
NM_001145256,IRAK4,12,11,30601,4207,26394,2399.454545,350.5833333,6.273829332
NM_001114182,IRAK4,13,12,30601,4354,26247,2187.25,334.9230769,6.028249885
NM_001145258,IRAK4,10,9,30601,3987,26614,2957.111111,398.7,6.675194382
NM_001286211,TMEM117,7,6,553883,2876,551007,91834.5,410.8571429,191.5879694
NM_001286212,TMEM117,7,6,553883,2906,550977,91829.5,415.1428571,189.5997935
NM_016123,IRAK4,12,11,30601,4305,26296,2390.545455,358.75,6.108246225
NM_001025356,ANO6,20,19,216366,6128,210238,11065.15789,306.4,34.30776762
NM_001142679,ANO6,20,19,224419,3611,220808,11621.47368,180.55,61.14871227
NM_001142678,ANO6,20,19,139670,5975,133695,7036.578947,298.75,22.37573222
NM_001204803,ANO6,21,20,216366,6192,210174,10508.7,294.8571429,33.94282946
NM_001278388,SLC38A1,16,15,86370,8386,77984,5198.933333,524.125,9.299308371
NM_001278387,SLC38A1,18,17,86370,8626,77744,4573.176471,479.2222222,9.012752145
NM_001278390,SLC38A1,17,16,72264,2902,69362,4335.125,170.7058824,23.90144728
NM_030674,SLC38A1,17,16,86369,8501,77868,4866.75,500.0588235,9.159863545
NM_001077484,SLC38A1,17,16,86369,8162,78207,4887.9375,480.1176471,9.581842686
NM_001281429,PCED1B,3,2,157062,1866,155196,77598,622,83.17041801
NM_138371,PCED1B,4,3,157062,2335,154727,51575.66667,583.75,66.26423983
NM_001267595,SENP1,18,17,63096,4957,58139,3419.941176,275.3888889,11.72866653
NM_001267594,SENP1,18,17,63412,4702,58710,3453.529412,261.2222222,12.4861761
NM_152319,C12orf54,9,8,14013,898,13115,1639.375,99.77777778,14.60467706
NM_012284,KCNH3,15,14,19139,3868,15271,1090.785714,257.8666667,3.94803516
NM_003482,KMT2D,54,53,36351,19473,16878,318.4528302,360.6111111,0.866738561
NM_198900,FMNL3,25,24,69475,11064,58411,2433.791667,442.56,5.279374548
NM_023071,SPATS2,14,13,160521,3810,156711,12054.69231,272.1428571,41.13149606
NM_001037806,NCKAP5L,13,12,37281,4913,32368,2697.333333,377.9230769,6.588235294
NM_175736,FMNL3,26,25,69475,11218,58257,2330.28,431.4615385,5.193171688
NM_001113546,LIMA1,11,10,107792,3752,104040,10404,341.0909091,27.72921109
NM_001113547,LIMA1,8,7,46927,3630,43297,6185.285714,453.75,11.92754821
NM_199188,LARP4,16,15,79198,6531,72667,4844.466667,408.1875,11.12647374
NM_199190,LARP4,15,14,79198,6320,72878,5205.571429,421.3333333,11.53132911
NM_001170808,LARP4,15,14,79198,6320,72878,5205.571429,421.3333333,11.53132911
NM_001170803,LARP4,14,13,79198,6106,73092,5622.461538,436.1428571,11.9705208
NM_016357,LIMA1,11,10,107792,3749,104043,10404.3,340.8181818,27.75220059
NM_001243775,LIMA1,5,4,25755,3354,22401,5600.25,670.8,6.678890877
NM_001095,ASIC1,12,11,25987,3868,22119,2010.818182,322.3333333,5.718459152
NM_020039,ASIC1,12,11,25987,4006,21981,1998.272727,333.8333333,5.487019471
NM_001145475,FAM186A,8,7,69312,7273,62039,8862.714286,909.125,8.530042623
NM_052879,LARP4,16,15,79198,6534,72664,4844.266667,408.375,11.12090603
NM_173602,DIP2B,38,37,243684,8753,234931,6349.486486,230.3421053,26.84005484
NM_182559,TMPRSS12,5,4,44964,1466,43498,10874.5,293.2,29.67121419
NM_001039960,SLC4A8,25,24,90955,11810,79145,3297.708333,472.4,6.701524132
NM_001031628,SMAGP,4,3,25071,1091,23980,7993.333333,272.75,21.97983501
NM_001173453,TFCP2,14,13,79389,3573,75816,5832,255.2142857,21.21914358
NM_001173452,TFCP2,15,14,79389,3727,75662,5404.428571,248.4666667,20.30104642
NM_001177984,SCN8A,26,25,221630,11459,210171,8406.84,440.7307692,18.34112924
NM_007210,GALNT6,12,11,39369,4532,34837,3167,377.6666667,7.686893204
NM_005653,TFCP2,15,14,79389,3730,75659,5404.214286,248.6666667,20.28391421
NM_014191,SCN8A,27,26,221630,11583,210047,8078.730769,429,18.1340758
NM_001033873,SMAGP,4,3,24863,1080,23783,7927.666667,270,22.0212963
NM_001258401,SLC4A8,25,24,124448,11756,112692,4695.5,470.24,9.585913576
NM_199187,KRT18,8,7,4032,1429,2603,371.8571429,178.625,1.821553534
NM_000224,KRT18,7,6,3844,1474,2370,395,210.5714286,1.607869742
NM_004693,KRT75,9,8,10258,2134,8124,1015.5,237.1111111,3.806935333
NM_175834,KRT79,9,8,12848,2075,10773,1346.625,230.5555556,5.191807229
NM_175078,KRT77,9,8,13838,3313,10525,1315.625,368.1111111,3.176878962
NM_031989,PCBP2,15,14,29062,3174,25888,1849.142857,211.6,8.156269691
NM_006897,HOXC9,2,1,3245,1543,1702,1702,771.5,1.103046014
NM_006856,ATF7,12,11,114358,6700,107658,9787.090909,558.3333333,16.06835821
NM_001243731,RARG,8,7,21692,2500,19192,2741.714286,312.5,7.6768
NM_001243730,RARG,9,8,21692,2650,19042,2380.25,294.4444444,7.185660377
NM_001128914,PCBP2,13,12,29062,3040,26022,2168.5,233.8461538,8.559868421
NM_001128913,PCBP2,14,13,29062,3092,25970,1997.692308,220.8571429,8.399094437
NM_001128912,PCBP2,15,14,29062,3171,25891,1849.357143,211.4,8.164932198
NM_001128911,PCBP2,15,14,29062,3183,25879,1848.5,212.2,8.130380145
NM_001042728,RARG,8,7,9849,2763,7086,1012.285714,345.375,2.564603692
NM_001098620,PCBP2,14,13,29062,3080,25982,1998.615385,220,8.435714286
NM_001243732,RARG,7,6,9849,2613,7236,1206,373.2857143,2.769230769
NM_000966,RARG,10,9,21692,2977,18715,2079.444444,297.7,6.286530064
NM_001206683,ATF7,4,3,83113,780,82333,27444.33333,195,105.5551282
NM_001206682,ATF7,4,3,83532,871,82661,27553.66667,217.75,94.90355913
NM_001130060,ATF7,12,11,114358,6637,107721,9792.818182,553.0833333,16.23037517
NM_005016,PCBP2,15,14,29062,3186,25876,1848.285714,212.4,8.1217828
NM_005337,NCKAP1L,31,30,45406,3924,41482,1382.733333,126.5806452,10.57135576
NM_001184976,NCKAP1L,31,30,44333,3795,40538,1351.266667,122.4193548,10.68194993
NM_012117,CBX5,5,4,49186,11555,37631,9407.75,2311,3.256685418
NM_002429,MMP19,9,8,7555,3295,4260,532.5,366.1111111,1.292867982
NM_002206,ITGA7,25,24,23334,4147,19187,799.4583333,165.88,4.626718109
NM_001982,ERBB3,28,27,23484,5785,17699,655.5185185,206.6071429,3.059464131
NM_001272101,MMP19,7,6,7555,3025,4530,755,432.1428571,1.497520661
NM_001144997,ITGA7,25,24,27737,3684,24053,1002.208333,147.36,6.529044517
NM_001144996,ITGA7,25,24,23334,4159,19175,798.9583333,166.36,4.610483289
NM_052827,CDK2,6,5,6014,2197,3817,763.4,366.1666667,1.73736914
NM_001798,CDK2,7,6,6014,2300,3714,619,328.5714286,1.614782609
NM_002332,LRP1,89,88,84845,14977,69868,793.9545455,168.2808989,4.665019697
NM_013251,TAC3,7,6,6565,845,5720,953.3333333,120.7142857,6.769230769
NM_013449,BAZ2A,29,28,40785,8963,31822,1136.5,309.0689655,3.550373759
NM_001178054,TAC3,6,5,6565,790,5775,1155,131.6666667,7.310126582
NM_001261413,DCTN2,14,13,17283,2127,15156,1165.846154,151.9285714,7.125528914
NM_001261412,DCTN2,14,13,17283,2133,15150,1165.384615,152.3571429,7.102672293
NM_001172697,TSFM,6,5,20113,936,19177,3835.4,156,20.48824786
NM_006400,DCTN2,14,13,17283,2128,15155,1165.769231,152,7.121710526
NM_006576,AVIL,19,18,18694,3013,15681,871.1666667,158.5789474,5.204447395
NM_001270622,SLC16A7,6,5,193816,11924,181892,36378.4,1987.333333,15.25427709
NM_001270623,SLC16A7,6,5,193816,11944,181872,36374.4,1990.666667,15.22705961
NM_004731,SLC16A7,5,4,100519,11781,88738,22184.5,2356.2,7.532297768
NM_006313,USP15,21,20,149382,8301,141081,7054.05,395.2857143,16.99566317
NM_178539,FAM19A2,5,4,484593,4141,480452,120113,828.2,116.0231828
NM_001252078,USP15,22,21,149382,8389,140993,6713.952381,381.3181818,16.80688997
NM_020700,PPM1H,10,9,290904,6210,284694,31632.66667,621,45.84444444
NM_020762,SRGAP1,22,21,303074,8497,294577,14027.47619,386.2272727,34.66835354
NM_013254,TBK1,21,20,50061,3108,46953,2347.65,148,15.10714286
NM_001099676,C12orf56,11,10,123584,1600,121984,12198.4,145.4545455,76.24
NM_001170633,C12orf56,13,12,123584,2082,121502,10125.16667,160.1538462,58.35830932
NM_001031679,MSRB3,7,6,188266,4424,183842,30640.33333,632,41.55560579
NM_001193461,MSRB3,7,6,187922,4286,183636,30606,612.2857143,42.84554363
NM_015279,TBC1D30,12,11,56448,7836,48612,4419.272727,653,6.203675345
NM_002076,GNS,14,13,46006,5142,40864,3143.384615,367.2857143,7.947102295
NM_198080,MSRB3,6,5,188266,4296,183970,36794,716,42.8235568
NM_001193460,MSRB3,8,7,188266,4589,183677,26239.57143,573.625,40.02549575
NM_003483,HMGA2,5,4,141833,4145,137688,34422,829,33.21785283
NM_021150,GRIP1,24,23,331716,5084,326632,14201.3913,211.8333333,64.24704957
NM_001178074,GRIP1,23,22,331716,5038,326678,14849,219.0434783,64.84279476
NM_001142523,IRAK3,11,10,65418,8164,57254,5725.4,742.1818182,7.012983831
NM_007199,IRAK3,12,11,65418,8348,57070,5188.181818,695.6666667,6.836367992
NM_033647,HELB,14,13,41090,3625,37465,2881.923077,258.9285714,10.33517241
NM_000619,IFNG,4,3,4973,1214,3759,1253,303.5,3.096375618
NM_001198842,CCT2,16,15,15897,2201,13696,913.0666667,137.5625,6.222626079
NM_006431,CCT2,16,15,16151,1970,14181,945.4,123.125,7.198477157
NM_001874,CPM,9,8,112066,6677,105389,13173.625,741.8888889,15.78388498
NM_001199302,CNOT2,17,16,111965,3169,108796,6799.75,186.4117647,34.33133481
NM_130846,PTPRR,10,9,116537,2775,113762,12640.22222,277.5,40.99531532
NM_014515,CNOT2,16,15,112001,3299,108702,7246.8,206.1875,32.94998484
NM_014505,KCNMB4,3,2,68012,4728,63284,31642,1576,13.38494078
NM_001207016,PTPRR,11,10,116688,2644,114044,11404.4,240.3636364,43.13313162
NM_001207015,PTPRR,13,12,150859,2856,148003,12333.58333,219.6923077,51.82177871
NM_001199303,CNOT2,16,15,111281,3421,107860,7190.666667,213.8125,31.52879275
NM_001277227,LGR5,17,16,146540,4410,142130,8883.125,259.4117647,32.22902494
NM_001277226,LGR5,17,16,146540,4554,141986,8874.125,267.8823529,31.17830479
NM_018279,TMEM19,6,5,17963,4664,13299,2659.8,777.3333333,2.851415094
NM_003667,LGR5,18,17,146540,4627,141913,8347.823529,257.0555556,30.67062892
NM_013381,TRHDE,19,18,392895,5571,387324,21518,293.2105263,69.52504039
NM_006851,GLIPR1,6,5,21205,3913,17292,3458.4,652.1666667,4.419115768
NM_001286548,CAPS2,18,17,113704,3858,109846,6461.529412,214.3333333,28.47226542
NM_152779,GLIPR1L1,5,4,35708,966,34742,8685.5,193.2,35.96480331
NM_001286549,CAPS2,11,10,113704,3026,110678,11067.8,275.0909091,36.57567746
NM_020841,OSBPL8,24,23,208013,7265,200748,8728.173913,302.7083333,27.63220922
NM_015336,ZDHHC17,17,16,89622,4788,84834,5302.125,281.6470588,17.71804511
NM_001003712,OSBPL8,23,22,208013,7218,200795,9127.045455,313.826087,27.81864782
NM_014903,NAV3,39,38,381725,9799,371926,9787.526316,251.2564103,37.95550566
NM_001024383,NAV3,40,39,381725,9866,371859,9534.846154,246.65,37.69095885
NM_001143886,PPP1R12A,25,24,140350,5362,134988,5624.5,214.48,25.17493473
NM_001143885,PPP1R12A,26,25,161894,5608,156286,6251.44,215.6923077,27.86840228
NM_002480,PPP1R12A,25,24,161637,5751,155886,6495.25,230.04,27.10589463
NM_001244990,PPP1R12A,25,24,161894,5502,156392,6516.333333,220.08,28.42457288
NM_001244992,PPP1R12A,24,23,161390,5335,156055,6785,222.2916667,29.25117151
NM_001220480,PPFIA2,22,21,111441,4214,107227,5106.047619,191.5454545,25.44542003
NM_001220479,PPFIA2,20,19,111441,4187,107254,5644.947368,209.35,25.61595414
NM_024560,ACSS3,16,15,177775,3049,174726,11648.4,190.5625,57.30600197
NM_001145026,PTPRQ,42,41,235844,7592,228252,5567.121951,180.7619048,30.06480506
NM_004664,LIN7A,6,5,140525,1236,139289,27857.8,206,112.6933657
NM_152588,TMTC2,12,11,447135,4854,442281,40207.36364,404.5,91.11681088
NM_001079910,LRRIQ1,27,26,208786,5471,203315,7819.807692,202.6296296,37.16231036
NM_025114,CEP290,54,53,93205,8009,85196,1607.471698,148.3148148,10.63753278
NM_001682,ATP2B1,20,19,68020,6799,61221,3222.157895,339.95,9.004412414
NM_001199781,POC1B-GALNT4,3,2,6851,5498,1353,676.5,1832.666667,0.246089487
NM_001199782,POC1B-GALNT4,3,2,6851,4731,2120,1060,1577,0.448108222
NM_001199777,POC1B,11,10,105848,3228,102620,10262,293.4545455,31.7905824
NM_003774,GALNT4,1,0,5395,5395,NA,NA,5395,NA
NM_172240,POC1B,12,11,106543,3248,103295,9390.454545,270.6666667,31.80264778
NM_001001323,ATP2B1,21,20,68020,6954,61066,3053.3,331.1428571,8.781420765
NM_003566,EEA1,29,28,156824,8032,148792,5314,276.9655172,18.5249004
NM_001256375,C12orf79,5,4,157697,2160,155537,38884.25,432,72.00787037
NM_001731,BTG1,2,1,5621,4682,939,939,2341,0.200555318
NM_001256374,C12orf79,5,4,157697,2137,155560,38890,427.4,72.79363594
NM_001256373,C12orf79,5,4,157697,2288,155409,38852.25,457.6,67.92351399
NM_003805,CRADD,3,2,173382,1191,172191,86095.5,397,144.5768262
NM_020698,TMCC3,4,3,83426,5867,77559,25853,1466.75,13.21953298
NM_001042399,CCDC41,16,15,151710,3188,148522,9901.466667,199.25,46.58782936
NM_005761,PLXNC1,31,30,158954,7377,151577,5052.566667,237.9677419,20.54724143
NM_016122,CCDC41,17,16,151710,3242,148468,9279.25,190.7058824,45.79518816
NM_021229,NTN4,10,9,132955,3625,129330,14370,362.5,35.67724138
NM_032147,USP44,6,5,34929,4025,30904,6180.8,670.8333333,7.678012422
NM_152435,AMDHD1,9,8,25301,2145,23156,2894.5,238.3333333,10.795338
NM_017599,VEZT,12,11,85046,4574,80472,7315.636364,381.1666667,17.59335374
NM_018351,FGD6,21,20,140717,9309,131408,6570.4,443.2857143,14.1162316
NM_001170464,CDK17,16,15,122329,4729,117600,7840,295.5625,24.86783675
NM_005230,ELK3,5,4,73401,2156,71245,17811.25,431.2,33.04499072
NM_002595,CDK17,17,16,122329,4202,118127,7382.9375,247.1764706,28.11208948
NM_001204068,ANKS1B,12,11,410827,3561,407266,37024.18182,296.75,114.3684358
NM_013229,APAF1,27,26,90135,7185,82950,3190.384615,266.1111111,11.54488518
NM_001160,APAF1,26,25,90135,7055,83080,3323.2,271.3461538,11.77604536
NM_181861,APAF1,27,26,90135,7218,82917,3189.115385,267.3333333,11.48753117
NM_181869,APAF1,8,7,90135,4554,85581,12225.85714,569.25,18.79249012
NM_181868,APAF1,26,25,90135,7088,83047,3321.88,272.6153846,11.71656321
NM_001204081,ANKS1B,10,9,160107,2015,158092,17565.77778,201.5,78.45756824
NM_001204079,ANKS1B,11,10,150924,3120,147804,14780.4,283.6363636,47.37307692
NM_001204070,ANKS1B,11,10,410827,3364,407463,40746.3,305.8181818,121.1245541
NM_001204069,ANKS1B,12,11,410827,3437,407390,37035.45455,286.4166667,118.5306954
NM_001204067,ANKS1B,12,11,411118,3079,408039,37094.45455,256.5833333,132.5232218
NM_001204066,ANKS1B,12,11,410895,2985,407910,37082.72727,248.75,136.6532663
NM_001204065,ANKS1B,11,10,150924,3120,147804,14780.4,283.6363636,47.37307692
NM_020140,ANKS1B,11,10,420010,2332,417678,41767.8,212,179.1072041
NM_001204080,ANKS1B,10,9,150924,3047,147877,16430.77778,304.7,48.53199869
NM_181670,ANKS1B,13,12,410827,3618,407209,33934.08333,278.3076923,112.5508568
NM_001006947,UHRF1BP1L,13,12,72958,2053,70905,5908.75,157.9230769,34.53726254
NM_015054,UHRF1BP1L,21,20,105781,5196,100585,5029.25,247.4285714,19.35816012
NM_001286616,ANO4,27,26,226997,3824,223173,8583.576923,141.6296296,58.36114017
NM_001206977,NR1H4,12,11,90096,2464,87632,7966.545455,205.3333333,35.56493506
NM_001206978,NR1H4,10,9,90096,2142,87954,9772.666667,214.2,41.06162465
NM_001206979,NR1H4,11,10,90096,2296,87800,8780,208.7272727,38.24041812
NM_001206993,NR1H4,9,8,60509,1876,58633,7329.125,208.4444444,31.25426439
NM_001145288,SLC17A8,11,10,64982,3844,61138,6113.8,349.4545455,15.90478668
NM_145913,SLC5A8,15,14,54024,3301,50723,3623.071429,220.0666667,15.36594971
NM_139319,SLC17A8,12,11,64982,3995,60987,5544.272727,332.9166667,15.26583229
NM_005123,NR1H4,11,10,90096,2284,87812,8781.2,207.6363636,38.44658494
NM_178826,ANO4,27,26,334047,4147,329900,12688.46154,153.5925926,79.551483
NM_001286615,ANO4,28,27,334047,4253,329794,12214.59259,151.8928571,77.5438514
NM_001206992,NR1H4,9,8,60509,1864,58645,7330.625,207.1111111,31.46190987
NM_020244,CHPT1,9,8,31431,1576,29855,3731.875,175.1111111,18.94352792
NM_024057,NUP37,9,8,44390,1214,43176,5397,134.8888889,35.56507414
NM_000277,PAH,13,12,79279,2694,76585,6382.083333,207.2307692,28.42798812
NM_001261445,TXNRD1,15,14,63627,4297,59330,4237.857143,286.4666667,13.80730742
NM_182743,TXNRD1,14,13,63627,3864,59763,4597.153846,276,15.46661491
NM_182742,TXNRD1,14,13,63627,4101,59526,4578.923077,292.9285714,14.51499634
NM_003330,TXNRD1,15,14,63627,4212,59415,4243.928571,280.8,14.10612536
NM_013320,HCFC2,15,14,42070,5750,36320,2594.285714,383.3333333,6.316521739
NM_003299,HSP90B1,18,17,17598,2880,14718,865.7647059,160,5.110416667
NM_017564,STAB2,69,68,179435,8299,171136,2516.705882,120.2753623,20.62127967
NM_001093771,TXNRD1,17,16,134530,3877,130653,8165.8125,228.0588235,33.69950993
NM_001261446,TXNRD1,14,13,63627,3851,59776,4598.153846,275.0714286,15.52220203
NM_182729,TXNRD1,15,14,63627,3975,59652,4260.857143,265,15.00679245
NM_001031701,NT5DC3,14,13,68896,7228,61668,4743.692308,516.2857143,8.531820697
NM_032148,SLC41A2,10,9,125199,3554,121645,13516.11111,355.4,34.22763084
NM_015275,KIAA1033,33,32,61416,5839,55577,1736.78125,176.9393939,9.518239425
NM_152318,C12orf45,4,3,8409,626,7783,2594.333333,156.5,12.43290735
NM_018082,POLR3B,28,27,152542,4301,148241,5490.407407,153.6071429,34.46663567
NM_001160708,POLR3B,28,27,152118,4148,147970,5480.37037,148.1428571,35.67261331
NM_213594,RFX4,18,17,179899,3975,175924,10348.47059,220.8333333,44.25761006
NM_032491,RFX4,14,13,78107,3390,74717,5747.461538,242.1428571,22.04041298
NM_001206691,RFX4,18,17,161669,3728,157941,9290.647059,207.1111111,42.36614807
NM_018157,RIC8B,9,8,114697,4998,109699,13712.375,555.3333333,21.94857943
NM_004075,CRY1,13,12,102494,3307,99187,8265.583333,254.3846154,29.99304506
NM_014653,WSCD2,9,8,120804,4644,116160,14520,516,25.0129199
NM_012406,PRDM4,12,11,28273,4199,24074,2188.545455,349.9166667,5.733269826
NM_014706,SART3,19,18,39176,4389,34787,1932.611111,231,7.925951242
NM_130466,UBE3B,28,27,59084,5772,53312,1974.518519,206.1428571,9.236313236
NM_183415,UBE3B,28,27,59084,5427,53657,1987.296296,193.8214286,9.88704625
NM_018984,SSH1,15,14,74895,8550,66345,4738.928571,570,7.759649123
NM_018711,SVOP,15,14,154189,3328,150861,10775.78571,221.8666667,45.33082933
NM_001101421,MYO1H,31,30,59654,4289,55365,1845.5,138.3548387,12.9086034
NM_001143779,IFT81,19,18,94462,2749,91713,5095.166667,144.6842105,33.36231357
NM_001681,ATP2A2,21,20,69867,4365,65502,3275.1,207.8571429,15.00618557
NM_014055,IFT81,19,18,94462,3167,91295,5071.944444,166.6842105,28.82696558
NM_001278556,ARPC3,7,6,15523,960,14563,2427.166667,137.1428571,15.16979167
NM_001177433,TRPV4,13,12,31742,2873,28869,2405.75,221,10.04838148
NM_001177428,TRPV4,14,13,31742,3054,28688,2206.769231,218.1428571,9.393582187
NM_001177431,TRPV4,16,15,31711,3064,28647,1909.8,191.5,9.349543081
NM_147204,TRPV4,14,13,31742,3015,28727,2209.769231,215.3571429,9.528026534
NM_170665,ATP2A2,20,19,69867,8334,61533,3238.578947,416.7,7.38336933
NM_021625,TRPV4,16,15,50322,3255,47067,3137.8,203.4375,14.45990783
NM_207435,C12orf76,5,4,26519,1951,24568,6142,390.2,12.59251666
NM_139283,PPTC7,6,5,48829,3754,45075,9015,625.6666667,12.00719233
NM_001287222,ARPC3,7,6,15523,957,14566,2427.666667,136.7142857,15.22048067
NM_001177996,FAM109A,4,3,8472,3260,5212,1737.333333,815,1.598773006
NM_001177997,FAM109A,3,2,8472,3152,5320,2660,1050.666667,1.687817259
NM_002973,ATXN2,25,24,147464,4727,142737,5947.375,189.08,30.19610747
NM_144671,FAM109A,3,2,8472,3171,5301,2650.5,1057,1.671712394
NM_015267,CUX2,22,21,316532,6866,309666,14746,312.0909091,45.10136906
NM_006817,ERP29,3,2,9874,1475,8399,4199.5,491.6666667,5.694237288
NM_001034025,ERP29,2,1,9874,1335,8539,8539,667.5,6.396254682
NM_003668,MAPKAPK5,14,13,51198,2299,48899,3761.461538,164.2142857,21.26968247
NM_139078,MAPKAPK5,14,13,51198,2305,48893,3761,164.6428571,21.21171367
NM_001109662,HECTD4,76,75,221906,15526,206380,2751.733333,204.2894737,13.29254154
NM_006700,TRAFD1,12,11,28061,2660,25401,2309.181818,221.6666667,9.54924812
NM_001143906,TRAFD1,12,11,28061,3191,24870,2260.909091,265.9166667,7.793795049
NM_024959,SLC8B1,16,15,36356,2992,33364,2224.266667,187,11.15106952
NM_022363,LHX5,5,4,9185,2089,7096,1774,417.8,3.396840594
NM_006187,OAS3,16,15,34807,6643,28164,1877.6,415.1875,4.23965076
NM_138451,IQCD,3,2,25655,1372,24283,12141.5,457.3333333,17.69897959
NM_004416,DTX1,9,8,40173,3297,36876,4609.5,366.3333333,11.18471338
NM_080717,TBX5,8,7,54514,3649,50865,7266.428571,456.125,13.93943546
NM_000192,TBX5,9,8,54514,3835,50679,6334.875,426.1111111,13.2148631
NM_181486,TBX5,9,8,52235,3742,48493,6061.625,415.7777778,12.95911277
NM_032814,RNFT2,11,10,115342,2426,112916,11291.6,220.5454545,46.54410552
NM_015335,MED13L,31,30,318612,9409,309203,10306.76667,303.516129,32.8624721
NM_001109903,RNFT2,12,11,115342,2910,112432,10221.09091,242.5,38.63642612
NM_003806,HRK,2,1,21009,1501,19508,19508,750.5,12.99666889
NM_001204218,NOS1,30,29,153662,12315,141347,4874.034483,410.5,11.47762891
NM_001204213,NOS1,28,27,96912,10803,86109,3189.222222,385.8214286,7.970841433
NM_000620,NOS1,29,28,153662,12212,141450,5051.785714,421.1034483,11.58286931
NM_001204214,NOS1,28,27,101270,10798,90472,3350.814815,385.6428571,8.378588628
NM_173598,KSR2,20,19,515213,17028,498185,26220.26316,851.4,29.25681231
NM_016281,TAOK3,21,20,223146,4405,218741,10937.05,209.7619048,49.65743473
NM_007174,CIT,47,46,191502,8629,182873,3975.5,183.5957447,21.1928381
NM_001206999,CIT,48,47,191502,8756,182746,3888.212766,182.4166667,20.87094564
NM_178499,CCDC60,14,13,206337,2464,203873,15682.53846,176,82.74066558
NM_001136534,TMEM233,3,2,48101,1576,46525,23262.5,525.3333333,29.52093909
NM_207311,CCDC64,9,8,104653,3090,101563,12695.375,343.3333333,32.86828479
NM_014868,RNF10,17,16,43267,3864,39403,2462.6875,227.2941176,10.19746377
NM_139015,SPPL3,11,10,141844,4140,137704,13770.4,376.3636364,33.26183575
NM_001137559,ANAPC5,17,16,45966,2381,43585,2724.0625,140.0588235,18.30533389
NM_002150,HPD,14,13,19338,1437,17901,1377,102.6428571,12.45720251
NM_001080825,TMEM120B,12,11,69318,7522,61796,5617.818182,626.8333333,8.215368253
NM_032590,KDM2B,23,22,152022,5329,146693,6667.863636,231.6956522,27.52730343
NM_001005366,KDM2B,23,22,151466,5247,146219,6646.318182,228.1304348,27.86716219
NM_001171993,HPD,16,15,49086,1915,47171,3144.733333,119.6875,24.63237598
NM_014938,MLXIP,17,16,112317,5493,106824,6676.5,323.1176471,19.44729656
NM_144668,WDR66,22,21,85371,3793,81578,3884.666667,172.4090909,21.50751384
NM_016237,ANAPC5,17,16,44219,2642,41577,2598.5625,155.4117647,15.73694171
NM_020845,PITPNM2,25,24,126950,6761,120189,5007.875,270.44,17.77680816
NM_002956,CLIP1,25,24,151137,5905,145232,6051.333333,236.2,24.59475021
NM_003959,HIP1R,32,31,27470,4505,22965,740.8064516,140.78125,5.097669256
NM_014708,KNTC1,64,63,99140,7029,92111,1462.079365,109.828125,13.10442453
NM_198240,CLIP1,24,23,151137,5799,145338,6319.043478,241.625,25.062597
NM_001247997,CLIP1,26,25,151137,5939,145198,5807.92,228.4230769,24.44822361
NM_001271866,GTF2H3,11,10,28867,3299,25568,2556.8,299.9090909,7.750227342
NM_178314,RILPL1,7,6,62358,2631,59727,9954.5,375.8571429,22.70125428
NM_001516,GTF2H3,13,12,28867,3430,25437,2119.75,263.8461538,7.416034985
NM_001271868,GTF2H3,12,11,28867,3265,25602,2327.454545,272.0833333,7.841347626
NM_001271867,GTF2H3,12,11,28867,3349,25518,2319.818182,279.0833333,7.619587937
NM_207437,DNAH10,78,77,173227,13758,159469,2071.025974,176.3846154,11.5910016
NM_005505,SCARB1,13,12,86347,2755,83592,6966,211.9230769,30.34192377
NM_032656,DHX37,27,26,42299,4578,37721,1450.807692,169.5555556,8.23962429
NM_001082959,SCARB1,12,11,86347,2625,83722,7611.090909,218.75,31.89409524
NM_023928,AACS,18,17,77948,3339,74609,4388.764706,185.5,22.34471399
NM_001206654,NCOR2,48,47,243055,8875,234180,4982.553191,184.8958333,26.38647887
NM_006312,NCOR2,49,48,243055,8906,234149,4878.104167,181.755102,26.29115203
NM_001077261,NCOR2,48,47,243055,8737,234318,4985.489362,182.0208333,26.81904544
NM_144669,GLT1D1,8,7,131430,2729,128701,18385.85714,341.125,47.16049835
NM_015347,RIMBP2,19,18,121731,6341,115390,6410.555556,333.7368421,18.1974452
NM_198827,GPR133,25,24,187558,5409,182149,7589.541667,216.36,33.67517101
NM_003565,ULK1,28,27,28430,5250,23180,858.5185185,187.5,4.415238095
NM_015409,EP400,53,52,130548,12370,118178,2272.653846,233.3962264,9.553597413
NM_001122636,GALNT9,11,10,224990,2674,222316,22231.6,243.0909091,83.13986537
NM_001261411,SFSWAP,19,18,88653,3424,85229,4734.944444,180.2105263,24.8916472
NM_004592,SFSWAP,18,17,88653,3267,85386,5022.705882,181.5,26.1359045
NM_001161347,CHFR,16,15,47268,3021,44247,2949.8,188.8125,14.64647468
NM_001161346,CHFR,18,17,47268,3263,44005,2588.529412,181.2777778,13.48605578
NM_001161345,CHFR,18,17,47268,3296,43972,2586.588235,183.1111111,13.34101942
NM_001161344,CHFR,18,17,47268,3299,43969,2586.411765,183.2777778,13.32797818
NM_018223,CHFR,18,17,47268,3176,44092,2593.647059,176.4444444,13.88287154
NM_016615,SLC6A13,15,14,42254,2241,40013,2858.071429,149.4,17.85497546
NM_001190997,SLC6A13,13,12,42254,1963,40291,3357.583333,151,20.52521651
NM_001206931,SLC6A12,15,14,24130,3192,20938,1495.571429,212.8,6.55952381
NM_001122847,SLC6A12,16,15,23622,3181,20441,1362.733333,198.8125,6.425966677
NM_001243392,SLC6A13,2,1,3886,1156,2730,2730,578,2.361591696
NM_003044,SLC6A12,17,16,23372,3517,19855,1240.9375,206.8823529,5.645436452
NM_001122848,SLC6A12,16,15,24130,3278,20852,1390.133333,204.875,6.361195851
NM_016533,NINJ2,4,3,99295,1066,98229,32743,266.5,92.14727955
NM_152441,FBXL14,2,1,28174,2113,26061,26061,1056.5,12.33364884
NM_032642,WNT5B,5,4,17968,2228,15740,3935,445.6,7.064631957
NM_030775,WNT5B,5,4,30157,2189,27968,6992,437.8,12.77661032
NM_001163926,LRTM2,5,4,16487,3958,12529,3132.25,791.6,3.16548762
NM_001163925,LRTM2,5,4,16487,3991,12496,3124,798.2,3.131044851
NM_001039029,LRTM2,5,4,16487,3955,12532,3133,791,3.168647282
NM_021953,FOXM1,9,8,19476,3541,15935,1991.875,393.4444444,4.500141203
NM_202003,FOXM1,8,7,19476,3495,15981,2283,436.875,4.572532189
NM_001243089,FOXM1,8,7,19476,3492,15984,2283.428571,436.5,4.577319588
NM_202002,FOXM1,10,9,19476,3656,15820,1757.777778,365.6,4.327133479
NM_031474,NRIP2,6,5,9709,2783,6926,1385.2,463.8333333,2.488681279
NM_001257098,RHNO1,3,2,12328,1974,10354,5177,658,5.245187437
NM_002014,FKBP4,10,9,10481,3751,6730,747.7777778,375.1,1.794188216
NM_001257097,RHNO1,3,2,12328,2075,10253,5126.5,691.6666667,4.941204819
NM_001252499,RHNO1,3,2,12328,1954,10374,5187,651.3333333,5.309109519
NM_001252500,RHNO1,3,2,12328,1912,10416,5208,637.3333333,5.447698745
NM_018463,ITFG2,12,11,12452,2374,10078,916.1818182,197.8333333,4.245155855
NM_001243088,FOXM1,8,7,19476,3495,15981,2283,436.875,4.572532189
NM_001759,CCND2,5,4,31622,6527,25095,6273.75,1305.4,3.844798529
NM_020996,FGF6,3,2,11474,747,10727,5363.5,249,14.3601071
NM_020638,FGF23,3,2,11503,3021,8482,4241,1007,2.807679576
NM_020374,C12orf4,14,13,50738,3833,46905,3608.076923,273.7857143,12.23715106
NM_006479,RAD51AP1,9,8,21265,2227,19038,2379.75,247.4444444,8.548720251
NM_001130862,RAD51AP1,10,9,21265,2279,18986,2109.555556,227.9,8.330846863
NM_001278309,AKAP3,6,5,33541,3346,30195,6039,557.6666667,9.02420801
NM_006422,AKAP3,6,5,33541,3324,30217,6043.4,554,9.09055355
NM_005002,NDUFA9,11,10,38458,1620,36838,3683.8,147.2727273,22.73950617
NM_002235,KCNA6,2,1,41938,5980,35958,35958,2990,6.013043478
NM_000217,KCNA1,2,1,8351,7985,366,366,3992.5,0.045835942
NM_002234,KCNA5,1,0,2871,2871,NA,NA,2871,NA
NM_002527,NTF3,1,0,1169,1169,NA,NA,1169,NA
NM_001102654,NTF3,2,1,63187,1337,61850,61850,668.5,46.26028422
NM_001769,CD9,8,7,37957,1322,36635,5233.571429,165.25,27.7118003
NM_002342,LTBR,10,9,7540,2278,5262,584.6666667,227.8,2.309920983
NM_001159576,SCNN1A,12,11,28383,3493,24890,2262.727273,291.0833333,7.125679931
NM_001159575,SCNN1A,13,12,30516,3213,27303,2275.25,247.1538462,8.497665733
NM_001038,SCNN1A,13,12,28898,3342,25556,2129.666667,257.0769231,7.646918013
NM_001065,TNFRSF1A,10,9,13362,2236,11126,1236.222222,223.6,4.975849732
NM_001270987,LTBR,10,9,16205,2083,14122,1569.111111,208.3,6.779644743
NM_016497,MRPL51,3,2,1157,680,477,238.5,226.6666667,0.701470588
NM_199245,VAMP1,4,3,8441,3142,5299,1766.333333,785.5,1.686505411
NM_080730,IFFO1,10,9,16557,2708,13849,1538.777778,270.8,5.114106352
NM_001242,CD27,6,5,6835,1326,5509,1101.8,221,4.154600302
NM_001039670,IFFO1,10,9,16557,2711,13846,1538.444444,271.1,5.107340465
NM_001193457,IFFO1,10,9,16557,2735,13822,1535.777778,273.5,5.053747715
NM_014231,VAMP1,5,4,8441,2740,5701,1425.25,548,2.080656934
NM_014865,NCAPD2,32,31,37836,4838,32998,1064.451613,151.1875,6.820587019
NM_006170,NOP2,16,15,11464,2696,8768,584.5333333,168.5,3.252225519
NM_018009,TAPBPL,7,6,10313,1825,8488,1414.666667,260.7142857,4.650958904
NM_016830,VAMP1,5,4,8441,1096,7345,1836.25,219.2,6.701642336
NM_001033714,NOP2,16,15,11464,2764,8700,580,172.75,3.147612156
NM_001258310,NOP2,17,16,11464,2819,8645,540.3125,165.8235294,3.066690316
NM_001258309,NOP2,17,16,11464,2808,8656,541,165.1764706,3.082621083
NM_001258308,NOP2,16,15,11464,2708,8756,583.7333333,169.25,3.23338257
NM_001289745,GAPDH,9,8,3972,1502,2470,308.75,166.8888889,1.644474035
NM_002046,GAPDH,9,8,3972,1410,2562,320.25,156.6666667,1.817021277
NM_001289746,GAPDH,8,7,3718,1395,2323,331.8571429,174.375,1.665232975
NM_001256799,GAPDH,8,7,3158,1443,1715,245,180.375,1.188496188
NM_016162,ING4,8,7,12606,1453,11153,1593.285714,181.625,7.675843083
NM_001135734,ZNF384,11,10,23097,3252,19845,1984.5,295.6363636,6.102398524
NM_001127585,ING4,7,6,12606,1383,11223,1870.5,197.5714286,8.114967462
NM_001127584,ING4,8,7,12606,1444,11162,1594.571429,180.5,7.729916898
NM_001127583,ING4,8,7,12606,1447,11159,1594.142857,180.875,7.711817554
NM_001127582,ING4,8,7,12606,1456,11150,1592.857143,182,7.657967033
NM_133476,ZNF384,10,9,22900,3141,19759,2195.444444,314.1,6.290671761
NM_001127586,ING4,7,6,12606,1307,11299,1883.166667,186.7142857,8.644988523
NM_020400,LPAR5,2,1,17298,2857,14441,14441,1428.5,5.05460273
NM_001039920,ZNF384,9,8,23097,2902,20195,2524.375,322.4444444,6.958993797
NM_032489,ACRBP,10,9,9340,1896,7444,827.1111111,189.6,3.926160338
NM_153685,PIANP,6,5,7054,2373,4681,936.2,395.5,1.972608512
NM_001244015,PIANP,6,5,6641,2439,4202,840.4,406.5,1.722837228
NM_001244014,PIANP,5,4,7054,2744,4310,1077.5,548.8,1.570699708
NM_001142961,LPAR5,2,1,12816,2697,10119,10119,1348.5,3.751946607
NM_001164095,COPS7A,8,7,7798,1887,5911,844.4285714,235.875,3.132485427
NM_001164094,COPS7A,8,7,7893,1911,5982,854.5714286,238.875,3.130298273
NM_001164093,COPS7A,7,6,7594,2045,5549,924.8333333,292.1428571,2.713447433
NM_016319,COPS7A,8,7,7863,1854,6009,858.4285714,231.75,3.241100324
NM_002286,LAG3,8,7,5953,2000,3953,564.7142857,250,1.9765
NM_001195017,CD4,8,7,31340,2821,28519,4074.142857,352.625,10.10953563
NM_019858,GPR162,5,4,5622,2521,3101,775.25,504.2,1.230067434
NM_001195016,CD4,8,7,31340,2843,28497,4071,355.375,10.02356665
NM_001195015,CD4,8,7,31340,2856,28484,4069.142857,357,9.973389356
NM_001195014,CD4,8,7,31340,3168,28172,4024.571429,396,8.892676768
NM_000616,CD4,10,9,31340,3126,28214,3134.888889,312.6,9.025591811
NM_002824,PTMS,5,4,4579,1155,3424,856,231,2.964502165
NM_014449,GPR162,5,4,5622,1519,4103,1025.75,303.8,2.701119157
NM_005439,MLF2,9,8,4926,1400,3526,440.75,155.5555556,2.518571429
NM_001146316,SPSB2,3,2,2351,1207,1144,572,402.3333333,0.947804474
NM_006992,LRRC23,7,6,9511,1337,8174,1362.333333,191,6.11368736
NM_001159287,TPI1,7,6,3528,1467,2061,343.5,209.5714286,1.404907975
NM_000365,TPI1,7,6,3419,1358,2061,343.5,194,1.517673049
NM_032641,SPSB2,3,2,2423,1259,1164,582,419.6666667,0.924543288
NM_031299,CDCA3,6,5,2486,1176,1310,262,196,1.113945578
NM_001975,ENO2,12,11,9247,2435,6812,619.2727273,202.9166667,2.797535934
NM_003481,USP5,20,19,14506,3135,11371,598.4736842,156.75,3.627113238
NM_002831,PTPN6,16,15,10047,2262,7785,519,141.375,3.441644562
NM_201650,LRRC23,8,7,9511,1636,7875,1125,204.5,4.813569682
NM_001007026,ATN1,10,9,17860,4361,13499,1499.888889,436.1,3.095390965
NM_001098536,USP5,20,19,14512,3210,11302,594.8421053,160.5,3.520872274
NM_002075,GNB3,11,10,7184,1934,5250,525,175.8181818,2.714581179
NM_001940,ATN1,10,9,14006,4354,9652,1072.444444,435.4,2.216812127
NM_080549,PTPN6,16,15,10047,2405,7642,509.4666667,150.3125,3.177546778
NM_080548,PTPN6,16,15,14741,2175,12566,837.7333333,135.9375,5.777471264
NM_001135217,LRRC23,8,7,9511,1808,7703,1100.428571,226,4.26050885
NM_001258026,TPI1,7,6,2834,1601,1233,205.5,228.7142857,0.77014366
NM_138425,C12orf57,3,2,1964,546,1418,709,182,2.597069597
NM_005768,LPCAT3,13,12,40497,2310,38187,3182.25,177.6923077,16.53116883
NM_006331,EMG1,7,6,5223,1077,4148,691.3333333,153.8571429,3.851439183
NM_001734,C1S,12,11,10357,2735,7622,692.9090909,227.9166667,2.786837294
NM_201442,C1S,12,11,10357,2822,7535,685,235.1666667,2.670092133
NM_031491,RBP5,4,3,5188,944,4244,1414.666667,236,4.495762712
NM_016546,C1RL,6,5,14725,3404,11321,2264.2,567.3333333,3.325793184
NM_014718,CLSTN3,18,17,28565,4020,24545,1443.823529,223.3333333,6.105721393
NM_000319,PEX5,15,14,21123,3187,17936,1281.142857,212.4666667,5.627863194
NM_001131024,PEX5,15,14,21799,3165,18634,1331,211,5.887519747
NM_001131025,PEX5,16,15,21799,3743,18056,1203.733333,233.9375,4.823938018
NM_001131023,PEX5,16,15,21799,3322,18477,1231.8,207.625,5.562010837
NM_001131026,PEX5,18,17,29412,2709,26703,1570.764706,150.5,9.857142857
NM_174941,CD163L1,20,19,89194,4602,84592,4452.210526,230.1,18.38157323
NM_203416,CD163,17,16,33004,4124,28880,1805,242.5882353,7.002909796
NM_004244,CD163,17,16,33004,4207,28797,1799.8125,247.4705882,6.845020204
NM_020634,GDF3,2,1,5981,1226,4755,4755,613,3.878466558
NM_001644,APOBEC1,5,4,16508,897,15611,3902.75,179.4,17.40356745
NM_024865,NANOG,4,3,6662,2102,4560,1520,525.5,2.169362512
NM_203503,CLEC4C,6,5,20060,1227,18833,3766.6,204.5,15.34881826
NM_130441,CLEC4C,7,6,20060,1321,18739,3123.166667,188.7142857,14.18546556
NM_001145465,NANOGNB,4,3,8907,911,7996,2665.333333,227.75,8.777167947
NM_006931,SLC2A3,10,9,17070,3948,13122,1458,394.8,3.323708207
NM_018416,FOXJ2,11,10,22761,5493,17268,1726.8,499.3636364,3.143637357
NM_015509,NECAP1,8,7,15568,2601,12967,1852.428571,325.125,4.985390235
NM_004054,C3AR1,2,1,8038,1957,6081,6081,978.5,3.107307103
NM_194450,CLEC4A,5,4,14977,1187,13790,3447.5,237.4,11.61752317
NM_194448,CLEC4A,4,3,14977,1069,13908,4636,267.25,13.01028999
NM_194447,CLEC4A,5,4,14977,1169,13808,3452,233.8,11.81180496
NM_016184,CLEC4A,6,5,14977,1287,13690,2738,214.5,10.63714064
NM_018088,FAM90A1,7,6,6360,2523,3837,639.5,360.4285714,1.520808561
NM_001004328,ZNF705A,5,4,7494,3443,4051,1012.75,688.6,1.176590183
NM_001007033,CLEC6A,6,5,22337,1619,20718,4143.6,269.8333333,12.79678814
NM_020661,AICDA,5,4,10682,2799,7883,1970.75,559.8,2.816362987
NM_080387,CLEC4D,6,5,8826,1940,6886,1377.2,323.3333333,3.549484536
NM_014358,CLEC4E,6,5,7659,2164,5495,1099,360.6666667,2.539279113
NM_003480,MFAP5,10,9,16895,2892,14003,1555.888889,289.2,4.84197787
NM_144670,A2ML1,36,35,54233,5228,49005,1400.142857,145.2222222,9.373565417
NM_001282424,A2ML1,25,24,31783,3814,27969,1165.375,152.56,7.333245936
NM_002355,M6PR,7,6,9402,2573,6829,1138.166667,367.5714286,2.654100272
NM_005810,KLRG1,5,4,21121,1793,19328,4832,358.6,10.77969883
NM_004426,PHC1,15,14,26746,5191,21555,1539.642857,346.0666667,4.152379118
NM_001207024,M6PR,5,4,9402,2313,7089,1772.25,462.6,3.064850843
NM_000014,A2M,36,35,48256,4689,43567,1244.771429,130.25,9.291320111
NM_002258,KLRB1,6,5,12629,746,11883,2376.6,124.3333333,15.92895442
NM_001253750,CLECL1,4,3,17441,1576,15865,5288.333333,394,10.06662437
NM_001267701,CLECL1,3,2,17441,1441,16000,8000,480.3333333,11.10340042
NM_001781,CD69,5,4,8417,1681,6736,1684,336.2,4.007138608
NM_172004,CLECL1,2,1,10809,675,10134,10134,337.5,15.01333333
NM_016523,KLRF1,6,5,17528,1247,16281,3256.2,207.8333333,13.05613472
NM_001130711,CLEC2A,5,4,19156,921,18235,4558.75,184.2,19.79913138
NM_001190765,KLRF2,6,5,14346,737,13609,2721.8,122.8333333,18.46540027
NM_005127,CLEC2B,5,4,17492,2043,15449,3862.25,408.6,7.561918747
NM_201623,CLEC12A,5,4,14188,1461,12727,3181.75,292.2,8.711156742
NM_001129998,CLEC12B,6,5,8170,1284,6886,1377.2,214,5.362928349
NM_138337,CLEC12A,6,5,14188,1561,12627,2525.4,260.1666667,8.089045484
NM_205852,CLEC12B,5,4,7319,3035,4284,1071,607,1.411532125
NM_016509,CLEC1B,6,5,6239,976,5263,1052.6,162.6666667,5.392418033
NM_001207010,CLEC12A,7,6,34281,1435,32846,5474.333333,205,22.88919861
NM_207345,CLEC9A,9,8,35291,1682,33609,4201.125,186.8888889,19.98156956
NM_001099431,CLEC1B,5,4,6239,876,5363,1340.75,175.2,6.122146119
NM_197954,CLEC7A,3,2,2948,512,2436,1218,170.6666667,4.7578125
NM_001172633,OLR1,5,4,13893,2405,11488,2872,481,4.776715177
NM_001172632,OLR1,5,4,13893,2381,11512,2878,476.2,4.834943301
NM_153022,TMEM52B,4,3,12848,2793,10055,3351.666667,698.25,3.600071608
NM_001079815,TMEM52B,6,5,21207,2569,18638,3727.6,428.1666667,7.254963021
NM_002543,OLR1,6,5,13893,2522,11371,2274.2,420.3333333,4.508723236
NM_197950,CLEC7A,4,3,13494,2379,11115,3705,594.75,4.672131148
NM_197947,CLEC7A,6,5,13494,2618,10876,2175.2,436.3333333,4.154316272
NM_197948,CLEC7A,5,4,13494,2498,10996,2749,499.6,4.401921537
NM_197949,CLEC7A,4,3,13494,2359,11135,3711.666667,589.75,4.720220432
NM_022570,CLEC7A,5,4,13494,2479,11015,2753.75,495.8,4.443323921
NM_002262,KLRD1,6,5,9435,3264,6171,1234.2,544,1.890625
NM_031412,GABARAPL1,4,3,10237,1871,8366,2788.666667,467.75,4.471405665
NM_007334,KLRD1,5,4,9435,3170,6265,1566.25,634,1.976340694
NM_001114396,KLRD1,7,6,12802,3202,9600,1600,457.4285714,2.998126171
NM_007360,KLRK1,8,7,17703,1597,16106,2300.857143,199.625,10.08515967
NM_213658,KLRC1,8,7,8579,1610,6969,995.5714286,201.25,4.328571429
NM_213657,KLRC1,7,6,8579,1555,7024,1170.666667,222.1428571,4.517041801
NM_007328,KLRC1,6,5,7343,1380,5963,1192.6,230,4.321014493
NM_001199805,KLRC4-KLRK1,13,12,37795,1960,35835,2986.25,150.7692308,18.28316327
NM_013431,KLRC4,4,3,2375,932,1443,481,233,1.548283262
NM_007333,KLRC3,6,5,5013,849,4164,832.8,141.5,4.90459364
NM_002261,KLRC3,7,6,8282,1032,7250,1208.333333,147.4285714,7.025193798
NM_002259,KLRC1,7,6,7343,1435,5908,984.6666667,205,4.117073171
NM_002260,KLRC2,6,5,5388,1219,4169,833.8,203.1666667,3.420016407
NM_001145426,YBX3,9,8,24279,1776,22503,2812.875,197.3333333,12.67060811
NM_018048,MAGOHB,5,4,9846,3039,6807,1701.75,607.8,2.23988154
NM_018423,STYK1,11,10,55355,3006,52349,5234.9,273.2727273,17.41483699
NM_003651,YBX3,10,9,24279,1984,22295,2477.222222,198.4,11.23739919
NM_023921,TAS2R10,1,0,925,925,NA,NA,925,NA
NM_023919,TAS2R7,1,0,1097,1097,NA,NA,1097,NA
NM_023918,TAS2R8,1,0,931,931,NA,NA,931,NA
NM_023917,TAS2R9,1,0,1076,1076,NA,NA,1076,NA
NM_007244,PRR4,4,3,3629,568,3061,1020.333333,142,5.389084507
NM_001098538,PRR4,4,3,3629,336,3293,1097.666667,84,9.800595238
NM_023922,TAS2R14,1,0,955,955,NA,NA,955,NA
NM_023920,TAS2R13,1,0,1638,1638,NA,NA,1638,NA
NM_006250,PRH1,5,4,3316,678,2638,659.5,135.6,3.890855457
NM_001110213,PRH2,4,3,5611,3181,2430,810,795.25,0.76391072
NM_005042,PRH2,3,2,5612,4326,1286,643,1442,0.297272307
NM_176890,TAS2R50,1,0,1001,1001,NA,NA,1001,NA
NM_176889,TAS2R20,1,0,1915,1915,NA,NA,1915,NA
NM_176888,TAS2R19,1,0,901,901,NA,NA,901,NA
NM_176885,TAS2R31,1,0,1022,1022,NA,NA,1022,NA
NM_176884,TAS2R43,1,0,1028,1028,NA,NA,1028,NA
NM_176887,TAS2R46,1,0,931,931,NA,NA,931,NA
NM_001097643,TAS2R30,1,0,961,961,NA,NA,961,NA
NM_181429,TAS2R42,1,0,946,946,NA,NA,946,NA
NM_001271592,LOC100129361,1,0,4841,4841,NA,NA,4841,NA
NM_199354,PRB1,5,4,3769,719,3050,762.5,143.8,4.242002782
NM_199353,PRB1,5,4,3769,779,2990,747.5,155.8,3.838254172
NM_001261399,PRB4,5,4,3356,716,2640,660,143.2,3.687150838
NM_006249,PRB3,5,4,3786,1096,2690,672.5,219.2,2.454379562
NM_002723,PRB4,4,3,3356,922,2434,811.3333333,230.5,2.639913232
NM_005039,PRB1,4,3,3769,1177,2592,864,294.25,2.202209006
NM_006248,PRB2,4,3,4026,1432,2594,864.6666667,358,1.811452514
NM_138722,BCL2L14,6,5,28227,1890,26337,5267.4,315,13.93492063
NM_138723,BCL2L14,6,5,28751,1896,26855,5371,316,14.16402954
NM_030766,BCL2L14,6,5,28227,2043,26184,5236.8,340.5,12.8164464
NM_018050,MANSC1,4,3,20953,2301,18652,6217.333333,575.25,8.106040852
NM_001310,CREBL2,4,3,33277,3817,29460,9820,954.25,7.718103222
NM_030817,APOLD1,2,1,5860,4647,1213,1213,2323.5,0.261028621
NM_001130415,APOLD1,2,1,65550,4739,60811,60811,2369.5,12.83203207
NM_004064,CDKN1B,3,2,5114,2525,2589,1294.5,841.6666667,1.025346535
NM_018654,GPRC5D,3,2,9611,1041,8570,4285,347,8.23246878
NM_003979,GPRC5A,4,3,22646,2855,19791,6597,713.75,6.932049037
NM_020853,KIAA1467,13,12,39070,4724,34346,2862.166667,363.3846154,7.270533446
NM_015987,HEBP1,4,3,25446,1212,24234,8078,303,19.9950495
NM_177925,H2AFJ,1,0,3668,3668,NA,NA,3668,NA
NM_175054,HIST4H4,1,0,413,413,NA,NA,413,NA
NM_001013698,SMCO3,2,1,9534,2106,7428,7428,1053,3.527065527
NM_001190839,MGP,5,4,4740,1478,3262,815.5,295.6,2.207036536
NM_021071,ART4,3,2,14170,1374,12796,6398,458,9.312954876
NM_000900,MGP,4,3,4740,1402,3338,1112.666667,350.5,2.380884451
NM_175874,C12orf60,2,1,20287,1128,19159,19159,564,16.98492908
NM_001175,ARHGDIB,6,5,19614,1222,18392,3678.4,203.6666667,15.0507365
NM_006205,PDE6H,4,3,8845,751,8094,2698,187.75,10.77762983
NM_007178,STRAP,10,9,21124,1915,19209,2134.333333,191.5,10.0308094
NM_018640,LMO3,4,3,58232,3837,54395,18131.66667,959.25,14.17643993
NM_001243609,LMO3,5,4,59844,3647,56197,14049.25,729.4,15.40910337
NM_001243613,LMO3,6,5,58780,3585,55195,11039,597.5,15.39609484
NM_001243612,LMO3,4,3,57600,3503,54097,18032.33333,875.75,15.44304882
NM_001243611,LMO3,4,3,57009,3815,53194,17731.33333,953.75,13.94338139
NM_001243610,LMO3,5,4,58430,3419,55011,13752.75,683.8,16.08979234
NM_001001395,LMO3,4,3,59844,3579,56265,18755,894.75,15.72087175
NM_024730,RERGL,6,5,9326,1153,8173,1634.6,192.1666667,7.088464874
NM_001286201,RERGL,5,4,9326,995,8331,2082.75,199,8.372864322
NM_033328,CAPZA3,1,0,1079,1079,NA,NA,1079,NA
NM_001190860,PLEKHA5,4,3,72313,2018,70295,23431.66667,504.5,34.83399405
NM_001244683,PDE3A,15,14,112245,6574,105671,7547.928571,438.2666667,16.07407971
NM_001145946,SLCO1C1,16,15,58033,3471,54562,3637.466667,216.9375,15.71938923
NM_001145945,SLCO1C1,15,14,58033,3220,54813,3915.214286,214.6666667,17.02267081
NM_001145944,SLCO1C1,13,12,57923,3185,54738,4561.5,245,17.18618524
NM_017435,SLCO1C1,15,14,57923,3380,54543,3895.928571,225.3333333,16.13698225
NM_021094,SLCO1A2,14,13,70300,7226,63074,4851.846154,516.1428571,8.728757265
NM_024854,PYROXD1,12,11,33646,4136,29510,2682.727273,344.6666667,7.134912959
NM_000415,IAPP,3,2,7114,1979,5135,2567.5,659.6666667,2.594744821
NM_030572,C12orf39,6,5,4956,589,4367,873.4,98.16666667,7.41426146
NM_021957,GYS2,16,15,68660,3148,65512,4367.466667,196.75,20.81067344
NM_016072,GOLT1B,5,4,16640,3277,13363,3340.75,655.4,4.077815075
NM_002300,LDHB,8,7,22516,1325,21191,3027.285714,165.625,15.99320755
NM_001174097,LDHB,8,7,22455,1547,20908,2986.857143,193.375,13.51519069
NM_004982,KCNJ8,3,2,9868,2392,7476,3738,797.3333333,3.12541806
NM_018686,CMAS,8,7,19498,1802,17696,2528,225.25,9.820199778
NM_001039481,ETNK1,3,2,19275,913,18362,9181,304.3333333,20.11171961
NM_001101339,C12orf77,4,3,4010,1513,2497,832.3333333,378.25,1.650363516
NM_001204127,LRMP,20,19,56090,2738,53352,2808,136.9,19.48575603
NM_001204126,LRMP,20,19,56090,2808,53282,2804.315789,140.4,18.97507123
NM_006152,LRMP,21,20,56090,2890,53200,2660,137.6190476,18.4083045
NM_001001660,LYRM5,3,2,9801,1138,8663,4331.5,379.3333333,7.612478032
NM_004985,KRAS,5,4,46144,5770,40374,10093.5,1154,6.997227036
NM_033360,KRAS,6,5,46144,5895,40249,8049.8,982.5,6.827650551
NM_030762,BHLHE41,5,4,5046,3785,1261,315.25,757,0.333157199
NM_005086,SSPN,3,2,39204,4534,34670,17335,1511.333333,7.646669607
NM_001135823,SSPN,3,2,39441,4351,35090,17545,1450.333333,8.064812687
NM_001171888,FGFR1OP2,5,4,22376,986,21390,5347.5,197.2,21.69371197
NM_001171887,FGFR1OP2,6,5,28278,2922,25356,5071.2,487,8.67761807
NM_018164,ASUN,17,16,33144,2993,30151,1884.4375,176.0588235,10.07383896
NM_015633,FGFR1OP2,7,6,28278,3037,25241,4206.833333,433.8571429,8.311162331
NM_004264,MED21,4,3,8153,2709,5444,1814.666667,677.25,2.009597638
NM_001271811,MED21,4,3,8153,2707,5446,1815.333333,676.75,2.011821204
NM_001080406,C12orf71,2,1,1467,968,499,499,484,0.515495868
NM_015000,STK38L,14,13,81814,5110,76704,5900.307692,365,15.01056751
NM_001145010,SMCO2,9,8,35377,1281,34096,4262,142.3333333,26.6167057
NM_021821,MRPS35,8,7,45533,1905,43628,6232.571429,238.125,22.90183727
NM_001029874,REP15,1,0,1140,1140,NA,NA,1140,NA
NM_001190864,MRPS35,7,6,45533,1794,43739,7289.833333,256.2857143,24.38071349
NM_020782,KLHL42,3,2,22788,6472,16316,8158,2157.333333,2.521013597
NM_198966,PTHLH,4,3,11879,1316,10563,3521,329,8.026595745
NM_198965,PTHLH,5,4,13901,1336,12565,3141.25,267.2,9.40494012
NM_198964,PTHLH,3,2,7642,1857,5785,2892.5,619,3.115239634
NM_002820,PTHLH,4,3,9664,1877,7787,2595.666667,469.25,4.148641449
NM_018099,FAR2,12,11,111995,3692,108303,9845.727273,307.6666667,29.33450704
NM_001271784,FAR2,11,10,111995,3464,108531,10853.1,314.9090909,31.33112009
NM_016570,ERGIC2,14,13,40566,1791,38775,2982.692308,127.9285714,21.64991625
NM_001002259,CAPRIN2,18,17,44964,4503,40461,2380.058824,250.1666667,8.985343105
NM_001206856,CAPRIN2,17,16,44964,4378,40586,2536.625,257.5294118,9.270443125
NM_023925,CAPRIN2,17,16,44964,4352,40612,2538.25,256,9.331801471
NM_032156,CAPRIN2,18,17,44964,4544,40420,2377.647059,252.4444444,8.895246479
NM_001080509,TSPAN11,8,7,69701,5570,64131,9161.571429,696.25,11.51364452
NM_030653,DDX11,27,26,30948,3954,26994,1038.230769,146.4444444,6.827010622
NM_001257144,DDX11,27,26,30948,3827,27121,1043.115385,141.7407407,7.086752025
NM_152438,DDX11,27,26,30948,3949,26999,1038.423077,146.2592593,6.836920739
NM_001257145,DDX11,27,26,30948,3759,27189,1045.730769,139.2222222,7.233040702
NM_004399,DDX11,26,25,30948,3803,27145,1085.8,146.2692308,7.137785958
NM_001135864,METTL20,4,3,21924,2094,19830,6610,523.5,9.46991404
NM_001135863,METTL20,4,3,9409,2113,7296,2432,528.25,3.452910554
NM_173802,METTL20,4,3,9897,2174,7723,2574.333333,543.5,3.552437902
NM_001013699,H3F3C,1,0,1058,1058,NA,NA,1058,NA
NM_012063,DNM1L,19,18,66452,4556,61896,3438.666667,239.7894737,13.5856014
NM_001278465,DNM1L,20,19,66452,4641,61811,3253.210526,232.05,13.31846585
NM_001278464,DNM1L,21,20,66452,4675,61777,3088.85,222.6190476,13.21433155
NM_001278466,DNM1L,17,16,66452,4228,62224,3889,248.7058824,14.71712394
NM_012062,DNM1L,20,19,66452,4635,61817,3253.526316,231.75,13.33700108
NM_001278463,DNM1L,19,18,66452,4601,61851,3436.166667,242.1578947,13.44294719
NM_005690,DNM1L,18,17,66452,4522,61930,3642.941176,251.2222222,13.69526758
NM_001040436,YARS2,5,4,9411,2178,7233,1808.25,435.6,3.320936639
NM_032834,ALG10,3,2,6022,3130,2892,1446,1043.333333,0.923961661
NM_001013620,ALG10B,3,2,12973,10077,2896,1448,3359,0.287387119
NM_001099650,GXYLT1,7,6,63027,7402,55625,9270.833333,1057.428571,7.514860848
NM_173601,GXYLT1,8,7,63027,7496,55531,7933,937,7.408084312
NM_001190980,YAF2,3,2,7127,5098,2029,1014.5,1699.333333,0.397999215
NM_033114,ZCRB1,8,7,14046,1852,12194,1742,231.5,6.584233261
NM_001271826,PUS7L,8,7,30212,3061,27151,3878.714286,382.625,8.869977132
NM_001098615,PUS7L,9,8,30151,4371,25780,3222.5,485.6666667,5.897963853
NM_001098614,PUS7L,9,8,30168,3973,26195,3274.375,441.4444444,6.593254468
NM_031292,PUS7L,9,8,30212,3988,26224,3278,443.1111111,6.575727182
NM_002822,TWF1,9,8,12654,3054,9600,1200,339.3333333,3.143418468
NM_001242397,TWF1,10,9,12654,3076,9578,1064.222222,307.6,3.113784135
NM_001004329,DBX2,4,3,36345,2726,33619,11206.33333,681.5,12.33272194
NM_004719,SCAF11,15,14,71489,7611,63878,4562.714286,507.4,8.39285245
NM_001278389,SLC38A1,17,16,83440,7652,75788,4736.75,450.1176471,9.904338735
NM_018976,SLC38A2,16,15,14676,4900,9776,651.7333333,306.25,1.995102041
NM_181847,AMIGO2,2,1,4246,3851,395,395,1925.5,0.102570761
NM_001143668,AMIGO2,3,2,3353,3061,292,146,1020.333333,0.095393662
NM_024604,RPAP3,17,16,44131,3704,40427,2526.6875,217.8823529,10.91441685
NM_001146076,RPAP3,16,15,44131,3544,40587,2705.8,221.5,11.45231377
NM_001146075,RPAP3,16,15,44131,3601,40530,2702,225.0625,11.25520689
NM_017842,SLC48A1,3,2,9571,3037,6534,3267,1012.333333,2.151465262
NM_015401,HDAC7,26,25,37258,4314,32944,1317.76,165.9230769,7.636532221
NM_001172439,ENDOU,10,9,15839,2469,13370,1485.555556,246.9,5.415147833
NM_006105,RAPGEF3,28,27,23793,5781,18012,667.1111111,206.4642857,3.115723923
NM_001098416,HDAC7,25,24,37258,4202,33056,1377.333333,168.08,7.866730129
NM_006025,ENDOU,9,8,15839,2345,13494,1686.75,260.5555556,5.754371002
NM_001172440,ENDOU,8,7,15839,2278,13561,1937.285714,284.75,5.953028973
NM_001098532,RAPGEF3,27,26,23730,6010,17720,681.5384615,222.5925926,2.948419301
NM_001098531,RAPGEF3,28,27,24438,6247,18191,673.7407407,223.1071429,2.91195774
NM_024056,TMEM106C,8,7,5333,1525,3808,544,190.625,2.49704918
NM_000376,VDR,10,9,63496,4663,58833,6537,466.3,12.61698477
NM_001143843,TMEM106C,8,7,5333,1539,3794,542,192.375,2.465237167
NM_001143842,TMEM106C,8,7,5333,1596,3737,533.8571429,199.5,2.341478697
NM_001143841,TMEM106C,8,7,5333,1468,3865,552.1428571,183.5,2.632833787
NM_001017535,VDR,11,10,63496,4786,58710,5871,435.0909091,12.26702883
NM_001017536,VDR,10,9,63496,5054,58442,6493.555556,505.4,11.56351405
NM_001844,COL2A1,54,53,31539,5141,26398,498.0754717,95.2037037,5.134798677
NM_033150,COL2A1,53,52,31539,4933,26606,511.6538462,93.0754717,5.393472532
NM_000289,PFKM,23,22,27176,3247,23929,1087.681818,141.173913,7.369571913
NM_024095,ASB8,4,3,9807,2617,7190,2396.666667,654.25,2.747420711
NM_001013635,C12orf68,1,0,2345,2345,NA,NA,2345,NA
NM_001166687,PFKM,23,22,23759,3101,20658,939,134.826087,6.661722025
NM_001166686,PFKM,25,24,40533,3551,36982,1540.916667,142.04,10.41453112
NM_001166688,PFKM,22,21,23759,3189,20570,979.5238095,144.9545455,6.450297899
NM_001004134,OR10AD1,1,0,955,955,NA,NA,955,NA
NM_001172682,ZNF641,5,4,11238,4280,6958,1739.5,856,1.625700935
NM_001172681,ZNF641,6,5,10883,4375,6508,1301.6,729.1666667,1.487542857
NM_152320,ZNF641,7,6,10883,4549,6334,1055.666667,649.8571429,1.392393933
NM_181788,H1FNT,1,0,1301,1301,NA,NA,1301,NA
NM_012404,ANP32D,1,0,397,397,NA,NA,397,NA
NM_002289,LALBA,4,3,2364,732,1632,544,183,2.229508197
NM_001005203,OR8S1,2,1,2473,1082,1391,1391,541,1.285582255
NM_001240,CCNT1,9,8,28542,7088,21454,2681.75,787.5555556,3.026805869
NM_017822,KANSL2,10,9,29042,2396,26646,2960.666667,239.6,11.12103506
NM_001277842,CCNT1,8,7,28542,6923,21619,3088.428571,865.375,3.122779142
NM_020983,ADCY6,21,20,22841,5898,16943,847.15,280.8571429,2.872668701
NM_015270,ADCY6,21,20,17904,6587,11317,565.85,313.6666667,1.718081069
NM_001206916,CACNB3,13,12,13371,2622,10749,895.75,201.6923077,4.099542334
NM_001206917,CACNB3,13,12,14513,2589,11924,993.6666667,199.1538462,4.605639243
NM_014470,RND1,5,4,8739,1670,7069,1767.25,334,4.232934132
NM_000725,CACNB3,13,12,10474,2971,7503,625.25,228.5384615,2.525412319
NM_001206915,CACNB3,12,11,10474,2847,7627,693.3636364,237.25,2.678960309
NM_004818,DDX23,17,16,22420,3284,19136,1196,193.1764706,5.827040195
NM_001143782,FKBP11,6,5,2423,992,1431,286.2,165.3333333,1.442540323
NM_001143781,FKBP11,5,4,2924,549,2375,593.75,109.8,4.326047359
NM_001286957,CCDC65,8,7,17468,1783,15685,2240.714286,222.875,8.796971397
NM_016594,FKBP11,6,5,3590,756,2834,566.8,126,3.748677249
NM_003394,WNT10B,5,4,6520,2374,4146,1036.5,474.8,1.746419545
NM_033124,CCDC65,8,7,17468,1823,15645,2235,227.875,8.58200768
NM_002733,PRKAG1,12,11,16576,1741,14835,1348.636364,145.0833333,8.520964963
NM_001206710,PRKAG1,12,11,16478,1851,14627,1329.727273,154.25,7.902215019
NM_001206709,PRKAG1,12,11,16576,1768,14808,1346.181818,147.3333333,8.375565611
NM_001659,ARF3,5,4,21262,3542,17720,4430,708.4,5.002823264
NM_015086,DDN,2,1,4157,3746,411,411,1873,0.109717032
NM_005430,WNT1,4,3,4162,2288,1874,624.6666667,572,0.819055944
NM_021044,DHH,3,2,5398,1937,3461,1730.5,645.6666667,1.786783686
NM_006082,TUBA1B,4,3,3739,1755,1984,661.3333333,438.75,1.13048433
NM_018113,LMBR1L,17,16,13759,2361,11398,712.375,138.8823529,4.827615417
NM_144593,RHEBL1,8,7,5309,1185,4124,589.1428571,148.125,3.480168776
NM_006009,TUBA1A,4,3,4531,1920,2611,870.3333333,480,1.359895833
NM_001270400,TUBA1A,4,3,4531,2008,2523,841,502,1.256474104
NM_001270399,TUBA1A,4,3,4531,2480,2051,683.6666667,620,0.827016129
NM_032704,TUBA1C,4,3,8250,1557,6693,2231,389.25,4.298651252
NM_024902,DNAJC22,3,2,4646,1830,2816,1408,610,1.538797814
NM_001278324,TROAP,4,3,1202,666,536,178.6666667,166.5,0.804804805
NM_001008223,C1QL4,2,1,4773,2067,2706,2706,1033.5,1.309143687
NM_006262,PRPH,9,8,3574,1842,1732,216.5,204.6666667,0.940282302
NM_005480,TROAP,15,14,8545,2633,5912,422.2857143,175.5333333,2.245347512
NM_001100620,TROAP,4,3,1202,742,460,153.3333333,185.5,0.619946092
NM_001031698,PRPF40B,26,25,21257,3359,17898,715.92,129.1923077,5.328371539
NM_032130,FAM186B,7,6,18147,2962,15185,2530.833333,423.1428571,5.126603646
NM_001012300,MCRS1,14,13,8138,1782,6356,488.9230769,127.2857143,3.5667789
NM_006337,MCRS1,15,14,9853,1961,7892,563.7142857,130.7333333,4.024477307
NM_001278341,MCRS1,13,12,9853,1700,8153,679.4166667,130.7692308,4.795882353
NM_003217,TMBIM6,10,9,23426,2894,20532,2281.333333,289.4,7.094678645
NM_001098576,TMBIM6,10,9,23127,3264,19863,2207,326.4,6.085477941
NM_012306,FAIM2,12,11,37083,4756,32327,2938.818182,396.3333333,6.797098402
NM_181708,BCDIN3D,2,1,7088,3251,3837,3837,1625.5,1.18025223
NM_013277,RACGAP1,19,18,36364,3334,33030,1835,175.4736842,9.907018596
NM_001652,AQP6,4,3,4304,2658,1646,548.6666667,664.5,0.619262603
NM_000486,AQP2,4,3,8142,4183,3959,1319.666667,1045.75,0.946449916
NM_001651,AQP5,4,3,4188,1829,2359,786.3333333,457.25,1.289775834
NM_001126104,RACGAP1,17,16,36364,3223,33141,2071.3125,189.5882353,10.28265591
NM_001126103,RACGAP1,19,18,36364,3345,33019,1834.388889,176.0526316,9.871150972
NM_139071,SMARCD1,12,11,15513,3318,12195,1108.636364,276.5,3.675406872
NM_032901,COX14,2,1,8478,745,7733,7733,372.5,10.37986577
NM_001257134,COX14,2,1,8478,941,7537,7537,470.5,8.009564293
NM_001257133,COX14,3,2,8478,806,7672,3836,268.6666667,9.518610422
NM_147190,CERS5,10,9,38229,2664,35565,3951.666667,266.4,13.35022523
NM_003076,SMARCD1,13,12,15513,3442,12071,1005.916667,264.7692308,3.50697269
NM_001256830,ASIC1,10,9,10039,3672,6367,707.4444444,367.2,1.733932462
NM_001281731,CERS5,11,10,38229,2866,35363,3536.3,260.5454545,12.33879972
NM_001257199,GPD1,8,7,7503,3022,4481,640.1428571,377.75,1.482792852
NM_005276,GPD1,8,7,7503,3091,4412,630.2857143,386.375,1.427369783
NM_001170804,LARP4,11,10,60682,1689,58993,5899.3,153.5454545,34.92776791
NM_005171,ATF1,7,6,57156,2512,54644,9107.333333,358.8571429,21.75318471
NM_014033,METTL7A,2,1,7768,3392,4376,4376,1696,1.29009434
NM_001109619,HIGD1C,3,2,16509,297,16212,8106,99,54.58585859
NM_030809,CSRNP2,5,4,22468,4597,17871,4467.75,919.4,3.887535349
NM_001243689,LETMD1,9,8,12127,2182,9945,1243.125,242.4444444,4.557745188
NM_015416,LETMD1,9,8,12127,2143,9984,1248,238.1111111,4.658889407
NM_001136266,DAZAP2,4,3,5211,2093,3118,1039.333333,523.25,1.489727664
NM_001136268,DAZAP2,3,2,5211,1923,3288,1644,641,1.709828393
NM_001136267,DAZAP2,4,3,5211,2074,3137,1045.666667,518.5,1.512536162
NM_014764,DAZAP2,4,3,5211,2170,3041,1013.666667,542.5,1.401382488
NM_002702,POU6F1,6,5,11233,4705,6528,1305.6,784.1666667,1.387460149
NM_001136264,DAZAP2,5,4,5211,2105,3106,776.5,421,1.475534442
NM_001136269,DAZAP2,4,3,7995,1223,6772,2257.333333,305.75,5.537203598
NM_016293,BIN2,13,12,43118,2224,40894,3407.833333,171.0769231,18.38758993
NM_001971,CELA1,8,7,18238,960,17278,2468.285714,120,17.99791667
NM_001258402,SLC4A8,15,14,49769,2333,47436,3388.285714,155.5333333,20.33261895
NM_001267615,SLC4A8,15,14,83262,2279,80983,5784.5,151.9333333,35.53444493
NM_001258403,SLC4A8,17,16,55492,3055,52437,3277.3125,179.7058824,17.16432079
NM_001130015,ANKRD33,6,5,3714,1785,1929,385.8,297.5,1.080672269
NM_001013690,FIGNL2,2,1,14027,4696,9331,9331,2348,1.987010221
NM_182608,ANKRD33,5,4,3714,1958,1756,439,391.6,0.896833504
NM_000020,ACVRL1,10,9,15945,4273,11672,1296.888889,427.3,2.731570325
NM_020328,ACVR1B,10,9,45414,4697,40717,4524.111111,469.7,8.668724718
NM_020327,ACVR1B,9,8,43701,4525,39176,4897,502.7777778,8.657679558
NM_001271856,GRASP,7,6,5399,1726,3673,612.1666667,246.5714286,2.128041715
NM_001077401,ACVRL1,9,8,11034,4135,6899,862.375,459.4444444,1.668440145
NM_004302,ACVR1B,9,8,45414,4573,40841,5105.125,508.1111111,8.930898754
NM_181711,GRASP,8,7,8946,1961,6985,997.8571429,245.125,3.561958185
NM_021934,C12orf44,4,3,7523,1441,6082,2027.333333,360.25,4.220680083
NM_002135,NR4A1,8,7,8107,2687,5420,774.2857143,335.875,2.017119464
NM_001098673,C12orf44,4,3,7523,1270,6253,2084.333333,317.5,4.923622047
NM_173157,NR4A1,7,6,8107,2536,5571,928.5,362.2857143,2.196766562
NM_002281,KRT81,9,8,5604,1919,3685,460.625,213.2222222,1.920270974
NM_001081492,KRT80,9,8,23006,3903,19103,2387.875,433.6666667,4.894440174
NM_001242696,C12orf80,4,3,5276,1296,3980,1326.666667,324,3.070987654
NM_005556,KRT7,9,8,15757,1711,14046,1755.75,190.1111111,8.209234366
NM_182507,KRT80,9,8,23006,3868,19138,2392.25,429.7777778,4.947776629
NM_002284,KRT86,9,8,7300,2100,5200,650,233.3333333,2.476190476
NM_002283,KRT85,9,8,7521,2500,5021,627.625,277.7777778,2.0084
NM_002282,KRT83,9,8,7099,1884,5215,651.875,209.3333333,2.768046709
NM_033045,KRT84,9,8,7823,2082,5741,717.625,231.3333333,2.757444765
NM_033033,KRT82,9,8,12443,2690,9753,1219.125,298.8888889,3.625650558
NM_033448,KRT71,9,8,9240,2274,6966,870.75,252.6666667,3.063324538
NM_000424,KRT5,9,8,5886,2312,3574,446.75,256.8888889,1.545847751
NM_005555,KRT6B,9,8,5477,2291,3186,398.25,254.5555556,1.390659101
NM_005554,KRT6A,9,8,6225,2459,3766,470.75,273.2222222,1.531516877
NM_173086,KRT6C,9,8,5271,2298,2973,371.625,255.3333333,1.293733681
NM_001146225,KRT72,10,9,15951,1898,14053,1561.444444,189.8,7.404109589
NM_001146226,KRT72,8,7,15951,1897,14054,2007.714286,237.125,7.4085398
NM_006121,KRT1,9,8,5673,2460,3213,401.625,273.3333333,1.306097561
NM_000423,KRT2,9,8,7619,2423,5196,649.5,269.2222222,2.14444903
NM_080747,KRT72,9,8,15951,2024,13927,1740.875,224.8888889,6.880928854
NM_175068,KRT73,9,8,10991,2293,8698,1087.25,254.7777778,3.793283908
NM_175053,KRT74,9,8,8008,2797,5211,651.375,310.7777778,1.863067572
NM_002272,KRT4,9,8,7575,2156,5419,677.375,239.5555556,2.513450835
NM_057088,KRT3,9,8,6425,2319,4106,513.25,257.6666667,1.770590772
NM_015848,KRT76,9,8,9192,2538,6654,831.75,282,2.621749409
NM_002273,KRT8,8,7,7899,1804,6095,870.7142857,225.5,3.378603104
NM_001256282,KRT8,9,8,29284,1806,27478,3434.75,200.6666667,15.21483942
NM_001256293,KRT8,9,8,52681,1900,50781,6347.625,211.1111111,26.72684211
NM_173352,KRT78,9,8,10034,1787,8247,1030.875,198.5555556,4.614997202
NM_015319,TENC1,29,28,15431,4980,10451,373.25,171.7241379,2.098594378
NM_032840,SPRYD3,11,10,15106,2943,12163,1216.3,267.5454545,4.132857628
NM_198316,TENC1,29,28,17354,4718,12636,451.2857143,162.6896552,2.678253497
NM_001417,EIF4B,15,14,35933,4043,31890,2277.857143,269.5333333,7.887707148
NM_170754,TENC1,29,28,14329,4890,9439,337.1071429,168.6206897,1.930265849
NM_003578,SOAT2,15,14,21051,2088,18963,1354.5,139.2,9.081896552
NM_000889,ITGB7,16,15,15991,2883,13108,873.8666667,180.1875,4.546652792
NM_015989,CSAD,17,16,22985,2712,20273,1267.0625,159.5294118,7.475294985
NM_001244706,CSAD,8,7,6832,1748,5084,726.2857143,218.5,2.908466819
NM_001244705,CSAD,17,16,23248,2615,20633,1289.5625,153.8235294,7.890248566
NM_002178,IGFBP6,4,3,4694,970,3724,1241.333333,242.5,3.839175258
NM_001004304,ZNF740,7,6,10121,4263,5858,976.3333333,609,1.37414966
NM_015665,AAAS,16,15,14174,1853,12321,821.4,115.8125,6.649217485
NM_002624,PFDN5,6,5,4001,693,3308,661.6,115.5,4.773448773
NM_012291,ESPL1,31,30,25346,6654,18692,623.0666667,214.6451613,2.809137361
NM_032889,MFSD5,2,1,2316,1768,548,548,884,0.309954751
NM_021640,C12orf10,7,6,7497,1222,6275,1045.833333,174.5714286,5.13502455
NM_001173466,AAAS,15,14,14174,1753,12421,887.2142857,116.8666667,7.085567598
NM_145897,PFDN5,4,3,4001,556,3445,1148.333333,139,6.196043165
NM_001170790,MFSD5,2,1,2822,2041,781,781,1020.5,0.382655561
NM_001173467,SP7,3,2,9646,2991,6655,3327.5,997,2.225008358
NM_152860,SP7,2,1,9179,2975,6204,6204,1487.5,2.085378151
NM_001164691,AMHR2,9,8,7681,1587,6094,761.75,176.3333333,3.83994959
NM_003109,SP1,6,5,35800,7600,28200,5640,1266.666667,3.710526316
NM_020547,AMHR2,11,10,7681,1874,5807,580.7,170.3636364,3.098719317
NM_001005354,PRR13,4,3,4996,1049,3947,1315.666667,262.25,3.762631077
NM_138473,SP1,6,5,36249,7663,28586,5717.2,1277.166667,3.730392797
NM_001164690,AMHR2,11,10,7681,1870,5811,581.1,170,3.107486631
NM_001251825,SP1,6,5,36249,7519,28730,5746,1253.166667,3.820986833
NM_018457,PRR13,4,3,4996,1199,3797,1265.666667,299.75,3.166805671
NM_134324,TARBP2,9,8,4840,1456,3384,423,161.7777778,2.324175824
NM_134323,TARBP2,9,8,5512,1881,3631,453.875,209,1.930356194
NM_006301,MAP3K12,15,14,19170,3556,15614,1115.285714,237.0666667,4.390888639
NM_003717,NPFF,3,2,950,595,355,177.5,198.3333333,0.596638655
NM_001193511,MAP3K12,14,13,19170,3654,15516,1193.538462,261,4.246305419
NM_004178,TARBP2,9,8,5512,1416,4096,512,157.3333333,2.892655367
NM_020898,CALCOCO1,15,14,16407,3061,13346,953.2857143,204.0666667,4.360013068
NM_005176,ATP5G2,5,4,11167,889,10278,2569.5,177.8,11.56130484
NM_001143682,CALCOCO1,14,13,16406,2804,13602,1046.307692,200.2857143,4.850927247
NM_001002031,ATP5G2,5,4,11570,1169,10401,2600.25,233.8,8.897348161
NM_014212,HOXC11,2,1,3295,2039,1256,1256,1019.5,0.61598823
NM_017409,HOXC10,2,1,5118,1961,3157,3157,980.5,1.609892912
NM_017410,HOXC13,2,1,7754,2398,5356,5356,1199,2.23352794
NM_173860,HOXC12,2,1,1638,851,787,787,425.5,0.92479436
NM_014620,HOXC4,4,3,39180,2310,36870,12290,577.5,15.96103896
NM_022658,HOXC8,2,1,3657,2290,1367,1367,1145,0.596943231
NM_018953,HOXC5,2,1,2314,1614,700,700,807,0.433705081
NM_004503,HOXC6,2,1,2415,1683,732,732,841.5,0.434937611
NM_153633,HOXC4,2,1,2155,1668,487,487,834,0.291966427
NM_153693,HOXC6,3,2,13973,2081,11892,5946,693.6666667,5.714560308
NM_001127321,CBX5,5,4,28641,11509,17132,4283,2301.8,1.488574159
NM_001243791,SMUG1,4,3,7541,665,6876,2292,166.25,10.33984962
NM_001243790,SMUG1,5,4,7504,946,6558,1639.5,189.2,6.932346723
NM_001243789,SMUG1,6,5,7504,1028,6476,1295.2,171.3333333,6.299610895
NM_001243788,SMUG1,3,2,8638,2617,6021,3010.5,872.3333333,2.300726022
NM_001243787,SMUG1,4,3,8638,2702,5936,1978.666667,675.5,2.196891192
NM_014311,SMUG1,4,3,8638,2705,5933,1977.666667,676.25,2.193345656
NM_001127322,CBX5,5,4,28600,11707,16893,4223.25,2341.4,1.442982831
NM_015481,ZNF385A,7,6,15563,2411,13152,2192,344.4285714,5.454997926
NM_031157,HNRNPA1,11,10,4544,1936,2608,260.8,176,1.347107438
NM_001130968,ZNF385A,7,6,22165,2100,20065,3344.166667,300,9.554761905
NM_001130967,ZNF385A,8,7,22165,2344,19821,2831.571429,293,8.45605802
NM_020370,GPR84,2,1,2043,1511,532,532,755.5,0.352084712
NM_006163,NFE2,3,2,3674,1684,1990,995,561.3333333,1.181710214
NM_002136,HNRNPA1,10,9,4544,1779,2765,307.2222222,177.9,1.554243957
NM_001271734,COPZ1,8,7,26763,1875,24888,3555.428571,234.375,13.2736
NM_001271736,COPZ1,9,8,26763,2029,24734,3091.75,225.4444444,12.1902415
NM_016057,COPZ1,9,8,26763,1945,24818,3102.25,216.1111111,12.75989717
NM_001136023,NFE2,3,2,8932,1685,7247,3623.5,561.6666667,4.300890208
NM_001271735,COPZ1,8,7,26763,1893,24870,3552.857143,236.625,13.13787639
NM_001261461,NFE2,4,3,8932,1816,7116,2372,454,3.918502203
NM_002205,ITGA5,30,29,24007,4280,19727,680.2413793,142.6666667,4.60911215
NM_144594,GTSF1,9,8,17652,821,16831,2103.875,91.22222222,20.50060901
NM_006741,PPP1R1A,7,6,9421,1841,7580,1263.333333,263,4.117327539
NM_033277,LACRT,5,4,4042,513,3529,882.25,102.6,6.8791423
NM_000924,PDE1B,16,15,29848,3417,26431,1762.066667,213.5625,7.73514779
NM_053283,DCD,5,4,3776,522,3254,813.5,104.4,6.233716475
NM_001165975,PDE1B,15,14,17797,3104,14693,1049.5,206.9333333,4.733569588
NM_001288768,PDE1B,16,15,29848,3479,26369,1757.933333,217.4375,7.579476861
NM_001288769,PDE1B,15,14,29161,3036,26125,1866.071429,202.4,8.605072464
NM_058173,MUCL1,4,3,3877,493,3384,1128,123.25,6.864097363
NM_001261844,TESPA1,10,9,25431,3624,21807,2423,362.4,6.017384106
NM_021191,NEUROD4,2,1,10074,3958,6116,6116,1979,1.545224861
NM_014796,TESPA1,9,8,25431,3714,21717,2714.625,412.6666667,5.84733441
NM_001098815,TESPA1,11,10,33537,3776,29761,2976.1,343.2727273,7.881620763
NM_001136030,TESPA1,11,10,36445,3873,32572,3257.2,352.0909091,8.410018074
NM_001005243,OR9K2,1,0,1009,1009,NA,NA,1009,NA
NM_001005493,OR6C6,1,0,946,946,NA,NA,946,NA
NM_001005490,OR6C74,1,0,940,940,NA,NA,940,NA
NM_001005280,OR10A7,1,0,952,952,NA,NA,952,NA
NM_001005183,OR6C76,1,0,940,940,NA,NA,940,NA
NM_001005518,OR6C65,1,0,940,940,NA,NA,940,NA
NM_054104,OR6C3,1,0,937,937,NA,NA,937,NA
NM_001005182,OR6C1,1,0,940,940,NA,NA,940,NA
NM_001005497,OR6C75,1,0,940,940,NA,NA,940,NA
NM_054105,OR6C2,1,0,940,940,NA,NA,940,NA
NM_001005494,OR6C4,1,0,931,931,NA,NA,931,NA
NM_001005499,OR6C70,1,0,940,940,NA,NA,940,NA
NM_001005519,OR6C68,1,0,940,940,NA,NA,940,NA
NM_206899,OR10P1,1,0,943,943,NA,NA,943,NA
NM_001258285,OR2AP1,1,0,931,931,NA,NA,931,NA
NM_152637,METTL7B,2,1,3066,1507,1559,1559,753.5,1.03450564
NM_032364,DNAJC14,7,6,8678,3337,5341,890.1666667,476.7142857,1.600539407
NM_005811,GDF11,3,2,9603,4263,5340,2670,1421,1.252638987
NM_001487,BLOC1S1,4,3,3675,582,3093,1031,145.5,5.31443299
NM_014182,ORMDL2,4,3,3155,1338,1817,605.6666667,334.5,1.35799701
NM_002905,RDH5,5,4,4377,1342,3035,758.75,268.4,2.261549925
NM_001780,CD63,8,7,3697,1040,2657,379.5714286,130,2.554807692
NM_001257392,CD63,7,6,2911,784,2127,354.5,112,2.713010204
NM_001257401,CD63,7,6,2347,953,1394,232.3333333,136.1428571,1.462749213
NM_001267698,CD63,8,7,3536,1036,2500,357.1428571,129.5,2.413127413
NM_033082,SARNP,11,10,60488,941,59547,5954.7,85.54545455,63.2805526
NM_001199771,RDH5,5,4,4377,1347,3030,757.5,269.4,2.249443207
NM_001257390,CD63,8,7,3209,989,2220,317.1428571,123.625,2.244691608
NM_001257389,CD63,8,7,4232,1246,2986,426.5714286,155.75,2.3964687
NM_001257391,CD63,7,6,3041,983,2058,343,140.4285714,2.093591048
NM_001257400,CD63,7,6,2459,813,1646,274.3333333,116.1428571,2.024600246
NM_006928,PMEL,12,11,12609,2193,10416,946.9090909,182.75,4.749658003
NM_201444,DGKA,24,23,21997,2796,19201,834.826087,116.5,6.867310443
NM_201554,DGKA,24,23,21997,2664,19333,840.5652174,111,7.257132132
NM_032345,WIBG,3,2,26502,1229,25273,12636.5,409.6666667,20.56387307
NM_001200053,PMEL,9,8,11959,1897,10062,1257.75,210.7777778,5.30416447
NM_001200054,PMEL,11,10,11959,2178,9781,978.1,198,4.490817264
NM_001143853,WIBG,3,2,25714,1090,24624,12312,363.3333333,22.59082569
NM_201445,DGKA,25,24,21997,2765,19232,801.3333333,110.6,6.955515371
NM_001345,DGKA,24,23,22863,2751,20112,874.4347826,114.625,7.310796074
NM_001252037,RAB5B,5,4,22674,5222,17452,4363,1044.4,3.342014554
NM_022465,IKZF4,8,7,17532,5459,12073,1724.714286,682.375,2.211577212
NM_000456,SUOX,6,5,8268,2468,5800,1160,411.3333333,2.350081037
NM_002868,RAB5B,6,5,22674,5346,17328,3465.6,891,3.241301908
NM_001032386,SUOX,5,4,8268,2341,5927,1481.75,468.2,2.531824007
NM_001252036,RAB5B,6,5,22772,5305,17467,3493.4,884.1666667,3.292554194
NM_001005915,ERBB3,3,2,5511,1053,4458,2229,351,4.233618234
NM_001029,RPS26,4,3,2323,686,1637,545.6666667,171.5,2.386297376
NM_001032387,SUOX,4,3,8268,2231,6037,2012.333333,557.75,2.705961452
NM_021104,RPL41,4,3,1244,473,771,257,118.25,1.630021142
NM_001184796,ESYT1,31,30,16476,4308,12168,405.6,138.9677419,2.824512535
NM_006191,PA2G4,13,12,9593,2639,6954,579.5,203,2.635089049
NM_001242826,RNF41,7,6,19199,5223,13976,2329.333333,746.1428571,2.675856787
NM_015292,ESYT1,31,30,16476,4278,12198,406.6,138,2.851332398
NM_001130420,SMARCC2,30,29,27717,5432,22285,768.4482759,181.0666667,4.102540501
NM_001035267,RPL41,3,2,1244,587,657,328.5,195.6666667,1.119250426
NM_032786,ZC3H10,3,2,4250,2124,2126,1063,708,1.00094162
NM_079423,MYL6,6,5,3323,770,2553,510.6,128.3333333,3.315584416
NM_005785,RNF41,7,6,19429,5284,14145,2357.5,754.8571429,2.676949281
NM_194358,RNF41,8,7,19429,5428,14001,2000.142857,678.5,2.579403095
NM_001199629,MYL6B,8,7,5569,1072,4497,642.4285714,134,4.194962687
NM_021019,MYL6,7,6,3323,816,2507,417.8333333,116.5714286,3.072303922
NM_139067,SMARCC2,29,28,27717,5365,22352,798.2857143,185,4.166262815
NM_194359,RNF41,7,6,19467,5179,14288,2381.333333,739.8571429,2.758833752
NM_003075,SMARCC2,28,27,27717,5616,22101,818.5555556,200.5714286,3.935363248
NM_002475,MYL6B,8,7,5569,1008,4561,651.5714286,126,4.524801587
NM_001190991,CNPY2,3,2,1872,1133,739,369.5,377.6666667,0.652250662
NM_005419,STAT2,24,23,18657,4574,14083,612.3043478,190.5833333,3.078924355
NM_001127460,PAN2,26,25,17528,5398,12130,485.2,207.6153846,2.247128566
NM_001135195,SLC39A5,11,10,7130,1976,5154,515.4,179.6363636,2.608299595
NM_014255,CNPY2,6,5,5917,1227,4690,938,204.5,3.822330888
NM_016584,IL23A,4,3,1533,1046,487,162.3333333,261.5,0.465583174
NM_198332,STAT2,24,23,18657,4562,14095,612.826087,190.0833333,3.089653661
NM_001099337,COQ10A,5,4,3685,1415,2270,567.5,283,1.604240283
NM_144576,COQ10A,5,4,4110,1659,2451,612.75,331.8,1.477396022
NM_001166279,PAN2,26,25,17832,5324,12508,500.32,204.7692308,2.349361382
NM_014871,PAN2,26,25,17832,5315,12517,500.68,204.4230769,2.355032926
NM_004077,CS,11,10,28694,2987,25707,2570.7,271.5454545,8.60629394
NM_173596,SLC39A5,13,12,7811,2007,5804,483.6666667,154.3846154,2.891878426
NM_173595,ANKRD52,28,27,20554,8684,11870,439.6296296,310.1428571,1.366881621
NM_001280798,GLS2,15,14,17472,2311,15161,1082.928571,154.0666667,6.560363479
NM_001280797,GLS2,17,16,17472,2535,14937,933.5625,149.1176471,5.892307692
NM_001280796,GLS2,18,17,17472,2739,14733,866.6470588,152.1666667,5.378970427
NM_013267,GLS2,18,17,17472,2666,14806,870.9411765,148.1111111,5.55363841
NM_012064,MIP,4,3,5151,2612,2539,846.3333333,653,0.972052067
NM_207344,SPRYD4,2,1,2468,2107,361,361,1053.5,0.17133365
NM_001638,APOF,2,1,2230,1691,539,539,845.5,0.318746304
NM_003920,TIMELESS,29,28,33045,5167,27878,995.6428571,178.1724138,5.395393846
NM_002898,RBMS2,14,13,74373,8500,65873,5067.153846,607.1428571,7.749764706
NM_001686,ATP5B,10,9,7895,1853,6042,671.3333333,185.3,3.260658392
NM_006601,PTGES3,8,7,25069,2038,23031,3290.142857,254.75,11.30078508
NM_001113202,NACA,8,7,13117,1049,12068,1724,131.125,11.5042898
NM_001113203,NACA,11,10,13117,3182,9935,993.5,289.2727273,3.122250157
NM_001282605,PTGES3,6,5,25069,1883,23186,4637.2,313.8333333,12.31332979
NM_000946,PRIM1,13,12,20784,1475,19309,1609.083333,113.4615385,13.09084746
NM_001282604,PTGES3,9,8,25069,2088,22981,2872.625,232,11.00622605
NM_001282603,PTGES3,7,6,25069,1938,23131,3855.166667,276.8571429,11.93550052
NM_001282602,PTGES3,7,6,25069,1947,23122,3853.666667,278.1428571,11.87570621
NM_001282601,PTGES3,7,6,25069,1974,23095,3849.166667,282,11.69959473
NM_003725,HSD17B6,5,4,24574,1623,22951,5737.75,324.6,14.14109673
NM_007264,GPR182,2,1,2116,1572,544,544,786,0.34605598
NM_014830,ZBTB39,2,1,7682,6240,1442,1442,3120,0.231089744
NM_148897,SDR9C7,4,3,11253,1769,9484,3161.333333,442.25,5.361221029
NM_003708,RDH16,4,3,6204,1727,4477,1492.333333,431.75,2.592356688
NM_001178078,STAT6,22,21,16011,4059,11952,569.1428571,184.5,2.944567627
NM_005967,NAB2,7,6,6584,2718,3866,644.3333333,388.2857143,1.422369389
NM_003153,STAT6,22,21,16011,4040,11971,570.047619,183.6363636,2.963118812
NM_001130963,TMEM194A,9,8,23150,5626,17524,2190.5,625.1111111,3.114824031
NM_001256041,MYO1A,29,28,22250,3687,18563,662.9642857,127.137931,5.034716572
NM_015257,TMEM194A,8,7,23150,5406,17744,2534.857143,675.75,3.282278949
NM_001178079,STAT6,22,21,14904,3985,10919,519.952381,181.1363636,2.740025094
NM_001178081,STAT6,20,19,16011,3762,12249,644.6842105,188.1,3.255980861
NM_001178080,STAT6,21,20,16011,3902,12109,605.45,185.8095238,3.103280369
NM_005379,MYO1A,28,27,21602,3649,17953,664.9259259,130.3214286,4.919978076
NM_001286256,STAC3,11,10,7740,1598,6142,614.2,145.2727273,3.843554443
NM_001166359,SHMT2,12,11,4609,2161,2448,222.5454545,180.0833333,1.132808885
NM_001166358,SHMT2,12,11,4892,2268,2624,238.5454545,189,1.15696649
NM_001166357,SHMT2,12,11,4577,2369,2208,200.7272727,197.4166667,0.932038835
NM_001166356,SHMT2,12,11,5364,2277,3087,280.6363636,189.75,1.355731225
NM_007224,NXPH4,2,1,9656,1806,7850,7850,903,4.34662237
NM_020142,NDUFA4L2,5,4,5791,1193,4598,1149.5,238.6,3.854149204
NM_145064,STAC3,12,11,7740,1666,6074,552.1818182,138.8333333,3.645858343
NM_001286257,STAC3,9,8,7740,1230,6510,813.75,136.6666667,5.292682927
NM_005412,SHMT2,12,11,5364,2307,3057,277.9090909,192.25,1.325097529
NM_001160045,GLI1,10,9,12131,3408,8723,969.2222222,340.8,2.559565728
NM_005538,INHBC,2,1,17379,3303,14076,14076,1651.5,4.261580381
NM_001195057,DDIT3,4,3,3931,901,3030,1010,225.25,3.362930078
NM_001195056,DDIT3,3,2,3931,1181,2750,1375,393.6666667,2.32853514
NM_001195053,DDIT3,4,3,3931,1072,2859,953,268,2.666977612
NM_052897,MBD6,13,12,7274,4163,3111,259.25,320.2307692,0.747297622
NM_032496,ARHGAP9,18,17,7597,2615,4982,293.0588235,145.2777778,1.905162524
NM_031479,INHBE,2,1,2697,2439,258,258,1219.5,0.105781058
NM_001167609,GLI1,11,10,12115,3490,8625,862.5,317.2727273,2.471346705
NM_004990,MARS,21,20,28704,2936,25768,1288.4,139.8095238,8.776566757
NM_001080157,ARHGAP9,16,15,7388,2603,4785,319,162.6875,1.838263542
NM_001195055,DDIT3,4,3,3931,996,2935,978.3333333,249,2.946787149
NM_001195054,DDIT3,4,3,3931,1019,2912,970.6666667,254.75,2.857703631
NM_005269,GLI1,12,11,12115,3614,8501,772.8181818,301.1666667,2.352241284
NM_004083,DDIT3,4,3,3931,915,3016,1005.333333,228.75,3.296174863
NM_001080156,ARHGAP9,16,15,5692,2101,3591,239.4,131.3125,1.709186102
NM_001146258,PIP4K2C,11,10,12271,2941,9330,933,267.3636364,3.172390343
NM_001146260,PIP4K2C,9,8,12271,3084,9187,1148.375,342.6666667,2.978923476
NM_001276468,B4GALNT1,10,9,6788,2438,4350,483.3333333,243.8,1.784249385
NM_133489,SLC26A10,14,13,6243,2423,3820,293.8461538,173.0714286,1.576557986
NM_001146259,PIP4K2C,10,9,12271,3175,9096,1010.666667,317.5,2.86488189
NM_001286245,DTX3,6,5,5184,2058,3126,625.2,343,1.518950437
NM_178502,DTX3,7,6,5184,2239,2945,490.8333333,319.8571429,1.315319339
NM_004984,KIF5A,29,28,34709,3926,30783,1099.392857,135.3793103,7.84080489
NM_001478,B4GALNT1,11,10,7346,2931,4415,441.5,266.4545455,1.506311839
NM_001276469,B4GALNT1,6,5,3910,2008,1902,380.4,334.6666667,0.947211155
NM_001111270,ARHGEF25,16,15,7067,2264,4803,320.2,141.5,2.121466431
NM_024779,PIP4K2C,10,9,12271,3229,9042,1004.666667,322.9,2.800247755
NM_182947,ARHGEF25,15,14,5812,2569,3243,231.6428571,171.2666667,1.262358895
NM_001286246,DTX3,6,5,5184,2077,3107,621.4,346.1666667,1.495907559
NM_001261420,OS9,14,13,27604,2711,24893,1914.846154,193.6428571,9.182220583
NM_001261422,OS9,13,12,27604,2551,25053,2087.75,196.2307692,9.820854567
NM_005981,TSPAN31,6,5,3244,1746,1498,299.6,291,0.857961054
NM_001017957,OS9,14,13,27604,2663,24941,1918.538462,190.2142857,9.36575291
NM_001261423,OS9,13,12,27604,2485,25119,2093.25,191.1538462,10.1082495
NM_001261421,OS9,13,12,27604,2611,24993,2082.75,200.8461538,9.572194561
NM_001172696,TSFM,7,6,14844,2109,12735,2122.5,301.2857143,6.038406828
NM_001172695,TSFM,5,4,14844,1956,12888,3222,391.2,6.588957055
NM_023033,METTL1,5,4,3565,1127,2438,609.5,225.4,2.163265306
NM_005726,TSFM,6,5,14844,2045,12799,2559.8,340.8333333,6.258679707
NM_006812,OS9,15,14,27604,2874,24730,1766.428571,191.6,8.604732081
NM_001122772,AGAP2,19,18,13955,5857,8098,449.8888889,308.2631579,1.382619088
NM_000785,CYP27B1,9,8,4861,2496,2365,295.625,277.3333333,0.947516026
NM_015433,METTL21B,3,2,9943,2704,7239,3619.5,901.3333333,2.67714497
NM_000075,CDK4,8,7,4722,2010,2712,387.4285714,251.25,1.349253731
NM_014770,AGAP2,18,17,17870,4878,12992,764.2352941,271,2.663386634
NM_206914,METTL21B,4,3,9943,2844,7099,2366.333333,711,2.496132208
NM_001017958,OS9,15,14,27604,2829,24775,1769.642857,188.6,8.757511488
NM_001017956,OS9,14,13,27604,2708,24896,1915.076923,193.4285714,9.193500739
NM_005371,METTL1,6,5,3565,1313,2252,450.4,218.8333333,1.715156131
NM_138396,Mar-09,4,3,5314,2989,2325,775,747.25,0.777852124
NM_005730,CTDSP2,8,7,27039,5028,22011,3144.428571,628.5,4.377684964
NM_033276,XRCC6BP1,6,5,15609,1166,14443,2888.6,194.3333333,12.38679245
NM_001136051,LRIG3,19,18,47392,3680,43712,2428.444444,193.6842105,11.87826087
NM_153377,LRIG3,19,18,48384,4099,44285,2460.277778,215.7368421,10.8038546
NM_001252079,USP15,7,6,76355,2293,74062,12343.66667,327.5714286,32.29917139
NM_175895,C12orf61,1,0,1685,1685,NA,NA,1685,NA
NM_000706,AVPR1A,2,1,10053,7833,2220,2220,3916.5,0.283416316
NM_001278237,TMEM5,6,5,29434,1972,27462,5492.4,328.6666667,13.92596349
NM_014254,TMEM5,6,5,29757,1962,27795,5559,327,14.16666667
NM_152440,C12orf66,3,2,29659,2603,27056,13528,867.6666667,10.39416058
NM_007235,XPOT,25,24,44312,3972,40340,1680.833333,158.88,10.15609265
NM_007191,WIF1,10,9,70944,2250,68694,7632.666667,225,30.53066667
NM_001167614,LEMD3,13,12,78792,4808,73984,6165.333333,369.8461538,15.38768719
NM_014319,LEMD3,13,12,78792,4811,73981,6165.083333,370.0769231,15.3774683
NM_003484,HMGA2,4,3,91069,1533,89536,29845.33333,383.25,58.40574038
NM_016056,TMBIM4,7,6,33138,1869,31269,5211.5,267,16.73033708
NM_001282606,TMBIM4,8,7,33138,2011,31127,4446.714286,251.375,15.47836897
NM_032338,LLPH,3,2,7686,1220,6466,3233,406.6666667,5.3
NM_001282610,TMBIM4,7,6,33138,1831,31307,5217.833333,261.5714286,17.09830694
NM_001282609,TMBIM4,7,6,33138,1834,31304,5217.333333,262,17.06870229
NM_018448,CAND1,15,14,45329,5923,39406,2814.714286,394.8666667,6.653047442
NM_003583,DYRK2,2,1,13934,6012,7922,7922,3006,1.317697937
NM_006482,DYRK2,3,2,13934,6162,7772,3886,2054,1.261278806
NM_020525,IL22,5,4,5258,1152,4106,1026.5,230.4,3.564236111
NM_018402,IL26,5,4,24444,1052,23392,5848,210.4,22.23574144
NM_001205029,MDM1,3,2,7378,2778,4600,2300,926,1.655867531
NM_001205028,MDM1,14,13,37817,2878,34939,2687.615385,205.5714286,12.1400278
NM_017440,MDM1,14,13,37817,2983,34834,2679.538462,213.0714286,11.67750587
NM_020128,MDM1,3,2,7378,2289,5089,2544.5,763,2.22324159
NM_001251922,RAP1B,7,6,49768,2008,47760,7960,286.8571429,23.78486056
NM_001251921,RAP1B,7,6,49768,2092,47676,7946,298.8571429,22.78967495
NM_001251918,RAP1B,6,5,49768,2022,47746,9549.2,337,23.6132542
NM_001251917,RAP1B,6,5,49768,2031,47737,9547.4,338.5,23.50418513
NM_015646,RAP1B,8,7,49768,2159,47609,6801.285714,269.875,22.05141269
NM_001010942,RAP1B,8,7,49768,2150,47618,6802.571429,268.75,22.14790698
NM_020401,NUP107,28,27,55744,3152,52592,1947.851852,112.5714286,16.68527919
NM_018656,SLC35E3,5,4,19919,2352,17567,4391.75,470.4,7.468962585
NM_001005502,CPM,9,8,82025,6645,75380,9422.5,738.3333333,11.34386757
NM_198320,CPM,9,8,82025,6663,75362,9420.25,740.3333333,11.31052079
NM_007007,CPSF6,10,9,34823,6626,28197,3133,662.6,4.255508602
NM_006530,YEATS4,7,6,31046,1392,29654,4942.333333,198.8571429,21.30316092
NM_000239,LYZ,4,3,5881,1520,4361,1453.666667,380,2.869078947
NM_006654,FRS2,10,9,109444,6883,102561,11395.66667,688.3,14.90062473
NM_001278355,FRS2,10,9,109444,6911,102533,11392.55556,691.1,14.83620315
NM_001278357,FRS2,7,6,109444,6673,102771,17128.5,953.2857143,15.40101903
NM_001278353,FRS2,11,10,109444,6941,102503,10250.3,631,14.76775681
NM_001278356,FRS2,9,8,109444,6814,102630,12828.75,757.1111111,15.0616378
NM_001278354,FRS2,10,9,109444,6929,102515,11390.55556,692.9,14.79506422
NM_001278351,FRS2,11,10,109444,6998,102446,10244.6,636.1818182,14.63932552
NM_001042555,FRS2,10,9,109444,6876,102568,11396.44444,687.6,14.9168121
NM_001282614,BEST3,10,9,55910,1617,54293,6032.555556,161.7,33.576376
NM_032735,BEST3,10,9,45809,3542,42267,4696.333333,354.2,11.93308865
NM_152439,BEST3,6,5,35670,2885,32785,6557,480.8333333,11.36395147
NM_201550,LRRC10,1,0,2599,2599,NA,NA,2599,NA
NM_001282616,BEST3,4,3,16177,1913,14264,4754.666667,478.25,7.456351281
NM_001282613,BEST3,8,7,45809,3278,42531,6075.857143,409.75,12.97467968
NM_001282615,BEST3,3,2,16177,1817,14360,7180,605.6666667,7.903137039
NM_022456,RAB3IP,11,10,84520,9523,74997,7499.7,865.7272727,7.875354405
NM_001278402,RAB3IP,9,8,44254,8785,35469,4433.625,976.1111111,4.037450199
NM_001024647,RAB3IP,9,8,44254,8870,35384,4423,985.5555556,3.989177001
NM_175625,RAB3IP,10,9,83816,9556,74260,8251.111111,955.6,7.771033905
NM_175624,RAB3IP,10,9,84520,9422,75098,8344.222222,942.2,7.970494587
NM_175623,RAB3IP,11,10,83816,9657,74159,7415.9,877.9090909,7.67929999
NM_002837,PTPRB,32,31,92994,10693,82301,2654.870968,334.15625,7.696717479
NM_001109754,PTPRB,34,33,120590,11364,109226,3309.878788,334.2352941,9.611580429
NM_001206972,PTPRB,31,30,92994,10422,82572,2752.4,336.1935484,7.922855498
NM_001206971,PTPRB,31,30,92994,10422,82572,2752.4,336.1935484,7.922855498
NM_004616,TSPAN8,9,8,32904,1139,31765,3970.625,126.5555556,27.88849868
NM_031435,THAP2,3,2,16753,4843,11910,5955,1614.333333,2.459219492
NM_144982,ZFC3H1,35,34,54372,7193,47179,1387.617647,205.5142857,6.55901571
NM_014999,RAB21,7,6,32494,2634,29860,4976.666667,376.2857143,11.33637054
NM_001146213,TBC1D15,17,16,87144,5762,81382,5086.375,338.9411765,14.12391531
NM_022771,TBC1D15,18,17,87144,5814,81330,4784.117647,323,13.98864809
NM_001146214,TBC1D15,18,17,87144,5855,81289,4781.705882,325.2777778,13.88368915
NM_001136262,ATXN7L3B,1,0,3683,3683,NA,NA,3683,NA
NM_032606,CAPS2,18,17,54079,2153,51926,3054.470588,119.6111111,24.11797492
NM_001286547,CAPS2,16,15,54079,1906,52173,3478.2,119.125,27.37303253
NM_152436,GLIPR1L2,4,3,32972,1772,31200,10400,443,17.60722348
NM_001270396,GLIPR1L2,6,5,41329,2324,39005,7801,387.3333333,16.78356282
NM_007043,KRR1,10,9,14001,3367,10634,1181.555556,336.7,3.158301158
NM_007350,PHLDA1,2,1,6331,5915,416,416,2957.5,0.07032967
NM_139207,NAP1L1,16,15,40068,4467,35601,2373.4,279.1875,7.969778375
NM_004537,NAP1L1,15,14,40068,5140,34928,2494.857143,342.6666667,6.795330739
NM_024685,BBS10,2,1,3958,3585,373,373,1792.5,0.10404463
NM_001321,CSRP2,6,5,20305,907,19398,3879.6,151.1666667,21.38699008
NM_203394,E2F7,13,12,44336,5754,38582,3215.166667,442.6153846,6.705248523
NM_002583,PAWR,7,6,99047,1958,97089,16181.5,279.7142857,49.58580184
NM_005593,MYF5,3,2,2741,1523,1218,609,507.6666667,0.79973736
NM_002469,MYF6,3,2,1850,1340,510,255,446.6666667,0.380597015
NM_014167,CCDC59,4,3,6118,1621,4497,1499,405.25,2.774213448
NM_001146335,SLC6A15,11,10,53343,4366,48977,4897.7,396.9090909,11.21781951
NM_182767,SLC6A15,12,11,53343,4844,48499,4409,403.6666667,10.01218002
NM_018057,SLC6A15,5,4,31981,4265,27716,6929,853,6.498475967
NM_001100917,TSPAN19,9,8,21963,1029,20934,2616.75,114.3333333,20.34402332
NM_006982,ALX1,4,3,21527,1297,20230,6743.333333,324.25,15.59753277
NM_005447,RASSF9,2,1,31989,1798,30191,30191,899,16.79143493
NM_006183,NTS,4,3,8699,1243,7456,2485.333333,310.75,5.99839099
NM_001009894,C12orf29,7,6,14671,2881,11790,1965,411.5714286,4.092329052
NM_152589,C12orf50,13,12,49362,1718,47644,3970.333333,132.1538462,27.7322468
NM_181783,TMTC3,14,13,57593,7217,50376,3875.076923,515.5,6.980185673
NM_000899,KITLG,10,9,87682,5453,82229,9136.555556,545.3,15.07958922
NM_003994,KITLG,9,8,87682,5368,82314,10289.25,596.4444444,15.33420268
NM_001946,DUSP6,3,2,5036,3398,1638,819,1132.666667,0.482048264
NM_022652,DUSP6,2,1,5036,2959,2077,2077,1479.5,0.701926326
NM_152638,CCER1,1,0,2963,2963,NA,NA,2963,NA
NM_007035,KERA,3,2,7862,2533,5329,2664.5,844.3333333,2.103829451
NM_004950,EPYC,7,6,41349,1546,39803,6633.833333,220.8571429,25.7457956
NM_002345,LUM,3,2,8312,2119,6193,3096.5,706.3333333,2.922605002
NM_133504,DCN,5,4,33296,1558,31738,7934.5,311.6,20.37098845
NM_133503,DCN,8,7,34326,2142,32184,4597.714286,267.75,15.02521008
NM_133506,DCN,3,2,33296,1322,31974,15987,440.6666667,24.18608169
NM_133505,DCN,4,3,33296,1443,31853,10617.66667,360.75,22.07415107
NM_001920,DCN,8,7,37773,2296,35477,5068.142857,287,15.45165505
NM_133507,DCN,2,1,33296,1208,32088,32088,604,26.56291391
NM_001025233,CLLU1,2,1,6997,3899,3098,3098,1949.5,0.794562708
NM_001025232,CLLU1OS,4,3,8056,690,7366,2455.333333,172.5,10.67536232
NM_001004330,PLEKHG7,12,11,35605,3279,32326,2938.727273,273.25,9.858493443
NM_001178097,C12orf74,2,1,5708,2371,3337,3337,1185.5,1.407423028
NM_001037671,C12orf74,3,2,5708,1861,3847,1923.5,620.3333333,2.067168189
NM_199040,NUDT4,5,4,25325,4818,20507,5126.75,963.6,4.256330428
NM_003348,UBE2N,4,3,33940,2556,31384,10461.33333,639,12.27856025
NM_019094,NUDT4,5,4,25325,4815,20510,5127.5,963,4.2596054
NM_014050,MRPL42,6,5,36284,3145,33139,6627.8,524.1666667,10.53704293
NM_001270467,SOCS2,3,2,6348,2646,3702,1851,882,1.399092971
NM_001270468,SOCS2,3,2,5766,2615,3151,1575.5,871.6666667,1.204971319
NM_001270469,SOCS2,3,2,5066,2613,2453,1226.5,871,0.9387677
NM_001270470,SOCS2,3,2,5066,2885,2181,1090.5,961.6666667,0.755979203
NM_001270471,SOCS2,2,1,4221,2537,1684,1684,1268.5,0.663776114
NM_003877,SOCS2,3,2,6925,2756,4169,2084.5,918.6666667,1.512699565
NM_172177,MRPL42,6,5,36284,3148,33136,6627.2,524.6666667,10.52604828
NM_001258338,NDUFA12,3,2,32387,498,31889,15944.5,166,64.03413655
NM_018838,NDUFA12,4,3,32387,587,31800,10600,146.75,54.17376491
NM_001127362,NR2C1,12,11,43221,2126,41095,3735.909091,177.1666667,19.32972719
NM_001032287,NR2C1,12,11,43221,1882,41339,3758.090909,156.8333333,21.96546227
NM_001042403,USP44,6,5,32286,3883,28403,5680.6,647.1666667,7.314705125
NM_001278393,USP44,6,5,31714,4099,27615,5523,683.1666667,6.737009027
NM_006838,METAP2,11,10,41793,3515,38278,3827.8,319.5454545,10.88990043
NM_003095,SNRPF,4,3,7531,797,6734,2244.666667,199.25,8.449184442
NM_182496,CCDC38,16,15,75604,1970,73634,4908.933333,123.125,37.37766497
NM_001256644,LTA4H,18,17,42769,2080,40689,2393.470588,115.5555556,19.56201923
NM_001256643,LTA4H,19,18,42769,2164,40605,2255.833333,113.8947368,18.76386322
NM_001258334,HAL,20,19,23705,3863,19842,1044.315789,193.15,5.13642247
NM_001258333,HAL,20,19,23705,3866,19839,1044.157895,193.3,5.131660631
NM_000895,LTA4H,19,18,34910,2233,32677,1815.388889,117.5263158,14.63367667
NM_002108,HAL,21,20,23705,3934,19771,988.55,187.3333333,5.025673615
NM_001135177,NEDD1,14,13,46470,3735,42735,3287.307692,266.7857143,11.44176707
NM_001135176,NEDD1,15,14,46470,3722,42748,3053.428571,248.1333333,11.485223
NM_001135175,NEDD1,15,14,46227,3803,42424,3030.285714,253.5333333,11.15540363
NM_152905,NEDD1,16,15,46470,3976,42494,2832.933333,248.5,10.68762575
NM_001032284,TMPO,6,5,34808,3860,30948,6189.6,643.3333333,8.01761658
NM_001032283,TMPO,9,8,34808,4190,30618,3827.25,465.5555556,7.307398568
NM_003276,TMPO,4,3,20063,3676,16387,5462.333333,919,4.457834603
NM_201613,IKBIP,2,1,31649,1468,30181,30181,734,20.55926431
NM_201612,IKBIP,3,2,31649,1587,30062,15031,529,18.94265911
NM_002635,SLC25A3,8,7,8377,1686,6691,955.8571429,210.75,3.96856465
NM_005888,SLC25A3,8,7,8377,1689,6688,955.4285714,211.125,3.959739491
NM_153687,IKBIP,3,2,20801,3165,17636,8818,1055,5.572195893
NM_213611,SLC25A3,7,6,8377,1919,6458,1076.333333,274.1428571,3.365294424
NM_153364,FAM71C,2,1,2366,1869,497,497,934.5,0.265917603
NM_022496,ACTR6,11,10,24339,2476,21863,2186.3,225.0909091,8.82996769
NM_152317,DEPDC4,5,4,14817,1159,13658,3414.5,231.8,11.78429681
NM_174942,GAS2L3,10,9,51198,2338,48860,5428.888889,233.8,20.89820359
NM_001177,ARL1,6,5,14671,3216,11455,2291,536,3.561878109
NM_152323,SPIC,4,3,9442,975,8467,2822.333333,243.75,8.684102564
NM_206820,MYBPC1,30,29,90951,3924,87027,3000.931034,130.8,22.17813456
NM_206819,MYBPC1,31,30,90951,3946,87005,2900.166667,127.2903226,22.04891029
NM_001254723,MYBPC1,27,26,90951,3785,87166,3352.538462,140.1851852,23.02932629
NM_001254722,MYBPC1,28,27,90951,3849,87102,3226,137.4642857,22.62977397
NM_001254721,MYBPC1,29,28,90951,3871,87080,3110,133.4827586,22.4954792
NM_001254720,MYBPC1,29,28,90951,3892,87059,3109.25,134.2068966,22.36870504
NM_001254719,MYBPC1,30,29,90951,3929,87022,3000.758621,130.9666667,22.14863833
NM_001254718,MYBPC1,30,29,90951,3940,87011,3000.37931,131.3333333,22.08401015
NM_002465,MYBPC1,32,31,90951,4006,86945,2804.677419,125.1875,21.70369446
NM_206821,MYBPC1,29,28,90951,3869,87082,3110.071429,133.4137931,22.50762471
NM_001177949,SYCP3,9,8,10826,1138,9688,1211,126.4444444,8.513181019
NM_001177948,SYCP3,9,8,10826,1123,9703,1212.875,124.7777778,8.640249332
NM_024312,GNPTAB,21,20,85372,5651,79721,3986.05,269.0952381,14.10741462
NM_153694,SYCP3,9,8,10826,1134,9692,1211.5,126,8.546737213
NM_018370,DRAM1,7,6,46298,3550,42748,7124.666667,507.1428571,12.04169014
NM_016053,CCDC53,7,6,49184,920,48264,8044,131.4285714,52.46086957
NM_002674,PMCH,3,2,1379,760,619,309.5,253.3333333,0.814473684
NM_017915,PARPBP,11,10,77344,3092,74252,7425.2,281.0909091,24.01423027
NM_001111285,IGF1,4,3,62926,953,61973,20657.66667,238.25,65.0293809
NM_001111284,IGF1,4,3,82786,7208,75578,25192.66667,1802,10.48529412
NM_001111283,IGF1,5,4,84735,7375,77360,19340,1475,10.48949153
NM_000618,IGF1,4,3,84735,7325,77410,25803.33333,1831.25,10.56791809
NM_004316,ASCL1,2,1,2844,2486,358,358,1243,0.144006436
NM_001135570,C12orf73,3,2,7014,1696,5318,2659,565.3333333,3.135613208
NM_003211,TDG,10,9,23065,3254,19811,2201.222222,325.4,6.08819914
NM_031302,GLT8D2,11,10,61152,1888,59264,5926.4,171.6363636,31.38983051
NM_006166,NFYB,8,7,21184,3490,17694,2527.714286,436.25,5.06991404
NM_001008394,EID3,1,0,1474,1474,NA,NA,1474,NA
NM_001034173,ALDH1L2,23,22,64781,7562,57219,2600.863636,328.7826087,7.566649035
NM_001251905,APPL2,21,20,60110,3294,56816,2840.8,156.8571429,17.2483303
NM_001251904,APPL2,21,20,62935,3269,59666,2983.3,155.6666667,18.25206485
NM_018171,APPL2,21,20,62935,3251,59684,2984.2,154.8095238,18.35865887
NM_001145199,C12orf75,6,5,40884,1372,39512,7902.4,228.6666667,28.79883382
NM_014840,NUAK1,7,6,76688,6828,69860,11643.33333,975.4285714,10.23140012
NM_006825,CKAP4,2,1,10056,3038,7018,7018,1519,2.310072416
NM_152772,TCP11L2,10,9,44225,2240,41985,4665,224,18.74330357
NM_001286262,TCP11L2,7,6,27079,1504,25575,4262.5,214.8571429,17.00465426
NM_025198,MTERFD3,3,2,9877,1783,8094,4047,594.3333333,4.539540101
NM_152261,C12orf23,4,3,18271,3373,14898,4966,843.25,4.416839609
NM_001033050,MTERFD3,3,2,9877,1793,8084,4042,597.6666667,4.50864473
NM_007062,PWP1,15,14,26669,1868,24801,1771.5,124.5333333,13.2767666
NM_203436,ASCL4,1,0,2261,2261,NA,NA,2261,NA
NM_004072,CMKLR1,3,2,51275,5423,45852,22926,1807.666667,8.455098654
NM_001142345,CMKLR1,3,2,32620,5113,27507,13753.5,1704.333333,5.379816155
NM_001142344,CMKLR1,3,2,51275,5286,45989,22994.5,1762,8.700151343
NM_001142343,CMKLR1,4,3,51275,5500,45775,15258.33333,1375,8.322727273
NM_007076,FICD,3,2,4331,1654,2677,1338.5,551.3333333,1.618500605
NM_014301,ISCU,6,5,6868,1179,5689,1137.8,196.5,4.825275657
NM_003006,SELPLG,2,1,11992,2566,9426,9426,1283,3.673421668
NM_181724,TMEM119,2,1,8274,2703,5571,5571,1351.5,2.061043285
NM_001206609,SELPLG,2,1,10176,2631,7545,7545,1315.5,2.867730901
NM_213595,ISCU,5,4,6868,1082,5786,1446.5,216.4,5.347504621
NM_001917,DAO,11,10,20855,1607,19248,1924.8,146.0909091,11.97759801
NM_001161331,SSH1,13,12,35634,2452,33182,2765.166667,188.6153846,13.53262643
NM_001161330,SSH1,14,13,65666,2361,63305,4869.615385,168.6428571,26.81279119
NM_080911,UNG,7,6,13401,2059,11342,1890.333333,294.1428571,5.508499271
NM_001205180,ALKBH2,3,2,5302,851,4451,2225.5,283.6666667,5.230317274
NM_001205179,ALKBH2,3,2,5302,898,4404,2202,299.3333333,4.904231626
NM_001145374,ALKBH2,4,3,5302,1201,4101,1367,300.25,3.414654455
NM_032663,USP30,13,12,35453,3766,31687,2640.583333,289.6923077,8.413967074
NM_001145375,ALKBH2,4,3,5302,948,4354,1451.333333,237,4.592827004
NM_003362,UNG,6,5,12877,2154,10723,2144.6,359,4.97818013
NM_001001655,ALKBH2,4,3,5302,1051,4251,1417,262.75,4.044719315
NM_001093,ACACB,52,51,128830,9301,119529,2343.705882,178.8653846,12.8511988
NM_213596,FOXN4,10,9,31244,3362,27882,3098,336.2,8.293277811
NM_031954,KCTD10,7,6,28697,3977,24720,4120,568.1428571,6.215740508
NM_001270449,UBE3B,9,8,13101,1486,11615,1451.875,165.1111111,7.81628533
NM_001270450,UBE3B,9,8,13101,1141,11960,1495,126.7777778,10.4820333
NM_001270451,UBE3B,9,8,13101,1153,11948,1493.5,128.1111111,10.36253252
NM_052845,MMAB,9,8,19839,4147,15692,1961.5,460.7777778,3.783940198
NM_000431,MVK,11,10,23573,2084,21489,2148.9,189.4545455,10.31142035
NM_001114185,MVK,11,10,23573,2075,21498,2149.8,188.6363636,10.36048193
NM_032829,FAM222A,3,2,56127,3143,52984,26492,1047.666667,16.85777919
NM_032300,TCHP,13,12,17553,3170,14383,1198.583333,243.8461538,4.537223975
NM_001143852,TCHP,13,12,17797,3109,14688,1224,239.1538462,4.724348665
NM_016433,GLTP,5,4,29547,2361,27186,6796.5,472.2,11.51461245
NM_001135213,GIT2,19,18,66589,5406,61183,3399.055556,284.5263158,11.31761006
NM_033121,ANKRD13A,15,14,40002,3923,36079,2577.071429,261.5333333,9.196788172
NM_001135214,GIT2,19,18,66589,5550,61039,3391.055556,292.1052632,10.99801802
NM_139201,GIT2,15,14,48329,2357,45972,3283.714286,157.1333333,19.50445482
NM_057169,GIT2,20,19,66589,5641,60948,3207.789474,282.05,10.80446729
NM_057170,GIT2,18,17,66589,5255,61334,3607.882353,291.9444444,11.6715509
NM_014776,GIT2,18,17,66589,5399,61190,3599.411765,299.9444444,11.33358029
NM_031473,IFT81,12,11,44112,2323,41789,3799,193.5833333,17.98923805
NM_001137664,ANAPC7,10,9,28265,2220,26045,2893.888889,222,11.73198198
NM_016238,ANAPC7,11,10,30832,3056,27776,2777.6,277.8181818,9.089005236
NM_001164373,GPN3,8,7,15800,1522,14278,2039.714286,190.25,9.38107753
NM_001282150,VPS29,6,5,10619,1281,9338,1867.6,213.5,7.289617486
NM_001164372,GPN3,8,7,16237,1613,14624,2089.142857,201.625,9.06633602
NM_001282151,VPS29,3,2,10619,887,9732,4866,295.6666667,10.97181511
NM_152442,RAD9B,12,11,29888,1897,27991,2544.636364,158.0833333,14.75540327
NM_013300,FAM216A,7,6,21962,1528,20434,3405.666667,218.2857143,13.37303665
NM_016301,GPN3,8,7,15800,1492,14308,2044,186.5,9.589812332
NM_016226,VPS29,4,3,10619,1124,9495,3165,281,8.447508897
NM_057180,VPS29,5,4,10619,1137,9482,2370.5,227.4,8.339489886
NM_001286536,RAD9B,9,8,29888,1578,28310,3538.75,175.3333333,17.94043093
NM_001286532,RAD9B,11,10,29888,2829,27059,2705.9,257.1818182,9.56486391
NM_001286533,RAD9B,12,11,29888,2986,26902,2445.636364,248.8333333,9.009377093
NM_001286535,RAD9B,11,10,29888,2836,27052,2705.2,257.8181818,9.538787024
NM_001286534,RAD9B,12,11,29745,2906,26839,2439.909091,242.1666667,9.235719202
NM_001286531,RAD9B,11,10,29888,2807,27081,2708.1,255.1818182,9.647666548
NM_024549,TCTN1,15,14,35105,1982,33123,2365.928571,132.1333333,16.71190716
NM_001082538,TCTN1,15,14,35105,2039,33066,2361.857143,135.9333333,16.21677293
NM_001082537,TCTN1,15,14,35105,2024,33081,2362.928571,134.9333333,16.34436759
NM_032369,HVCN1,8,7,40473,1735,38738,5534,216.875,22.32737752
NM_001173976,TCTN1,15,14,35105,1968,33137,2366.928571,131.2,16.8379065
NM_001256413,HVCN1,7,6,41128,1703,39425,6570.833333,243.2857143,23.15032296
NM_001173975,TCTN1,15,14,35025,2005,33020,2358.571429,133.6666667,16.46882793
NM_001040107,HVCN1,8,7,41128,1744,39384,5626.285714,218,22.58256881
NM_002710,PPP1CC,7,6,23172,2518,20654,3442.333333,359.7142857,8.2025417
NM_001244974,PPP1CC,8,7,23172,1619,21553,3079,202.375,13.3125386
NM_000432,MYL2,7,6,9782,836,8946,1491,119.4285714,10.70095694
NM_001286243,CCDC63,11,10,60577,1899,58678,5867.8,172.6363636,30.89942075
NM_001286244,CCDC63,10,9,60577,1728,58849,6538.777778,172.8,34.05613426
NM_152591,CCDC63,12,11,60577,2005,58572,5324.727273,167.0833333,29.21296758
NM_005475,SH2B3,8,7,45677,5414,40263,5751.857143,676.75,7.43683044
NM_025247,ACAD10,21,20,71056,4035,67021,3351.05,192.1428571,16.60991326
NM_006768,BRAP,12,11,43842,4038,39804,3618.545455,336.5,9.857355126
NM_001136538,ACAD10,22,21,71056,4129,66927,3187,187.6818182,16.20900945
NM_001204889,ALDH2,12,11,43100,1931,41169,3742.636364,160.9166667,21.32004143
NM_000690,ALDH2,13,12,43100,2073,41027,3418.916667,159.4615385,19.79112397
NM_138341,TMEM116,10,9,81938,1549,80389,8932.111111,154.9,51.89735313
NM_001193531,TMEM116,11,10,81938,1614,80324,8032.4,146.7272727,49.76703841
NM_001193453,TMEM116,10,9,81938,1508,80430,8936.666667,150.8,53.33554377
NM_024953,NAA25,24,23,82144,5843,76301,3317.434783,243.4583333,13.05853158
NM_001024662,RPL6,7,6,4451,1137,3314,552.3333333,162.4285714,2.914687775
NM_000970,RPL6,7,6,4451,961,3490,581.6666667,137.2857143,3.631633715
NM_002834,PTPN11,16,15,91183,6299,84884,5658.933333,393.6875,13.47578981
NM_080601,PTPN11,11,10,68193,2064,66129,6612.9,187.6363636,32.03924419
NM_016816,OAS1,6,5,12975,1669,11306,2261.2,278.1666667,6.774116237
NM_002534,OAS1,5,4,11094,1475,9619,2404.75,295,6.521355932
NM_001032409,OAS1,6,5,12975,1571,11404,2280.8,261.8333333,7.259070656
NM_002535,OAS2,10,9,32231,3657,28574,3174.888889,365.7,7.81350834
NM_016817,OAS2,11,10,33256,3550,29706,2970.6,322.7272727,8.367887324
NM_001032731,OAS2,2,1,10338,2087,8251,8251,1043.5,3.953521802
NM_024072,DDX54,20,19,28308,4398,23910,1258.421053,219.9,5.436562074
NM_032848,RITA1,4,3,6844,2057,4787,1595.666667,514.25,2.327175498
NM_001286215,RITA1,3,2,6844,1924,4920,2460,641.3333333,2.557172557
NM_001144872,CCDC42B,8,7,9420,1522,7898,1128.285714,190.25,5.189224704
NM_001111322,DDX54,20,19,28308,4401,23907,1258.263158,220.05,5.432174506
NM_001193521,RASAL1,21,20,36937,3754,33183,1659.15,178.7619048,8.839371337
NM_001193520,RASAL1,22,21,37422,3854,33568,1598.47619,175.1818182,8.70991178
NM_004658,RASAL1,22,21,37422,3863,33559,1598.047619,175.5909091,8.687289671
NM_001143819,TPCN1,29,28,77131,5378,71753,2562.607143,185.4482759,13.34194868
NM_017901,TPCN1,28,27,77131,5284,71847,2661,188.7142857,13.59708554
NM_001159727,PLBD2,11,10,31089,2747,28342,2834.2,249.7272727,10.3174372
NM_006843,SDS,8,7,11443,1612,9831,1404.428571,201.5,6.098635236
NM_173542,PLBD2,12,11,31089,2844,28245,2567.727273,237,9.931434599
NM_138432,SDSL,9,8,15867,1406,14461,1807.625,156.2222222,10.28520626
NM_005996,TBX3,7,6,13912,4730,9182,1530.333333,675.7142857,1.941226216
NM_016569,TBX3,8,7,13912,4791,9121,1303,598.875,1.903777917
NM_001085481,MAP1LC3B2,2,1,17241,834,16407,16407,417,19.67266187
NM_024738,C12orf49,5,4,22249,2780,19469,4867.25,556,7.00323741
NM_017899,TESC,8,7,60525,1027,59498,8499.714286,128.375,57.93378773
NM_001168325,TESC,7,6,60525,945,59580,9930,135,63.04761905
NM_033624,FBXO21,12,11,46717,4245,42472,3861.090909,353.75,10.00518257
NM_015002,FBXO21,12,11,46717,4224,42493,3863,352,10.05989583
NM_001130112,RFC5,12,11,15538,2247,13291,1208.272727,187.25,5.914997775
NM_007370,RFC5,11,10,15538,2120,13418,1341.8,192.7272727,6.329245283
NM_181578,RFC5,12,11,15538,2485,13053,1186.636364,207.0833333,5.252716298
NM_001206801,RFC5,11,10,15538,2111,13427,1342.7,191.9090909,6.360492658
NM_002567,PEBP1,4,3,9522,1495,8027,2675.666667,373.75,5.369230769
NM_019086,VSIG10,9,8,40414,5012,35402,4425.25,556.8888889,7.063447725
NM_022491,SUDS3,12,11,41484,4740,36744,3340.363636,395,7.751898734
NM_014365,HSPB8,3,2,15958,2005,13953,6976.5,668.3333333,6.959102244
NM_006253,PRKAB1,7,6,13670,2408,11262,1877,344,4.676910299
NM_006861,RAB35,6,5,21746,2951,18795,3759,491.8333333,6.369027448
NM_001167606,RAB35,5,4,21746,2825,18921,4730.25,565,6.697699115
NM_025157,PXN,11,10,39724,3826,35898,3589.8,347.8181818,9.38264506
NM_001080855,PXN,12,11,55334,3805,51529,4684.454545,317.0833333,13.54244415
NM_002859,PXN,11,10,55334,3702,51632,5163.2,336.5454545,13.94705565
NM_001243756,PXN,11,10,55334,3846,51488,5148.8,349.6363636,13.3874155
NM_001002,RPLP0,8,7,4513,1212,3301,471.5714286,151.5,2.72359736
NM_053275,RPLP0,8,7,4513,1272,3241,463,159,2.547955975
NM_002442,MSI1,15,14,27852,2990,24862,1775.857143,199.3333333,8.315050167
NM_012240,SIRT4,4,3,10923,1214,9709,3236.333333,303.5,7.99752883
NM_000928,PLA2G1B,4,3,5680,569,5111,1703.666667,142.25,8.982425308
NM_032314,COQ5,7,6,25884,1516,24368,4061.333333,216.5714286,16.07387863
NM_001037494,DYNLL1,3,2,28640,812,27828,13914,270.6666667,34.27093596
NM_001037495,DYNLL1,3,2,2441,739,1702,851,246.3333333,2.303112314
NM_003746,DYNLL1,3,2,2441,725,1716,858,241.6666667,2.366896552
NM_016399,TRIAP1,2,1,2453,1184,1269,1269,592,1.071790541
NM_004373,COX6A1,3,2,2654,575,2079,1039.5,191.6666667,3.615652174
NM_003769,SRSF9,4,3,8089,1167,6922,2307.333333,291.75,5.931448158
NM_176818,GATC,4,3,17317,4252,13065,4355,1063,3.072671684
NM_031205,CABP1,7,6,16819,1246,15573,2595.5,178,12.49839486
NM_198202,POP5,4,3,2355,655,1700,566.6666667,163.75,2.595419847
NM_015918,POP5,5,4,2351,802,1549,387.25,160.4,1.931421446
NM_001033677,CABP1,6,5,26707,1610,25097,5019.4,268.3333333,15.58819876
NM_004276,CABP1,6,5,16819,1065,15754,3150.8,177.5,14.79248826
NM_014730,MLEC,5,4,14720,6354,8366,2091.5,1270.8,1.316650929
NM_001080533,UNC119B,5,4,13207,4409,8798,2199.5,881.8,1.995463824
NM_000017,ACADS,10,9,14242,1927,12315,1368.333333,192.7,6.390762844
NM_198213,OASL,5,4,18952,1848,17104,4276,369.6,9.255411255
NM_001286195,C12orf43,6,5,14082,2524,11558,2311.6,420.6666667,4.579239303
NM_000545,HNF1A,10,9,23767,3248,20519,2279.888889,324.8,6.317426108
NM_001286197,C12orf43,5,4,14082,2457,11625,2906.25,491.4,4.731379731
NM_001286196,C12orf43,6,5,14082,2521,11561,2312.2,420.1666667,4.58587862
NM_003733,OASL,6,5,18952,2091,16861,3372.2,348.5,8.06360593
NM_001286191,C12orf43,6,5,14082,2647,11435,2287,441.1666667,4.319984889
NM_001286192,C12orf43,6,5,14082,2557,11525,2305,426.1666667,4.507235041
NM_001286198,C12orf43,7,6,14082,2815,11267,1877.833333,402.1428571,4.002486679
NM_022895,C12orf43,6,5,14082,2554,11528,2305.6,425.6666667,4.513703994
NM_001261825,OASL,4,3,18952,1699,17253,5751,424.75,10.15479694
NM_002562,P2RX7,13,12,53725,3693,50032,4169.333333,284.0769231,13.54779312
NM_006549,CAMKK2,17,16,60618,5620,54998,3437.375,330.5882353,9.786120996
NM_002560,P2RX4,12,11,24247,2040,22207,2018.818182,170,10.88578431
NM_001256796,P2RX4,13,12,24247,2089,22158,1846.5,160.6923077,10.60698899
NM_001261398,P2RX4,11,10,24247,1790,22457,2245.7,162.7272727,12.54581006
NM_001270486,CAMKK2,16,15,36895,4522,32373,2158.2,282.625,7.159000442
NM_001270485,CAMKK2,17,16,59063,4966,54097,3381.0625,292.1176471,10.89347563
NM_001261397,P2RX4,12,11,24247,1959,22288,2026.181818,163.25,11.37723328
NM_172216,CAMKK2,16,15,60618,5490,55128,3675.2,343.125,10.04153005
NM_172215,CAMKK2,16,15,54722,2854,51868,3457.866667,178.375,18.17379117
NM_172214,CAMKK2,17,16,54722,2984,51738,3233.625,175.5294118,17.33847185
NM_172226,CAMKK2,16,15,59063,4922,54141,3609.4,307.625,10.99979683
NM_153499,CAMKK2,16,15,60618,5576,55042,3669.466667,348.5,9.871233859
NM_153500,CAMKK2,15,14,60618,5446,55172,3940.857143,363.0666667,10.13073816
NM_194271,RNF34,7,6,24236,2063,22173,3695.5,294.7142857,10.74793989
NM_025126,RNF34,6,5,24271,2031,22240,4448,338.5,10.9502708
NM_001256858,RNF34,5,4,24271,1454,22817,5704.25,290.8,15.69257221
NM_173855,MORN3,6,5,18269,1164,17105,3421,194,14.69501718
NM_032790,ORAI1,2,1,15493,1504,13989,13989,752,9.301196809
NM_019034,RHOF,5,4,15936,2440,13496,3374,488,5.531147541
NM_015048,SETD1B,17,16,27926,8212,19714,1232.125,483.0588235,2.40063322
NM_002813,PSMD9,6,5,29136,2358,26778,5355.6,393,11.3562341
NM_001261400,PSMD9,4,3,29136,2041,27095,9031.666667,510.25,13.27535522
NM_001178003,WDR66,18,17,53513,3472,50041,2943.588235,192.8888889,14.41273041
NM_020993,BCL7A,6,5,40091,3720,36371,7274.2,620,9.777150538
NM_001024808,BCL7A,6,5,40091,3657,36434,7286.8,609.5,9.962811047
NM_001014336,IL31,3,2,2171,907,1264,632,302.3333333,1.393605292
NM_138930,DIABLO,6,5,18908,1970,16938,3387.6,328.3333333,8.597969543
NM_001278304,DIABLO,5,4,18190,2467,15723,3930.75,493.4,6.373327929
NM_001278342,DIABLO,5,4,18908,1866,17042,4260.5,373.2,9.132904609
NM_019887,DIABLO,7,6,19874,2264,17610,2935,323.4285714,7.778268551
NM_030765,B3GNT4,3,2,3858,1507,2351,1175.5,502.3333333,1.560053086
NM_001278303,DIABLO,5,4,18908,1865,17043,4260.75,373,9.138337802
NM_001278302,DIABLO,5,4,18908,1837,17071,4267.75,367.4,9.292868808
NM_022916,VPS33A,13,12,34976,2616,32360,2696.666667,201.2307692,12.37003058
NM_017612,ZCCHC8,14,13,29476,4269,25207,1939,304.9285714,5.904661513
NM_023012,RSRC2,10,9,22372,2359,20013,2223.666667,235.9,8.483679525
NM_006018,HCAR3,1,0,2138,2138,NA,NA,2138,NA
NM_177551,HCAR2,1,0,2066,2066,NA,NA,2066,NA
NM_032554,HCAR1,1,0,2978,2978,NA,NA,2978,NA
NM_201435,CCDC62,13,12,52873,3229,49644,4137,248.3846154,15.37441932
NM_003677,DENR,8,7,18584,3069,15515,2216.428571,383.625,5.055392636
NM_024623,OGFOD2,8,7,5236,2088,3148,449.7142857,261,1.507662835
NM_016638,ARL6IP4,6,5,2855,1597,1258,251.6,266.1666667,0.787726988
NM_001278379,ARL6IP4,6,5,2855,1237,1618,323.6,206.1666667,1.308003234
NM_001278378,ARL6IP4,6,5,2855,1486,1369,273.8,247.6666667,0.921265141
NM_001243014,ABCB9,12,11,45560,2455,43105,3918.636364,204.5833333,17.55804481
NM_001243013,ABCB9,11,10,37519,3352,34167,3416.7,304.7272727,10.19301909
NM_019625,ABCB9,12,11,37519,3542,33977,3088.818182,295.1666667,9.592603049
NM_019624,ABCB9,11,10,37519,3412,34107,3410.7,310.1818182,9.996189918
NM_024667,VPS37B,4,3,30839,2753,28086,9362,688.25,10.2019615
NM_001002252,ARL6IP4,5,4,2855,1677,1178,294.5,335.4,0.702444842
NM_001002251,ARL6IP4,6,5,2855,1630,1225,245,271.6666667,0.751533742
NM_203444,ABCB9,12,11,41986,2648,39338,3576.181818,220.6666667,14.85574018
NM_018694,ARL6IP4,6,5,2855,1654,1201,240.2,275.6666667,0.726118501
NM_001278380,ARL6IP4,6,5,2855,1763,1092,218.4,293.8333333,0.619398752
NM_022782,MPHOSPH9,24,23,76844,4309,72535,3153.695652,179.5416667,16.83337201
NM_001167856,SBNO1,31,30,61334,11012,50322,1677.4,355.2258065,4.5697421
NM_018183,SBNO1,31,30,61334,11009,50325,1677.5,355.1290323,4.571259878
NM_001270434,CDK2AP1,4,3,7286,1149,6137,2045.666667,287.25,5.341166232
NM_001270433,CDK2AP1,4,3,9266,1121,8145,2715,280.25,7.265834077
NM_004642,CDK2AP1,4,3,11172,1640,9532,3177.333333,410,5.812195122
NM_022717,SNRNP35,2,1,8292,972,7320,7320,486,7.530864198
NM_020382,SETD8,8,7,25198,2759,22439,3205.571429,344.875,8.13301921
NM_180699,SNRNP35,2,1,6692,1056,5636,5636,528,5.337121212
NM_145058,RILPL2,4,3,21330,1439,19891,6630.333333,359.75,13.82279361
NM_020936,DDX55,14,13,18812,2636,16176,1244.307692,188.2857143,6.136570561
NM_006815,TMED2,4,3,13614,2130,11484,3828,532.5,5.391549296
NM_001414,EIF2B1,9,8,12755,1879,10876,1359.5,208.7777778,5.788185205
NM_024809,TCTN2,18,17,37292,2930,34362,2021.294118,162.7777778,11.72764505
NM_012463,ATP6V0A2,20,19,49438,6561,42877,2256.684211,328.05,6.53513184
NM_001143850,TCTN2,18,17,37292,2927,34365,2021.470588,162.6111111,11.74069013
NM_025140,CCDC92,5,4,36210,1798,34412,8603,359.6,19.13904338
NM_001204298,ZNF664,5,4,42226,4277,37949,9487.25,855.4,8.872808043
NM_152437,ZNF664,5,4,42226,4329,37897,9474.25,865.8,8.754215754
NM_021009,UBC,2,1,3397,2586,811,811,1293,0.313611756
NM_080626,BRI3BP,3,2,32157,1275,30882,15441,425,24.22117647
NM_001286219,TMEM132B,5,4,39927,9664,30263,7565.75,1932.8,3.13151904
NM_145648,SLC15A4,8,7,30804,2797,28007,4001,349.625,10.01322846
NM_007197,FZD10,1,0,3283,3283,NA,NA,3283,NA
NM_001190971,PIWIL1,20,19,33494,2817,30677,1614.578947,140.85,10.88995385
NM_004764,PIWIL1,21,20,34446,3612,30834,1541.7,172,8.53654485
NM_001980,STX2,10,9,49676,3349,46327,5147.444444,334.9,13.8330845
NM_194356,STX2,11,10,49676,3476,46200,4620,316,13.29113924
NM_006325,RAN,7,6,4211,1078,3133,522.1666667,154,2.906307978
NM_016155,MMP17,10,9,23377,2418,20959,2328.777778,241.8,8.667907361
NM_025215,PUS1,6,5,14595,2020,12575,2515,336.6666667,6.225247525
NM_001002020,PUS1,6,5,14663,1672,12991,2598.2,278.6666667,7.769736842
NM_001002019,PUS1,6,5,14610,1643,12967,2593.4,273.8333333,7.892270237
NM_024078,NOC4L,15,14,7995,1647,6348,453.4285714,109.8,3.85428051
NM_175066,DDX51,15,14,7742,4732,3010,215,315.4666667,0.636094675
NM_021808,GALNT9,7,6,9658,1734,7924,1320.666667,247.7142857,4.569780854
NM_001142641,FBRSL1,17,16,94618,4564,90054,5628.375,268.4705882,19.73137599
NM_001282165,P2RX2,10,9,3608,1974,1634,181.5555556,197.4,0.827760892
NM_001282164,P2RX2,11,10,3608,1575,2033,203.3,143.1818182,1.290793651
NM_138575,PGAM5,6,5,8361,1200,7161,1432.2,200,5.9675
NM_001195520,LRCOL1,6,5,7303,880,6423,1284.6,146.6666667,7.298863636
NM_016318,P2RX2,10,9,3608,1805,1803,200.3333333,180.5,0.998891967
NM_012226,P2RX2,9,8,3608,1660,1948,243.5,184.4444444,1.173493976
NM_018663,PXMP2,5,4,17387,962,16425,4106.25,192.4,17.07380457
NM_006231,POLE,49,48,63764,8054,55710,1160.625,164.3673469,6.917059846
NM_001170544,PGAM5,6,5,11932,2852,9080,1816,475.3333333,3.183730715
NM_001170543,PGAM5,6,5,11932,2855,9077,1815.4,475.8333333,3.179334501
NM_170683,P2RX2,10,9,3608,1955,1653,183.6666667,195.5,0.845524297
NM_170682,P2RX2,11,10,3608,1878,1730,173,170.7272727,0.921192758
NM_174873,P2RX2,12,11,3608,1678,1930,175.4545455,139.8333333,1.150178784
NM_174872,P2RX2,9,8,3608,1600,2008,251,177.7777778,1.255
NM_005895,GOLGA3,24,23,59795,9276,50519,2196.478261,386.5,5.446205261
NM_001172557,GOLGA3,16,15,44974,3800,41174,2744.933333,237.5,10.83526316
NM_015114,ANKLE2,13,12,36199,4471,31728,2644,343.9230769,7.096399016
NM_001164715,ZNF605,5,4,34875,6190,28685,7171.25,1238,4.634087237
NM_183238,ZNF605,5,4,34851,6196,28655,7163.75,1239.2,4.624757908
NM_019591,ZNF26,4,3,26222,3186,23036,7678.666667,796.5,7.230382925
NM_003440,ZNF140,5,4,27223,3070,24153,6038.25,614,7.86742671
NM_001256280,ZNF26,3,2,26222,3089,23133,11566.5,1029.666667,7.488831337
NM_001256279,ZNF26,5,4,26222,3286,22936,5734,657.2,6.97991479
NM_001127372,ZNF84,5,4,26020,7053,18967,4741.75,1410.6,2.689210265
NM_003428,ZNF84,5,4,26020,7037,18983,4745.75,1407.4,2.697598408
NM_015394,ZNF10,5,4,28837,4408,24429,6107.25,881.6,5.541969147
NM_001277291,ZNF891,2,1,10506,2305,8201,8201,1152.5,3.55791757
NM_003415,ZNF268,6,5,25704,5761,19943,3988.6,960.1666667,3.461725395
NM_001165887,ZNF268,6,5,25704,5666,20038,4007.6,944.3333333,3.53653371
NM_001165886,ZNF268,4,3,25704,5431,20273,6757.666667,1357.75,3.73283005
NM_001165884,ZNF268,3,2,25704,5334,20370,10185,1778,3.818897638
NM_001165883,ZNF268,4,3,25704,5536,20168,6722.666667,1384,3.643063584
NM_001165882,ZNF268,6,5,25639,5644,19995,3999,940.6666667,3.542700213
NM_001165881,ZNF268,6,5,25639,5637,20002,4000.4,939.5,3.548341316
NM_001191054,ANHX,9,8,17526,1774,15752,1969,197.1111111,8.879368658
NM_152943,ZNF268,7,6,25704,5868,19836,3306,838.2857143,3.380368098
NM_001165885,ZNF268,5,4,25704,5633,20071,5017.75,1126.6,3.563110243
NM_203487,PCDH9,5,4,927504,6232,921272,230318,1246.4,147.8292683
NM_020403,PCDH9,4,3,927504,6129,921375,307125,1532.25,150.3303965
NM_002267,KPNA3,17,16,93616,4491,89125,5570.3125,264.1764706,19.84524605
NM_024561,NAA16,20,19,65827,4367,61460,3234.736842,218.35,14.07373483
NM_004466,GPC5,8,7,1468554,2888,1465666,209380.8571,361,507.5020776
NM_153251,ZDHHC20,12,11,86800,5352,81448,7404.363636,446,15.21823617
NM_001286638,ZDHHC20,11,10,86801,5328,81473,8147.3,484.3636364,15.29147898
NM_007106,UBL3,5,4,86277,4351,81926,20481.5,870.2,18.82923466
NM_006646,WASF3,10,9,131244,4844,126400,14044.44444,484.4,26.09413708
NM_016529,ATP8A2,37,36,649213,5043,644170,17893.61111,136.2972973,127.7354749
NM_015678,NBEA,58,57,730451,11178,719273,12618.82456,192.7241379,64.34719986
NM_004734,DCLK1,18,17,362727,8481,354246,20838,471.1666667,41.76936682
NM_001127615,ENOX1,17,16,415915,2675,413240,25827.5,157.3529412,154.482243
NM_001243799,TSC22D1,2,1,144424,4028,140396,140396,2014,34.8550149
NM_183422,TSC22D1,3,2,144424,6199,138225,69112.5,2066.333333,22.29795128
NM_020377,CYSLTR2,1,0,2549,2549,NA,NA,2549,NA
NM_017993,ENOX1,17,16,573452,3059,570393,35649.5625,179.9411765,186.4638771
NM_015116,LRCH1,19,18,191742,5495,186247,10347.05556,289.2105263,33.89390355
NM_001242863,ENOX1,17,16,573452,3033,570419,35651.1875,178.4117647,188.0708869
NM_001164213,LRCH1,19,18,199881,4736,195145,10841.38889,249.2631579,41.20460304
NM_001164211,LRCH1,20,19,191742,5601,186141,9796.894737,280.05,33.23352973
NM_182542,FAM194B,15,14,74444,2436,72008,5143.428571,162.4,29.55993432
NM_198989,DLEU7,2,1,131128,1182,129946,129946,591,109.9373942
NM_007249,KLF12,8,7,447919,10917,437002,62428.85714,1364.625,40.02949528
NM_080759,DACH1,11,10,429234,5250,423984,42398.4,477.2727273,80.75885714
NM_080760,DACH1,8,7,429234,4803,424431,60633,600.375,88.36789507
NM_006346,PIBF1,18,17,234363,3131,231232,13601.88235,173.9444444,73.85244331
NM_004392,DACH1,7,6,429234,4640,424594,70765.66667,662.8571429,91.50732759
NM_012158,FBXL3,5,4,21944,3554,18390,4597.5,710.8,5.174451322
NM_015296,DOCK9,56,55,292921,7578,285343,5188.054545,135.3214286,37.65413038
NM_001130050,DOCK9,33,32,117905,4129,113776,3555.5,125.1212121,27.55534028
NM_001130049,DOCK9,33,32,226227,4012,222215,6944.21875,121.5757576,55.38758724
NM_001130048,DOCK9,56,55,184599,7695,176904,3216.436364,137.4107143,22.98947368
NM_020121,UGGT2,39,38,251902,4968,246934,6498.263158,127.3846154,49.70491143
NM_005708,GPC6,9,8,1181197,7111,1174086,146760.75,790.1111111,165.1084236
NM_001080396,FAM155A,3,2,698583,3862,694721,347360.5,1287.333333,179.8863283
NM_052867,NALCN,44,43,362685,6967,355718,8272.511628,158.3409091,51.05755705
NM_175929,FGF14,5,4,680921,2836,678085,169521.25,567.2,239.0990832
NM_007111,TFDP1,12,11,56734,2663,54071,4915.545455,221.9166667,20.30454375
NM_001846,COL4A2,48,47,205744,6311,199433,4243.255319,131.4791667,31.60085565
NM_001190965,ZMYM2,25,24,132996,10178,122818,5117.416667,407.12,12.06700727
NM_199254,TPTE2,21,20,113886,1984,111902,5595.1,94.47619048,56.40221774
NM_130785,TPTE2,18,17,113886,1750,112136,6596.235294,97.22222222,64.07771429
NM_001190964,ZMYM2,26,25,133122,10164,122958,4918.32,390.9230769,12.0974026
NM_003453,ZMYM2,26,25,133160,10272,122888,4915.52,395.0769231,11.96339564
NM_197968,ZMYM2,25,24,133160,10224,122936,5122.333333,408.96,12.02425665
NM_001141968,TPTE2,19,18,113886,1841,112045,6224.722222,96.89473684,60.86094514
NM_001042414,PSPC1,10,9,80152,2025,78127,8680.777778,202.5,38.58123457
NM_014572,LATS2,8,7,88548,5550,82998,11856.85714,693.75,14.95459459
NM_006531,IFT88,26,25,124370,2957,121413,4856.52,113.7307692,41.05951978
NM_022459,XPO4,23,22,125447,9908,115539,5251.772727,430.7826087,11.66118288
NM_175605,IFT88,28,27,124370,3188,121182,4488.222222,113.8571429,38.0119197
NM_152726,MICU2,12,11,111529,1945,109584,9962.181818,162.0833333,56.34138817
NM_000231,SGCG,8,7,144246,1663,142583,20369,207.875,85.73842453
NM_014363,SACS,10,9,104907,15678,89229,9914.333333,1567.8,5.691350938
NM_001204459,TNFRSF19,8,7,105737,4286,101451,14493,535.75,23.67032198
NM_001204458,TNFRSF19,10,9,96747,4193,92554,10283.77778,419.3,22.07345576
NM_148957,TNFRSF19,10,9,105737,4502,101235,11248.33333,450.2,22.48667259
NM_153023,SPATA13,12,11,146359,6711,139648,12695.27273,559.25,20.80882134
NM_006437,PARP4,34,33,91881,5503,86378,2617.515152,161.8529412,15.69652917
NM_005932,MIPEP,19,18,159261,2448,156813,8711.833333,128.8421053,64.05759804
NM_001166271,SPATA13,13,12,146359,8476,137883,11490.25,652,16.26746107
NM_001286792,SPATA13,15,14,327449,8802,318647,22760.5,586.8,36.20165871
NM_001184993,RNF17,36,35,115759,5131,110628,3160.8,142.5277778,21.56070941
NM_031277,RNF17,36,35,115759,5143,110616,3160.457143,142.8611111,21.50806922
NM_004685,MTMR6,14,13,41365,5228,36137,2779.769231,373.4285714,6.91220352
NM_001260,CDK8,13,12,149815,1782,148033,12336.08333,137.0769231,83.07126824
NM_182488,USP12,9,8,105748,4512,101236,12654.5,501.3333333,22.43705674
NM_153371,LNX2,10,9,74672,4814,69858,7762,481.4,14.51142501
NM_001159920,FLT1,13,12,109579,6512,103067,8588.916667,500.9230769,15.82724201
NM_002019,FLT1,30,29,194784,7153,187631,6470.034483,238.4333333,26.23109185
NM_001160030,FLT1,15,14,127033,2983,124050,8860.714286,198.8666667,41.58565203
NM_175854,PAN3,19,18,156834,5651,151183,8399.055556,297.4210526,26.753318
NM_003045,SLC7A1,13,12,86276,7356,78920,6576.666667,565.8461538,10.72865688
NM_015233,MTUS2,9,8,77309,4000,73309,9163.625,444.4444444,18.32725
NM_001033602,MTUS2,14,13,481338,6953,474385,36491.15385,496.6428571,68.22738386
NM_001014380,KATNAL1,11,10,104426,7523,96903,9690.3,683.9090909,12.88089858
NM_032116,KATNAL1,11,10,104859,7565,97294,9729.4,687.7272727,12.86107072
NM_005800,USPL1,9,8,41858,3913,37945,4743.125,434.7777778,9.697163302
NM_001629,ALOX5AP,5,4,28922,911,28011,7002.75,182.2,30.74753019
NM_001204406,ALOX5AP,6,5,50952,1233,49719,9943.8,205.5,40.32360097
NM_194318,B3GALTL,15,14,132301,4228,128073,9148.071429,281.8666667,30.29162725
NM_001166058,RXFP2,17,16,63332,2748,60584,3786.5,161.6470588,22.04657933
NM_006644,HSPH1,18,17,27049,5378,21671,1274.764706,298.7777778,4.029564894
NM_001286505,HSPH1,16,15,27416,5003,22413,1494.2,312.6875,4.479912053
NM_130806,RXFP2,18,17,63332,2821,60511,3559.470588,156.7222222,21.45019497
NM_001286504,HSPH1,18,17,27416,5239,22177,1304.529412,291.0555556,4.233059744
NM_001286503,HSPH1,17,16,27049,5245,21804,1362.75,308.5294118,4.157102002
NM_001278432,N4BP2L2,10,9,106399,2928,103471,11496.77778,292.8,35.33845628
NM_015032,PDS5B,35,34,191596,7533,184063,5413.617647,215.2285714,24.43422275
NM_033111,N4BP2L2,10,9,106399,2883,103516,11501.77778,288.3,35.90565383
NM_023037,FRY,61,60,265341,10778,254563,4242.716667,176.6885246,23.61876044
NM_000059,BRCA2,27,26,84194,11413,72781,2799.269231,422.7037037,6.377026198
NM_001243476,STARD13,18,17,573662,6251,567411,33377.11765,347.2777778,90.7712366
NM_052851,STARD13,14,13,102917,5877,97040,7464.615385,419.7857143,16.51182576
NM_178006,STARD13,14,13,182631,5940,176691,13591.61538,424.2857143,29.7459596
NM_178007,STARD13,14,13,82946,5847,77099,5930.692308,417.6428571,13.18607833
NM_181558,RFC3,9,8,148491,1470,147021,18377.625,163.3333333,100.0142857
NM_001204197,NBEA,18,17,195990,4109,191881,11287.11765,228.2777778,46.69773668
NM_001014286,SUPT20H,26,25,50401,2972,47429,1897.16,114.3076923,15.95861373
NM_001278482,SUPT20H,25,24,50175,3008,47167,1965.291667,120.32,15.68051862
NM_001278481,SUPT20H,25,24,50401,2870,47531,1980.458333,114.8,16.56132404
NM_001278480,SUPT20H,25,24,50401,3104,47297,1970.708333,124.16,15.23743557
NM_001198908,CCDC169,8,7,70815,1029,69786,9969.428571,128.625,67.81924198
NM_001198910,CCDC169-SOHLH2,16,15,129649,2666,126983,8465.533333,166.625,47.63053263
NM_005905,SMAD9,6,5,75443,5487,69956,13991.2,914.5,12.74940769
NM_017569,SUPT20H,25,24,50401,2949,47452,1977.166667,117.96,16.09087826
NM_001144983,CCDC169,7,6,70815,944,69871,11645.16667,134.8571429,74.01588983
NM_001144982,CCDC169,7,6,70815,948,69867,11644.5,135.4285714,73.69936709
NM_001144981,CCDC169,8,7,67082,1207,65875,9410.714286,150.875,54.57746479
NM_001127217,SMAD9,7,6,75443,5599,69844,11640.66667,799.8571429,12.47437042
NM_001144986,CCDC169,7,6,67082,1122,65960,10993.33333,160.2857143,58.78787879
NM_001144985,CCDC169,7,6,67082,1126,65956,10992.66667,160.8571429,58.57548845
NM_001144984,CCDC169,6,5,70815,906,69909,13981.8,151,77.16225166
NM_006475,POSTN,23,22,36264,3403,32861,1493.681818,147.9565217,9.656479577
NM_016179,TRPC4,11,10,233168,3447,229721,22972.1,313.3636364,66.64374819
NM_003306,TRPC4,11,10,233168,3462,229706,22970.6,314.7272727,66.35066436
NM_001135957,TRPC4,11,10,233168,3024,230144,23014.4,274.9090909,76.10582011
NM_001135958,TRPC4,10,9,233168,2927,230241,25582.33333,292.7,78.66108644
NM_001135956,TRPC4,11,10,233168,3000,230168,23016.8,272.7272727,76.72266667
NM_001135955,TRPC4,12,11,233168,3196,229972,20906.54545,266.3333333,71.95619524
NM_001135936,POSTN,20,19,36264,3145,33119,1743.105263,157.25,10.53068362
NM_001135935,POSTN,21,20,36264,3236,33028,1651.4,154.0952381,10.20642769
NM_001135934,POSTN,21,20,36264,3230,33034,1651.7,153.8095238,10.22724458
NM_001286667,POSTN,19,18,36264,3054,33210,1845,160.7368421,10.87426326
NM_001286666,POSTN,20,19,36264,3139,33125,1743.421053,156.95,10.5527238
NM_001286665,POSTN,22,21,36264,3321,32943,1568.714286,150.9545455,9.919602529
NM_001286704,UFM1,6,5,13238,2814,10424,2084.8,469,3.704335466
NM_001286705,UFM1,7,6,13238,2679,10559,1759.833333,382.7142857,3.941396043
NM_207361,FREM2,24,23,200096,16186,183910,7996.086957,674.4166667,11.3622884
NM_001286703,UFM1,6,5,13238,2636,10602,2120.4,439.3333333,4.022003035
NM_001286706,UFM1,6,5,13238,3312,9926,1985.2,552,2.996980676
NM_016617,UFM1,6,5,13238,2642,10596,2119.2,440.3333333,4.010598032
NM_005780,LHFP,4,3,260329,2162,258167,86055.66667,540.5,119.4111933
NM_020751,COG6,19,18,97003,3628,93375,5187.5,190.9473684,25.73732084
NM_001145079,COG6,19,18,136040,5276,130764,7264.666667,277.6842105,24.78468537
NM_002015,FOXO1,3,2,110935,5741,105194,52597,1913.666667,18.32328863
NM_001145353,ELF1,8,7,50365,3530,46835,6690.714286,441.25,13.26770538
NM_004294,MTRF1,10,9,47199,2184,45015,5001.666667,218.4,20.61126374
NM_172373,ELF1,9,8,87455,3748,83707,10463.375,416.4444444,22.33377801
NM_152910,DGKH,29,28,181050,4195,176855,6316.25,144.6551724,42.15852205
NM_016248,AKAP11,13,12,51116,9933,41183,3431.916667,764.0769231,4.146078727
NM_015058,VWA8,45,44,394262,7205,387057,8796.75,160.1111111,53.72061069
NM_001204506,DGKH,28,27,91715,3982,87733,3249.37037,142.2142857,22.03239578
NM_001204505,DGKH,29,28,91715,4031,87684,3131.571429,139,21.75241875
NM_001204504,DGKH,30,29,189721,4232,185489,6396.172414,141.0666667,43.83010397
NM_178009,DGKH,30,29,181050,4327,176723,6093.896552,144.2333333,40.84192281
NM_001009814,VWA8,26,25,241750,3466,238284,9531.36,133.3076923,68.74899019
NM_013238,DNAJC15,6,5,85946,2782,83164,16632.8,463.6666667,29.89360173
NM_033255,EPSTI1,11,10,105885,3147,102738,10273.8,286.0909091,32.64632984
NM_001002264,EPSTI1,13,12,105885,3214,102671,8555.916667,247.2307692,31.94492844
NM_001010897,SERP2,3,2,23874,787,23087,11543.5,262.3333333,29.33545108
NM_144974,CCDC122,7,6,43339,2015,41324,6887.333333,287.8571429,20.50818859
NM_004128,GTF2F2,8,7,163610,1461,162149,23164.14286,182.625,110.9849418
NM_025113,KIAA0226L,15,14,45502,3994,41508,2964.857143,266.2666667,10.39258888
NM_198849,SIAH3,2,1,71432,3996,67436,67436,1998,16.87587588
NM_001278541,CPB2,10,9,51891,1665,50226,5580.666667,166.5,30.16576577
NM_001872,CPB2,11,10,51891,1777,50114,5011.4,161.5454545,28.20146314
NM_001282460,LRRC63,10,9,64862,2124,62738,6970.888889,212.4,29.53766478
NM_001286761,KIAA0226L,15,14,48044,3972,44072,3148,264.8,11.09566969
NM_001286766,KIAA0226L,13,12,45502,3219,42283,3523.583333,247.6153846,13.13544579
NM_001286765,KIAA0226L,14,13,45502,3336,42166,3243.538462,238.2857143,12.63968825
NM_001286763,KIAA0226L,15,14,45502,3607,41895,2992.5,240.4666667,11.61491544
NM_001286764,KIAA0226L,14,13,45502,3490,42012,3231.692308,249.2857143,12.03782235
NM_001286762,KIAA0226L,13,12,45502,3722,41780,3481.666667,286.3076923,11.22514777
NM_001165947,HTR2A,3,2,65536,4705,60831,30415.5,1568.333333,12.92901169
NM_000621,HTR2A,4,3,65536,5446,60090,20030,1361.5,11.03378627
NM_000321,RB1,27,26,178145,4799,173346,6667.153846,177.7407407,36.12127527
NM_001079670,CAB39L,11,10,135478,3575,131903,13190.3,325,36.89594406
NM_001278438,FNDC3A,26,25,233172,6355,226817,9072.68,244.4230769,35.69110936
NM_030925,CAB39L,9,8,92890,3624,89266,11158.25,402.6666667,24.63189845
NM_001079673,FNDC3A,26,25,233869,6312,227557,9102.28,242.7692308,36.05148923
NM_001287339,CAB39L,10,9,105103,3376,101727,11303,337.6,30.13240521
NM_001287338,CAB39L,12,11,105103,3709,101394,9217.636364,309.0833333,27.33728768
NM_001287337,CAB39L,12,11,135478,3714,131764,11978.54545,309.5,35.47765213
NM_199464,KCNRG,3,2,5670,1628,4042,2021,542.6666667,2.482800983
NM_173605,KCNRG,2,1,5670,1529,4141,4141,764.5,2.708306082
NM_024570,RNASEH2B,11,10,47089,1640,45449,4544.9,149.0909091,27.71280488
NM_001142279,RNASEH2B,10,9,60784,1679,59105,6567.222222,167.9,35.20250149
NM_052950,WDFY2,12,11,177689,3821,173868,15806.18182,318.4166667,45.50327139
NM_199289,NEK5,22,21,64316,2932,61384,2923.047619,133.2727273,20.93587995
NM_199263,THSD1,4,3,29328,3192,26136,8712,798,8.187969925
NM_001011724,HNRNPA1L2,7,6,26316,2372,23944,3990.666667,338.8571429,10.09443508
NM_001011725,HNRNPA1L2,6,5,26316,2230,24086,4817.2,371.6666667,10.80089686
NM_000053,ATP7B,21,20,78826,6662,72164,3608.2,317.2380952,10.83218253
NM_001243182,ATP7B,22,21,78826,6330,72496,3452.190476,287.7272727,11.45276461
NM_018676,THSD1,5,4,29328,3352,25976,6494,670.4,7.749403341
NM_001005918,ATP7B,17,16,78826,6037,72789,4549.3125,355.1176471,12.05714759
NM_006418,OLFM4,5,4,23322,2924,20398,5099.5,584.8,6.976060192
NM_030932,DIAPH3,21,20,239048,2756,236292,11814.6,131.2380952,85.73730044
NM_001042517,DIAPH3,28,27,498398,4824,493574,18280.51852,172.2857143,102.316335
NM_001258370,DIAPH3,16,15,151957,2296,149661,9977.4,143.5,65.18336237
NM_001258369,DIAPH3,27,26,389824,3591,386233,14855.11538,133,107.555834
NM_001258368,DIAPH3,26,25,498400,4614,493786,19751.44,177.4615385,107.0190724
NM_001258367,DIAPH3,26,25,498400,4686,493714,19748.56,180.2307692,105.3593683
NM_001258366,DIAPH3,27,26,498400,4792,493608,18984.92308,177.4814815,103.0066778
NM_001146071,TDRD3,14,13,177424,3034,174390,13414.61538,216.7142857,57.47857614
NM_030794,TDRD3,14,13,177424,3031,174393,13414.84615,216.5,57.53645661
NM_001146070,TDRD3,14,13,176588,2594,173994,13384.15385,185.2857143,67.07555898
NM_020866,KLHL1,11,10,407902,4161,403741,40374.1,378.2727273,97.02980053
NM_001286725,KLHL1,10,9,407902,3977,403925,44880.55556,397.7,101.5652502
NM_015842,LMO7,27,26,99211,6802,92409,3554.192308,251.9259259,13.58556307
NM_005358,LMO7,30,29,239438,7267,232171,8005.896552,242.2333333,31.94867208
NM_001286658,TBC1D4,20,19,197452,6368,191084,10057.05263,318.4,30.00690955
NM_001270952,UCHL3,9,8,56542,1059,55483,6935.375,117.6666667,52.39187913
NM_001286659,TBC1D4,19,18,197452,6202,191250,10625,326.4210526,30.83682683
NM_006002,UCHL3,9,8,56272,981,55291,6911.375,109,56.36187564
NM_014832,TBC1D4,21,20,197452,6393,191059,9552.95,304.4285714,29.88565619
NM_001160706,SCEL,31,30,109591,3131,106460,3548.666667,101,34.00191632
NM_015057,MYCBP2,83,82,282387,15108,267279,3259.5,182.0240964,17.69122319
NM_000115,EDNRB,8,7,80050,4290,75760,10822.85714,536.25,17.65967366
NM_144777,SCEL,33,32,109591,3259,106332,3322.875,98.75757576,32.62718625
NM_003843,SCEL,32,31,109591,3198,106393,3432.032258,99.9375,33.26860538
NM_001161407,NDFIP2,8,7,74955,4603,70352,10050.28571,575.375,15.28394525
NM_019080,NDFIP2,8,7,74955,4663,70292,10041.71429,582.875,15.07441561
NM_022118,RBM26,21,20,87355,5164,82191,4109.55,245.9047619,15.91615027
NM_001286632,RBM26,21,20,87355,5173,82182,4109.1,246.3333333,15.88671951
NM_001286631,RBM26,22,21,87355,5252,82103,3909.666667,238.7272727,15.63271135
NM_182848,CLDN10,5,4,146159,2663,143496,35874,532.6,53.885092
NM_006984,CLDN10,5,4,27065,2495,24570,6142.5,499,9.847695391
NM_005845,ABCC4,31,30,281606,5874,275732,9191.066667,189.483871,46.94109636
NM_001160100,CLDN10,5,4,146159,2606,143553,35888.25,521.2,55.08557176
NM_006260,DNAJC3,12,11,117852,5603,112249,10204.45455,466.9166667,20.03373193
NM_001105515,ABCC4,21,20,205664,3084,202580,10129,146.8571429,65.68741894
NM_153456,HS6ST3,2,1,748725,7806,740919,740919,3903,94.91660261
NM_144778,MBNL2,9,8,171826,4737,167089,20886.125,526.3333333,35.27316867
NM_207304,MBNL2,7,6,171826,4604,167222,27870.33333,657.7142857,36.3210252
NM_001286839,FARP1,28,27,307213,4954,302259,11194.77778,176.9285714,61.01312071
NM_178861,RNF113B,2,1,1484,1380,104,104,690,0.075362319
NM_001032296,STK24,11,10,126954,4646,122308,12230.8,422.3636364,26.32544124
NM_005073,SLC15A1,23,22,68876,3150,65726,2987.545455,136.9565217,20.86539683
NM_005766,FARP1,27,26,306677,5039,301638,11601.46154,186.6296296,59.86068664
NM_001286649,STK24,10,9,126954,4588,122366,13596.22222,458.8,26.67088056
NM_001001715,FARP1,3,2,102208,1406,100802,50401,468.6666667,71.69416785
NM_001144072,UBAC2,9,8,186076,2692,183384,22923,299.1111111,68.1218425
NM_177967,UBAC2,7,6,185592,2604,182988,30498,372,70.2718894
NM_206808,CLYBL,9,8,286102,1410,284692,35586.5,156.6666667,201.9092199
NM_001079669,TMTC4,18,17,71101,3648,67453,3967.823529,202.6666667,18.4904057
NM_001127692,PCCA,23,22,441424,2509,438915,19950.68182,109.0869565,174.9362296
NM_000282,PCCA,24,23,441424,2588,438836,19079.82609,107.8333333,169.5656878
NM_001195087,GGACT,3,2,58630,2666,55964,27982,888.6666667,20.99174794
NM_032813,TMTC4,19,18,71101,3859,67242,3735.666667,203.1052632,17.42472143
NM_001178004,PCCA,23,22,441424,2446,438978,19953.54545,106.3478261,179.4677024
NM_001286453,TMTC4,16,15,71101,3313,67788,4519.2,207.0625,20.4612134
NM_001271755,ITGBL1,10,9,263854,2381,261473,29052.55556,238.1,109.8164637
NM_001271754,ITGBL1,11,10,268265,4894,263371,26337.1,444.9090909,53.81507969
NM_001271756,ITGBL1,10,9,226495,2020,224475,24941.66667,202,111.1262376
NM_004791,ITGBL1,11,10,263854,2529,261325,26132.5,229.9090909,103.3313563
NM_004115,FGF14,5,4,195792,2725,193067,48266.75,545,70.85027523
NM_003291,TPP2,29,28,82239,4739,77500,2767.857143,163.4137931,16.35366111
NM_018011,ARGLU1,4,3,24854,1755,23099,7699.666667,438.75,13.16182336
NM_001198950,MYO16,35,34,578786,7471,571315,16803.38235,213.4571429,76.47102128
NM_015011,MYO16,35,34,611857,6909,604948,17792.58824,197.4,87.55941526
NM_001845,COL4A1,52,51,158188,6584,151604,2972.627451,126.6153846,23.02612394
NM_001242882,CARKD,10,9,24537,2609,21928,2436.444444,260.9,8.404752779
NM_001242881,CARKD,10,9,24413,2612,21801,2422.333333,261.2,8.346477795
NM_001113512,ARHGEF7,18,17,179920,5393,174527,10266.29412,299.6111111,32.36176525
NM_001113511,ARHGEF7,20,19,179920,5545,174375,9177.631579,277.25,31.44724977
NM_001113513,ARHGEF7,20,19,118910,4966,113944,5997.052632,248.3,22.94482481
NM_145735,ARHGEF7,19,18,179920,5481,174439,9691.055556,288.4736842,31.82612662
NM_017664,ANKRD10,6,5,36569,2539,34030,6806,423.1666667,13.40291453
NM_001242883,CARKD,7,6,24537,2320,22217,3702.833333,331.4285714,9.576293103
NM_018210,CARKD,10,9,24413,2748,21665,2407.222222,274.8,7.883915575
NM_003899,ARHGEF7,20,19,152022,5079,146943,7733.842105,253.95,28.93148258
NM_005986,SOX1,1,0,4109,4109,NA,NA,4109,NA
NM_001278514,CUL4A,20,19,56386,3731,52655,2771.315789,186.55,14.11283838
NM_001278513,CUL4A,20,19,56887,4063,52824,2780.210526,203.15,13.00123062
NM_001008895,CUL4A,20,19,55575,3919,51656,2718.736842,195.95,13.1809135
NM_000131,F7,9,8,14895,3137,11758,1469.75,348.5555556,3.748167039
NM_032189,ATP11A,29,28,196841,8797,188044,6715.857143,303.3448276,21.37592361
NM_003589,CUL4A,20,19,56308,3745,52563,2766.473684,187.25,14.03551402
NM_019616,F7,8,7,14895,3070,11825,1689.285714,383.75,3.851791531
NM_017905,TMCO3,13,12,59238,3099,56139,4678.25,238.3846154,18.11519845
NM_015205,ATP11A,30,29,196841,8825,188016,6483.310345,294.1666667,21.30492918
NM_001267554,F7,6,5,14895,2882,12013,2402.6,480.3333333,4.168285913
NM_001112732,MCF2L,30,29,130520,6447,124073,4278.37931,214.9,19.24507523
NM_032436,CHAMP1,3,2,12840,3821,9019,4509.5,1273.666667,2.360376865
NM_007368,RASA3,24,23,150903,4224,146679,6377.347826,176,34.72514205
NM_002929,GRK1,7,6,117042,2105,114937,19156.16667,300.7142857,54.60190024
NM_000820,GAS6,15,14,43526,2520,41006,2929,168,16.27222222
NM_001164145,CHAMP1,3,2,12840,3782,9058,4529,1260.666667,2.395029085
NM_001164144,CHAMP1,3,2,12840,3818,9022,4511,1272.666667,2.363017287
NM_006001,TUBA3C,5,4,8084,1556,6528,1632,311.2,4.195372751
NM_001271850,TPTE2,7,6,15598,1108,14490,2415,158.2857143,13.07761733
NM_017520,MPHOSPH8,14,13,39813,4282,35531,2733.153846,305.8571429,8.297758057
NM_001142684,ZMYM5,8,7,40154,3276,36878,5268.285714,409.5,11.25702076
NM_001039649,ZMYM5,5,4,26185,1225,24960,6240,245,20.3755102
NM_001039650,ZMYM5,6,5,26185,1512,24673,4934.6,252,16.31812169
NM_021954,GJA3,2,1,22790,5207,17583,17583,2603.5,3.376800461
NM_001110219,GJB6,5,4,10435,2145,8290,2072.5,429,3.864801865
NM_006783,GJB6,3,2,9273,2075,7198,3599,691.6666667,3.468915663
NM_004004,GJB2,2,1,5512,2334,3178,3178,1167,1.361610968
NM_001110221,GJB6,3,2,10435,1909,8526,4263,636.3333333,4.466212677
NM_001110220,GJB6,4,3,10435,2034,8401,2800.333333,508.5,4.130285152
NM_015974,CRYL1,8,7,122208,1509,120699,17242.71429,188.625,79.9860835
NM_174928,N6AMT2,5,4,44986,877,44109,11027.25,175.4,50.29532497
NM_138284,IL17D,3,2,19757,1864,17893,8946.5,621.3333333,9.599248927
NM_024026,MRPL57,2,1,2850,2657,193,193,1328.5,0.072638314
NM_001166017,SKA3,8,7,23009,2808,20201,2885.857143,351,7.194088319
NM_145061,SKA3,9,8,23009,2928,20081,2510.125,325.3333333,6.858265027
NM_005870,SAP18,4,3,8573,2305,6268,2089.333333,576.25,2.719305857
NM_002010,FGF9,3,2,33427,4533,28894,14447,1511,6.374145158
NM_001278055,SACS,8,7,46722,15145,31577,4511,1893.125,2.084978541
NM_018647,TNFRSF19,9,8,89915,1634,88281,11035.125,181.5555556,54.02753978
NM_001014442,C1QTNF9B-AS1,4,3,3216,808,2408,802.6666667,202,2.98019802
NM_001135816,C1QTNF9B-AS1,4,3,2652,705,1947,649,176.25,2.761702128
NM_001007537,C1QTNF9B,3,2,5909,1215,4694,2347,405,3.863374486
NM_178540,C1QTNF9,4,3,12955,1830,11125,3708.333333,457.5,6.079234973
NM_001286794,SPATA13,11,10,36389,6416,29973,2997.3,583.2727273,4.671602244
NM_001286795,SPATA13,10,9,36389,6207,30182,3353.555556,620.7,4.862574513
NM_001286793,SPATA13,9,8,36389,6020,30369,3796.125,668.8888889,5.044684385
NM_001185085,ATP12A,23,22,31376,3757,27619,1255.409091,163.3478261,7.351344158
NM_001676,ATP12A,23,22,31376,3739,27637,1256.227273,162.5652174,7.391548542
NM_018451,CENPJ,17,16,40617,5132,35485,2217.8125,301.8823529,6.914458301
NM_030979,PABPC3,1,0,2430,2430,NA,NA,2430,NA
NM_199138,AMER2,3,2,10490,9942,548,274,3314,0.055119694
NM_152704,AMER2,1,0,10606,10606,NA,NA,10606,NA
NM_001008564,NUPL1,15,14,40897,4314,36583,2613.071429,287.6,8.480064905
NM_014089,NUPL1,16,15,40897,4351,36546,2436.4,271.9375,8.399448403
NM_001007538,SHISA2,2,1,6465,2891,3574,3574,1445.5,1.236250432
NM_183043,RNF6,5,4,9125,3330,5795,1448.75,666,1.74024024
NM_183044,RNF6,5,4,8991,3464,5527,1381.75,692.8,1.595554273
NM_005977,RNF6,5,4,9605,3589,6016,1504,717.8,1.676232934
NM_005288,GPR12,2,1,5585,4850,735,735,2425,0.151546392
NM_000982,RPL21,6,5,5012,572,4440,888,95.33333333,7.762237762
NM_206827,RASL11A,4,3,3365,1547,1818,606,386.75,1.175177763
NM_002097,GTF3A,9,8,11167,1413,9754,1219.25,157,6.903043171
NM_152912,MTIF3,5,4,14965,1042,13923,3480.75,208.4,13.36180422
NM_001166263,MTIF3,6,5,14965,1104,13861,2772.2,184,12.55525362
NM_001166262,MTIF3,5,4,14552,1074,13478,3369.5,214.8,12.54934823
NM_001166261,MTIF3,5,4,14560,1004,13556,3389,200.8,13.50199203
NM_015972,POLR1D,2,1,1676,812,864,864,406,1.064039409
NM_152705,POLR1D,3,2,45645,2046,43599,21799.5,682,21.30938416
NM_001206559,POLR1D,3,2,46681,2213,44468,22234,737.6666667,20.09399006
NM_145657,GSX1,2,1,1311,849,462,462,424.5,0.544169611
NM_000209,PDX1,2,1,6285,2575,3710,3710,1287.5,1.440776699
NM_001265,CDX2,3,2,7302,2354,4948,2474,784.6666667,2.101954121
NM_001105577,URAD,2,1,10533,524,10009,10009,262,19.10114504
NM_004119,FLT3,24,23,97320,3866,93454,4063.217391,161.0833333,24.17330574
NM_001160031,FLT1,12,11,96086,1923,94163,8560.272727,160.25,48.96671867
NM_015932,POMP,6,5,19954,1467,18487,3697.4,244.5,12.60190866
NM_001135919,SLC46A3,7,6,18934,2807,16127,2687.833333,401,5.745279658
NM_181785,SLC46A3,6,5,18934,3350,15584,3116.8,558.3333333,4.651940299
NM_002128,HMGB1,5,4,7204,3431,3773,943.25,686.2,1.099679394
NM_032849,MEDAG,5,4,19399,2395,17004,4251,479,7.099791232
NM_152325,TEX26,7,6,42321,1005,41316,6886,143.5714286,41.11044776
NM_001136571,ZAR1L,4,3,8185,1107,7078,2359.333333,276.75,6.393857272
NM_001286459,N4BP2L1,6,5,27457,2047,25410,5082,341.1666667,12.41328774
NM_001079691,N4BP2L1,5,4,27457,3044,24413,6103.25,608.8,8.020039422
NM_052818,N4BP2L1,5,4,27457,3052,24405,6101.25,610.4,7.996395806
NM_001286461,N4BP2L1,6,5,27457,1805,25652,5130.4,300.8333333,14.21163435
NM_001286460,N4BP2L1,6,5,27457,1797,25660,5132,299.5,14.27935448
NM_014887,N4BP2L2,6,5,21904,2845,19059,3811.8,474.1666667,6.699121265
NM_004795,KL,5,4,49713,5011,44702,11175.5,1002.2,8.920774297
NM_001243466,STARD13,8,7,68533,2817,65716,9388,352.125,23.32836351
NM_001243474,STARD13,8,7,88504,2869,85635,12233.57143,358.625,29.84837923
NM_002915,RFC3,9,8,19440,2402,17038,2129.75,266.8888889,7.09325562
NM_005584,MAB21L1,1,0,2908,2908,NA,NA,2908,NA
NM_001195430,DCLK1,3,2,9963,5327,4636,2318,1775.666667,0.870283462
NM_001195416,DCLK1,13,12,87211,7531,79680,6640,579.3076923,10.58026822
NM_001195415,DCLK1,14,13,87211,7606,79605,6123.461538,543.2857143,10.46607941
NM_001282147,SOHLH2,7,6,32625,1943,30682,5113.666667,277.5714286,15.79104478
NM_017826,SOHLH2,11,10,46409,2204,44205,4420.5,200.3636364,20.05671506
NM_015087,SPG20,9,8,44873,5024,39849,4981.125,558.2222222,7.931727707
NM_001142294,SPG20,9,8,68544,4831,63713,7964.125,536.7777778,13.1883668
NM_001142296,SPG20,10,9,44873,5008,39865,4429.444444,500.8,7.960263578
NM_001142295,SPG20,9,8,45161,4955,40206,5025.75,550.5555556,8.114228052
NM_001111045,CCNA1,9,8,10612,1971,8641,1080.125,219,4.384069001
NM_001111047,CCNA1,9,8,11054,1850,9204,1150.5,205.5555556,4.975135135
NM_001111046,CCNA1,9,8,11054,1853,9201,1150.125,205.8888889,4.965461414
NM_003914,CCNA1,9,8,10612,1974,8638,1079.75,219.3333333,4.375886525
NM_203451,SERTM1,2,1,23928,3208,20720,20720,1604,6.458852868
NM_000538,RFXAP,3,2,10403,2828,7575,3787.5,942.6666667,2.678571429
NM_013338,ALG5,10,9,49598,1223,48375,5375,122.3,39.55437449
NM_181503,EXOSC8,11,10,9075,1422,7653,765.3,129.2727273,5.38185654
NM_001142364,ALG5,9,8,49598,1132,48466,6058.25,125.7777778,42.81448763
NM_145203,CSNK1A1L,1,0,2406,2406,NA,NA,2406,NA
NM_145286,STOML3,7,6,24936,1921,23015,3835.833333,274.4285714,11.9807392
NM_001144033,STOML3,8,7,24936,2006,22930,3275.714286,250.75,11.43070788
NM_025138,PROSER1,13,12,28213,5182,23031,1919.25,398.6153846,4.444423003
NM_001012754,NHLRC3,7,6,11798,3561,8237,1372.833333,508.7142857,2.313114294
NM_001017370,NHLRC3,6,5,11798,3359,8439,1687.8,559.8333333,2.512354868
NM_005830,MRPS31,7,6,41917,1346,40571,6761.833333,192.2857143,30.14190193
NM_014252,SLC25A15,7,6,23051,4028,19023,3170.5,575.4285714,4.722691162
NM_007187,WBP4,10,9,22444,2343,20101,2233.444444,234.3,8.579172002
NM_032138,KBTBD7,1,0,2993,2993,NA,NA,2993,NA
NM_152903,KBTBD6,1,0,5229,5229,NA,NA,5229,NA
NM_018527,NAA16,10,9,47515,1729,45786,5087.333333,172.9,26.48120301
NM_001110798,NAA16,11,10,47515,1837,45678,4567.8,167,24.86554164
NM_014059,RGCC,5,4,13473,1113,12360,3090,222.6,11.10512129
NM_033012,TNFSF11,7,6,45279,2366,42913,7152.166667,338,18.13736264
NM_003701,TNFSF11,5,4,33860,2203,31657,7914.25,440.6,14.36995007
NM_182508,FAM216B,4,3,10001,3306,6695,2231.666667,826.5,2.025105868
NM_001128303,LACC1,7,6,14650,4270,10380,1730,610,2.430913349
NM_153218,LACC1,7,6,14101,4106,9995,1665.833333,586.5714286,2.434242572
NM_024058,SMIM2,3,2,18108,1217,16891,8445.5,405.6666667,13.87921118
NM_006022,TSC22D1,3,2,4783,3217,1566,783,1072.333333,0.486788934
NM_001243798,TSC22D1,3,2,42160,2880,39280,19640,960,13.63888889
NM_001243797,TSC22D1,3,2,5113,2875,2238,1119,958.3333333,0.778434783
NM_012345,NUFIP1,10,9,50231,3497,46734,5192.666667,349.7,13.36402631
NM_018559,GPALPP1,8,7,38719,1400,37319,5331.285714,175,26.65642857
NM_198404,KCTD4,2,1,8189,2121,6068,6068,1060.5,2.860914663
NM_001010875,SLC25A30,10,9,25138,3752,21386,2376.222222,375.2,5.69989339
NM_001286273,TPT1,5,4,7815,4580,3235,808.75,916,0.706331878
NM_001286272,TPT1,6,5,7815,4820,2995,599,803.3333333,0.621369295
NM_001286807,SLC25A30,10,9,25138,3810,21328,2369.777778,381,5.597900262
NM_003295,TPT1,6,5,7815,4655,3160,632,775.8333333,0.678839957
NM_001286806,SLC25A30,9,8,25138,3632,21506,2688.25,403.5555556,5.921255507
NM_031431,COG3,23,22,71805,4619,67186,3053.909091,200.826087,14.54557263
NM_001286342,SPERT,3,2,12092,1509,10583,5291.5,503,7.01325381
NM_001286341,SPERT,2,1,12257,1542,10715,10715,771,6.948767834
NM_152719,SPERT,3,2,12257,1624,10633,5316.5,541.3333333,6.547413793
NM_015070,ZC3H13,17,16,90584,6428,84156,5259.75,378.1176471,13.09209708
NM_002298,LCP1,16,15,56403,3806,52597,3506.466667,237.875,13.81949553
NM_001984,ESD,10,9,25978,1202,24776,2752.888889,120.2,20.61231281
NM_018283,NUDT15,3,2,9581,2025,7556,3778,675,3.731358025
NM_003850,SUCLA2,11,10,58673,2175,56498,5649.8,197.7272727,25.97609195
NM_014166,MED4,7,6,19415,2294,17121,2853.5,327.7142857,7.463382738
NM_001270629,MED4,7,6,19415,2188,17227,2871.166667,312.5714286,7.873400366
NM_021999,ITM2B,6,5,28960,1902,27058,5411.6,317,14.22607781
NM_005767,LPAR6,7,6,33660,3010,30650,5108.333333,430,10.18272425
NM_001162498,LPAR6,1,0,2473,2473,NA,NA,2473,NA
NM_001162497,LPAR6,5,4,15863,2526,13337,3334.25,505.2,5.279889153
NM_001286832,RCBTB2,10,9,44295,2639,41656,4628.444444,263.9,15.78476696
NM_001286830,RCBTB2,14,13,44295,3200,41095,3161.153846,228.5714286,12.8421875
NM_001286831,RCBTB2,12,11,44295,3003,41292,3753.818182,250.25,13.75024975
NM_001268,RCBTB2,15,14,44295,3266,41029,2930.642857,217.7333333,12.56246173
NM_001507,MLNR,2,1,2041,1241,800,800,620.5,0.644641418
NM_014923,FNDC3A,24,23,99478,5934,93544,4067.130435,247.25,15.76407145
NM_030911,CDADC1,10,9,45577,3411,42166,4685.111111,341.1,12.36177074
NM_001193478,CDADC1,10,9,45577,2317,43260,4806.666667,231.7,18.67069486
NM_031915,SETDB2,15,14,50712,6235,44477,3176.928571,415.6666667,7.133440257
NM_001160308,SETDB2,13,12,43453,5633,37820,3151.666667,433.3076923,6.714006746
NM_001040443,PHF11,10,9,33318,1659,31659,3517.666667,165.9,19.08318264
NM_018191,RCBTB1,13,12,53639,4046,49593,4132.75,311.2307692,12.25729115
NM_001040444,PHF11,11,10,32591,1482,31109,3110.9,134.7272727,20.99122807
NM_138450,ARL11,2,1,5575,3762,1813,1813,1881,0.481924508
NM_001278636,EBPL,5,4,30813,1043,29770,7442.5,208.6,28.54266539
NM_032565,EBPL,4,3,30813,980,29833,9944.333333,245,30.44183673
NM_001127482,SPRYD7,4,3,23785,3089,20696,6898.666667,772.25,6.699902881
NM_001007278,TRIM13,4,3,21462,6958,14504,4834.666667,1739.5,2.084507042
NM_005798,TRIM13,3,2,21462,6758,14704,7352,2252.666667,2.175791654
NM_052811,TRIM13,3,2,21462,6843,14619,7309.5,2281,2.136343709
NM_213590,TRIM13,2,1,21462,7292,14170,14170,3646,1.943225453
NM_020456,SPRYD7,5,4,23785,3207,20578,5144.5,641.4,6.416588712
NM_001242312,FAM124A,4,3,61909,4798,57111,19037,1199.5,11.90308462
NM_145019,FAM124A,5,4,61909,4907,57002,14250.5,981.4,11.61646627
NM_001101320,SERPINE3,7,6,21073,1448,19625,3270.833333,206.8571429,13.5531768
NM_012141,INTS6,18,17,91576,7483,84093,4946.647059,415.7222222,11.23787251
NM_001039937,INTS6,19,18,91576,6992,84584,4699.111111,368,12.097254
NM_001039938,INTS6,3,2,3657,2497,1160,580,832.3333333,0.464557469
NM_024705,DHRS12,8,7,36171,1985,34186,4883.714286,248.125,17.22216625
NM_001031719,DHRS12,8,7,33387,1403,31984,4569.142857,175.375,22.79686386
NM_001270424,DHRS12,10,9,36171,1211,34960,3884.444444,121.1,28.86870355
NM_031290,CCDC70,2,1,4257,1156,3101,3101,578,2.682525952
NM_021645,UTP14C,2,1,8911,5531,3380,3380,2765.5,0.611101067
NM_001004127,ALG11,4,3,17259,2569,14690,4896.666667,642.25,5.718178279
NM_152720,NEK3,16,15,26893,2431,24462,1630.8,151.9375,10.06252571
NM_002498,NEK3,16,15,27219,2412,24807,1653.8,150.75,10.28482587
NM_001146099,NEK3,15,14,27219,2360,24859,1775.642857,157.3333333,10.53347458
NM_001098525,CKAP2,9,8,21273,3748,17525,2190.625,416.4444444,4.675827108
NM_016075,VPS36,14,13,38078,4487,33591,2583.923077,320.5,7.486293737
NM_018204,CKAP2,9,8,21273,3745,17528,2191,416.1111111,4.680373832
NM_001282168,VPS36,14,13,38078,4460,33618,2586,318.5714286,7.537668161
NM_001282169,VPS36,14,13,37644,4621,33023,2540.230769,330.0714286,7.146288682
NM_001286687,CKAP2,6,5,10485,2057,8428,1685.6,342.8333333,4.097228974
NM_001286686,CKAP2,9,8,20661,3686,16975,2121.875,409.5555556,4.605263158
NM_007015,LECT1,7,6,36549,1453,35096,5849.333333,207.5714286,24.1541638
NM_001130912,SUGT1,14,13,35604,1800,33804,2600.307692,128.5714286,18.78
NM_001011705,LECT1,7,6,36549,1450,35099,5849.833333,207.1428571,24.2062069
NM_006704,SUGT1,13,12,35604,1703,33901,2825.083333,131,19.90663535
NM_032949,PCDH8,3,2,4668,3715,953,476.5,1238.333333,0.256527591
NM_002590,PCDH8,3,2,4668,4006,662,331,1335.333333,0.165252122
NM_198441,PRR20A,3,2,3023,1850,1173,586.5,616.6666667,0.634054054
NM_198441,PRR20A,3,2,3023,1850,1173,586.5,616.6666667,0.634054054
NM_198441,PRR20A,3,2,3023,1850,1173,586.5,616.6666667,0.634054054
NM_198441,PRR20A,3,2,3023,1850,1173,586.5,616.6666667,0.634054054
NM_198441,PRR20A,3,2,3023,1850,1173,586.5,616.6666667,0.634054054
NM_001130407,PRR20E,3,2,3023,1850,1173,586.5,616.6666667,0.634054054
NM_001130407,PRR20E,3,2,3023,1850,1173,586.5,616.6666667,0.634054054
NM_001130407,PRR20E,3,2,3023,1850,1173,586.5,616.6666667,0.634054054
NM_001130407,PRR20E,3,2,3023,1850,1173,586.5,616.6666667,0.634054054
NM_001130407,PRR20E,3,2,3023,1850,1173,586.5,616.6666667,0.634054054
NM_001130406,PRR20D,3,2,3023,1850,1173,586.5,616.6666667,0.634054054
NM_001130406,PRR20D,3,2,3023,1850,1173,586.5,616.6666667,0.634054054
NM_001130406,PRR20D,3,2,3023,1850,1173,586.5,616.6666667,0.634054054
NM_001130406,PRR20D,3,2,3023,1850,1173,586.5,616.6666667,0.634054054
NM_001130406,PRR20D,3,2,3023,1850,1173,586.5,616.6666667,0.634054054
NM_001130405,PRR20C,3,2,3023,1850,1173,586.5,616.6666667,0.634054054
NM_001130405,PRR20C,3,2,3023,1850,1173,586.5,616.6666667,0.634054054
NM_001130405,PRR20C,3,2,3023,1850,1173,586.5,616.6666667,0.634054054
NM_001130405,PRR20C,3,2,3023,1850,1173,586.5,616.6666667,0.634054054
NM_001130405,PRR20C,3,2,3023,1850,1173,586.5,616.6666667,0.634054054
NM_001130404,PRR20B,3,2,3023,1850,1173,586.5,616.6666667,0.634054054
NM_001130404,PRR20B,3,2,3023,1850,1173,586.5,616.6666667,0.634054054
NM_001130404,PRR20B,3,2,3023,1850,1173,586.5,616.6666667,0.634054054
NM_001130404,PRR20B,3,2,3023,1850,1173,586.5,616.6666667,0.634054054
NM_001130404,PRR20B,3,2,3023,1850,1173,586.5,616.6666667,0.634054054
NM_001040429,PCDH17,4,3,97278,8013,89265,29755,2003.25,11.14002246
NM_022843,PCDH20,2,1,5838,4779,1059,1059,2389.5,0.221594476
NM_001128226,DIS3,21,20,26728,7497,19231,961.55,357,2.565159397
NM_024808,BORA,12,11,28451,2948,25503,2318.454545,245.6666667,8.650949796
NM_001286746,BORA,12,11,28296,3046,25250,2295.454545,253.8333333,8.289560079
NM_001071775,MZT1,3,2,19445,2415,17030,8515,805,7.051759834
NM_001286747,BORA,11,10,28451,2840,25611,2561.1,258.1818182,9.017957746
NM_014953,DIS3,21,20,26728,7587,19141,957.05,361.2857143,2.522868064
NM_001730,KLF5,4,3,18752,3570,15182,5060.666667,892.5,4.252661064
NM_001286818,KLF5,4,3,22568,2956,19612,6537.333333,739,6.634641407
NM_203495,COMMD6,4,3,12655,1699,10956,3652,424.75,6.448499117
NM_203497,COMMD6,5,4,12660,1744,10916,2729,348.8,6.259174312
NM_001287394,COMMD6,3,2,24222,1694,22528,11264,564.6666667,13.2987013
NM_001287393,COMMD6,4,3,12655,1864,10791,3597,466,5.78916309
NM_001287392,COMMD6,4,3,12655,1879,10776,3592,469.75,5.734965407
NM_001257995,C13orf45,4,3,12776,1172,11604,3868,293,9.901023891
NM_138444,KCTD12,1,0,6238,6238,NA,NA,6238,NA
NM_006493,CLN5,4,3,10595,2804,7791,2597,701,2.77853067
NM_001258406,IRG1,4,3,6154,2094,4060,1353.333333,523.5,1.93887297
NM_001242871,SLAIN1,6,5,23084,2400,20684,4136.8,400,8.618333333
NM_001242870,SLAIN1,5,4,23084,1973,21111,5277.75,394.6,10.69994932
NM_001242869,SLAIN1,6,5,23084,2124,20960,4192,354,9.868173258
NM_001242868,SLAIN1,7,6,66390,2862,63528,10588,408.8571429,22.19706499
NM_144595,SLAIN1,6,5,23084,2316,20768,4153.6,386,8.967184801
NM_001040153,SLAIN1,7,6,65363,2353,63010,10501.66667,336.1428571,26.77858054
NM_003991,EDNRB,7,6,23352,2537,20815,3469.166667,362.4285714,8.20457233
NM_001201397,EDNRB,8,7,24289,4479,19810,2830,559.875,4.422862246
NM_001122659,EDNRB,7,6,23352,4313,19039,3173.166667,616.1428571,4.414328773
NM_024546,RNF219,6,5,44895,3540,41355,8271,590,11.68220339
NM_006237,POU4F1,2,1,4467,3816,651,651,1908,0.170597484
NM_005842,SPRY2,2,1,4976,2112,2864,2864,1056,1.356060606
NM_052910,SLITRK1,1,0,5190,5190,NA,NA,5190,NA
NM_001281503,SLITRK1,2,1,5190,4748,442,442,2374,0.093091828
NM_032229,SLITRK6,2,1,6563,4183,2380,2380,2091.5,0.568969639
NM_015567,SLITRK5,2,1,7002,4448,2554,2554,2224,0.574190647
NM_001922,DCT,8,7,40097,2306,37791,5398.714286,288.25,16.38811795
NM_001129889,DCT,10,9,40097,2407,37690,4187.777778,240.7,15.65849605
NM_180989,GPR180,9,8,32797,8884,23913,2989.125,987.1111111,2.691692931
NM_014305,TGDS,12,11,22205,1914,20291,1844.636364,159.5,10.60135841
NM_007084,SOX21,1,0,2512,2512,NA,NA,2512,NA
NM_198968,DZIP1,23,22,66506,7514,58992,2681.454545,326.6956522,7.850944903
NM_014934,DZIP1,22,21,66506,7456,59050,2811.904762,338.9090909,7.919796137
NM_080818,OXGR1,4,3,8633,2289,6344,2114.666667,572.25,2.771515946
NM_021033,RAP2A,2,1,33779,4360,29419,29419,2180,6.747477064
NM_002271,IPO5,29,28,70623,6031,64592,2306.857143,207.9655172,10.70999834
NM_003576,STK24,11,10,71928,4590,67338,6733.8,417.2727273,14.67058824
NM_001098200,GPR18,2,1,3717,1471,2246,2246,735.5,1.526852481
NM_005292,GPR18,3,2,3717,1664,2053,1026.5,554.6666667,1.233774038
NM_004951,GPR183,2,1,12962,1787,11175,11175,893.5,6.253497482
NM_004800,TM9SF2,17,16,62676,3532,59144,3696.5,207.7647059,16.74518686
NM_007129,ZIC2,3,2,4995,2978,2017,1008.5,992.6666667,0.677300201
NM_033132,ZIC5,2,1,8905,4599,4306,4306,2299.5,0.936290498
NM_033110,GGACT,2,1,3640,2680,960,960,1340,0.358208955
NM_001010977,METTL21C,4,3,8776,1106,7670,2556.666667,276.5,6.934900542
NM_001146197,CCDC168,4,3,29707,21474,8233,2744.333333,5368.5,0.383393872
NM_138779,TEX30,6,5,7935,1403,6532,1306.4,233.8333333,4.655737705
NM_024089,KDELC1,10,9,14775,2117,12658,1406.444444,211.7,5.979215872
NM_000123,ERCC5,15,14,30162,4100,26062,1861.571429,273.3333333,6.356585366
NM_017693,BIVM,11,10,42491,3875,38616,3861.6,352.2727273,9.965419355
NM_001204425,BIVM-ERCC5,23,22,68857,5166,63691,2895.045455,224.6086957,12.32888115
NM_001159596,BIVM,9,8,42491,3210,39281,4910.125,356.6666667,12.23707165
NM_001286776,TEX30,5,4,7935,1327,6608,1652,265.4,4.979653353
NM_001286775,TEX30,5,4,7935,1196,6739,1684.75,239.2,5.634615385
NM_000452,SLC10A2,6,5,22850,3785,19065,3813,630.8333333,5.036988111
NM_172370,DAOA,5,4,24820,774,24046,6011.5,154.8,31.06718346
NM_001161812,DAOA,5,4,24820,929,23891,5972.75,185.8,25.71689989
NM_001161814,DAOA,6,5,25169,1015,24154,4830.8,169.1666667,23.79704433
NM_004093,EFNB2,5,4,45311,4392,40919,10229.75,878.4,9.316712204
NM_001098268,LIG4,2,1,10926,4062,6864,6864,2031,1.689807976
NM_032859,ABHD13,2,1,15842,5304,10538,10538,2652,1.986802413
NM_002312,LIG4,2,1,7340,4100,3240,3240,2050,0.790243902
NM_206937,LIG4,3,2,8092,3980,4112,2056,1326.666667,1.033165829
NM_006573,TNFSF13B,6,5,38857,2677,36180,7236,446.1666667,13.51512888
NM_001145645,TNFSF13B,5,4,38857,2619,36238,9059.5,523.8,13.83657885
NM_003749,IRS2,2,1,32732,7000,25732,25732,3500,3.676
NM_017817,RAB20,2,1,38660,1511,37149,37149,755.5,24.58570483
NM_005537,ING1,2,1,6064,2845,3219,3219,1422.5,1.131458699
NM_024537,CARS2,15,14,64725,1877,62848,4489.142857,125.1333333,33.4832179
NM_198219,ING1,2,1,7813,2871,4942,4942,1435.5,1.721351445
NM_198218,ING1,2,1,7813,2172,5641,5641,1086,2.597145488
NM_198217,ING1,2,1,8453,2203,6250,6250,1101.5,2.837040399
NM_001267728,ING1,2,1,5639,1940,3699,3699,970,1.906701031
NM_001286721,ANKRD10,5,4,22417,1299,21118,5279.5,259.8,16.25712086
NM_152324,TEX29,6,5,23581,715,22866,4573.2,119.1666667,31.98041958
NM_145248,SPACA7,7,6,58360,790,57570,9595,112.8571429,72.87341772
NM_001286279,TUBGCP3,10,9,41705,2521,39184,4353.777778,252.1,15.54303848
NM_001286278,TUBGCP3,21,20,89380,2804,86576,4328.8,133.5238095,30.87589158
NM_006322,TUBGCP3,22,21,103182,3939,99243,4725.857143,179.0454545,25.19497334
NM_001286277,TUBGCP3,22,21,103182,3909,99273,4727.285714,177.6818182,25.39600921
NM_207440,C13orf35,3,2,37455,2244,35211,17605.5,748,15.69117647
NM_024979,MCF2L,30,29,98027,6479,91548,3156.827586,215.9666667,14.12995833
NM_003891,PROZ,8,7,13732,1497,12235,1747.857143,187.125,8.173012692
NM_001256134,PROZ,9,8,13732,1564,12168,1521,173.7777778,7.780051151
NM_018386,PCID2,15,14,31178,1758,29420,2101.428571,117.2,16.73492605
NM_001258212,PCID2,15,14,31178,1952,29226,2087.571429,130.1333333,14.97233607
NM_001258213,PCID2,14,13,31111,2462,28649,2203.769231,175.8571429,11.63647441
NM_000504,F10,8,7,26732,1544,25188,3598.285714,193,16.3134715
NM_001127203,PCID2,15,14,31178,1790,29388,2099.142857,119.3333333,16.41787709
NM_001127202,PCID2,14,13,31178,1954,29224,2248,139.5714286,14.95598772
NM_024719,GRTP1,8,7,39986,1440,38546,5506.571429,180,26.76805556
NM_001286732,GRTP1,7,6,39307,1843,37464,6244,263.2857143,20.32772653
NM_005561,LAMP1,9,8,26274,2549,23725,2965.625,283.2222222,9.307571597
NM_001286733,GRTP1,6,5,39986,1079,38907,7781.4,179.8333333,36.0583874
NM_001014283,DCUN1D2,7,6,34891,3036,31855,5309.166667,433.7142857,10.49242424
NM_199162,ADPRHL1,7,6,27204,1884,25320,4220,269.1428571,13.43949045
NM_138430,ADPRHL1,7,6,31586,2041,29545,4924.166667,291.5714286,14.47574718
NM_000705,ATP4B,7,6,9393,1504,7889,1314.833333,214.8571429,5.245345745
NM_001143946,GAS6,7,6,13194,2514,10680,1780,359.1428571,4.248210024
NM_001143945,GAS6,9,8,15497,2181,13316,1664.5,242.3333333,6.105456213
NM_182614,TMEM255B,9,8,52685,1040,51645,6455.625,115.5555556,49.65865385
NM_001278674,LINC00452,8,7,26216,1615,24601,3514.428571,201.875,15.23281734
NM_080687,UPF3A,9,8,24234,2296,21938,2742.25,255.1111111,9.554878049
NM_001078645,CDC16,18,17,37790,2311,35479,2087,128.3888889,15.35222847
NM_023011,UPF3A,10,9,24234,2396,21838,2426.444444,239.6,9.114357262
NM_003903,CDC16,19,18,37790,2230,35560,1975.555556,117.3684211,15.94618834
NM_020806,GPHN,23,22,674402,4325,670077,30458.04545,188.0434783,154.9310983
NM_001024218,GPHN,22,21,674402,4225,670177,31913.19048,192.0454545,158.6217751
NM_001164749,NPAS3,12,11,864925,5945,858980,78089.09091,495.4166667,144.4878049
NM_022123,NPAS3,11,10,864925,5848,859077,85907.7,531.6363636,146.9009918
NM_001165893,NPAS3,11,10,864925,5854,859071,85907.1,532.1818182,146.7494021
NM_152132,PSMA3,11,10,27206,988,26218,2621.8,89.81818182,26.53643725
NM_002788,PSMA3,11,10,27206,1009,26197,2619.7,91.72727273,25.96333003
NM_173159,NPAS3,12,11,864925,5906,859019,78092.63636,492.1666667,145.4485269
NM_001128596,TC2N,12,11,87786,5164,82622,7511.090909,430.3333333,15.9996127
NM_001040108,MLH3,13,12,37770,7909,29861,2488.416667,608.3846154,3.775572133
NM_014381,MLH3,12,11,37770,7836,29934,2721.272727,653,3.820061256
NM_152332,TC2N,12,11,56776,5233,51543,4685.727273,436.0833333,9.849608255
NM_001128595,TC2N,12,11,56776,5045,51731,4702.818182,420.4166667,10.25391477
NM_001289134,TC2N,11,10,56776,4852,51924,5192.4,441.0909091,10.70156636
NM_022060,ABHD4,7,6,14120,2516,11604,1934,359.4285714,4.612082671
NM_014574,STRN3,16,15,132604,3986,128618,8574.533333,249.125,32.26743603
NM_001083893,STRN3,18,17,132604,4240,128364,7550.823529,235.5555556,30.2745283
NM_001256681,KIAA0391,6,5,151528,1595,149933,29986.6,265.8333333,94.00188088
NM_001256680,KIAA0391,7,6,151528,1644,149884,24980.66667,234.8571429,91.1703163
NM_001256678,KIAA0391,7,6,151759,2832,148927,24821.16667,404.5714286,52.58721751
NM_014672,KIAA0391,8,7,151759,2881,148878,21268.28571,360.125,51.67580701
NM_001256679,KIAA0391,8,7,151759,2328,149431,21347.28571,291,64.18857388
NM_138731,MIPOL1,14,13,353348,6134,347214,26708.76923,438.1428571,56.60482556
NM_001195297,MIPOL1,15,14,353348,6274,347074,24791,418.2666667,55.31941345
NM_001195296,MIPOL1,15,14,353348,6288,347060,24790,419.2,55.19402036
NM_006544,EXOC5,18,17,66425,8529,57896,3405.647059,473.8333333,6.7881346
NM_021255,PELI2,6,5,182940,5702,177238,35447.6,950.3333333,31.08347948
NM_053064,GNG2,4,3,109498,3890,105608,35202.66667,972.5,27.14858612
NM_002863,PYGL,20,19,39315,2866,36449,1918.368421,143.3,12.71772505
NM_001243774,GNG2,3,2,109498,3848,105650,52825,1282.666667,27.45582121
NM_001243773,GNG2,4,3,109498,3886,105612,35204,971.5,27.17756047
NM_001163940,PYGL,19,18,39315,2763,36552,2030.666667,145.4210526,13.22909881
NM_004480,FUT8,10,9,333531,4746,328785,36531.66667,474.6,69.27623262
NM_001282182,PPP2R5E,13,12,134348,3446,130902,10908.5,265.0769231,37.98665119
NM_001282181,PPP2R5E,13,12,134348,3491,130857,10904.75,268.5384615,37.48410198
NM_001282180,PPP2R5E,14,13,169471,4110,165361,12720.07692,293.5714286,40.23381995
NM_001282179,PPP2R5E,14,13,169471,4122,165349,12719.15385,294.4285714,40.11377972
NM_006255,PRKCH,14,13,229185,3520,225665,17358.84615,251.4285714,64.109375
NM_006246,PPP2R5E,14,13,169471,4125,165346,12718.92308,294.6428571,40.08387879
NM_178156,FUT8,10,9,333531,5078,328453,36494.77778,507.8,64.68156755
NM_178155,FUT8,11,10,333531,5177,328354,32835.4,470.6363636,63.42553602
NM_014992,DAAM1,25,24,107966,5845,102121,4255.041667,233.8,17.47151411
NM_001270520,DAAM1,25,24,182744,5921,176823,7367.625,236.84,29.86370546
NM_016026,RDH11,7,6,18993,2573,16420,2736.666667,367.5714286,6.381655655
NM_015604,DCAF4,14,13,33319,2566,30753,2365.615385,183.2857143,11.98480125
NM_003049,SLC10A1,5,4,21456,1636,19820,4955,327.2,12.11491443
NM_181341,DCAF4,12,11,33319,2384,30935,2812.272727,198.6666667,12.9760906
NM_001249,ENTPD5,16,15,52847,2064,50783,3385.533333,129,24.60416667
NM_001252650,RDH11,6,5,18993,2362,16631,3326.2,393.6666667,7.041066892
NM_001163509,DCAF4,14,13,33319,2537,30782,2367.846154,181.2142857,12.13322822
NM_001163508,DCAF4,14,13,33319,2548,30771,2367,182,12.07653061
NM_181340,DCAF4,13,12,33319,2465,30854,2571.166667,189.6153846,12.5168357
NM_004796,NRXN3,17,16,1464561,10039,1454522,90907.625,590.5294118,144.8871402
NM_001102564,IFT43,9,8,97998,842,97156,12144.5,93.55555556,115.3871734
NM_001256430,STON2,8,7,166756,4316,162440,23205.71429,539.5,37.63670065
NM_033104,STON2,6,5,166564,12948,153616,30723.2,2158,11.86407167
NM_052873,IFT43,8,7,97998,856,97142,13877.42857,107,113.4836449
NM_001010854,TTC7B,20,19,275831,3454,272377,14335.63158,172.7,78.85842501
NM_183387,EML5,43,42,177924,7214,170710,4064.52381,167.7674419,23.66370945
NM_001272011,MOK,11,10,76381,1881,74500,7450,171,39.60659224
NM_001203258,MTA1,21,20,50873,2814,48059,2402.95,134,17.07853589
NM_014226,MOK,12,11,76381,1972,74409,6764.454545,164.3333333,37.73275862
NM_183004,EIF5,11,10,10165,5812,4353,435.3,528.3636364,0.748967653
NM_001969,EIF5,12,11,11024,5956,5068,460.7272727,496.3333333,0.850906649
NM_004689,MTA1,21,20,50873,2861,48012,2400.6,136.2380952,16.78154491
NM_007110,TEP1,55,54,47755,10749,37006,685.2962963,195.4363636,3.442738859
NM_001282211,NDRG2,15,14,54111,1973,52138,3724.142857,131.5333333,26.42574759
NM_001170629,CHD8,37,36,46516,8267,38249,1062.472222,223.4324324,4.6267086
NM_020366,RPGRIP1,24,23,63326,3970,59356,2580.695652,165.4166667,14.9511335
NM_020920,CHD8,38,37,52106,7513,44593,1205.216216,197.7105263,5.935445228
NM_001282322,C14orf164,15,14,36369,2451,33918,2422.714286,163.4,13.83843329
NM_001130708,C14orf93,7,6,23302,2172,21130,3521.666667,310.2857143,9.728360958
NM_001130706,C14orf93,8,7,23302,2252,21050,3007.142857,281.5,9.347246892
NM_021944,C14orf93,7,6,23302,2418,20884,3480.666667,345.4285714,8.636889992
NM_001282968,C14orf93,8,7,23302,2107,21195,3027.857143,263.375,10.05932606
NM_002471,MYH6,39,38,26289,5980,20309,534.4473684,153.3333333,3.396153846
NM_001282970,C14orf93,8,7,23302,2299,21003,3000.428571,287.375,9.135711179
NM_001282969,C14orf93,8,7,14138,1839,12299,1757,229.875,6.687873844
NM_015299,KHNYN,8,7,11408,6303,5105,729.2857143,787.875,0.809931779
NM_005132,REC8,20,19,8231,2250,5981,314.7894737,112.5,2.658222222
NM_001277864,DHRS4L1,5,4,44370,1438,42932,10733,287.6,29.85535466
NM_001048205,REC8,19,18,8231,2350,5881,326.7222222,123.6842105,2.502553191
NM_001286367,NOP9,10,9,9274,5887,3387,376.3333333,588.7,0.575335485
NM_174913,NOP9,10,9,9274,6053,3221,357.8888889,605.3,0.532132827
NM_014178,STXBP6,6,5,237791,1963,235828,47165.6,327.1666667,120.1365257
NM_006491,NOVA1,5,4,127638,1215,126423,31605.75,243,104.0518519
NM_006489,NOVA1,4,3,151873,3850,148023,49341,962.5,38.44753247
NM_002515,NOVA1,5,4,151873,3923,147950,36987.5,784.6,37.71348458
NM_002742,PRKD1,18,17,351214,3695,347519,20442.29412,205.2777778,94.0511502
NM_001283033,SCFD1,22,21,113575,1952,111623,5315.380952,88.72727273,57.18391393
NM_017769,G2E3,15,14,60719,5596,55123,3937.357143,373.0666667,9.850428878
NM_016106,SCFD1,25,24,113575,2257,111318,4638.25,90.28,49.32122286
NM_001257376,SCFD1,23,22,113510,2093,111417,5064.409091,91,53.23315815
NM_182835,SCFD1,24,23,113575,2185,111390,4843.043478,91.04166667,50.97940503
NM_001283031,SCFD1,24,23,113575,2168,111407,4843.782609,90.33333333,51.38699262
NM_001283032,SCFD1,24,23,113575,2167,111408,4843.826087,90.29166667,51.41116751
NM_025152,NUBPL,11,10,299840,3069,296771,29677.1,279,96.69957641
NM_015382,HECTD1,43,42,107367,9177,98190,2337.857143,213.4186047,10.69957502
NM_015473,HEATR5A,36,35,128796,7879,120917,3454.771429,218.8611111,15.34674451
NM_001201574,NUBPL,6,5,146656,2731,143925,28785,455.1666667,52.70047602
NM_001201573,NUBPL,9,8,283309,2831,280478,35059.75,314.5555556,99.0738255
NM_004274,AKAP6,14,13,503791,10401,493390,37953.07692,742.9285714,47.43678492
NM_182648,BAZ1A,26,25,122918,5946,116972,4678.88,228.6923077,19.6723848
NM_001289022,FAM177A1,6,5,37132,2985,34147,6829.4,497.5,11.43953099
NM_018453,EAPP,6,5,23810,1354,22456,4491.2,225.6666667,16.58493353
NM_013448,BAZ1A,27,26,122918,6043,116875,4495.192308,223.8148148,19.34055932
NM_001079519,FAM177A1,7,6,38478,3263,35215,5869.166667,466.1428571,10.79221575
NM_173607,FAM177A1,5,4,36981,2931,34050,8512.5,586.2,11.6171955
NM_194301,RALGAPA1,40,39,270876,7873,263003,6743.666667,196.825,33.40569033
NM_014990,RALGAPA1,41,40,270876,7905,262971,6574.275,192.804878,33.26641366
NM_032352,BRMS1L,10,9,45574,2594,42980,4775.555556,259.4,16.5690054
NM_001282234,PSMA6,7,6,38923,1006,37917,6319.5,143.7142857,37.69085487
NM_001282233,PSMA6,6,5,25164,985,24179,4835.8,164.1666667,24.54720812
NM_001282232,PSMA6,7,6,25164,1129,24035,4005.833333,161.2857143,21.28875111
NM_002791,PSMA6,7,6,25164,1081,24083,4013.833333,154.4285714,22.27844588
NM_001283043,RALGAPA1,42,41,270876,7945,262931,6412.95122,189.1666667,33.09389553
NM_001283044,RALGAPA1,41,40,260720,6707,254013,6350.325,163.5853659,37.87281944
NM_001101341,SFTA3,4,3,40498,1490,39008,13002.66667,372.5,26.17986577
NM_030631,SLC25A21,10,9,494741,3957,490784,54531.55556,395.7,124.0293151
NM_001171170,SLC25A21,11,10,494741,1781,492960,49296,161.9090909,276.7883212
NM_001009182,GEMIN2,9,8,22691,1323,21368,2671,147,16.15117158
NM_003616,GEMIN2,10,9,22691,1369,21322,2369.111111,136.9,15.57487217
NM_001009183,GEMIN2,9,8,22691,1309,21382,2672.75,145.4444444,16.33460657
NM_054024,MIA2,6,5,19452,2287,17165,3433,381.1666667,7.505465676
NM_152447,LRFN5,6,5,296990,3738,293252,58650.4,623,78.45157838
NM_020937,FANCM,23,22,64959,7151,57808,2627.636364,310.9130435,8.083904349
NM_015091,FAM179B,19,18,112220,6261,105959,5886.611111,329.5263158,16.92365437
NM_001113498,MDGA2,17,16,835331,5559,829772,51860.75,327,149.2664148
NM_182830,MDGA2,17,16,503625,5267,498358,31147.375,309.8235294,94.61894817
NM_203467,LRR1,3,2,15977,1026,14951,7475.5,342,14.57212476
NM_172193,KLHDC1,13,12,60049,2704,57345,4778.75,208,21.20747041
NM_152329,LRR1,4,3,15977,1749,14228,4742.666667,437.25,8.134934248
NM_024884,L2HGDH,10,9,69797,6105,63692,7076.888889,610.5,10.43276003
NM_001012706,C14orf182,4,3,25810,2690,23120,7706.666667,672.5,8.594795539
NM_006939,SOS2,23,22,114255,5336,108919,4950.863636,232,20.41210645
NM_001282236,CDKL1,9,8,65480,2219,63261,7907.625,246.5555556,28.50878774
NM_198794,MAP4K5,32,31,114167,4467,109700,3538.709677,139.59375,24.55786882
NM_020921,NIN,31,30,111360,10324,101036,3367.866667,333.0322581,9.786516854
NM_182944,NIN,30,29,103890,6818,97072,3347.310345,227.2666667,14.23760634
NM_006575,MAP4K5,32,31,114167,4419,109748,3540.258065,138.09375,24.83548314
NM_016350,NIN,29,28,105295,4398,100897,3603.464286,151.6551724,22.94156435
NM_021818,SAV1,5,4,34775,3146,31629,7907.25,629.2,10.05371901
NM_182946,NIN,30,29,105295,6538,98757,3405.413793,217.9333333,15.10507801
NM_004196,CDKL1,9,8,66335,1622,64713,8089.125,180.2222222,39.89704069
NM_001267046,FRMD6,14,13,78870,4865,74005,5692.692308,347.5,15.21171634
NM_001042481,FRMD6,15,14,241607,5066,236541,16895.78571,337.7333333,46.69186735
NM_152330,FRMD6,14,13,78870,4841,74029,5694.538462,345.7857143,15.29208841
NM_015163,TRIM9,10,9,120443,4936,115507,12834.11111,493.6,23.40093193
NM_052978,TRIM9,7,6,99639,4358,95281,15880.16667,622.5714286,21.86346948
NM_001160047,TXNDC16,21,20,121995,4647,117348,5867.4,221.2857143,25.25242092
NM_006832,FERMT2,15,14,93828,3350,90478,6462.714286,223.3333333,27.00835821
NM_020784,TXNDC16,21,20,121995,4662,117333,5866.65,222,25.16795367
NM_145251,STYX,11,10,44824,4874,39950,3995,443.0909091,8.196553139
NM_001099652,GPR137C,7,6,84567,3895,80672,13445.33333,556.4285714,20.71168164
NM_001135000,FERMT2,15,14,91611,2176,89435,6388.214286,145.0666667,41.10064338
NM_001130701,STYX,12,11,44824,4627,40197,3654.272727,385.5833333,8.687486492
NM_001134999,FERMT2,16,15,93828,3372,90456,6030.4,210.75,26.82562278
NM_030637,DDHD1,12,11,116590,12889,103701,9427.363636,1074.083333,8.045697882
NM_001160148,DDHD1,13,12,116590,12974,103616,8634.666667,998,7.986434407
NM_001160147,DDHD1,13,12,116590,12911,103679,8639.916667,993.1538462,8.030284254
NM_015589,SAMD4A,12,11,225705,6845,218860,19896.36364,570.4166667,31.97370343
NM_001024024,GCH1,7,6,60820,1986,58834,9805.666667,283.7142857,29.62437059
NM_001161576,SAMD4A,11,10,225705,6580,219125,21912.5,598.1818182,33.30167173
NM_007086,WDHD1,26,25,88165,6058,82107,3284.28,233,13.553483
NM_000161,GCH1,6,5,60820,2931,57889,11577.8,488.5,19.75059707
NM_001024071,GCH1,6,5,60820,1842,58978,11795.6,307,32.0184582
NM_001024070,GCH1,7,6,60820,1931,58889,9814.833333,275.8571429,30.49663387
NM_001008396,WDHD1,25,24,88165,5964,82201,3425.041667,238.56,13.78286385
NM_014924,ATG14,10,9,45469,4753,40716,4524,475.3,8.566379129
NM_001271014,KTN1,44,43,104379,4817,99562,2315.395349,109.4772727,20.66888105
NM_001079522,KTN1,43,42,104379,4747,99632,2372.190476,110.3953488,20.98841373
NM_001079521,KTN1,44,43,104379,4777,99602,2316.325581,108.5681818,20.85032447
NM_004986,KTN1,42,41,104379,4604,99775,2433.536585,109.6190476,21.67137272
NM_001206920,SLC35F4,8,7,301954,1725,300229,42889.85714,215.625,174.0457971
NM_001001872,C14orf37,8,7,148041,3090,144951,20707.28571,386.25,46.90970874
NM_001244189,KIAA0586,34,33,121448,6068,115380,3496.363636,178.4705882,19.01450231
NM_001244190,KIAA0586,32,31,121448,5824,115624,3729.806452,182,19.85302198
NM_001244191,KIAA0586,31,30,121448,5631,115817,3860.566667,181.6451613,20.56774996
NM_001244192,KIAA0586,32,31,121448,5755,115693,3732.032258,179.84375,20.10304083
NM_001244193,KIAA0586,27,26,97534,4353,93181,3583.884615,161.2222222,21.40615667
NM_016651,DACT1,4,3,10283,3865,6418,2139.333333,966.25,1.660543338
NM_001079520,DACT1,4,3,10283,3754,6529,2176.333333,938.5,1.739211508
NM_014749,KIAA0586,30,29,120841,5621,115220,3973.103448,187.3666667,20.498132
NM_021136,RTN1,9,8,274865,3318,271547,33943.375,368.6666667,81.84056661
NM_001164399,CCDC175,20,19,71766,2630,69136,3638.736842,131.5,26.28745247
NM_002431,MNAT1,8,7,233941,1391,232550,33221.42857,173.875,167.1818835
NM_001172702,SLC38A6,17,16,102621,1768,100853,6303.3125,104,57.04355204
NM_001177963,MNAT1,7,6,233941,1264,232677,38779.5,180.5714286,184.0799051
NM_174978,C14orf39,18,17,50092,2781,47311,2783,154.5,17.01222582
NM_153811,SLC38A6,16,15,71431,1665,69766,4651.066667,104.0625,41.9015015
NM_031914,SYT16,6,5,105888,3143,102745,20549,523.8333333,32.690105
NM_003082,SNAPC1,10,9,34073,2666,31407,3489.666667,266.6,11.78057014
NM_020663,RHOJ,5,4,89130,3624,85506,21376.5,724.8,23.59437086
NM_139318,KCNH5,11,10,338667,3965,334702,33470.2,360.4545455,84.41412358
NM_172375,KCNH5,10,9,338667,3767,334900,37211.11111,376.7,88.90363685
NM_005956,MTHFD1,28,27,71968,3476,68492,2536.740741,124.1428571,19.70425777
NM_001214902,ESR2,8,7,56044,2401,53643,7663.285714,300.125,22.34194086
NM_001214903,ESR2,7,6,48190,1586,46604,7767.333333,226.5714286,29.38461538
NM_001008726,WDR89,4,3,44886,3274,41612,13870.66667,818.5,12.70983506
NM_001271876,ESR2,8,7,55259,1732,53527,7646.714286,216.5,30.90473441
NM_001437,ESR2,9,8,61383,2178,59205,7400.625,242,27.18319559
NM_080666,WDR89,3,2,44886,3164,41722,20861,1054.666667,13.18647282
NM_001271877,ESR2,6,5,50048,1524,48524,9704.8,254,31.83989501
NM_015180,SYNE2,115,114,373486,21926,351560,3083.859649,190.6608696,16.03393232
NM_182914,SYNE2,116,115,373486,21993,351493,3056.46087,189.5948276,15.98203974
NM_001258272,WDR89,3,2,44886,3669,41217,20608.5,1223,11.23385119
NM_001040275,ESR2,9,8,67379,2465,64914,8114.25,273.8888889,26.33427992
NM_001024858,SPTB,35,34,76867,10099,66768,1963.764706,288.5428571,6.611347658
NM_197957,MAX,4,3,96445,564,95881,31960.33333,141,170.001773
NM_001202559,CHURC1-FNTB,14,13,148296,2908,145388,11183.69231,207.7142857,49.99587345
NM_001202558,CHURC1-FNTB,13,12,148296,2836,145460,12121.66667,218.1538462,51.29055007
NM_001271069,MAX,3,2,96445,536,95909,47954.5,178.6666667,178.9347015
NM_000347,SPTB,31,30,56751,6757,49994,1666.466667,217.9677419,7.398845642
NM_022474,MPP5,15,14,94768,5623,89145,6367.5,374.8666667,15.85363685
NM_001256550,MPP5,15,14,94768,5391,89377,6384.071429,359.4,16.57892784
NM_020715,PLEKHH1,29,28,56249,6569,49680,1774.285714,226.5172414,7.562794946
NM_002877,RAD51B,11,10,678104,1882,676222,67622.2,171.0909091,359.3103082
NM_133509,RAD51B,11,10,776244,2661,773583,77358.3,241.9090909,290.7113867
NM_133510,RAD51B,11,10,658316,1570,656746,65674.6,142.7272727,418.3095541
NM_020692,GALNT16,16,15,94511,3164,91347,6089.8,197.75,28.87073325
NM_001161498,PLEKHD1,13,12,43746,1825,41921,3493.416667,140.3846154,22.97041096
NM_001284208,DCAF5,7,6,63995,3058,60937,10156.16667,436.8571429,19.92707652
NM_001284207,DCAF5,9,8,101681,5747,95934,11991.75,638.5555556,16.69288324
NM_001284206,DCAF5,9,8,102279,5991,96288,12036,665.6666667,16.07210816
NM_014734,KIAA0247,6,5,103553,5399,98154,19630.8,899.8333333,18.18003334
NM_001168368,GALNT16,15,14,94511,4324,90187,6441.928571,288.2666667,20.85730805
NM_004450,ERH,4,3,18183,805,17378,5792.666667,201.25,21.58757764
NM_003861,DCAF5,9,8,102279,5994,96285,12035.625,666,16.06356356
NM_182936,SLC8A3,5,4,36002,2866,33136,8284,573.2,11.56175855
NM_182932,SLC8A3,7,6,144855,5257,139598,23266.33333,751,26.55468899
NM_183002,SLC8A3,8,7,144855,5276,139579,19939.85714,659.5,26.45545868
NM_001034852,SMOC1,12,11,152971,3710,149261,13569.18182,309.1666667,40.23207547
NM_022137,SMOC1,12,11,152971,3707,149264,13569.45455,308.9166667,40.26544376
NM_033262,SLC8A3,8,7,144855,5270,139585,19940.71429,658.75,26.48671727
NM_001130417,SLC8A3,6,5,36002,2971,33031,6606.2,495.1666667,11.11780545
NM_058240,SLC8A3,8,7,144855,5267,139588,19941.14286,658.375,26.50237327
NM_015556,SIPA1L1,22,21,211919,7866,204053,9716.809524,357.5454545,25.94113908
NM_014982,PCNX,36,35,207979,12955,195024,5572.114286,359.8611111,15.053956
NM_001284245,SIPA1L1,21,20,211919,7802,204117,10205.85,371.5238095,26.16213791
NM_001284247,SIPA1L1,21,20,153660,7803,145857,7292.85,371.5714286,18.69242599
NM_001284246,SIPA1L1,21,20,154950,8388,146562,7328.1,399.4285714,17.47281831
NM_001204424,RGS6,18,17,634084,6077,628007,36941.58824,337.6111111,103.3416159
NM_001204422,RGS6,16,15,629678,1567,628111,41874.06667,97.9375,400.8366305
NM_001204421,RGS6,17,16,629678,1622,628056,39253.5,95.41176471,387.2108508
NM_001204420,RGS6,16,15,633454,5641,627813,41854.2,352.5625,111.2946286
NM_001204419,RGS6,17,16,633454,5696,627758,39234.875,335.0588235,110.210323
NM_001204418,RGS6,17,16,629678,1679,627999,39249.9375,98.76470588,374.0315664
NM_001204417,RGS6,18,17,629678,1734,627944,36937.88235,96.33333333,362.1361015
NM_001204416,RGS6,18,17,633454,5808,627646,36920.35294,322.6666667,108.0657713
NM_001280544,DPF3,10,9,231608,4530,227078,25230.88889,453,50.12759382
NM_001280543,DPF3,11,10,233075,4232,228843,22884.3,384.7272727,54.07443289
NM_001280542,DPF3,11,10,274822,1177,273645,27364.5,107,232.4936279
NM_012074,DPF3,10,9,233075,4087,228988,25443.11111,408.7,56.02838268
NM_004296,RGS6,17,16,633454,5753,627701,39231.3125,338.4117647,109.1084651
NM_001204423,RGS6,16,15,634423,5548,628875,41925,346.75,113.3516583
NM_001043318,ELMSAN1,12,11,72138,7733,64405,5855,644.4166667,8.32859175
NM_021239,RBM25,19,18,62857,4322,58535,3251.944444,227.4736842,13.54349838
NM_001005743,NUMB,13,12,183370,3657,179713,14976.08333,281.3076923,49.14219305
NM_007318,PSEN1,12,11,87258,6090,81168,7378.909091,507.5,13.32807882
NM_194278,ELMSAN1,12,11,45178,8112,37066,3369.636364,676,4.569280079
NM_000021,PSEN1,12,11,87258,6102,81156,7377.818182,508.5,13.29990167
NM_003744,NUMB,12,11,183370,3623,179747,16340.63636,301.9166667,49.61275186
NM_001005745,NUMB,11,10,183370,3478,179892,17989.2,316.1818182,51.72282921
NM_001005744,NUMB,12,11,183370,3512,179858,16350.72727,292.6666667,51.21241458
NM_019589,YLPM1,21,20,73946,8158,65788,3289.4,388.4761905,8.064231429
NM_182894,VSX2,5,4,23268,3000,20268,5067,600,6.756
NM_001024674,LIN52,6,5,115463,1804,113659,22731.8,300.6666667,63.00388027
NM_000428,LTBP2,36,35,114150,8590,105560,3016,238.6111111,12.2887078
NM_001933,DLST,15,14,21858,2857,19001,1357.214286,190.4666667,6.650682534
NM_006827,TMED10,5,4,45180,4149,41031,10257.75,829.8,9.889370933
NM_015072,TTLL5,32,31,293876,4789,289087,9325.387097,149.65625,60.36479432
NM_017926,GPATCH2L,10,9,60920,12528,48392,5376.888889,1252.8,3.862707535
NM_194287,C14orf166B,14,13,43922,1748,42174,3244.153846,124.8571429,24.12700229
NM_017972,GPATCH2L,9,8,58451,12405,46046,5755.75,1378.333333,3.711890367
NM_004452,ESRRB,11,10,130492,3025,127467,12746.7,275,42.13785124
NM_020431,TMEM63C,24,23,77738,5426,72312,3144,226.0833333,13.32694434
NM_001010860,SAMD15,3,2,13827,2028,11799,5899.5,676,5.818047337
NM_001142545,ADCK1,10,9,133873,2040,131833,14648.11111,204,64.62401961
NM_020421,ADCK1,11,10,133873,2245,131628,13162.8,204.0909091,58.63162584
NM_004863,SPTLC2,12,11,110772,8176,102596,9326.909091,681.3333333,12.54843444
NM_001272020,NRXN3,6,5,588953,9199,579754,115950.8,1533.166667,63.02358952
NM_001105250,NRXN3,7,6,588953,8666,580287,96714.5,1238,66.96134318
NM_138970,NRXN3,6,5,588953,8584,580369,116073.8,1430.666667,67.61055452
NM_015859,GTF2A1,9,8,45502,6345,39157,4894.625,705,6.171315997
NM_201595,GTF2A1,9,8,45781,5965,39816,4977,662.7777778,6.674937133
NM_001278940,GTF2A1,10,9,45502,6413,39089,4343.222222,641.3,6.095275222
NM_000369,TSHR,10,9,190779,4410,186369,20707.66667,441,42.26054422
NM_001142626,TSHR,9,8,153427,1259,152168,19021,139.8888889,120.8641779
NM_152446,CEP128,24,23,443065,4481,438584,19068.86957,186.7083333,97.87636688
NM_001018036,TSHR,9,8,153427,1196,152231,19028.875,132.8888889,127.2834448
NM_003608,GPR65,2,1,9689,4524,5165,5165,2262,1.141688771
NM_021161,KCNK10,7,6,146806,7508,139298,23216.33333,1072.571429,18.55327651
NM_138318,KCNK10,7,6,90805,7188,83617,13936.16667,1026.857143,11.63286032
NM_138317,KCNK10,7,6,143143,7517,135626,22604.33333,1073.857143,18.04257017
NM_007039,PTPN21,19,18,89003,6234,82769,4598.277778,328.1052632,13.27702919
NM_018418,SPATA7,12,11,52818,2025,50793,4617.545455,168.75,25.08296296
NM_001040428,SPATA7,11,10,52818,1928,50890,5089,175.2727273,26.39522822
NM_001085471,FOXN3,7,6,462980,7859,455121,75853.5,1122.714286,57.9108029
NM_005197,FOXN3,6,5,260940,7909,253031,50606.2,1318.166667,31.99279302
NM_001008744,TDP1,16,15,88864,3540,85324,5688.266667,221.25,24.10282486
NM_145231,EFCAB11,6,5,159787,2866,156921,31384.2,477.6666667,54.75261689
NM_022054,KCNK13,2,1,124094,2524,121570,121570,1262,48.16561014
NM_018319,TDP1,17,16,88864,3764,85100,5318.75,221.4117647,22.60892667
NM_001284269,EFCAB11,6,5,159567,2877,156690,31338,479.5,54.46298227
NM_001284267,EFCAB11,6,5,159787,2719,157068,31413.6,453.1666667,57.76682604
NM_001102369,C14orf159,15,14,111385,2796,108589,7756.357143,186.4,38.83726753
NM_024764,CATSPERB,27,26,151297,3633,147664,5679.384615,134.5555556,40.64519681
NM_001080414,CCDC88C,30,29,146523,7573,138950,4791.37931,252.4333333,18.3480787
NM_001286472,C14orf159,15,14,111385,2847,108538,7752.714286,189.8,38.12363892
NM_001286473,C14orf159,7,6,53718,1048,52670,8778.333333,149.7142857,50.25763359
NM_001102366,C14orf159,16,15,111385,3198,108187,7212.466667,199.875,33.82958099
NM_001102368,C14orf159,14,13,111385,2795,108590,8353.076923,199.6428571,38.85152057
NM_001286470,C14orf159,17,16,111385,3493,107892,6743.25,205.4705882,30.88806184
NM_001286471,C14orf159,14,13,110698,3031,107667,8282.076923,216.5,35.52193995
NM_001102367,C14orf159,15,14,110763,2963,107800,7700,197.5333333,36.38204522
NM_182398,RPS6KA5,13,12,166676,2310,164366,13697.16667,177.6923077,71.15411255
NM_024952,C14orf159,14,13,111385,3025,108360,8335.384615,216.0714286,35.8214876
NM_004755,RPS6KA5,17,16,189828,3892,185936,11621,228.9411765,47.77389517
NM_024832,RIN3,10,9,175211,3857,171354,19039.33333,385.7,44.42675655
NM_001164781,ATXN3,9,8,48071,6722,41349,5168.625,746.8888889,6.151294258
NM_001164779,ATXN3,7,6,48071,6567,41504,6917.333333,938.1428571,6.320085275
NM_001164780,ATXN3,8,7,48071,6635,41436,5919.428571,829.375,6.245064054
NM_001127696,ATXN3,10,9,48071,6888,41183,4575.888889,688.8,5.978948897
NM_030660,ATXN3,10,9,48071,6768,41303,4589.222222,676.8,6.102689125
NM_001127697,ATXN3,9,8,48071,6779,41292,5161.5,753.2222222,6.091163888
NM_001008530,LGMN,15,14,44897,2190,42707,3050.5,146,19.50091324
NM_153647,SLC24A4,18,17,178290,9779,168511,9912.411765,543.2777778,17.23192555
NM_153648,SLC24A4,17,16,178902,9664,169238,10577.375,568.4705882,17.51221026
NM_153646,SLC24A4,17,16,177675,9762,167913,10494.5625,574.2352941,17.20067609
NM_006329,FBLN5,11,10,78293,2644,75649,7564.9,240.3636364,28.61157337
NM_005606,LGMN,14,13,44897,2071,42826,3294.307692,147.9285714,20.67889908
NM_001164782,ATXN3,3,2,48071,6078,41993,20996.5,2026,6.909016124
NM_001164778,ATXN3,7,6,48071,6445,41626,6937.666667,920.7142857,6.458650116
NM_001164776,ATXN3,5,4,48071,6290,41781,10445.25,1258,6.642448331
NM_001164774,ATXN3,4,3,48071,6244,41827,13942.33333,1561,6.698750801
NM_001164777,ATXN3,4,3,48071,6124,41947,13982.33333,1531,6.849608099
NM_004993,ATXN3,11,10,48071,6934,41137,4113.7,630.3636364,5.932650707
NM_020818,UNC79,50,49,374126,8521,365605,7461.326531,170.42,42.90634902
NM_014216,ITPK1,11,10,176197,3383,172814,17281.4,307.5454545,51.08306237
NM_001142594,ITPK1,11,10,179006,2814,176192,17619.2,255.8181818,62.61265103
NM_001142593,ITPK1,11,10,176197,3262,172935,17293.5,296.5454545,53.01502146
NM_001002860,BTBD7,11,10,95544,8512,87032,8703.2,773.8181818,10.22462406
NM_178013,PRIMA1,5,4,70124,3655,66469,16617.25,731,18.18577291
NM_001289133,BTBD7,9,8,95544,7242,88302,11037.75,804.6666667,12.1930406
NM_023112,OTUB2,6,5,22554,3879,18675,3735,646.5,4.814385151
NM_024734,CLMN,13,12,137971,12763,125208,10434,981.7692308,9.810232704
NM_032632,PAPOLA,22,21,64742,4543,60199,2866.619048,206.5,13.25093551
NM_152327,AK7,18,17,97318,3318,94000,5529.411765,184.3333333,28.33031947
NM_001252007,PAPOLA,7,6,33224,4843,28381,4730.166667,691.8571429,5.860210613
NM_001252006,PAPOLA,9,8,33224,4011,29213,3651.625,445.6666667,7.283221142
NM_016337,EVL,14,13,78824,1856,76968,5920.615385,132.5714286,41.46982759
NM_199123,SETD3,9,8,71087,1440,69647,8705.875,160,48.36597222
NM_001127258,HHIPL1,9,8,31533,3471,28062,3507.75,385.6666667,8.084701815
NM_032233,SETD3,13,12,83145,2901,80244,6687,223.1538462,27.66080662
NM_001144995,CCDC85C,6,5,93126,5677,87449,17489.8,946.1666667,15.40408667
NM_004434,EML1,22,21,148652,4485,144167,6865.095238,203.8636364,32.14425864
NM_001008707,EML1,23,22,148652,4543,144109,6550.409091,197.5217391,31.7211094
NM_001161476,WDR25,7,6,153887,1997,151890,25315,285.2857143,76.05908863
NM_024515,WDR25,7,6,153809,2128,151681,25280.16667,304,71.27866541
NM_207117,SLC25A47,6,5,7038,1739,5299,1059.8,289.8333333,3.047153537
NM_001161725,PPP2R5C,16,15,166195,4499,161696,10779.73333,281.1875,35.94043121
NM_002719,PPP2R5C,14,13,118190,4448,113742,8749.384615,317.7142857,25.57149281
NM_181308,WDR20,2,1,70680,2251,68429,68429,1125.5,30.39937805
NM_001242417,WDR20,4,3,70680,2529,68151,22717,632.25,26.94780546
NM_001242416,WDR20,3,2,83823,2428,81395,40697.5,809.3333333,33.52347611
NM_001242415,WDR20,4,3,75154,3086,72068,24022.66667,771.5,23.35320804
NM_001242414,WDR20,3,2,70680,2265,68415,34207.5,755,30.20529801
NM_001242418,WDR20,3,2,70680,2471,68209,34104.5,823.6666667,27.60380413
NM_181291,WDR20,4,3,83823,2612,81211,27070.33333,653,31.09150077
NM_001376,DYNC1H1,78,77,86272,14418,71854,933.1688312,184.8461538,4.983631572
NM_144574,WDR20,3,2,70680,2435,68245,34122.5,811.6666667,28.02669405
NM_001161726,PPP2R5C,15,14,166195,4453,161742,11553,296.8666667,36.32203009
NM_178586,PPP2R5C,13,12,118190,4330,113860,9488.333333,333.0769231,26.29561201
NM_178587,PPP2R5C,12,11,102824,1630,101194,9199.454545,135.8333333,62.08220859
NM_014844,TECPR2,20,19,139520,8706,130814,6884.947368,435.3,15.02572938
NM_145726,TRAF3,11,10,134023,7712,126311,12631.1,701.0909091,16.37850104
NM_145725,TRAF3,12,11,134023,7788,126235,11475.90909,649,16.20891115
NM_001172631,TECPR2,17,16,102710,4414,98296,6143.5,259.6470588,22.26914363
NM_001199427,TRAF3,8,7,134023,7396,126627,18089.57143,924.5,17.12101136
NM_015156,RCOR1,12,11,137919,5768,132151,12013.72727,480.6666667,22.91106103
NM_003300,TRAF3,11,10,134023,7648,126375,12637.5,695.2727273,16.52392782
NM_006035,CDC42BPB,37,36,125028,6738,118290,3285.833333,182.1081081,17.5556545
NM_001128921,MARK3,16,15,118467,3264,115203,7680.2,204,35.29503676
NM_001128919,MARK3,17,16,118467,3520,114947,7184.1875,207.0588235,32.65539773
NM_001128918,MARK3,18,17,118467,3548,114919,6759.941176,197.1111111,32.38979707
NM_001128920,MARK3,16,15,118467,3426,115041,7669.4,214.125,33.57880911
NM_002376,MARK3,16,15,118467,3474,114993,7666.2,217.125,33.10103627
NM_153046,TDRD9,36,35,124189,4800,119389,3411.114286,133.3333333,24.87270833
NM_015316,PPP1R13B,17,16,113841,4976,108865,6804.0625,292.7058824,21.87801447
NM_001014432,AKT1,15,14,26395,2872,23523,1680.214286,191.4666667,8.19045961
NM_001014431,AKT1,14,13,26395,2787,23608,1816,199.0714286,8.470757086
NM_001243127,PACS2,24,23,97338,6195,91143,3962.73913,258.125,14.71234867
NM_001242787,BRF1,18,17,106293,3389,102904,6053.176471,188.2777778,30.36411921
NM_001242786,BRF1,18,17,106293,3455,102838,6049.294118,191.9444444,29.76497829
NM_005163,AKT1,14,13,24253,3002,21251,1634.692308,214.4285714,7.078947368
NM_177533,NUDT14,5,4,8388,872,7516,1879,174.4,8.619266055
NM_001013354,OR11H12,1,0,982,982,NA,NA,982,NA
NM_001005356,POTEG,11,10,31579,1937,29642,2964.2,176.0909091,15.30304595
NM_001145442,POTEM,11,10,36320,6677,29643,2964.3,607,4.439568669
NM_001197287,OR11H2,2,1,1430,1087,343,343,543.5,0.315547378
NM_001005500,OR4M1,1,0,943,943,NA,NA,943,NA
NM_172194,OR4Q3,1,0,943,943,NA,NA,943,NA
NM_001004723,OR4N2,1,0,925,925,NA,NA,925,NA
NM_001005486,OR4K15,1,0,1048,1048,NA,NA,1048,NA
NM_001005483,OR4K5,1,0,973,973,NA,NA,973,NA
NM_001005501,OR4K2,1,0,946,946,NA,NA,946,NA
NM_001004063,OR4K1,1,0,1077,1077,NA,NA,1077,NA
NM_001004717,OR4L1,1,0,940,940,NA,NA,940,NA
NM_001004714,OR4K13,1,0,916,916,NA,NA,916,NA
NM_001004712,OR4K14,1,0,934,934,NA,NA,934,NA
NM_001005503,OR11G2,1,0,1039,1039,NA,NA,1039,NA
NM_001004724,OR4N5,1,0,928,928,NA,NA,928,NA
NM_001004715,OR4K17,1,0,1033,1033,NA,NA,1033,NA
NM_001004480,OR11H6,1,0,994,994,NA,NA,994,NA
NM_182852,CCNB1IP1,8,7,21946,1694,20252,2893.142857,211.75,11.95513577
NM_182849,CCNB1IP1,6,5,21946,1311,20635,4127,218.5,15.73989321
NM_021178,CCNB1IP1,7,6,21946,1512,20434,3405.666667,216,13.51455026
NM_138376,TTC5,10,9,16854,1875,14979,1664.333333,187.5,7.9888
NM_001042618,PARP2,16,15,14292,1864,12428,828.5333333,116.5,6.667381974
NM_005484,PARP2,16,15,14292,1903,12389,825.9333333,118.9375,6.510246978
NM_001004479,OR11H4,1,0,976,976,NA,NA,976,NA
NM_001100814,TMEM55B,7,6,3761,1855,1906,317.6666667,265,1.027493261
NM_144568,TMEM55B,7,6,3761,1834,1927,321.1666667,262,1.050708833
NM_080649,APEX1,5,4,2643,1502,1141,285.25,300.4,0.759653795
NM_000270,PNP,6,5,8629,2427,6202,1240.4,404.5,2.555418212
NM_017807,OSGEP,11,10,8062,1636,6426,642.6,148.7272727,3.927872861
NM_001641,APEX1,5,4,2643,1558,1085,271.25,311.6,0.696405648
NM_001244249,APEX1,5,4,2643,1553,1090,272.5,310.6,0.701867354
NM_080648,APEX1,5,4,2643,1492,1151,287.75,298.4,0.771447721
NM_001109997,KLHL33,4,3,6833,1867,4966,1655.333333,466.75,2.659882164
NM_001110360,RNASE9,4,3,4840,1216,3624,1208,304,2.980263158
NM_001110359,RNASE9,5,4,4840,1252,3588,897,250.4,2.865814696
NM_001110358,RNASE9,4,3,4840,1141,3699,1233,285.25,3.241893076
NM_145250,RNASE11,3,2,7367,1769,5598,2799,589.6666667,3.164499717
NM_001024822,RNASE12,1,0,744,744,NA,NA,744,NA
NM_001012975,RNASE10,1,0,652,652,NA,NA,652,NA
NM_001001673,RNASE9,2,1,4840,1051,3789,3789,525.5,3.605137964
NM_001110357,RNASE9,3,2,4840,1087,3753,1876.5,362.3333333,3.452621895
NM_001110356,RNASE9,3,2,4840,1104,3736,1868,368,3.384057971
NM_001110361,RNASE9,5,4,4840,1177,3663,915.75,235.4,3.112149533
NM_001289110,RNASE9,4,3,4840,1140,3700,1233.333333,285,3.245614035
NM_006683,EDDM3A,2,1,2442,881,1561,1561,440.5,1.77185017
NM_194431,RNASE4,2,1,11827,1348,10479,10479,674,7.773738872
NM_001282193,RNASE4,2,1,16391,1734,14657,14657,867,8.452710496
NM_001282192,RNASE4,3,2,16391,1901,14490,7245,633.6666667,7.62230405
NM_001097577,ANG,2,1,5415,744,4671,4671,372,6.278225806
NM_001145,ANG,2,1,10011,1224,8787,8787,612,7.178921569
NM_002937,RNASE4,2,1,16391,1796,14595,14595,898,8.126391982
NM_001001968,OR6S1,1,0,997,997,NA,NA,997,NA
NM_002933,RNASE1,2,1,1523,821,702,702,410.5,0.855054811
NM_198235,RNASE1,3,2,1523,905,618,309,301.6666667,0.682872928
NM_198234,RNASE1,3,2,1523,893,630,315,297.6666667,0.705487122
NM_198232,RNASE1,2,1,1045,891,154,154,445.5,0.172839506
NM_022360,EDDM3B,2,1,2523,898,1625,1625,449,1.809576837
NM_002935,RNASE3,2,1,947,718,229,229,359,0.318941504
NM_005615,RNASE6,2,1,1418,1063,355,355,531.5,0.333960489
NM_002934,RNASE2,2,1,966,737,229,229,368.5,0.310719132
NM_001282216,NDRG2,15,14,8344,1988,6356,454,132.5333333,3.197183099
NM_001282215,NDRG2,16,15,9015,2038,6977,465.1333333,127.375,3.423454367
NM_001282214,NDRG2,16,15,8265,2241,6024,401.6,140.0625,2.688085676
NM_001282212,NDRG2,15,14,8884,2199,6685,477.5,146.6,3.04001819
NM_201536,NDRG2,15,14,9015,2028,6987,499.0714286,135.2,3.445266272
NM_201535,NDRG2,17,16,9015,2139,6876,429.75,125.8235294,3.214586255
NM_201539,NDRG2,16,15,8344,2048,6296,419.7333333,128,3.07421875
NM_201538,NDRG2,15,14,8344,2005,6339,452.7857143,133.6666667,3.16159601
NM_201537,NDRG2,16,15,9015,2071,6944,462.9333333,129.4375,3.35296958
NM_001256588,SLC39A2,4,3,2622,1417,1205,401.6666667,354.25,0.850388144
NM_022734,METTL17,14,13,7231,1727,5504,423.3846154,123.3571429,3.187029531
NM_201541,NDRG2,16,15,8344,2073,6271,418.0666667,129.5625,3.025084419
NM_201540,NDRG2,17,16,8344,2116,6228,389.25,124.4705882,2.943289225
NM_001029991,METTL17,13,12,7231,1799,5432,452.6666667,138.3846154,3.019455253
NM_001282213,NDRG2,16,15,8344,2253,6091,406.0666667,140.8125,2.703506436
NM_014579,SLC39A2,4,3,2622,1422,1200,400,355.5,0.843881857
NM_016250,NDRG2,16,15,9015,2096,6919,461.2666667,131,3.301049618
NM_001146683,TMEM253,8,7,4789,1534,3255,465,191.75,2.12190352
NM_016423,ZNF219,5,4,8605,3085,5520,1380,617,1.789303079
NM_001278530,ARHGEF40,23,22,19989,5648,14341,651.8636364,245.5652174,2.539128895
NM_001278529,ARHGEF40,24,23,19989,5987,14002,608.7826087,249.4583333,2.338733924
NM_001102454,ZNF219,5,4,14660,2941,11719,2929.75,588.2,3.984699082
NM_001101672,ZNF219,5,4,8970,2951,6019,1504.75,590.2,2.039647577
NM_001012264,RNASE13,2,1,1967,1609,358,358,804.5,0.222498446
NM_032572,RNASE7,2,1,2009,1500,509,509,750,0.339333333
NM_018071,ARHGEF40,24,23,19989,5960,14029,609.9565217,248.3333333,2.35385906
NM_138331,RNASE8,1,0,466,466,NA,NA,466,NA
NM_173846,TPPP2,4,3,1989,801,1188,396,200.25,1.483146067
NM_001004731,OR5AU1,1,0,1090,1090,NA,NA,1090,NA
NM_031314,HNRNPC,9,8,60344,3260,57084,7135.5,362.2222222,17.51042945
NM_001077443,HNRNPC,8,7,60344,3194,57150,8164.285714,399.25,17.89292423
NM_001077442,HNRNPC,8,7,60344,3233,57111,8158.714286,404.125,17.66501701
NM_004500,HNRNPC,9,8,60344,3221,57123,7140.375,357.8888889,17.73455449
NM_007192,SUPT16H,26,25,32796,4710,28086,1123.44,181.1538462,5.963057325
NM_019852,METTL3,11,10,13177,1966,11211,1121.1,178.7272727,5.702441506
NM_032846,RAB2B,8,7,17955,2936,15019,2145.571429,367,5.115463215
NM_014828,TOX4,9,8,21986,4533,17453,2181.625,503.6666667,3.850209574
NM_005407,SALL2,2,1,16107,4914,11193,11193,2457,2.277777778
NM_001163380,RAB2B,7,6,17655,2862,14793,2465.5,408.8571429,5.168763103
NM_001005466,OR10G2,1,0,934,934,NA,NA,934,NA
NM_001005465,OR10G3,1,0,943,943,NA,NA,943,NA
NM_001001912,OR4E2,1,0,943,943,NA,NA,943,NA
NM_001344,DAD1,3,2,24338,700,23638,11819,233.3333333,33.76857143
NM_181307,MRPL52,4,3,5156,1057,4099,1366.333333,264.25,3.877956481
NM_181306,MRPL52,5,4,5156,1131,4025,1006.25,226.2,3.558797524
NM_181304,MRPL52,5,4,5156,1306,3850,962.5,261.2,2.947932619
NM_178336,MRPL52,5,4,5156,1123,4033,1008.25,224.6,3.591273375
NM_001126106,SLC7A7,11,10,46590,2282,44308,4430.8,207.4545455,19.41630149
NM_004995,MMP14,10,9,11068,3604,7464,829.3333333,360.4,2.071032186
NM_005015,OXA1L,10,9,5269,1729,3540,393.3333333,172.9,2.047426258
NM_181305,MRPL52,4,3,5156,1231,3925,1308.333333,307.75,3.188464663
NM_180982,MRPL52,5,4,5156,1120,4036,1009,224,3.603571429
NM_001126105,SLC7A7,11,10,42677,2176,40501,4050.1,197.8181818,18.61259191
NM_198086,AJUBA,6,5,6051,3295,2756,551.2,549.1666667,0.836418816
NM_032876,AJUBA,8,7,11470,4270,7200,1028.571429,533.75,1.68618267
NM_001289097,AJUBA,2,1,4032,1809,2223,2223,904.5,1.228855721
NM_001039619,PRMT5,17,16,9076,2633,6443,402.6875,154.8823529,2.44701861
NM_001282953,PRMT5,16,15,9076,2500,6576,438.4,156.25,2.6304
NM_006109,PRMT5,17,16,9076,2548,6528,408,149.8823529,2.562009419
NM_014045,LRP10,7,6,6333,3257,3076,512.6666667,465.2857143,0.944427387
NM_017815,HAUS4,10,9,10916,1640,9276,1030.666667,164,5.656097561
NM_018107,RBM23,13,12,18544,2569,15975,1331.25,197.6153846,6.218372908
NM_001077352,RBM23,12,11,18544,2514,16030,1457.272727,209.5,6.376292761
NM_001077351,RBM23,14,13,18544,2618,15926,1225.076923,187,6.083269672
NM_001166269,HAUS4,10,9,10916,1648,9268,1029.777778,164.8,5.623786408
NM_001166270,HAUS4,9,8,10916,1504,9412,1176.5,167.1111111,6.257978723
NM_173527,REM2,5,4,4459,1864,2595,648.75,372.8,1.392167382
NM_001282956,PRMT5,13,12,9076,2167,6909,575.75,166.6923077,3.188278726
NM_001282955,PRMT5,16,15,9076,2415,6661,444.0666667,150.9375,2.758178054
NM_001282954,PRMT5,16,15,9076,2513,6563,437.5333333,157.0625,2.611619578
NM_001164817,ACIN1,13,12,13007,2531,10476,873,194.6923077,4.139075464
NM_001164816,ACIN1,12,11,13007,2468,10539,958.0909091,205.6666667,4.270259319
NM_001164815,ACIN1,18,17,37051,4835,32216,1895.058824,268.6111111,6.663081696
NM_001164814,ACIN1,19,18,37051,4917,32134,1785.222222,258.7894737,6.535285743
NM_014977,ACIN1,19,18,37051,4956,32095,1783.055556,260.8421053,6.475988701
NM_144985,CDH24,13,12,10479,3452,7027,585.5833333,265.5384615,2.035631518
NM_022478,CDH24,14,13,10479,3567,6912,531.6923077,254.7857143,1.937762826
NM_001144932,PSMB5,4,3,9296,1383,7913,2637.666667,345.75,5.721619667
NM_002797,PSMB5,3,2,9296,1297,7999,3999.5,432.3333333,6.167309175
NM_017924,C14orf119,2,1,4984,2947,2037,2037,1473.5,0.691211401
NM_001805,CEBPE,2,1,2307,1549,758,758,774.5,0.489347966
NM_001099780,PSMB11,1,0,1895,1895,NA,NA,1895,NA
NM_001130725,PSMB5,3,2,9371,944,8427,4213.5,314.6666667,8.92690678
NM_182728,SLC7A8,9,8,29157,3183,25974,3246.75,353.6666667,8.160226202
NM_001267037,SLC7A8,8,7,29157,3028,26129,3732.714286,378.5,8.629128137
NM_012244,SLC7A8,11,10,58367,4247,54120,5412,386.0909091,12.74311279
NM_001267036,SLC7A8,9,8,30165,3284,26881,3360.125,364.8888889,8.18544458
NM_138460,CMTM5,5,4,2966,1205,1761,440.25,241,1.461410788
NM_001276318,PPP1R3E,5,4,6929,4500,2429,607.25,900,0.539777778
NM_005864,EFS,6,5,9235,3126,6109,1221.8,521,1.954254639
NM_022789,IL25,2,1,3544,1317,2227,2227,658.5,1.690964313
NM_020834,HOMEZ,2,1,12467,3743,8724,8724,1871.5,2.330750735
NM_032459,EFS,5,4,9235,2846,6389,1597.25,569.2,2.24490513
NM_001037288,CMTM5,4,3,2966,1111,1855,618.3333333,277.75,1.669666967
NM_001199864,BCL2L2-PABPN1,9,8,19425,2139,17286,2160.75,237.6666667,8.081346424
NM_001199839,BCL2L2,4,3,4901,3564,1337,445.6666667,891,0.375140292
NM_001288745,CMTM5,3,2,2966,957,2009,1004.5,319,2.099268548
NM_001288744,CMTM5,4,3,2966,1051,1915,638.3333333,262.75,1.822074215
NM_001277174,EFS,6,5,9235,2619,6616,1323.2,436.5,2.526155021
NM_004050,BCL2L2,4,3,4999,3609,1390,463.3333333,902.25,0.385148241
NM_004643,PABPN1,7,6,5999,3109,2890,481.6666667,444.1428571,0.929559344
NM_172314,IL25,3,2,3596,1170,2426,1213,390,2.073504274
NM_001288746,CMTM5,6,5,2966,1407,1559,311.8,234.5,1.108031272
NM_001289050,SLC22A17,9,8,6142,2021,4121,515.125,224.5555556,2.03908956
NM_020372,SLC22A17,9,8,6142,2200,3942,492.75,244.4444444,1.791818182
NM_016609,SLC22A17,10,9,6603,2414,4189,465.4444444,241.4,1.735294118
NM_015514,NGDN,10,9,8506,1598,6908,767.5555556,159.8,4.32290363
NM_001042635,NGDN,11,10,8506,1153,7353,735.3,104.8181818,6.37727667
NM_000257,MYH7,40,39,22925,6070,16855,432.1794872,151.75,2.776771005
NM_032452,JPH4,7,6,10767,4411,6356,1059.333333,630.1428571,1.440943097
NM_005794,DHRS2,9,8,9277,1685,7592,949,187.2222222,4.505637982
NM_182908,DHRS2,9,8,9277,1696,7581,947.625,188.4444444,4.469929245
NM_024328,THTPA,2,1,3601,2212,1389,1389,1106,0.627938517
NM_001256062,THTPA,2,1,3601,1947,1654,1654,973.5,0.84951207
NM_033400,ZFHX2,10,9,30796,9192,21604,2400.444444,919.2,2.350304613
NM_001146028,JPH4,6,5,10767,4284,6483,1296.6,714,1.513305322
NM_001256323,THTPA,3,2,3601,1544,2057,1028.5,514.6666667,1.332253886
NM_001256322,THTPA,2,1,3601,1942,1659,1659,971,0.854273944
NM_001256321,THTPA,3,2,3601,1549,2052,1026,516.3333333,1.324725629
NM_001126339,THTPA,3,2,3601,1814,1787,893.5,604.6666667,0.985115766
NM_001282474,AP1G2,20,19,8275,2775,5500,289.4736842,138.75,1.981981982
NM_003917,AP1G2,22,21,8275,2669,5606,266.952381,121.3181818,2.100412139
NM_001282475,AP1G2,20,19,7963,2563,5400,284.2105263,128.15,2.10690597
NM_001282991,DHRS4,4,3,15546,943,14603,4867.666667,235.75,15.48568399
NM_001282990,DHRS4,6,5,15546,1068,14478,2895.6,178,13.55617978
NM_198083,DHRS4L2,8,7,17592,1382,16210,2315.714286,172.75,11.72937771
NM_001193637,DHRS4L2,6,5,36536,1458,35078,7015.6,243,24.05898491
NM_001193636,DHRS4L2,8,7,36536,1583,34953,4993.285714,197.875,22.08022742
NM_021004,DHRS4,8,7,15546,1307,14239,2034.142857,163.375,10.89441469
NM_001193635,DHRS4L2,9,8,36395,1341,35054,4381.75,149,26.14019389
NM_001282989,DHRS4,5,4,15546,1046,14500,3625,209.2,13.8623327
NM_001282988,DHRS4,7,6,15546,1204,14342,2390.333333,172,11.91196013
NM_001282987,DHRS4,6,5,15546,1099,14447,2889.4,183.1666667,13.1455869
NM_001163484,DCAF11,15,14,10547,3869,6678,477,257.9333333,1.726027397
NM_017999,RNF31,21,20,13213,3577,9636,481.8,170.3333333,2.693877551
NM_016049,EMC9,6,5,2625,841,1784,356.8,140.1666667,2.121284185
NM_203402,FITM1,2,1,1385,1005,380,380,502.5,0.378109453
NM_001281529,PSME1,11,10,2811,978,1833,183.3,88.90909091,1.874233129
NM_006084,IRF9,9,8,5354,1687,3667,458.375,187.4444444,2.173681091
NM_025230,DCAF11,15,14,10467,4319,6148,439.1428571,287.9333333,1.423477657
NM_001281528,PSME1,11,10,2811,1025,1786,178.6,93.18181818,1.742439024
NM_001280558,CPNE6,18,17,7265,2253,5012,294.8235294,125.1666667,2.224589436
NM_001018073,PCK2,7,6,6289,1721,4568,761.3333333,245.8571429,2.654270773
NM_006177,NRL,3,2,4518,1977,2541,1270.5,659,1.285280728
NM_138360,LRRC16B,40,39,17733,4640,13093,335.7179487,116,2.821767241
NM_002818,PSME2,11,10,3283,840,2443,244.3,76.36363636,2.908333333
NM_006032,CPNE6,17,16,6755,2240,4515,282.1875,131.7647059,2.015625
NM_006263,PSME1,11,10,2811,1017,1794,179.4,92.45454545,1.764011799
NM_004563,PCK2,10,9,9858,2231,7627,847.4444444,223.1,3.418646347
NM_181357,DCAF11,15,14,9959,3671,6288,449.1428571,244.7333333,1.712884773
NM_176783,PSME1,10,9,2811,1191,1620,180,119.1,1.360201511
NM_024658,IPO4,30,29,8701,3630,5071,174.862069,121,1.396969697
NM_016576,GMPR2,9,8,6371,1901,4470,558.75,211.2222222,2.351394003
NM_182836,RABGGTA,17,16,6091,1993,4098,256.125,117.2352941,2.056196688
NM_000359,TGM1,15,14,14098,2792,11306,807.5714286,186.1333333,4.049426934
NM_001283022,GMPR2,8,7,6371,2083,4288,612.5714286,260.375,2.058569371
NM_001002002,GMPR2,10,9,6371,1661,4710,523.3333333,166.1,2.83564118
NM_001002001,GMPR2,10,9,6821,1922,4899,544.3333333,192.2,2.548907388
NM_006156,NEDD8,4,3,15521,629,14892,4964,157.25,23.67567568
NM_138476,MDP1,6,5,2135,739,1396,279.2,123.1666667,1.889039242
NM_001199823,NEDD8-MDP1,7,6,18435,779,17656,2942.666667,111.2857143,22.66495507
NM_001199822,MDP1,6,5,2135,787,1348,269.6,131.1666667,1.712833545
NM_001199821,MDP1,5,4,2135,598,1537,384.25,119.6,2.570234114
NM_001283023,GMPR2,9,8,6371,1576,4795,599.375,175.1111111,3.04251269
NM_006405,TM9SF1,6,5,6595,2507,4088,817.6,417.8333333,1.630634224
NM_012461,TINF2,6,5,3031,2183,848,169.6,363.8333333,0.388456253
NM_014169,CHMP4A,6,5,4251,1362,2889,577.8,227,2.121145374
NM_138452,DHRS1,9,8,8864,1481,7383,922.875,164.5555556,4.985145172
NM_001099274,TINF2,9,8,3031,1859,1172,146.5,206.5555556,0.630446477
NM_001136050,DHRS1,9,8,9237,1489,7748,968.5,165.4444444,5.203492277
NM_001184739,TSSK4,4,3,2530,1327,1203,401,331.75,0.906556142
NM_001014842,TM9SF1,5,4,5700,2182,3518,879.5,436.4,1.61228231
NM_004581,RABGGTA,16,15,6091,2309,3782,252.1333333,144.3125,1.637938502
NM_174944,TSSK4,4,3,2530,1297,1233,411,324.25,0.950655359
NM_001289006,TM9SF1,6,5,6595,2301,4294,858.8,383.5,1.866145154
NM_001283021,GMPR2,10,9,6821,2240,4581,509,224,2.045089286
NM_001002000,GMPR2,10,9,6821,1981,4840,537.7777778,198.1,2.4432105
NM_025081,NYNRIN,9,8,20504,7866,12638,1579.75,874,1.606661581
NM_006871,RIPK3,10,9,4017,1931,2086,231.7777778,193.1,1.080269291
NM_019839,LTB4R2,2,1,1904,1506,398,398,753,0.264276228
NM_001039771,CBLN3,3,2,2993,2347,646,323,782.3333333,0.275244994
NM_001198967,NFATC4,11,10,12696,4629,8067,806.7,420.8181818,1.742709008
NM_001198966,NFATC4,10,9,10525,4594,5931,659,459.4,1.291031781
NM_001198592,ADCY4,26,25,16724,3445,13279,531.16,132.5,3.854571843
NM_014430,CIDEB,7,6,6185,2249,3936,656,321.2857143,1.750111161
NM_001198568,ADCY4,25,24,16724,3745,12979,540.7916667,149.8,3.465687583
NM_001164692,LTB4R2,2,1,1904,1562,342,342,781,0.218950064
NM_001136022,NFATC4,10,9,12696,5711,6985,776.1111111,571.1,1.22307827
NM_001143919,LTB4R,2,1,6539,2708,3831,3831,1354,1.414697194
NM_139247,ADCY4,26,25,16724,3441,13283,531.32,132.3461538,3.860215054
NM_001198965,NFATC4,10,9,11586,4615,6971,774.5555556,461.5,1.510509209
NM_004554,NFATC4,10,9,11586,4939,6647,738.5555556,493.9,1.345818992
NM_001288802,NFATC4,9,8,10454,5501,4953,619.125,611.2222222,0.900381749
NM_181657,LTB4R,2,1,4931,4316,615,615,2158,0.142493049
NM_001836,CMA1,5,4,2761,789,1972,493,157.8,2.499366286
NM_020195,SDR39U1,6,5,3037,1237,1800,360,206.1666667,1.455133387
NM_001911,CTSG,5,4,2744,929,1815,453.75,185.8,1.953713671
NM_033423,GZMH,5,4,3242,976,2266,566.5,195.2,2.321721311
NM_001270781,GZMH,4,3,3242,717,2525,841.6666667,179.25,3.521617852
NM_001270780,GZMH,5,4,3242,784,2458,614.5,156.8,3.135204082
NM_004131,GZMB,5,4,3273,931,2342,585.5,186.2,2.515574651
NM_005249,FOXG1,1,0,3207,3207,NA,NA,3207,NA
NM_001135058,COCH,11,10,16083,2893,13190,1319,263,4.559281023
NM_004086,COCH,12,11,16083,2570,13513,1228.454545,214.1666667,5.257976654
NM_007077,AP4S1,6,5,60334,1795,58539,11707.8,299.1666667,32.61225627
NM_001128126,AP4S1,6,5,70982,4245,66737,13347.4,707.5,15.7213192
NM_001254726,AP4S1,5,4,60334,1722,58612,14653,344.4,34.03716609
NM_001254729,AP4S1,6,5,71346,4120,67226,13445.2,686.6666667,16.31699029
NM_001254728,AP4S1,6,5,69809,4602,65207,13041.4,767,14.16927423
NM_001254727,AP4S1,7,6,60334,1918,58416,9736,274,30.45672576
NM_001197184,GPR33,2,1,5003,1079,3924,3924,539.5,3.636700649
NM_080664,DTD2,3,2,11439,2683,8756,4378,894.3333333,3.263510995
NM_001030055,ARHGAP5,7,6,82441,9611,72830,12138.33333,1373,7.577775466
NM_001173,ARHGAP5,7,6,82441,9608,72833,12138.83333,1372.571429,7.580453789
NM_022073,EGLN3,5,4,26865,2727,24138,6034.5,545.4,8.851485149
NM_138288,SPTSSA,2,1,29326,2536,26790,26790,1268,10.56388013
NM_021249,SNX6,13,12,68699,3093,65606,5467.166667,237.9230769,21.21112189
NM_152233,SNX6,14,13,68750,2989,65761,5058.538462,213.5,22.00100368
NM_021914,CFL2,4,3,3437,3129,308,102.6666667,782.25,0.098434004
NM_001243645,CFL2,4,3,4175,3106,1069,356.3333333,776.5,0.344172569
NM_138638,CFL2,4,3,4443,3271,1172,390.6666667,817.75,0.358300214
NM_001146282,SRP54,15,14,46671,2204,44467,3176.214286,146.9333333,20.17558984
NM_003136,SRP54,16,15,46671,2297,44374,2958.266667,143.5625,19.31824118
NM_017917,PPP2R3C,13,12,36843,1847,34996,2916.333333,142.0769231,18.9474824
NM_020529,NFKBIA,6,5,3246,1573,1673,334.6,262.1666667,1.063572791
NM_032594,INSM2,1,0,3014,3014,NA,NA,3014,NA
NM_001144891,MBIP,9,8,22120,1654,20466,2558.25,183.7777778,12.37363966
NM_016586,MBIP,9,8,22120,1657,20463,2557.875,184.1111111,12.34942667
NM_003317,NKX2-1,2,1,3301,2338,963,963,1169,0.411890505
NM_014360,NKX2-8,2,1,2572,1805,767,767,902.5,0.424930748
NM_001079668,NKX2-1,3,2,3828,2184,1644,822,728,0.752747253
NM_006194,PAX9,5,4,20240,3111,17129,4282.25,622.2,5.505946641
NM_004496,FOXA1,2,1,5570,3382,2188,2188,1691,0.646954465
NM_001049,SSTR1,3,2,5066,4294,772,386,1431.333333,0.179785748
NM_175060,CLEC14A,1,0,2372,2372,NA,NA,2372,NA
NM_006364,SEC23A,20,19,71316,3861,67455,3550.263158,193.05,17.47086247
NM_001079537,TRAPPC6B,6,5,22621,3357,19264,3852.8,559.5,5.738456956
NM_002687,PNN,9,8,8037,3615,4422,552.75,401.6666667,1.223236515
NM_177452,TRAPPC6B,5,4,22621,3272,19349,4837.25,654.4,5.913508557
NM_203356,CTAGE5,24,23,84897,3535,81362,3537.478261,147.2916667,23.01612447
NM_203355,CTAGE5,23,22,84071,3574,80497,3658.954545,155.3913043,22.52294348
NM_203354,CTAGE5,24,23,85923,3455,82468,3585.565217,143.9583333,23.86917511
NM_001247990,CTAGE5,24,23,84071,3609,80462,3498.347826,150.375,22.29481851
NM_001247989,CTAGE5,24,23,84071,3719,80352,3493.565217,154.9583333,21.60580801
NM_001247988,CTAGE5,23,22,84897,3405,81492,3704.181818,148.0434783,23.93303965
NM_005930,CTAGE5,24,23,84071,3704,80367,3494.217391,154.3333333,21.69735421
NM_203301,FBXO33,4,3,36129,5153,30976,10325.33333,1288.25,6.011255579
NM_032135,FSCB,1,0,3147,3147,NA,NA,3147,NA
NM_017658,KLHL28,5,4,37654,6556,31098,7774.5,1311.2,4.743441123
NM_001017923,C14orf28,5,4,9955,2911,7044,1761,582.2,2.419787015
NM_002013,FKBP3,7,6,18932,1354,17578,2929.666667,193.4285714,12.98227474
NM_017922,PRPF39,14,13,31504,2882,28622,2201.692308,205.8571429,9.93129771
NM_018353,MIS18BP1,17,16,50214,4794,45420,2838.75,282,9.474342929
NM_080746,RPL10L,1,0,810,810,NA,NA,810,NA
NM_001030001,RPS29,3,2,9746,1417,8329,4164.5,472.3333333,5.87791108
NM_001032,RPS29,3,2,2846,339,2507,1253.5,113,7.395280236
NM_001083908,DNAAF2,2,1,10058,2821,7237,7237,1410.5,2.56540234
NM_001197331,POLE2,17,16,38201,1775,36426,2276.625,104.4117647,20.52169014
NM_001197330,POLE2,18,17,44830,1801,43029,2531.117647,100.0555556,23.89172682
NM_001001,RPL36AL,2,1,1999,579,1420,1420,289.5,2.452504318
NM_002692,POLE2,19,18,44830,1880,42950,2386.111111,98.94736842,22.84574468
NM_002408,MGAT2,1,0,2712,2712,NA,NA,2712,NA
NM_018139,DNAAF2,3,2,10058,2966,7092,3546,988.6666667,2.391099123
NM_014315,KLHDC2,13,12,15071,1819,13252,1104.333333,139.9230769,7.285321605
NM_004713,NEMF,33,32,69009,4154,64855,2026.71875,125.8787879,15.61266249
NM_001663,ARF6,2,1,4038,3941,97,97,1970.5,0.024613042
NM_024558,VCPKMT,6,5,7949,1790,6159,1231.8,298.3333333,3.440782123
NM_001040662,VCPKMT,5,4,7949,1684,6265,1566.25,336.8,3.720308789
NM_001014830,C14orf183,5,4,8994,980,8014,2003.5,196,8.17755102
NM_015684,ATP5S,3,2,10698,1362,9336,4668,454,6.854625551
NM_001003805,ATP5S,4,3,13901,1677,12224,4074.666667,419.25,7.289206917
NM_001003803,ATP5S,5,4,13901,1850,12051,3012.75,370,6.514054054
NM_015915,ATL1,14,13,73043,2659,70384,5414.153846,189.9285714,26.47010154
NM_001127713,ATL1,14,13,99986,2828,97158,7473.692308,202,34.35572843
NM_181598,ATL1,13,12,73043,2643,70400,5866.666667,203.3076923,26.63639803
NM_181814,ABHD12B,11,10,32812,1488,31324,3132.4,135.2727273,21.05107527
NM_001206673,ABHD12B,13,12,32812,1721,31091,2590.916667,132.3846154,18.0656595
NM_030755,TMX1,8,7,17488,4111,13377,1911,513.875,3.25395281
NM_001267047,FRMD6,5,4,13445,3613,9832,2458,722.6,2.721284251
NM_007361,NID2,22,21,64428,5068,59360,2826.666667,230.3636364,11.71270718
NM_016039,C14orf166,8,7,15194,1059,14135,2019.285714,132.375,13.34749764
NM_001281469,PTGDR,3,2,9013,3036,5977,2988.5,1012,1.968708827
NM_000953,PTGDR,2,1,9013,2944,6069,6069,1472,2.061480978
NM_000956,PTGER2,2,1,14308,2480,11828,11828,1240,4.769354839
NM_002806,PSMC6,14,13,20822,1607,19215,1478.076923,114.7857143,11.95706285
NM_014584,ERO1L,16,15,53816,3326,50490,3366,207.875,15.18039687
NM_198066,GNPNAT1,6,5,16477,3934,12543,2508.6,655.6666667,3.188357905
NM_001202,BMP4,4,3,7101,1945,5156,1718.666667,486.25,2.650899743
NM_130851,BMP4,4,3,4817,1790,3027,1009,447.5,1.691061453
NM_130850,BMP4,4,3,7101,1736,5365,1788.333333,434,3.090437788
NM_005776,CNIH1,5,4,14503,1428,13075,3268.75,285.6,9.156162465
NM_005192,CDKN3,8,7,23263,899,22364,3194.857143,112.375,24.87652948
NM_001130851,CDKN3,7,6,23263,778,22485,3747.5,111.1428571,28.90102828
NM_006568,CGRRF1,6,5,28749,1329,27420,5484,221.5,20.63205418
NM_004124,GMFB,7,6,14537,4132,10405,1734.166667,590.2857143,2.518151016
NM_001161577,SAMD4A,9,8,38529,5579,32950,4118.75,619.8888889,5.906076358
NM_199421,SOCS4,3,2,22364,7015,15349,7674.5,2338.333333,2.188025659
NM_144578,MAPK1IP1L,4,3,18552,6473,12079,4026.333333,1618.25,1.866059014
NM_080867,SOCS4,2,1,22364,6885,15479,15479,3442.5,2.24822077
NM_002306,LGALS3,6,5,16215,1006,15209,3041.8,167.6666667,15.11829026
NM_001177388,LGALS3,6,5,16215,733,15482,3096.4,122.1666667,21.12141883
NM_001146015,DLGAP5,20,19,43564,3104,40460,2129.473684,155.2,13.03479381
NM_014750,DLGAP5,19,18,43564,3012,40552,2252.888889,158.5263158,13.46347942
NM_017943,FBXO34,2,1,82310,3468,78842,78842,1734,22.73414072
NM_152231,FBXO34,2,1,80931,2833,78098,78098,1416.5,27.56724321
NM_199047,TBPL2,7,6,26335,1302,25033,4172.166667,186,19.2265745
NM_017799,TMEM260,16,15,69723,4279,65444,4362.933333,267.4375,15.29422762
NM_172337,OTX2,3,2,4958,2108,2850,1425,702.6666667,1.35199241
NM_021728,OTX2,5,4,9771,2211,7560,1890,442.2,3.4192673
NM_001270525,OTX2,3,2,4958,2132,2826,1413,710.6666667,1.325515947
NM_001270524,OTX2,4,3,9771,2339,7432,2477.333333,584.75,3.177426251
NM_001270523,OTX2,5,4,9771,2187,7584,1896,437.4,3.46776406
NM_018229,AP5M1,8,7,21193,3103,18090,2584.285714,387.875,5.829842088
NM_001011713,NAA30,5,4,22197,4480,17717,4429.25,896,3.9546875
NM_001283058,C14orf105,6,5,24565,3144,21421,4284.2,524,6.813295165
NM_018168,C14orf105,6,5,24565,3100,21465,4293,516.6666667,6.924193548
NM_001283060,C14orf105,6,5,15084,1031,14053,2810.6,171.8333333,13.63045587
NM_001283056,C14orf105,7,6,24565,3221,21344,3557.333333,460.1428571,6.626513505
NM_001283057,C14orf105,6,5,24565,3097,21468,4293.6,516.1666667,6.931869551
NM_001283059,C14orf105,6,5,24565,3124,21441,4288.2,520.6666667,6.863316261
NM_018477,ACTR10,13,12,35522,2454,33068,2755.666667,188.7692308,13.47514262
NM_023000,ARID4A,24,23,75231,5634,69597,3025.956522,234.75,12.35303514
NM_002892,ARID4A,24,23,75231,5796,69435,3018.913043,241.5,11.97981366
NM_023001,ARID4A,23,22,75231,5588,69643,3165.590909,242.9565217,12.46295634
NM_012460,TIMM9,6,5,18864,1084,17780,3556,180.6666667,16.40221402
NM_207377,TOMM20L,5,4,12777,615,12162,3040.5,123,19.77560976
NM_016475,JKAMP,7,6,20965,2424,18541,3090.166667,346.2857143,7.648927393
NM_022571,GPR135,1,0,1821,1821,NA,NA,1821,NA
NM_001284203,JKAMP,7,6,20965,2456,18509,3084.833333,350.8571429,7.536237785
NM_001098625,JKAMP,7,6,20965,2406,18559,3093.166667,343.7142857,7.713632585
NM_144581,L3HYPDH,5,4,11669,1386,10283,2570.75,277.2,7.419191919
NM_001284204,JKAMP,6,5,20965,2346,18619,3723.8,391,7.936487639
NM_001284202,JKAMP,8,7,20965,2534,18431,2633,316.75,7.273480663
NM_001284201,JKAMP,7,6,20965,2947,18018,3003,421,6.114014252
NM_206852,RTN1,7,6,34840,1711,33129,5521.5,244.4285714,19.36236119
NM_016029,DHRS7,7,6,20713,1395,19318,3219.666667,199.2857143,13.84802867
NM_022495,PCNXL4,10,9,42905,3942,38963,4329.222222,394.2,9.884069001
NM_021003,PPM1A,6,5,49841,8210,41631,8326.2,1368.333333,5.070767357
NM_177952,PPM1A,6,5,53337,8075,45262,9052.4,1345.833333,5.605201238
NM_177951,PPM1A,4,3,39308,4321,34987,11662.33333,1080.25,8.096968294
NM_007374,SIX6,2,1,2589,1477,1112,1112,738.5,0.752877454
NM_005982,SIX1,2,1,4740,2689,2051,2051,1344.5,0.762737077
NM_017420,SIX4,3,2,14598,6278,8320,4160,2092.666667,1.325262823
NM_020810,TRMT5,5,4,9617,5286,4331,1082.75,1057.2,0.81933409
NM_001017970,TMEM30B,1,0,4443,4443,NA,NA,4443,NA
NM_001530,HIF1A,15,14,52860,4074,48786,3484.714286,271.6,11.97496318
NM_181054,HIF1A,14,13,52860,3946,48914,3762.615385,281.8571429,12.39584389
NM_001243084,HIF1A,15,14,50639,3971,46668,3333.428571,264.7333333,11.75220348
NM_145171,GPHB5,3,2,6046,545,5501,2750.5,181.6666667,10.09357798
NM_030791,SGPP1,3,2,43823,3311,40512,20256,1103.666667,12.23557838
NM_182910,SYNE2,9,8,10497,2590,7907,988.375,287.7777778,3.052895753
NM_182913,SYNE2,11,10,12310,2700,9610,961,245.4545455,3.559259259
NM_006977,ZBTB25,3,2,17001,1580,15421,7710.5,526.6666667,9.760126582
NM_001123329,ZBTB1,2,1,20379,3840,16539,16539,1920,4.30703125
NM_021979,HSPA2,1,0,2770,2770,NA,NA,2770,NA
NM_014950,ZBTB1,3,2,29118,4122,24996,12498,1374,6.064046579
NM_004857,AKAP5,2,1,9006,6489,2517,2517,3244.5,0.387887194
NM_172365,PPP1R36,12,11,39478,1417,38061,3460.090909,118.0833333,26.86026817
NM_015549,PLEKHG3,15,14,39869,4415,35454,2532.428571,294.3333333,8.030351076
NM_001204064,CHURC1,3,2,21007,3542,17465,8732.5,1180.666667,4.93083004
NM_001204063,CHURC1,4,3,21007,3614,17393,5797.666667,903.5,4.812672939
NM_145165,CHURC1,4,3,21007,3617,17390,5796.666667,904.25,4.807851811
NM_002083,GPX2,2,1,3755,1090,2665,2665,545,2.444954128
NM_198686,RAB15,7,6,26345,3398,22947,3824.5,485.4285714,6.753090053
NM_002028,FNTB,12,11,75865,2831,73034,6639.454545,235.9166667,25.79795125
NM_145114,MAX,4,3,18807,941,17866,5955.333333,235.25,18.98618491
NM_001271068,MAX,3,2,18807,913,17894,8947,304.3333333,19.59912377
NM_145113,MAX,6,5,27422,2147,25275,5055,357.8333333,11.77224034
NM_145112,MAX,4,3,27422,2017,25405,8468.333333,504.25,12.59543877
NM_002382,MAX,5,4,27422,2045,25377,6344.25,409,12.40929095
NM_173526,FAM71D,9,8,39159,1799,37360,4670,199.8888889,20.76709283
NM_004094,EIF2S1,8,7,26201,4173,22028,3146.857143,521.625,5.278696382
NM_016445,PLEK2,9,8,25130,1469,23661,2957.625,163.2222222,16.10687543
NM_015994,ATP6V1D,9,8,22141,1815,20326,2540.75,201.6666667,11.19889807
NM_182526,TMEM229B,3,2,45040,4071,40969,20484.5,1357,10.06362073
NM_001172,ARG2,8,7,31859,1988,29871,4267.285714,248.5,15.02565392
NM_006370,VTI1B,6,5,23737,1336,22401,4480.2,222.6666667,16.76721557
NM_004569,PIGH,4,3,10996,1442,9554,3184.666667,360.5,6.625520111
NM_015346,ZFYVE26,42,41,70071,9717,60354,1472.04878,231.3571429,6.211176289
NM_152443,RDH12,9,8,32567,1887,30680,3835,209.6666667,16.25861155
NM_001244698,ZFP36L1,3,2,6261,3157,3104,1552,1052.333333,0.98321191
NM_001244701,ZFP36L1,3,2,8590,3199,5391,2695.5,1066.333333,1.685214129
NM_004926,ZFP36L1,2,1,6261,3873,2388,2388,1936.5,0.616576297
NM_001130005,ACTN1,21,20,105245,3731,101514,5075.7,177.6666667,27.20825516
NM_001102,ACTN1,21,20,105245,3746,101499,5074.95,178.3809524,27.09530166
NM_001130004,ACTN1,22,21,105245,3813,101432,4830.095238,173.3181818,26.60162602
NM_001193360,EXD2,10,9,52545,5042,47503,5278.111111,504.2,9.421459738
NM_018199,EXD2,8,7,52545,4576,47969,6852.714286,572,10.48273601
NM_001193363,EXD2,9,8,52256,5116,47140,5892.5,568.4444444,9.214229867
NM_001193362,EXD2,10,9,52256,5201,47055,5228.333333,520.1,9.047298596
NM_001193361,EXD2,9,8,52545,4957,47588,5948.5,550.7777778,9.600161388
NM_001252151,SLC39A9,7,6,64013,4857,59156,9859.333333,693.8571429,12.17953469
NM_001252148,SLC39A9,6,5,63724,5360,58364,11672.8,893.3333333,10.88880597
NM_001252152,SLC39A9,8,7,64013,4846,59167,8452.428571,605.75,12.20945109
NM_001252150,SLC39A9,7,6,63724,2096,61628,10271.33333,299.4285714,29.40267176
NM_018375,SLC39A9,7,6,63724,5430,58294,9715.666667,775.7142857,10.73554328
NM_001271507,CCDC177,2,1,5071,4181,890,890,2090.5,0.212867735
NM_006925,SRSF5,8,7,4890,1525,3365,480.7142857,190.625,2.206557377
NM_001039465,SRSF5,8,7,4895,1659,3236,462.2857143,207.375,1.950572634
NM_001204090,COX16,3,2,34652,1648,33004,16502,549.3333333,20.02669903
NM_016468,COX16,4,3,34652,1721,32931,10977,430.25,19.13480535
NM_018373,SYNJ2BP,4,3,50596,7064,43532,14510.66667,1766,6.162514156
NM_001202547,SYNJ2BP-COX16,6,5,92011,1961,90050,18010,326.8333333,45.92044875
NM_001202548,SYNJ2BP-COX16,6,5,92011,1934,90077,18015.4,322.3333333,46.57549121
NM_001202549,SYNJ2BP-COX16,5,4,92011,1861,90150,22537.5,372.2,48.44169801
NM_003814,ADAM20,2,1,12656,2794,9862,9862,1397,3.529706514
NM_003813,ADAM21,2,1,7750,2666,5084,5084,1333,1.906976744
NM_015351,TTC9,3,2,33575,5220,28355,14177.5,1740,5.431992337
NM_001284211,MED6,9,8,17471,1709,15762,1970.25,189.8888889,9.22293739
NM_005466,MED6,8,7,17471,2394,15077,2153.857143,299.25,6.297827903
NM_001284210,MED6,7,6,17471,2277,15194,2532.333333,325.2857143,6.672815108
NM_001284209,MED6,8,7,17471,2415,15056,2150.857143,301.875,6.23436853
NM_033141,MAP3K9,13,12,86647,11224,75423,6285.25,863.3846154,6.719796864
NM_001284231,MAP3K9,12,11,60928,10754,50174,4561.272727,896.1666667,4.665612795
NM_001284232,MAP3K9,11,10,60928,10707,50221,5022.1,973.3636364,4.690482862
NM_001284230,MAP3K9,12,11,86647,11181,75466,6860.545455,931.75,6.749485735
NM_001281735,ZFYVE1,9,8,17513,2637,14876,1859.5,293,5.641259006
NM_001281734,ZFYVE1,12,11,57769,4462,53307,4846.090909,371.8333333,11.94688481
NM_021260,ZFYVE1,12,11,57769,4504,53265,4842.272727,375.3333333,11.82615453
NM_178441,ZFYVE1,9,8,17513,2642,14871,1858.875,293.5555556,5.628690386
NM_173462,PAPLN,26,25,37144,5859,31285,1251.4,225.3461538,5.339648404
NM_203309,HEATR4,17,16,80464,3489,76975,4810.9375,205.2352941,22.06219547
NM_001037161,ACOT1,3,2,6572,1606,4966,2483,535.3333333,3.092154421
NM_001220484,HEATR4,18,17,80464,3569,76895,4523.235294,198.2777778,21.54525077
NM_024644,C14orf169,1,0,2463,2463,NA,NA,2463,NA
NM_006821,ACOT2,3,2,6601,1782,4819,2409.5,594,2.704264871
NM_006029,PNMA1,1,0,2644,2644,NA,NA,2644,NA
NM_031427,DNAL1,8,7,58855,8532,50323,7189,1066.5,5.898148148
NM_001037162,ACOT6,2,1,3046,1006,2040,2040,503,2.027833002
NM_001201366,DNAL1,9,8,58855,8579,50276,6284.5,953.2222222,5.860356685
NM_152331,ACOT4,3,2,4062,1635,2427,1213.5,545,1.48440367
NM_001242928,ZNF410,13,12,45675,2740,42935,3577.916667,210.7692308,15.66970803
NM_001242924,ZNF410,14,13,45675,2817,42858,3296.769231,201.2142857,15.21405751
NM_021188,ZNF410,12,11,45675,2646,43029,3911.727273,220.5,16.26190476
NM_152445,FAM161B,9,8,17424,3605,13819,1727.375,400.5555556,3.833287101
NM_182480,COQ6,12,11,13178,1614,11564,1051.272727,134.5,7.164807931
NM_182476,COQ6,12,11,12860,1611,11249,1022.636364,134.25,6.982619491
NM_001242927,ZNF410,11,10,45675,2426,43249,4324.9,220.5454545,17.82728772
NM_001242926,ZNF410,11,10,45675,2504,43171,4317.1,227.6363636,17.2408147
NM_001146155,PTGR2,10,9,33623,2562,31061,3451.222222,256.2,12.12373146
NM_001146154,PTGR2,10,9,33636,2514,31122,3458,251.4,12.37947494
NM_152444,PTGR2,10,9,33549,2604,30945,3438.333333,260.4,11.88364055
NM_025057,CCDC176,12,11,46739,3119,43620,3965.454545,259.9166667,13.98525168
NM_001278594,ALDH6A1,12,11,26830,4859,21971,1997.363636,404.9166667,4.521712286
NM_005589,ALDH6A1,12,11,26830,4696,22134,2012.181818,391.3333333,4.713373083
NM_001278593,ALDH6A1,12,11,26830,4657,22173,2015.727273,388.0833333,4.761219669
NM_018228,VRTN,2,1,11547,3418,8129,8129,1709,2.378291398
NM_005050,ABCD4,19,18,17789,3176,14613,811.8333333,167.1578947,4.601070529
NM_001272007,ISCA2,3,2,1850,975,875,437.5,325,0.897435897
NM_006432,NPC2,5,4,13443,902,12541,3135.25,180.4,13.90354767
NM_194279,ISCA2,4,3,1850,1092,758,252.6666667,273,0.694139194
NM_001105579,SYNDIG1L,4,3,20211,2611,17600,5866.666667,652.75,6.740712371
NM_001039479,AREL1,20,19,51854,5465,46389,2441.526316,273.25,8.488380604
NM_015962,FCF1,8,7,23542,2413,21129,3018.428571,301.625,8.756319934
NM_001243007,PROX2,4,3,10803,3882,6921,2307,970.5,1.782843895
NM_001244883,DLST,7,6,10002,1236,8766,1461,176.5714286,7.09223301
NM_001080408,PROX2,3,2,10803,3200,7603,3801.5,1066.666667,2.3759375
NM_002632,PGF,7,6,13936,1918,12018,2003,274,6.265901981
NM_031464,RPS6KL1,11,10,18490,5206,13284,1328.4,473.2727273,2.551671149
NM_014239,EIF2B2,8,7,6684,1549,5135,733.5714286,193.625,3.315041963
NM_001207012,PGF,6,5,13936,1854,12082,2416.4,309,6.516720604
NM_203488,ACYP1,4,3,10810,690,10120,3373.333333,172.5,14.66666667
NM_024643,ZC2HC1C,3,2,10412,3989,6423,3211.5,1329.666667,1.610177989
NM_033116,NEK9,22,21,44962,5565,39397,1876.047619,252.9545455,7.079424978
NM_001107,ACYP1,3,2,10810,610,10200,5100,203.3333333,16.72131148
NM_001042430,ZC2HC1C,3,2,10412,3474,6938,3469,1158,1.997121474
NM_005252,FOS,4,3,3458,2162,1296,432,540.5,0.599444958
NM_130469,JDP2,4,3,44346,3995,40351,13450.33333,998.75,10.10037547
NM_001135048,JDP2,4,3,44486,3781,40705,13568.33333,945.25,10.76567046
NM_001135047,JDP2,4,3,44897,3789,41108,13702.66667,947.25,10.84930061
NM_001135049,JDP2,4,3,40569,3948,36621,12207,987,9.275835866
NM_006399,BATF,3,2,24552,943,23609,11804.5,314.3333333,25.03605514
NM_007176,C14orf1,5,4,10307,1545,8762,2190.5,309,5.671197411
NM_017791,FLVCR2,10,9,69574,3664,65910,7323.333333,366.4,17.98853712
NM_001195283,FLVCR2,10,9,42709,2782,39927,4436.333333,278.2,14.3519051
NM_001255995,IFT43,4,3,73540,903,72637,24212.33333,225.75,80.43964563
NM_003239,TGFB3,7,6,23652,3190,20462,3410.333333,455.7142857,6.414420063
NM_014909,VASH1,7,6,21130,6037,15093,2515.5,862.4285714,2.500082823
NM_015305,ANGEL1,10,9,25699,4121,21578,2397.555556,412.1,5.236107741
NM_024496,IRF2BPL,1,0,4158,4158,NA,NA,4158,NA
NM_033426,CIPC,4,3,19054,4352,14702,4900.666667,1088,3.378216912
NM_174976,ZDHHC22,3,2,10523,3411,7112,3556,1137,2.085019056
NM_213601,TMED8,6,5,35284,984,34300,6860,164,34.85772358
NM_145870,GSTZ1,9,8,10712,1344,9368,1171,149.3333333,6.970238095
NM_145871,GSTZ1,8,7,10712,1217,9495,1356.428571,152.125,7.801972062
NM_013382,POMT2,21,20,45928,4895,41033,2051.65,233.0952381,8.382635342
NM_001513,GSTZ1,10,9,10236,1435,8801,977.8888889,143.5,6.133101045
NM_021257,NGB,4,3,5823,1880,3943,1314.333333,470,2.097340426
NM_012111,AHSA1,9,8,11444,1409,10035,1254.375,156.5555556,7.122072392
NM_001113475,NOXRED1,6,5,29036,1862,27174,5434.8,310.3333333,14.59398496
NM_199296,ISM2,7,6,24474,2997,21477,3579.5,428.1428571,7.166166166
NM_022067,VIPAS39,21,20,30967,2861,28106,1405.3,136.2380952,9.823837819
NM_001193314,VIPAS39,20,19,30967,2989,27978,1472.526316,149.45,9.360321178
NM_001193317,VIPAS39,20,19,30967,2766,28201,1484.263158,138.3,10.1955893
NM_001193316,VIPAS39,19,18,30967,2441,28526,1584.777778,128.4736842,11.68619418
NM_001193315,VIPAS39,20,19,30967,2589,28378,1493.578947,129.45,10.9609888
NM_182509,ISM2,6,5,24474,2650,21824,4364.8,441.6666667,8.235471698
NM_031210,SLIRP,4,3,9529,412,9117,3039,103,22.12864078
NM_006020,ALKBH1,6,5,35609,2591,33018,6603.6,431.8333333,12.74334234
NM_001173978,C14orf178,2,1,8914,634,8280,8280,317,13.05993691
NM_012245,SNW1,14,13,43555,2139,41416,3185.846154,152.7857143,19.36231884
NM_001267864,SLIRP,4,3,9529,428,9101,3033.666667,107,21.26401869
NM_001267863,SLIRP,4,3,9529,406,9123,3041,101.5,22.47044335
NM_174943,C14orf178,3,2,8914,649,8265,4132.5,216.3333333,12.73497689
NM_013989,DIO2,2,1,14104,6143,7961,7961,3071.5,1.295946606
NM_001242503,DIO2,3,2,13998,6172,7826,3913,2057.333333,1.267984446
NM_001242502,DIO2,4,3,13998,6281,7717,2572.333333,1570.25,1.228626015
NM_001007023,DIO2,3,2,13998,6146,7852,3926,2048.666667,1.277578913
NM_000793,DIO2,4,3,33531,6376,27155,9051.666667,1594,4.258939774
NM_001244984,SEL1L,8,7,35053,1665,33388,4769.714286,208.125,20.05285285
NM_005065,SEL1L,21,20,62316,7948,54368,2718.4,378.4761905,6.84046301
NM_013231,FLRT2,2,1,97784,7181,90603,90603,3590.5,12.61704498
NM_000153,GALC,17,16,60259,3900,56359,3522.4375,229.4117647,14.45102564
NM_001201402,GALC,17,16,60653,3881,56772,3548.25,228.2941176,14.62818861
NM_001201401,GALC,16,15,60259,3830,56429,3761.933333,239.375,14.73342037
NM_024824,ZC3H14,17,16,50602,4211,46391,2899.4375,247.7058824,11.01662313
NM_001160103,ZC3H14,17,16,50602,4208,46394,2899.625,247.5294118,11.02519011
NM_001160104,ZC3H14,17,16,50602,4193,46409,2900.5625,246.6470588,11.06820892
NM_207662,ZC3H14,7,6,19125,3027,16098,2683,432.4285714,5.318136769
NM_207661,ZC3H14,15,14,50164,3664,46500,3321.428571,244.2666667,12.69104803
NM_207660,ZC3H14,14,13,50602,3737,46865,3605,266.9285714,12.54080813
NM_198310,TTC8,14,13,53845,2224,51621,3970.846154,158.8571429,23.21088129
NM_144596,TTC8,16,15,53845,2346,51499,3433.266667,146.625,21.95183291
NM_198309,TTC8,15,14,53845,2315,51530,3680.714286,154.3333333,22.25917927
NM_001288782,TTC8,14,13,53845,2312,51533,3964.076923,165.1428571,22.28935986
NM_001288781,TTC8,16,15,53845,2394,51451,3430.066667,149.625,21.49164578
NM_001288783,TTC8,15,14,53845,2285,51560,3682.857143,152.3333333,22.56455142
NM_001284266,EFCAB11,6,5,31502,1934,29568,5913.6,322.3333333,15.2885212
NM_001284268,EFCAB11,6,5,31282,1945,29337,5867.4,324.1666667,15.08329049
NM_002802,PSMC1,11,10,16074,1597,14477,1447.7,145.1818182,9.065122104
NM_017970,NRDE2,14,13,54085,4024,50061,3850.846154,287.4285714,12.44060636
NM_006888,CALM1,6,5,11294,4262,7032,1406.4,710.3333333,1.649929611
NM_003485,GPR68,2,1,21350,2816,18534,18534,1408,6.581676136
NM_001177676,GPR68,2,1,11978,2862,9116,9116,1431,3.185185185
NM_001284281,SMEK1,13,12,53001,3909,49092,4091,300.6923077,12.55871067
NM_001284280,SMEK1,15,14,53001,4589,48412,3458,305.9333333,10.54957507
NM_004239,TRIP11,21,20,72162,8109,64053,3202.65,386.1428571,7.89900111
NM_017437,CPSF2,16,15,42247,5088,37159,2477.266667,318,7.303262579
NM_004545,NDUFB1,3,2,5687,422,5265,2632.5,140.6666667,12.47630332
NM_005113,GOLGA5,13,12,45732,2980,42752,3562.666667,229.2307692,14.34630872
NM_001275,CHGA,8,7,12195,2051,10144,1449.142857,256.375,4.945880059
NM_032490,C14orf142,2,1,4224,1178,3046,3046,589,2.58573854
NM_022151,MOAP1,3,2,2710,2420,290,145,806.6666667,0.119834711
NM_015676,TMEM251,2,1,2137,911,1226,1226,455.5,1.345773875
NM_001098621,TMEM251,2,1,2052,1279,773,773,639.5,0.604378421
NM_175748,UBR7,11,10,22162,3705,18457,1845.7,336.8181818,4.981646424
NM_182971,COX8C,2,1,1165,533,632,632,266.5,1.185741088
NM_018167,BTBD7,4,3,45466,2625,42841,14280.33333,656.25,16.32038095
NM_016150,ASB2,8,7,23270,2764,20506,2929.428571,345.5,7.418958032
NM_001207072,FAM181A,2,1,2225,1654,571,571,827,0.3452237
NM_001207071,FAM181A,2,1,10716,1513,9203,9203,756.5,6.082617317
NM_001207074,FAM181A,2,1,2268,1470,798,798,735,0.542857143
NM_001207073,FAM181A,2,1,2267,1524,743,743,762,0.487532808
NM_138344,FAM181A,3,2,10716,1837,8879,4439.5,612.3333333,4.833424061
NM_001202429,ASB2,10,9,42579,2791,39788,4420.888889,279.1,14.25582229
NM_032036,IFI27L2,4,3,1841,471,1370,456.6666667,117.75,2.908704883
NM_001288959,IFI27,4,3,5959,506,5453,1817.666667,126.5,10.77667984
NM_145249,IFI27L1,5,4,21423,720,20703,5175.75,144,28.75416667
NM_020414,DDX24,9,8,30292,2957,27335,3416.875,328.5555556,9.244166385
NM_001288960,IFI27,4,3,5959,510,5449,1816.333333,127.5,10.68431373
NM_001288958,IFI27,5,4,5959,590,5369,1342.25,118,9.1
NM_001288957,IFI27,5,4,5877,725,5152,1288,145,7.106206897
NM_001288956,IFI27,5,4,5959,622,5337,1334.25,124.4,8.580385852
NM_001288954,IFI27,6,5,5959,714,5245,1049,119,7.345938375
NM_001288952,IFI27,6,5,5959,710,5249,1049.8,118.3333333,7.392957746
NM_206949,IFI27L1,5,4,21423,674,20749,5187.25,134.8,30.78486647
NM_005532,IFI27,5,4,5959,660,5299,1324.75,132,8.028787879
NM_001130080,IFI27,5,4,5959,656,5303,1325.75,131.2,8.083841463
NM_001288995,IFI27,5,4,5959,626,5333,1333.25,125.2,8.519169329
NM_016186,SERPINA10,5,4,9713,2458,7255,1813.75,491.6,2.951586656
NM_020958,PPP4R4,5,4,53535,906,52629,13157.25,181.2,58.08940397
NM_001100607,SERPINA10,5,4,9960,2125,7835,1958.75,425,3.687058824
NM_058237,PPP4R4,25,24,105425,3893,101532,4230.5,155.72,26.08065759
NM_001127706,SERPINA1,6,5,13947,3309,10638,2127.6,551.5,3.21486854
NM_001127707,SERPINA1,6,5,13947,3306,10641,2128.2,551,3.218693285
NM_001127705,SERPINA1,7,6,13947,3517,10430,1738.333333,502.4285714,2.965595678
NM_001127704,SERPINA1,7,6,13947,3499,10448,1741.333333,499.8571429,2.985995999
NM_001127703,SERPINA1,7,6,13947,3502,10445,1740.833333,500.2857143,2.982581382
NM_001756,SERPINA6,5,4,19105,1497,17608,4402,299.4,11.76219105
NM_000295,SERPINA1,5,4,12071,3225,8846,2211.5,645,2.742945736
NM_001127702,SERPINA1,6,5,13947,3346,10601,2120.2,557.6666667,3.16826061
NM_001127701,SERPINA1,7,6,13947,3539,10408,1734.666667,505.5714286,2.940943769
NM_001127700,SERPINA1,5,4,13947,3241,10706,2676.5,648.2,3.30330145
NM_001002236,SERPINA1,7,6,13947,3520,10427,1737.833333,502.8571429,2.962215909
NM_001002235,SERPINA1,5,4,13947,3204,10743,2685.75,640.8,3.352996255
NM_006220,SERPINA2P,3,2,3066,1063,2003,1001.5,354.3333333,1.884289746
NM_001042518,SERPINA9,6,5,13614,1547,12067,2413.4,257.8333333,7.800258565
NM_001284276,SERPINA9,6,5,13614,1554,12060,2412,259,7.760617761
NM_001284275,SERPINA9,5,4,13614,1656,11958,2989.5,331.2,7.221014493
NM_001080451,SERPINA11,5,4,10323,1476,8847,2211.75,295.2,5.993902439
NM_173850,SERPINA12,6,5,30563,2067,28496,5699.2,344.5,13.78616352
NM_175739,SERPINA9,5,4,13614,1846,11768,2942,369.2,6.374864572
NM_001085,SERPINA3,5,4,11678,1595,10083,2520.75,319,6.321630094
NM_000624,SERPINA5,6,5,11753,2343,9410,1882,390.5,4.016218523
NM_001289032,SERPINA4,5,4,8495,2014,6481,1620.25,402.8,3.217974181
NM_001289033,SERPINA4,5,4,8495,1859,6636,1659,371.8,3.569661108
NM_006215,SERPINA4,5,4,8495,1699,6796,1699,339.8,4
NM_173849,GSC,3,2,1941,1192,749,374.5,397.3333333,0.628355705
NM_001271282,DICER1,27,26,46486,6201,40285,1549.423077,229.6666667,6.496532817
NM_030621,DICER1,28,27,55492,10249,45243,1675.666667,366.0357143,4.414381891
NM_001195573,DICER1,25,24,47277,9946,37331,1555.458333,397.84,3.753368188
NM_177438,DICER1,27,26,71196,10304,60892,2342,381.6296296,5.909549689
NM_152592,SYNE3,17,16,58344,3292,55052,3440.75,193.6470588,16.72296476
NM_016417,GLRX5,2,1,9734,1173,8561,8561,586.5,7.298380222
NM_021966,TCL1A,4,3,4231,1400,2831,943.6666667,350,2.022142857
NM_001098725,TCL1A,4,3,4231,1395,2836,945.3333333,348.75,2.03297491
NM_004918,TCL1B,4,3,6228,1170,5058,1686,292.5,4.323076923
NM_001252507,C14orf132,2,1,54649,7667,46982,46982,3833.5,6.12782053
NM_001282463,C14orf132,3,2,54649,7767,46882,23441,2589,6.036049955
NM_001282464,C14orf132,3,2,54649,909,53740,26870,303,59.11991199
NM_001289139,C14orf132,3,2,54649,7761,46888,23444,2587,6.041489499
NM_000710,BDKRB1,3,2,8555,1304,7251,3625.5,434.6666667,5.560582822
NM_000623,BDKRB2,3,2,39533,4200,35333,17666.5,1400,8.412619048
NM_001271904,GSKIP,4,3,22556,2663,19893,6631,665.75,7.470146451
NM_016472,GSKIP,4,3,23840,2249,21591,7197,562.25,9.600266785
NM_018036,ATG2B,42,41,82085,11141,70944,1730.341463,265.2619048,6.367830536
NM_001271906,GSKIP,3,2,23840,2147,21693,10846.5,715.6666667,10.10386586
NM_001271905,GSKIP,4,3,23840,2216,21624,7208,554,9.758122744
NM_003384,VRK1,13,12,84269,1716,82553,6879.416667,132,48.10780886
NM_182560,C14orf177,4,3,6155,1293,4862,1620.666667,323.25,3.760247486
NM_022898,BCL11B,3,2,102427,7833,94594,47297,2611,12.07634367
NM_001282238,BCL11B,3,2,102427,7830,94597,47298.5,2610,12.08135377
NM_001282237,BCL11B,4,3,102427,8044,94383,31461,2011,11.73334162
NM_138576,BCL11B,4,3,102427,8047,94380,31460,2011.75,11.72859451
NM_001099402,CCNK,11,10,30115,2617,27498,2749.8,237.9090909,10.50745128
NM_032425,HHIPL1,8,7,24133,2246,21887,3126.714286,280.75,9.744879786
NM_006668,CYP46A1,15,14,42885,2092,40793,2913.785714,139.4666667,19.49952199
NM_206918,DEGS2,3,2,13261,1408,11853,5926.5,469.3333333,8.418323864
NM_001039355,SLC25A29,4,3,15409,2374,13035,4345,593.5,5.49073294
NM_003403,YY1,5,4,40271,3164,37107,9276.75,632.8,11.72787611
NM_213646,WARS,10,9,41804,2722,39082,4342.444444,272.2,14.35782513
NM_213645,WARS,10,9,42557,2498,40059,4451,249.8,16.03642914
NM_004184,WARS,11,10,41804,2895,38909,3890.9,263.1818182,13.44006908
NM_173701,WARS,11,10,42557,2671,39886,3988.6,242.8181818,14.9329839
NM_001159531,BEGAIN,6,5,30925,2756,28169,5633.8,459.3333333,10.22097242
NM_020836,BEGAIN,7,6,32649,2683,29966,4994.333333,383.2857143,11.16884085
NM_003836,DLK1,5,4,8267,1595,6672,1668,319,4.1830721
NM_001134888,RTL1,1,0,4194,4194,NA,NA,4194,NA
NM_001362,DIO3,1,0,2103,2103,NA,NA,2103,NA
NM_005348,HSP90AA1,11,10,6439,3374,3065,306.5,306.7272727,0.908417309
NM_001017963,HSP90AA1,12,11,59013,3896,55117,5010.636364,324.6666667,14.14707392
NM_032630,CINP,5,4,14636,984,13652,3413,196.8,13.87398374
NM_001267828,ZNF839,8,7,23878,3720,20158,2879.714286,465,5.418817204
NM_001267827,ZNF839,8,7,25799,3789,22010,3144.285714,473.625,5.80892056
NM_018335,ZNF839,8,7,23425,3802,19623,2803.285714,475.25,5.161230931
NM_152326,ANKRD9,4,3,2932,1630,1302,434,407.5,0.798773006
NM_030943,AMN,12,11,8188,1569,6619,601.7272727,130.75,4.21861058
NM_001077594,EXOC3L4,11,10,10415,2590,7825,782.5,235.4545455,3.021235521
NM_006291,TNFAIP2,11,10,11114,4186,6928,692.8,380.5454545,1.655040612
NM_032374,APOPT1,5,4,27939,1240,26699,6674.75,248,21.53145161
NM_001823,CKB,8,7,3203,1466,1737,248.1428571,183.25,1.184856753
NM_152307,TRMT61A,4,3,7903,3245,4658,1552.666667,811.25,1.435439137
NM_001015049,BAG5,2,1,5776,5057,719,719,2528.5,0.142179158
NM_001015048,BAG5,2,1,6272,4850,1422,1422,2425,0.293195876
NM_004873,BAG5,2,1,5776,4870,906,906,2435,0.186036961
NM_024071,ZFYVE21,7,6,17926,1460,16466,2744.333333,208.5714286,11.27808219
NM_001198953,ZFYVE21,8,7,17926,1515,16411,2344.428571,189.375,10.83234323
NM_005552,KLC1,15,14,57045,2618,54427,3887.642857,174.5333333,20.789534
NM_001100118,XRCC3,9,8,17871,2554,15317,1914.625,283.7777778,5.997259201
NM_001100119,XRCC3,10,9,17871,2649,15222,1691.333333,264.9,5.746319366
NM_005432,XRCC3,10,9,17871,2612,15259,1695.444444,261.2,5.841883614
NM_182923,KLC1,15,14,72365,2397,69968,4997.714286,159.8,29.18982061
NM_001130107,KLC1,16,15,72365,2529,69836,4655.733333,158.0625,27.61407671
NM_001127393,C14orf2,5,4,9280,926,8354,2088.5,185.2,9.021598272
NM_001257268,RD3L,3,2,1884,1204,680,340,401.3333333,0.564784053
NM_004894,C14orf2,4,3,9280,656,8624,2874.666667,164,13.14634146
NM_001080464,ASPG,16,15,27025,1988,25037,1669.133333,124.25,12.59406439
NM_015656,KIF26A,15,14,42177,6772,35405,2528.928571,451.4666667,5.228145304
NM_001008404,C14orf180,5,4,10165,1888,8277,2069.25,377.6,4.384004237
NM_001286390,TMEM179,4,3,10681,860,9821,3273.666667,215,11.41976744
NM_001286389,TMEM179,4,3,13898,3340,10558,3519.333333,835,3.161077844
NM_001286400,C14orf180,5,4,8708,2053,6655,1663.75,410.6,3.241597662
NM_001286399,C14orf180,5,4,10165,1844,8321,2080.25,368.8,4.512472885
NM_199165,ADSSL1,13,12,17421,1825,15596,1299.666667,140.3846154,8.545753425
NM_032714,INF2,5,4,15204,1708,13496,3374,341.6,7.901639344
NM_006427,SIVA1,4,3,6528,775,5753,1917.666667,193.75,7.423225806
NM_022489,INF2,23,22,30006,4733,25273,1148.772727,205.7826087,5.339742235
NM_152328,ADSSL1,13,12,23115,1768,21347,1778.916667,136,12.07409502
NM_001031714,INF2,22,21,30006,4675,25331,1206.238095,212.5,5.418395722
NM_021709,SIVA1,3,2,6528,579,5949,2974.5,193,10.2746114
NM_015005,CEP170B,18,17,31459,6696,24763,1456.647059,372,3.698178017
NM_001137601,ZBTB42,2,1,4117,3638,479,479,1819,0.13166575
NM_001112726,CEP170B,19,18,31459,6724,24735,1374.166667,353.8947368,3.67861392
NM_017955,CDCA4,2,1,11517,2455,9062,9062,1227.5,3.691242363
NM_145701,CDCA4,3,2,11517,1930,9587,4793.5,643.3333333,4.967357513
NM_138420,AHNAK2,7,6,41105,18324,22781,3796.833333,2617.714286,1.243232919
NM_138790,PLD4,11,10,8388,1945,6443,644.3,176.8181818,3.312596401
NM_174891,C14orf79,5,4,9241,1895,7346,1836.5,379,3.87651715
NM_002226,JAG2,26,25,27845,5861,21984,879.36,225.4230769,3.750895752
NM_001278695,GPR132,3,2,16163,3003,13160,6580,1001,4.382284382
NM_013345,GPR132,4,3,16163,3784,12379,4126.333333,946,3.27140592
NM_001278696,GPR132,2,1,16163,2888,13275,13275,1444,4.596606648
NM_145159,JAG2,25,24,27845,5746,22099,920.7916667,229.84,3.845979812
NM_001278694,GPR132,5,4,16163,3875,12288,3072,775,3.171096774
NM_033271,BTBD6,5,4,2553,1992,561,140.25,398.4,0.281626506
NM_145685,BRF1,14,13,38601,3584,35017,2693.615385,256,9.770368304
NM_001519,BRF1,18,17,91708,3680,88028,5178.117647,204.4444444,23.92065217
NM_001242790,BRF1,4,3,44808,1170,43638,14546,292.5,37.2974359
NM_001242789,BRF1,13,12,40120,2874,37246,3103.833333,221.0769231,12.95963814
NM_001242788,BRF1,17,16,91708,3598,88110,5506.875,211.6470588,24.48860478
NM_001195082,TEX22,4,3,15278,2575,12703,4234.333333,643.75,4.933203883
NM_001100913,PACS2,25,24,83734,6719,77015,3208.958333,268.76,11.46227117
NM_015197,PACS2,24,23,83734,6673,77061,3350.478261,278.0416667,11.54817923
NM_025268,TMEM121,2,1,3588,1521,2067,2067,760.5,1.358974359
NM_001198983,C14orf80,8,7,9395,1628,7767,1109.571429,203.5,4.770884521
NM_001311,CRIP1,6,5,1869,484,1385,277,80.66666667,2.861570248
NM_001312,CRIP2,8,7,5397,1240,4157,593.8571429,155,3.352419355
NM_001270841,CRIP2,4,3,5397,873,4524,1508,218.25,5.182130584
NM_001270837,CRIP2,8,7,7234,1684,5550,792.8571429,210.5,3.295724466
NM_001134876,C14orf80,7,6,8001,1618,6383,1063.833333,231.1428571,3.94499382
NM_001134875,C14orf80,8,7,8001,1718,6283,897.5714286,214.75,3.657159488
NM_001134877,C14orf80,8,7,9067,1546,7521,1074.428571,193.25,4.864812419
NM_022805,SNRPN,12,11,122033,1617,120416,10946.90909,134.75,74.46876933
NM_022808,SNRPN,12,11,154937,1655,153282,13934.72727,137.9166667,92.61752266
NM_022807,SNRPN,13,12,154937,1764,153173,12764.41667,135.6923077,86.83276644
NM_022806,SNRPN,12,11,154937,1628,153309,13937.18182,135.6666667,94.17014742
NM_024837,ATP8B4,28,27,260986,5705,255281,9454.851852,203.75,44.74688869
NM_015492,C15orf39,3,2,10291,4430,5861,2930.5,1476.666667,1.323024831
NM_139057,ADAMTS17,22,21,370542,6353,364189,17342.33333,288.7727273,57.3255155
NM_001142275,NIPA1,5,4,43566,6391,37175,9293.75,1278.2,5.816773588
NM_144599,NIPA1,5,4,43159,6570,36589,9147.25,1314,5.569101979
NM_000275,OCA2,24,23,344437,3162,341275,14838.04348,131.75,107.9301075
NM_005503,APBA2,14,13,196678,3651,193027,14848.23077,260.7857143,52.86962476
NM_033223,GABRG3,10,9,561946,2014,559932,62214.66667,201.4,278.019861
NM_001270873,GABRG3,6,5,510052,1518,508534,101706.8,253,335.002635
NM_001130414,APBA2,13,12,196678,3614,193064,16088.66667,278,53.42114001
NM_005739,RASGRP1,17,16,76707,5042,71665,4479.0625,296.5882353,14.21360571
NM_133647,SLC12A6,25,24,106850,7527,99323,4138.458333,301.08,13.19556264
NM_001128602,RASGRP1,16,15,76707,4936,71771,4784.733333,308.5,14.54031605
NM_001042497,SLC12A6,24,23,106850,7481,99369,4320.391304,311.7083333,13.28284989
NM_001042496,SLC12A6,26,25,107766,7780,99986,3999.44,299.2307692,12.85167095
NM_001042495,SLC12A6,26,25,108070,7389,100681,4027.24,284.1923077,13.6257951
NM_144508,CASC5,26,25,68436,7633,60803,2432.12,293.5769231,7.965806367
NM_001042494,SLC12A6,26,25,107766,7714,100052,4002.08,296.6923077,12.97018408
NM_005135,SLC12A6,25,24,88826,7352,81474,3394.75,294.08,11.08188248
NM_170589,CASC5,27,26,68436,7712,60724,2335.538462,285.6296296,7.873962656
NM_014701,SECISBP2L,17,16,57927,7058,50869,3179.3125,415.1764706,7.207282516
NM_020759,STARD9,33,32,145341,15617,129724,4053.875,473.2424242,8.306588974
NM_001193489,SECISBP2L,18,17,57927,7194,50733,2984.294118,399.6666667,7.052126772
NM_005313,PDIA3,13,12,26216,3067,23149,1929.083333,235.9230769,7.547766547
NM_016194,GNB5,13,12,70444,3097,67347,5612.25,238.2307692,21.74588311
NM_001252335,CGNL1,20,19,174224,7359,166865,8782.368421,367.95,22.67495584
NM_183235,RAB27A,7,6,86851,3456,83395,13899.16667,493.7142857,24.13049769
NM_001080534,UNC13C,31,30,615707,8171,607536,20251.2,263.5806452,74.35271081
NM_032866,CGNL1,19,18,174224,7243,166981,9276.722222,381.2105263,23.05412122
NM_006578,GNB5,11,10,59041,2990,56051,5605.1,271.8181818,18.74615385
NM_207381,TNFAIP8L3,3,2,48676,2261,46415,23207.5,753.6666667,20.5285272
NM_005848,DENND4A,32,31,131676,7234,124442,4014.258065,226.0625,17.20237766
NM_134262,RORA,10,9,104226,10679,93547,10394.11111,1067.9,8.759902613
NM_134261,RORA,11,10,741021,10839,730182,73018.2,985.3636364,67.36617769
NM_134260,RORA,12,11,139248,11010,128238,11658,917.5,11.64741144
NM_002943,RORA,11,10,139248,10985,128263,12826.3,998.6363636,11.67619481
NM_003922,HERC1,78,77,225332,15275,210057,2728.012987,195.8333333,13.75168576
NM_001144823,DENND4A,33,32,131676,7371,124305,3884.53125,223.3636364,16.86406186
NM_152450,FAM81A,9,8,85381,3477,81904,10238,386.3333333,23.55593903
NM_001199018,LRRC49,17,16,157656,3104,154552,9659.5,182.5882353,49.79123711
NM_001172624,NEO1,28,27,252724,7083,245641,9097.814815,252.9642857,34.68036143
NM_001172623,NEO1,28,27,252724,6957,245767,9102.481481,248.4642857,35.32657755
NM_001199017,LRRC49,16,15,157656,3029,154627,10308.46667,189.3125,51.04886101
NM_006901,MYO9A,42,41,292081,8740,283341,6910.756098,208.0952381,32.41887872
NM_002499,NEO1,29,28,252724,7117,245607,8771.678571,245.4137931,34.50990586
NM_017691,LRRC49,16,15,157656,3014,154642,10309.46667,188.375,51.30789648
NM_001284357,LRRC49,17,16,196860,3062,193798,12112.375,180.1176471,63.29131287
NM_024776,PEAK1,8,7,311950,11825,300125,42875,1478.125,25.38054968
NM_000126,ETFA,12,11,95183,1366,93817,8528.818182,113.8333333,68.68008785
NM_014862,ARNT2,19,18,193587,6577,187010,10389.44444,346.1578947,28.43393645
NM_001127716,ETFA,11,10,95183,1218,93965,9396.5,110.7272727,77.14696223
NM_007200,AKAP13,37,36,368744,13354,355390,9871.944444,360.9189189,26.61299985
NM_006738,AKAP13,37,36,368744,13366,355378,9871.611111,361.2432432,26.58820889
NM_198525,KIF7,19,18,27483,4577,22906,1272.555556,240.8947368,5.004588158
NM_152336,AGBL1,24,23,887043,3517,883526,38414.17391,146.5416667,251.2158089
NM_001287810,CYFIP1,32,31,110956,4615,106341,3430.354839,144.21875,23.04247021
NM_014608,CYFIP1,31,30,110956,4495,106461,3548.7,145,23.68431591
NM_024490,ATP10A,21,20,184491,5255,179236,8961.8,250.2380952,34.10770695
NM_001165037,GABRA5,11,10,82086,2775,79311,7931.1,252.2727273,28.58054054
NM_001278631,GABRB3,10,9,229531,5888,223643,24849.22222,588.8,37.98284647
NM_001191320,GABRB3,7,6,173220,5587,167633,27938.83333,798.1428571,30.0041167
NM_001191321,GABRB3,7,6,85633,5637,79996,13332.66667,805.2857143,14.19123647
NM_000814,GABRB3,9,8,229531,5791,223740,27967.5,643.4444444,38.63581419
NM_000810,GABRA5,11,10,82493,2909,79584,7958.4,264.4545455,27.35785493
NM_021912,GABRB3,9,8,230243,5741,224502,28062.75,637.8888889,39.10503397
NM_004667,HERC2,93,92,211117,15433,195684,2127,165.9462366,12.67958271
NM_015307,FAM189A1,11,10,450474,4718,445756,44575.6,428.9090909,94.47986435
NM_175610,TJP1,27,26,122351,6951,115400,4438.461538,257.4444444,16.60192778
NM_003257,TJP1,28,27,122351,7192,115159,4265.148148,256.8571429,16.01209677
NM_148911,CHRFAM7A,9,8,32423,2803,29620,3702.5,311.4444444,10.56724938
NM_001252024,TRPM1,28,27,100667,5820,94847,3512.851852,207.8571429,16.2967354
NM_001252020,TRPM1,27,26,160214,6031,154183,5930.115385,223.3703704,25.56508042
NM_139320,CHRFAM7A,10,9,32423,2868,29555,3283.888889,286.8,10.30509066
NM_002420,TRPM1,27,26,100667,5733,94934,3651.307692,212.3333333,16.55921856
NM_001190455,CHRNA7,10,9,139700,3443,136257,15139.66667,344.3,39.57507987
NM_130901,OTUD7A,11,10,172215,3053,169162,16916.2,277.5454545,55.4084507
NM_000746,CHRNA7,10,9,139700,3356,136344,15149.33333,335.6,40.62693683
NM_001282494,GOLGA8N,19,18,13856,5348,8508,472.6666667,281.4736842,1.590875093
NM_001277313,FMN1,21,20,429191,13551,415640,20782,645.2857143,30.67227511
NM_001103184,FMN1,17,16,302490,12522,289968,18123,736.5882353,23.15668424
NM_024713,KATNBL1,10,9,69424,2750,66674,7408.222222,275,24.24509091
NM_012125,CHRM5,3,2,96200,3042,93158,46579,1014,30.62393162
NM_020371,AVEN,6,5,172877,1537,171340,34268,256.1666667,111.4769031
NM_001036,RYR3,104,103,555128,15663,539465,5237.524272,150.6057692,34.44199706
NM_001243996,RYR3,103,102,555128,15647,539481,5289.029412,151.9126214,34.47823864
NM_014691,AQR,35,34,113445,5115,108330,3186.176471,146.1428571,21.17888563
NM_080650,DPH6,9,8,175236,2056,173180,21647.5,228.4444444,84.23151751
NM_001220482,MEIS2,13,12,210280,3119,207161,17263.41667,239.9230769,66.41904457
NM_001130010,C15orf41,12,11,230639,2489,228150,20740.90909,207.4166667,91.6633186
NM_170677,MEIS2,13,12,209121,3369,205752,17146,259.1538462,61.07212823
NM_170676,MEIS2,12,11,209121,3251,205870,18715.45455,270.9166667,63.32513073
NM_170675,MEIS2,12,11,209121,3272,205849,18713.54545,272.6666667,62.91228606
NM_170674,MEIS2,13,12,209121,3348,205773,17147.75,257.5384615,61.46146953
NM_032499,C15orf41,11,10,169645,2606,167039,16703.9,236.9090909,64.09785111
NM_002399,MEIS2,13,12,210280,3070,207210,17267.5,236.1538462,67.49511401
NM_172316,MEIS2,13,12,208377,3135,205242,17103.5,241.1538462,65.46794258
NM_172315,MEIS2,12,11,207342,2844,204498,18590.72727,237,71.90506329
NM_001013703,EIF2AK4,39,38,101452,5551,95901,2523.710526,142.3333333,17.2763466
NM_007223,GPR176,3,2,121872,4527,117345,58672.5,1509,25.92113983
NM_001211,BUB1B,23,22,60129,3765,56364,2562,163.6956522,14.97051793
NM_130468,CHST14,1,0,2199,2199,NA,NA,2199,NA
NM_001271854,GPR176,4,3,121872,4525,117347,39115.66667,1131.25,25.93303867
NM_001271855,GPR176,3,2,30256,3685,26571,13285.5,1228.333333,7.210583446
NM_207380,C15orf52,11,10,9517,5338,4179,417.9,485.2727273,0.782877482
NM_152597,FSIP1,12,11,182809,2825,179984,16362.18182,235.4166667,63.71115044
NM_016013,NDUFAF1,5,4,15113,1482,13631,3407.75,296.4,9.197705803
NM_007236,CHP1,7,6,50648,3235,47413,7902.166667,462.1428571,14.65625966
NM_015540,RPAP1,25,24,27102,4707,22395,933.125,188.28,4.757807521
NM_017553,INO80,36,35,137367,6366,131001,3742.885714,176.8333333,20.57822809
NM_001206670,PLA2G4E,20,19,69123,4799,64324,3385.473684,239.95,13.40362576
NM_014994,MAPKBP1,31,30,53423,7263,46160,1538.666667,234.2903226,6.355500482
NM_022473,ZNF106,19,18,45132,10900,34232,1901.777778,573.6842105,3.140550459
NM_018097,HAUS2,6,5,21181,3950,17231,3446.2,658.3333333,4.362278481
NM_198141,GANC,24,23,79500,4610,74890,3256.086957,192.0833333,16.24511931
NM_015289,VPS39,25,24,49605,4857,44748,1864.5,194.28,9.213094503
NM_001265611,MAPKBP1,30,29,53423,6431,46992,1620.413793,214.3666667,7.307106204
NM_001130447,HAUS2,5,4,21181,3856,17325,4331.25,771.2,4.492997925
NM_139265,EHD4,6,5,73118,2899,70219,14043.8,483.1666667,24.22180062
NM_001128608,MAPKBP1,32,31,53423,7282,46141,1488.419355,227.5625,6.336308706
NM_001284306,ZNF106,18,17,45132,8456,36676,2157.411765,469.7777778,4.337275307
NM_001284307,ZNF106,20,19,78762,8473,70289,3699.421053,423.65,8.29564499
NM_005657,TP53BP1,28,27,103297,6264,97033,3593.814815,223.7142857,15.4905811
NM_153700,STRC,29,28,19239,5544,13695,489.1071429,191.1724138,2.470238095
NM_001141980,TP53BP1,28,27,85944,6244,79700,2951.851852,223,12.76425368
NM_001141979,TP53BP1,28,27,85944,6238,79706,2952.074074,222.7857143,12.77749279
NM_174916,UBR1,47,46,163190,7792,155398,3378.217391,165.787234,19.94327515
NM_173500,TTBK2,15,14,176467,5640,170827,12201.92857,376,30.28847518
NM_032892,FRMD5,14,13,324535,5091,319444,24572.61538,363.6428571,62.74680809
NM_001286491,FRMD5,15,14,324535,5411,319124,22794.57143,360.7333333,58.97689891
NM_001286490,FRMD5,16,15,323687,4849,318838,21255.86667,303.0625,65.75335121
NM_138423,CASC4,10,9,127052,3995,123057,13673,399.5,30.80275344
NM_177974,CASC4,9,8,127052,3826,123226,15403.25,425.1111111,32.20752744
NM_138356,SHF,8,7,33963,2508,31455,4493.571429,313.5,12.54186603
NM_003104,SORD,9,8,51987,2822,49165,6145.625,313.5555556,17.42204111
NM_001198999,SEMA6D,20,19,590019,5945,584074,30740.73684,297.25,98.24625736
NM_203349,SHC4,12,11,139709,4568,135141,12285.54545,380.6666667,29.58428196
NM_000138,FBN1,66,65,237484,11761,225723,3472.661538,178.1969697,19.19250064
NM_001948,DUT,6,5,11207,1880,9327,1865.4,313.3333333,4.961170213
NM_001025249,DUT,7,6,11951,1837,10114,1685.666667,262.4285714,5.505715841
NM_001025248,DUT,7,6,11951,2153,9798,1633,307.5714286,4.550859266
NM_152647,FAM227B,16,15,292528,2010,290518,19367.86667,125.625,144.5363184
NM_001001556,GALK2,10,9,174048,3238,170810,18978.88889,323.8,52.75169858
NM_001289030,GALK2,11,10,159791,3471,156320,15632,315.5454545,45.03601268
NM_001289031,GALK2,10,9,159791,3323,156468,17385.33333,332.3,47.08636774
NM_002044,GALK2,10,9,159791,3340,156451,17383.44444,334,46.84161677
NM_016655,GABPB1,8,7,69530,1619,67911,9701.571429,202.375,41.94626313
NM_001128610,USP8,20,19,76708,5715,70993,3736.473684,285.75,12.42222222
NM_007347,AP4E1,21,20,97230,6780,90450,4522.5,322.8571429,13.34070796
NM_016654,GABPB1,9,8,78218,3025,75193,9399.125,336.1111111,24.85719008
NM_017672,TRPM7,39,38,129662,10442,119220,3137.368421,267.7435897,11.417353
NM_181427,GABPB1,9,8,69530,1644,67886,8485.75,182.6666667,41.29318735
NM_002041,GABPB1,8,7,69530,1655,67875,9696.428571,206.875,41.01208459
NM_001252127,AP4E1,21,20,97230,6803,90427,4521.35,323.952381,13.29222402
NM_001283049,USP8,17,16,76708,5254,71454,4465.875,309.0588235,13.59992387
NM_005254,GABPB1,9,8,78218,3061,75157,9394.625,340.1111111,24.55308723
NM_005154,USP8,20,19,76708,5575,71133,3743.842105,278.75,12.75928251
NM_015263,DMXL2,43,42,175048,10639,164409,3914.5,247.4186047,15.45342607
NM_001174117,DMXL2,41,40,175048,8729,166319,4157.975,212.902439,19.05361439
NM_001174116,DMXL2,43,42,175048,10642,164406,3914.428571,247.4883721,15.44878782
NM_014547,TMOD3,10,9,82508,4676,77832,8648,467.6,16.64499572
NM_031226,CYP19A1,11,10,130543,4525,126018,12601.8,411.3636364,27.84928177
NM_000103,CYP19A1,10,9,130543,4415,126128,14014.22222,441.5,28.56806342
NM_001143917,LYSMD2,3,2,28391,1104,27287,13643.5,368,24.71648551
NM_181789,GLDN,10,9,66498,5093,61405,6822.777778,509.3,12.05674455
NM_019600,FAM214A,13,12,97315,4241,93074,7756.166667,326.2307692,21.94623909
NM_000259,MYO5A,41,40,221769,12266,209503,5237.575,299.1707317,17.07997717
NM_001142495,MYO5A,40,39,221769,12184,209585,5373.974359,304.6,17.20165791
NM_018728,MYO5C,41,40,103482,7016,96466,2411.65,171.1219512,13.74942987
NM_182758,WDR72,20,19,245923,7329,238594,12557.57895,366.45,32.55478237
NM_015617,PYGO1,3,2,49967,8399,41568,20784,2799.666667,4.949160614
NM_173814,PRTG,20,19,131440,11992,119448,6286.736842,599.6,9.960640427
NM_006154,NEDD4,29,28,166829,5901,160928,5747.428571,203.4827586,27.27130995
NM_001198784,C15orf65,2,1,10189,754,9435,9435,377,12.5132626
NM_022841,RFX7,9,8,152754,7204,145550,18193.75,800.4444444,20.2040533
NM_003205,TCF12,20,19,369883,4734,365149,19218.36842,236.7,77.13329109
NM_001288588,ZNF280D,22,21,103912,4991,98921,4710.52381,226.8636364,19.81987578
NM_001288589,ZNF280D,6,5,36333,4279,32054,6410.8,713.1666667,7.491002571
NM_017661,ZNF280D,22,21,103912,4998,98914,4710.190476,227.1818182,19.79071629
NM_018365,MNS1,10,9,36408,2033,34375,3819.444444,203.3,16.90850959
NM_207038,TCF12,20,19,369883,4724,365159,19218.89474,236.2,77.29868755
NM_207040,TCF12,13,12,69061,3988,65073,5422.75,306.7692308,16.3172016
NM_207037,TCF12,21,20,369883,4807,365076,18253.8,228.9047619,75.94674433
NM_207036,TCF12,21,20,369883,4797,365086,18254.3,228.4285714,76.1071503
NM_001002844,ZNF280D,6,5,36333,4272,32061,6412.2,712,7.50491573
NM_001002843,ZNF280D,21,20,103912,4928,98984,4949.2,234.6666667,20.08603896
NM_001018091,GCOM1,13,12,125655,4470,121185,10098.75,343.8461538,27.11073826
NM_001285900,GCOM1,15,14,125655,5322,120333,8595.214286,354.8,22.61048478
NM_001018090,GCOM1,14,13,125655,4676,120979,9306.076923,334,25.87232678
NM_001206897,ALDH1A2,14,13,112501,3714,108787,8368.230769,265.2857143,29.29106085
NM_020980,AQP9,6,5,47704,3027,44677,8935.4,504.5,14.75949785
NM_152451,MYZAP,12,11,93462,2326,91136,8285.090909,193.8333333,39.18142734
NM_001018100,MYZAP,13,12,93462,2411,91051,7587.583333,185.4615385,37.76482787
NM_003888,ALDH1A2,13,12,112501,3616,108885,9073.75,278.1538462,30.11200221
NM_170696,ALDH1A2,12,11,112501,3501,109000,9909.090909,291.75,31.13396173
NM_017610,RNF111,14,13,109755,5916,103839,7987.615385,422.5714286,17.55223124
NM_001040453,FAM63B,9,8,86343,4999,81344,10168,555.4444444,16.27205441
NM_000236,LIPC,9,8,136900,1613,135287,16910.875,179.2222222,83.87290763
NM_001110,ADAM10,16,15,154776,5050,149726,9981.733333,315.625,29.64871287
NM_001270529,RNF111,14,13,109755,5913,103842,7987.846154,422.3571429,17.56164384
NM_001270528,RNF111,14,13,109755,5943,103812,7985.538462,424.5,17.46794548
NM_004998,MYO1E,28,27,236905,5138,231767,8583.962963,183.5,45.10840794
NM_001270530,RNF111,14,13,109275,5797,103478,7959.846154,414.0714286,17.85026738
NM_001040450,FAM63B,9,8,86343,5002,81341,10167.625,555.7777778,16.26169532
NM_001136015,ANXA2,14,13,50837,1673,49164,3781.846154,119.5,29.38673042
NM_001002857,ANXA2,14,13,50837,1649,49188,3783.692308,117.7857143,29.82898727
NM_004039,ANXA2,13,12,50837,1567,49270,4105.833333,120.5384615,31.44224633
NM_001002858,ANXA2,13,12,50837,1639,49198,4099.833333,126.0769231,30.01708359
NM_020821,VPS13C,85,84,208076,13504,194572,2316.333333,158.8705882,14.40847156
NM_017684,VPS13C,83,82,208076,13373,194703,2374.426829,161.1204819,14.55941075
NM_018080,VPS13C,80,79,196161,14547,181614,2298.911392,181.8375,12.48463601
NM_001018088,VPS13C,82,81,196161,14678,181483,2240.530864,179,12.36428669
NM_031301,APH1B,6,5,31578,4199,27379,5475.8,699.8333333,6.520361991
NM_001256702,USP3,14,13,90131,5488,84643,6511,392,15.42328717
NM_006537,USP3,15,14,90131,5621,84510,6036.428571,374.7333333,15.03469134
NM_015059,TLN2,56,55,197321,11705,185616,3374.836364,209.0178571,15.85783853
NM_001145646,APH1B,5,4,31578,4075,27503,6875.75,815,6.749202454
NM_022048,CSNK1G1,12,11,190728,8175,182553,16595.72727,681.25,22.3306422
NM_014326,DAPK2,12,11,139288,2640,136648,12422.54545,220,51.76060606
NM_015042,ZNF609,9,8,186649,8626,178023,22252.875,958.4444444,20.63795502
NM_001195059,PLEKHO2,5,4,26121,3576,22545,5636.25,715.2,6.304530201
NM_130434,DPP8,20,19,72039,4116,67923,3574.894737,205.8,16.50218659
NM_025201,PLEKHO2,6,5,26121,3727,22394,4478.8,621.1666667,6.008585994
NM_016630,SPG21,9,8,26924,1841,25083,3135.375,204.5555556,13.62466051
NM_001127889,SPG21,9,8,26484,1660,24824,3103,184.4444444,14.95421687
NM_001127890,SPG21,8,7,26924,1759,25165,3595,219.875,14.3064241
NM_017743,DPP8,18,17,72039,3814,68225,4013.235294,211.8888889,17.88804405
NM_197961,DPP8,20,19,72039,4099,67940,3575.789474,204.95,16.57477434
NM_004727,SLC24A1,10,9,34330,5778,28552,3172.444444,577.8,4.94150225
NM_197960,DPP8,21,20,71613,4107,67506,3375.3,195.5714286,16.43681519
NM_004884,IGDCC3,14,13,50915,4493,46422,3570.923077,320.9285714,10.33207211
NM_032445,MEGF11,23,22,358443,5937,352506,16023,258.1304348,59.37443153
NM_002755,MAP2K1,11,10,104673,2597,102076,10207.6,236.0909091,39.30535233
NM_001278562,LCTL,12,11,18513,2579,15934,1448.545455,214.9166667,6.178363707
NM_207338,LCTL,13,12,18031,2871,15160,1263.333333,220.8461538,5.280390108
NM_001031715,IQCH,21,20,247006,4260,242746,12137.3,202.8571429,56.98262911
NM_001271886,AAGAB,10,9,54063,3354,50709,5634.333333,335.4,15.11896243
NM_024666,AAGAB,10,9,54063,3209,50854,5650.444444,320.9,15.84730446
NM_001284348,IQCH,17,16,247006,3693,243313,15207.0625,217.2352941,65.88491741
NM_001284347,IQCH,16,15,247006,3519,243487,16232.46667,219.9375,69.19210003
NM_145160,MAP2K5,22,21,264436,2389,262047,12478.42857,108.5909091,109.6889912
NM_002757,MAP2K5,21,20,264436,2358,262078,13103.9,112.2857143,111.14419
NM_001206804,MAP2K5,22,21,258115,1805,256310,12205.2381,82.04545455,142
NM_001271885,AAGAB,10,9,54525,3093,51432,5714.666667,309.3,16.628516
NM_005902,SMAD3,9,8,129340,6244,123096,15387,693.7777778,19.71428571
NM_001284349,IQCH,7,6,119368,1875,117493,19582.16667,267.8571429,62.66293333
NM_016166,PIAS1,14,13,133834,2294,131540,10118.46154,163.8571429,57.34088928
NM_001190457,CORO2B,12,11,95819,3625,92194,8381.272727,302.0833333,25.43282759
NM_001190456,CORO2B,12,11,111267,3346,107921,9811,278.8333333,32.2537358
NM_006091,CORO2B,12,11,148838,3580,145258,13205.27273,298.3333333,40.57486034
NM_006305,ANP32A,7,6,42388,2473,39915,6652.5,353.2857143,16.14031541
NM_001004439,ITGA11,30,29,130452,5039,125413,4324.586207,167.9666667,24.88846993
NM_001281301,KIF23,21,20,34183,3355,30828,1541.4,159.7619048,9.188673621
NM_024505,NOX5,16,15,42469,2820,39649,2643.266667,176.25,14.05992908
NM_001184780,NOX5,16,15,126664,2863,123801,8253.4,178.9375,43.24170451
NM_017705,PAQR5,9,8,108684,5195,103489,12936.125,577.2222222,19.92088547
NM_015554,GLCE,5,4,111573,5048,106525,26631.25,1009.6,21.1024168
NM_138555,KIF23,23,22,34183,3746,30437,1383.5,162.8695652,8.125200214
NM_001184779,NOX5,16,15,42469,2736,39733,2648.866667,171,14.52229532
NM_004856,KIF23,22,21,34183,3433,30750,1464.285714,156.0454545,8.957180309
NM_020908,TLE3,20,19,50128,5728,44400,2336.842105,286.4,7.751396648
NM_001282982,TLE3,18,17,46996,4493,42503,2500.176471,249.6111111,9.459826397
NM_001282981,TLE3,20,19,48963,4688,44275,2330.263158,234.4,9.444325939
NM_018003,UACA,19,18,108959,6876,102083,5671.277778,361.8947368,14.84627691
NM_001282980,TLE3,20,19,50128,5749,44379,2335.736842,287.45,7.719429466
NM_001282979,TLE3,20,19,50128,5740,44388,2336.210526,287,7.733101045
NM_001105192,TLE3,20,19,50128,5755,44373,2335.421053,287.75,7.710338836
NM_005078,TLE3,20,19,50128,5764,44364,2334.947368,288.2,7.696738376
NM_024817,THSD4,17,16,641936,9162,632774,39548.375,538.9411765,69.0650513
NM_001286429,THSD4,12,11,236183,8206,227977,20725.18182,683.8333333,27.78174506
NM_033028,BBS4,16,15,52299,2514,49785,3319,157.125,19.80310263
NM_001252678,BBS4,15,14,52299,2466,49833,3559.5,164.4,20.2080292
NM_001012642,GRAMD2,12,11,37991,3304,34687,3153.363636,275.3333333,10.49848668
NM_005744,ARIH1,14,13,112231,5265,106966,8228.153846,376.0714286,20.31642925
NM_017455,NPTN,8,7,73411,2114,71297,10185.28571,264.25,33.72611164
NM_001161364,NPTN,8,7,73411,2102,71309,10187,262.75,33.92435775
NM_001161363,NPTN,9,8,73411,2451,70960,8870,272.3333333,28.95144839
NM_012428,NPTN,9,8,73411,2463,70948,8868.5,273.6666667,28.80552172
NM_002675,PML,8,7,48705,2246,46459,6637,280.75,20.68521817
NM_033250,PML,7,6,41723,2936,38787,6464.5,419.4285714,13.21083106
NM_033249,PML,7,6,48705,2101,46604,7767.333333,300.1428571,22.18181818
NM_033247,PML,5,4,41723,1787,39936,9984,357.4,22.34806939
NM_033246,PML,6,5,48705,1841,46864,9372.8,306.8333333,25.45573058
NM_033244,PML,8,7,41723,3089,38634,5519.142857,386.125,12.50696018
NM_033240,PML,7,6,41723,3721,38002,6333.666667,531.5714286,10.21284601
NM_033238,PML,9,8,53143,5604,47539,5942.375,622.6666667,8.483047823
NM_033239,PML,8,7,41723,3081,38642,5520.285714,385.125,12.54203181
NM_001042367,C15orf60,6,5,116856,931,115925,23185,155.1666667,124.5166488
NM_025055,CCDC33,19,18,99854,2806,97048,5391.555556,147.6842105,34.58588738
NM_001142444,EDC3,8,7,65489,3862,61627,8803.857143,482.75,15.95727602
NM_001142443,EDC3,10,9,65489,4079,61410,6823.333333,407.9,15.05516058
NM_006465,ARID3B,9,8,56926,4250,52676,6584.5,472.2222222,12.39435294
NM_025083,EDC3,7,6,65489,3772,61717,10286.16667,538.8571429,16.36187699
NM_001146029,SEMA7A,13,12,24671,3347,21324,1777,257.4615385,6.371078578
NM_001146030,SEMA7A,14,13,24373,3243,21130,1625.384615,231.6428571,6.515572001
NM_003612,SEMA7A,14,13,24671,3390,21281,1637,242.1428571,6.277581121
NM_001042581,SNUPN,9,8,28024,1707,26317,3289.625,189.6666667,15.41710603
NM_001284379,COMMD4,6,5,4195,773,3422,684.4,128.8333333,4.42690815
NM_001145335,UBE2Q2,13,12,57005,2992,54013,4501.083333,230.1538462,18.05247326
NM_001284382,UBE2Q2,12,11,57763,3005,54758,4978,250.4166667,18.22229617
NM_138573,NRG4,6,5,70459,2187,68272,13654.4,364.5,31.2171925
NM_152335,C15orf27,11,10,145007,2410,142597,14259.7,219.0909091,59.16887967
NM_017828,COMMD4,8,7,4283,974,3309,472.7142857,121.75,3.397330595
NM_001284377,COMMD4,7,6,4283,796,3487,581.1666667,113.7142857,4.380653266
NM_002833,PTPN9,13,12,112172,3958,108214,9017.833333,304.4615385,27.34057605
NM_001042588,SNUPN,9,8,28297,1512,26785,3348.125,168,17.71494709
NM_173469,UBE2Q2,13,12,57763,3111,54652,4554.333333,239.3076923,17.56734169
NM_005701,SNUPN,9,8,28024,1812,26212,3276.5,201.3333333,14.46578366
NM_001284378,COMMD4,6,5,4283,714,3569,713.8,119,4.99859944
NM_001145923,SCAPER,32,31,513760,4884,508876,16415.35484,152.625,104.1924652
NM_020843,SCAPER,31,30,535692,4740,530952,17698.4,152.9032258,112.0151899
NM_001199377,ACSBG1,14,13,63864,2982,60882,4683.230769,213,20.41649899
NM_015162,ACSBG1,14,13,63864,2994,60870,4682.307692,213.8571429,20.33066132
NM_018200,HMG20A,11,10,64704,3896,60808,6080.8,354.1818182,15.60780287
NM_001166694,CHRNA3,6,5,28244,2035,26209,5241.8,339.1666667,12.87911548
NM_006791,MORF4L1,12,11,24960,1893,23067,2097,157.75,12.18541997
NM_206839,MORF4L1,13,12,24960,2011,22949,1912.416667,154.6923077,11.41173545
NM_002891,RASGRF1,28,27,130928,6422,124506,4611.333333,229.3571429,19.38741825
NM_000743,CHRNA3,6,5,25992,3324,22668,4533.6,554,6.819494585
NM_001265604,MORF4L1,12,11,24752,1846,22906,2082.363636,153.8333333,12.4084507
NM_001265605,MORF4L1,12,11,24752,1746,23006,2091.454545,145.5,13.17640321
NM_001265603,MORF4L1,10,9,24960,1776,23184,2576,177.6,13.05405405
NM_001145648,RASGRF1,27,26,130928,6373,124555,4790.576923,236.037037,19.54417072
NM_004136,IREB2,22,21,63282,6389,56893,2709.190476,290.4090909,8.904836438
NM_000137,FAH,14,13,33693,1811,31882,2452.461538,129.3571429,17.60463832
NM_021214,ABHD17C,3,2,60312,2363,57949,28974.5,787.6666667,24.52348709
NM_001080532,TMC3,22,21,41660,3325,38335,1825.47619,151.1363636,11.52932331
NM_018689,CEMIP,29,28,172289,7109,165180,5899.285714,245.137931,23.23533549
NM_001172128,IL16,19,18,115887,8341,107546,5974.777778,439,12.89365783
NM_172217,IL16,18,17,87466,8083,79383,4669.588235,449.0555556,9.820982309
NM_024580,EFTUD1,20,19,132545,3705,128840,6781.052632,185.25,34.77462888
NM_001008226,FAM154B,3,2,22117,3133,18984,9492,1044.333333,6.059368018
NM_001040610,EFTUD1,18,17,132545,3550,128995,7587.941176,197.2222222,36.33661972
NM_001278511,AP3B2,25,24,50629,3659,46970,1957.083333,146.36,12.83684067
NM_001278512,AP3B2,27,26,50629,3814,46815,1800.576923,141.2592593,12.27451494
NM_001282503,GOLGA6L20,9,8,9340,4320,5020,627.5,480,1.162037037
NM_001079535,CPEB1,10,9,28624,3188,25436,2826.222222,318.8,7.978670013
NM_001079534,CPEB1,11,10,28624,3088,25536,2553.6,280.7272727,8.269430052
NM_001079533,CPEB1,11,10,28624,3103,25521,2552.1,282.0909091,8.224621334
NM_001288820,CPEB1,10,9,28624,2860,25764,2862.666667,286,9.008391608
NM_001288819,CPEB1,12,11,104407,3543,100864,9169.454545,295.25,28.46852949
NM_198181,GOLGA6L9,9,8,9403,4383,5020,627.5,487,1.145334246
NM_001080435,WHAMM,10,9,25235,3864,21371,2374.555556,386.4,5.530797101
NM_004644,AP3B2,26,25,50629,3756,46873,1874.92,144.4615385,12.47949947
NM_030594,CPEB1,12,11,104818,3235,101583,9234.818182,269.5833333,31.40123648
NM_003027,SH3GL3,9,8,171404,1702,169702,21212.75,189.1111111,99.70740306
NM_207517,ADAMTSL3,30,29,385757,7365,378392,13048,245.5,51.37705363
NM_001287761,SLC28A1,15,14,61137,2170,58967,4211.928571,144.6666667,27.17373272
NM_032856,WDR73,8,7,11511,1850,9661,1380.142857,231.25,5.222162162
NM_004213,SLC28A1,19,18,61137,2788,58349,3241.611111,146.7368421,20.92862267
NM_014630,ZNF592,11,10,57847,8190,49657,4965.7,744.5454545,6.063125763
NM_002605,PDE8A,22,21,157169,3939,153230,7296.666667,179.0454545,38.90073623
NM_001243137,PDE8A,22,21,158634,3741,154893,7375.857143,170.0454545,41.40417001
NM_001287762,SLC28A1,18,17,61137,2671,58466,3439.176471,148.3888889,21.88918008
NM_173454,PDE8A,21,20,157169,3800,153369,7668.45,180.952381,40.36026316
NM_001270546,AKAP13,29,28,129410,9157,120253,4294.75,315.7586207,13.13235776
NM_001243101,NTRK3,18,17,379976,2956,377020,22177.64706,164.2222222,127.5439783
NM_002530,NTRK3,19,18,379976,2981,376995,20944.16667,156.8947368,126.465951
NM_001007156,NTRK3,16,15,279368,4141,275227,18348.46667,258.8125,66.46389761
NM_001012338,NTRK3,20,19,379976,3024,376952,19839.57895,151.2,124.6534392
NM_007011,ABHD2,15,14,114212,9148,105064,7504.571429,609.8666667,11.48491474
NM_152924,ABHD2,11,10,114212,8746,105466,10546.6,795.0909091,12.05876972
NM_013227,ACAN,18,17,71913,8858,63055,3709.117647,492.1111111,7.118424023
NM_001135,ACAN,16,15,71913,8559,63354,4223.6,534.9375,7.402032948
NM_001199058,C15orf38-AP3S2,10,9,82393,6266,76127,8458.555556,626.6,12.149218
NM_198526,ZNF710,5,4,80682,4494,76188,19047,898.8,16.95327103
NM_022769,CRTC3,15,14,115461,5266,110195,7871.071429,351.0666667,20.92575009
NM_003870,IQGAP1,38,37,114004,7248,106756,2885.297297,190.7368421,14.7290287
NM_001042574,CRTC3,15,14,115461,5263,110198,7871.285714,350.8666667,20.93824815
NM_000057,BLM,22,21,98136,4577,93559,4455.190476,208.0454545,20.44111864
NM_001039675,UNC45A,23,22,23915,4025,19890,904.0909091,175,4.941614907
NM_018671,UNC45A,20,19,19110,3572,15538,817.7894737,178.6,4.349944009
NM_001287248,BLM,22,21,98136,4743,93393,4447.285714,215.5909091,19.69070209
NM_014848,SV2B,14,13,201002,11357,189645,14588.07692,811.2142857,16.69851193
NM_001167580,SV2B,12,11,201359,10782,190577,17325.18182,898.5,17.67547765
NM_001287246,BLM,23,22,98136,4688,93448,4247.636364,203.826087,19.9334471
NM_001287247,BLM,20,19,98136,4182,93954,4944.947368,209.1,22.46628407
NM_013272,SLCO3A1,10,9,312201,5116,307085,34120.55556,511.6,60.02443315
NM_001145044,SLCO3A1,11,10,318729,2864,315865,31586.5,260.3636364,110.2880587
NM_207446,FAM174B,3,2,38354,2632,35722,17861,877.3333333,13.57218845
NM_001042572,CHD2,13,12,48914,2247,46667,3888.916667,172.8461538,20.76858033
NM_001271,CHD2,39,38,127688,9403,118285,3112.763158,241.1025641,12.57949591
NM_001159643,MCTP2,20,19,185753,7475,178278,9383.052632,373.75,23.84989967
NM_018349,MCTP2,22,21,185753,7642,178111,8481.47619,347.3636364,23.30685684
NM_000875,IGF1R,21,20,315000,11263,303737,15186.85,536.3333333,26.96768179
NM_005587,MEF2A,11,10,150498,5565,144933,14493.3,505.9090909,26.04366577
NM_001288616,TTC23,12,11,114905,3313,111592,10144.72727,276.0833333,33.68306671
NM_152449,LYSMD4,6,5,6045,2918,3127,625.4,486.3333333,1.0716244
NM_001171894,MEF2A,12,11,150498,5768,144730,13157.27273,480.6666667,25.09188627
NM_001130927,MEF2A,10,9,150498,5296,145202,16133.55556,529.6,27.41729607
NM_001130926,MEF2A,10,9,150498,5476,145022,16113.55556,547.6,26.48319942
NM_144598,LRRC28,10,9,134949,1561,133388,14820.88889,156.1,85.45035234
NM_001288615,TTC23,14,13,113298,3924,109374,8413.384615,280.2857143,27.87308869
NM_001284400,LRRC28,9,8,134949,1400,133549,16693.625,155.5555556,95.39214286
NM_001284422,LYSMD4,5,4,6045,2852,3193,798.25,570.4,1.119565217
NM_001284421,LYSMD4,4,3,6045,2751,3294,1098,687.75,1.19738277
NM_001284420,LYSMD4,2,1,6045,2433,3612,3612,1216.5,1.48458693
NM_001284419,LYSMD4,5,4,6045,2802,3243,810.75,560.4,1.15738758
NM_001284417,LYSMD4,3,2,6045,2724,3321,1660.5,908,1.219162996
NM_001284418,LYSMD4,3,2,5986,2725,3261,1630.5,908.3333333,1.196697248
NM_198243,ASB7,6,5,49151,4969,44182,8836.4,828.1666667,8.89152747
NM_178842,CERS3,13,12,144327,3907,140420,11701.66667,300.5384615,35.9406194
NM_000693,ALDH1A3,13,12,36823,3508,33315,2776.25,269.8461538,9.49686431
NM_024652,LRRK1,34,33,150859,7665,143194,4339.212121,225.4411765,18.68153947
NM_138325,PCSK6,14,13,125110,2355,122755,9442.692308,168.2142857,52.12526539
NM_138324,PCSK6,15,14,143242,3267,139975,9998.214286,217.8,42.84511785
NM_138322,PCSK6,10,9,106236,2310,103926,11547.33333,231,44.98961039
NM_138321,PCSK6,19,18,176966,3349,173617,9645.388889,176.2631579,51.84144521
NM_138320,PCSK6,20,19,176966,3389,173577,9135.631579,169.45,51.21776335
NM_138323,PCSK6,14,13,143242,3220,140022,10770.92308,230,43.48509317
NM_138319,PCSK6,21,20,186056,4534,181522,9076.1,215.9047619,40.03573004
NM_152334,TARSL2,19,18,70692,3313,67379,3743.277778,174.3684211,20.33776034
NM_002570,PCSK6,22,21,186056,4574,181482,8642,207.9090909,39.67686926
NM_001145004,GOLGA6L6,9,8,10022,4100,5922,740.25,455.5555556,1.444390244
NM_001277303,POTEB2,11,10,30944,1698,29246,2924.6,154.3636364,17.2237927
NM_001277304,POTEB,11,10,30944,1698,29246,2924.6,154.3636364,17.2237927
NM_207355,LOC339010,11,10,31278,2032,29246,2924.6,184.7272727,14.39271654
NM_001277304,POTEB,11,10,30952,1698,29254,2925.4,154.3636364,17.22850412
NM_001277303,POTEB2,11,10,30952,1698,29254,2925.4,154.3636364,17.22850412
NM_207355,LOC339010,11,10,31286,2032,29254,2925.4,184.7272727,14.39665354
NM_001005241,OR4N4,1,0,1344,1344,NA,NA,1344,NA
NM_001004719,OR4M2,1,0,1085,1085,NA,NA,1085,NA
NM_001001413,GOLGA6L1,9,8,9758,3831,5927,740.875,425.6666667,1.547115636
NM_001102610,TUBGCP5,22,21,39390,3464,35926,1710.761905,157.4545455,10.37124711
NM_052903,TUBGCP5,23,22,40498,3871,36627,1664.863636,168.3043478,9.461896151
NM_001008894,NIPA2,5,4,29745,2942,26803,6700.75,588.4,9.110469069
NM_001008892,NIPA2,6,5,29745,3000,26745,5349,500,8.915
NM_030922,NIPA2,8,7,29745,3260,26485,3783.571429,407.5,8.124233129
NM_001184889,NIPA2,10,9,29745,3487,26258,2917.555556,348.7,7.530255234
NM_001184888,NIPA2,6,5,29745,3091,26654,5330.8,515.1666667,8.623099321
NM_001033028,CYFIP1,16,15,47850,3350,44500,2966.666667,209.375,13.28358209
NM_001008860,NIPA2,7,6,29745,3137,26608,4434.666667,448.1428571,8.481989162
NM_001271664,LOC440243,9,8,9709,3786,5923,740.375,420.6666667,1.564447966
NM_005664,MKRN3,1,0,2714,2714,NA,NA,2714,NA
NM_019066,MAGEL2,1,0,4299,4299,NA,NA,4299,NA
NM_002487,NDN,1,0,1898,1898,NA,NA,1898,NA
NM_018958,NPAP1,1,0,8054,8054,NA,NA,8054,NA
NM_003097,SNRPN,10,9,23596,1336,22260,2473.333333,133.6,16.66167665
NM_022804,SNURF,4,3,13908,426,13482,4494,106.5,31.64788732
NM_005678,SNURF,10,9,23596,1336,22260,2473.333333,133.6,16.66167665
NM_130838,UBE3A,10,9,68259,4501,63758,7084.222222,450.1,14.1652966
NM_000462,UBE3A,14,13,101781,5290,96491,7422.384615,377.8571429,18.24026465
NM_130839,UBE3A,13,12,101781,5224,96557,8046.416667,401.8461538,18.48334609
NM_001282468,GOLGA8M,19,18,13728,5275,8453,469.6111111,277.6315789,1.602464455
NM_138704,NDNL2,1,0,1669,1669,NA,NA,1669,NA
NM_001282472,GOLGA8J,19,18,13748,5218,8530,473.8888889,274.6315789,1.634725949
NM_001282484,GOLGA8R,19,18,13700,5191,8509,472.7222222,273.2105263,1.639183202
NM_001039841,ARHGAP11B,7,6,12136,1024,11112,1852,146.2857143,10.8515625
NM_001282490,GOLGA8H,19,18,13798,5279,8519,473.2777778,277.8421053,1.613752605
NM_014967,FAN1,15,14,39236,4905,34331,2452.214286,327,6.999184506
NM_001146096,FAN1,4,3,7917,2858,5059,1686.333333,714.5,1.770118964
NM_001146095,FAN1,4,3,7938,2742,5196,1732,685.5,1.894967177
NM_001146094,FAN1,4,3,7917,2845,5072,1690.666667,711.25,1.782776801
NM_017762,MTMR10,16,15,52665,4977,47688,3179.2,311.0625,9.581675708
NM_001252030,TRPM1,3,2,32338,990,31348,15674,330,31.66464646
NM_001243538,RP11-16E12.2,4,3,8081,1036,7045,2348.333333,259,6.80019305
NM_015995,KLF13,2,1,51021,6802,44219,44219,3401,6.500882094
NM_001277308,GOLGA8O,19,18,13722,5208,8514,473,274.1052632,1.634792627
NM_001282493,GOLGA8K,19,18,13709,5207,8502,472.3333333,274.0526316,1.632801997
NM_001191323,GREM1,3,2,16667,4018,12649,6324.5,1339.333333,3.148083624
NM_001191322,GREM1,3,2,16667,3931,12736,6368,1310.333333,3.239888069
NM_199357,ARHGAP11A,11,10,20693,2482,18211,1821.1,225.6363636,7.337228042
NM_003020,SCG5,6,5,55430,1247,54183,10836.6,207.8333333,43.45068164
NM_001144757,SCG5,6,5,55430,1250,54180,10836,208.3333333,43.344
NM_001286480,ARHGAP11A,13,12,24461,5292,19169,1597.416667,407.0769231,3.622260015
NM_014783,ARHGAP11A,12,11,24461,5910,18551,1686.454545,492.5,3.13891709
NM_013372,GREM1,2,1,16667,4140,12527,12527,2070,3.025845411
NM_001286479,ARHGAP11A,12,11,24807,5169,19638,1785.272727,430.75,3.799187464
NM_001277314,FMN1,5,4,44951,3972,40979,10244.75,794.4,10.31696878
NM_152595,PGBD4,1,0,2319,2319,NA,NA,2319,NA
NM_020154,EMC7,5,4,17831,1058,16773,4193.25,211.6,15.85349716
NM_016454,EMC4,5,4,5170,1052,4118,1029.5,210.4,3.914448669
NM_001286420,EMC4,4,3,5170,890,4280,1426.666667,222.5,4.808988764
NM_181077,GOLGA8A,16,15,10733,4279,6454,430.2666667,267.4375,1.508296331
NM_018648,NOP10,2,1,1447,537,910,910,268.5,1.694599628
NM_153613,LPCAT4,14,13,8308,1922,6386,491.2307692,137.2857143,3.322580645
NM_175741,NUTM1,8,7,14424,4204,10220,1460,525.5,2.431018078
NM_001284292,NUTM1,8,7,14424,4119,10305,1472.142857,514.875,2.50182083
NM_001284293,NUTM1,7,6,14424,4024,10400,1733.333333,574.8571429,2.584493042
NM_001023567,GOLGA8B,16,15,10740,4286,6454,430.2666667,267.875,1.505832944
NM_020660,GJD2,2,1,2142,1098,1044,1044,549,0.950819672
NM_005159,ACTC1,7,6,7632,3700,3932,655.3333333,528.5714286,1.062702703
NM_014106,ZNF770,3,2,9957,5451,4506,2253,1817,0.826637314
NM_001141972,DPH6,4,3,25932,2384,23548,7849.333333,596,9.877516779
NM_152453,TMCO5A,11,10,16168,1169,14999,1499.9,106.2727273,12.83062447
NM_152594,SPRED1,7,6,104400,7262,97138,16189.66667,1037.428571,13.3762049
NM_173611,FAM98B,8,7,33585,4396,29189,4169.857143,549.5,6.639899909
NM_207444,C15orf53,2,1,3442,2045,1397,1397,1022.5,0.683129584
NM_207445,C15orf54,2,1,4165,3082,1083,1083,1541,0.351395198
NM_003246,THBS1,22,21,16390,5812,10578,503.7142857,264.1818182,1.820027529
NM_003134,SRP14,5,4,3500,1131,2369,592.25,226.2,2.094606543
NM_033503,BMF,4,3,18549,4541,14008,4669.333333,1135.25,3.084783087
NM_001003942,BMF,3,2,18197,4391,13806,6903,1463.666667,3.144158506
NM_001003940,BMF,5,4,20985,4691,16294,4073.5,938.2,3.473459817
NM_001003943,BMF,4,3,20996,4540,16456,5485.333333,1135,3.624669604
NM_001276718,PAK6,10,9,38398,4226,34172,3796.888889,422.6,8.08613346
NM_001276717,PAK6,10,9,24311,2556,21755,2417.222222,255.6,8.511345853
NM_001190479,ANKRD63,1,0,1144,1144,NA,NA,1144,NA
NM_001128628,PAK6,11,10,60061,3890,56171,5617.1,353.6363636,14.43984576
NM_001128629,PAK6,10,9,60061,3806,56255,6250.555556,380.6,14.78060956
NM_001284299,PLCB2,8,7,7308,1834,5474,782,229.25,2.984732824
NM_001284297,PLCB2,32,31,20078,4697,15381,496.1612903,146.78125,3.274643389
NM_001039905,C15orf56,2,1,2246,2129,117,117,1064.5,0.054955378
NM_001284298,PLCB2,31,30,20078,4663,15415,513.8333333,150.4193548,3.305811709
NM_020168,PAK6,11,10,37692,3949,33743,3374.3,359,8.544694859
NM_004573,PLCB2,32,31,20078,4709,15369,495.7741935,147.15625,3.263750265
NM_001159508,IVD,11,10,15828,4586,11242,1124.2,416.9090909,2.451373746
NM_001142762,KNSTRN,8,7,11569,1703,9866,1409.428571,212.875,5.793305931
NM_002225,IVD,12,11,15828,4677,11151,1013.727273,389.75,2.384220654
NM_001142761,KNSTRN,9,8,11569,2042,9527,1190.875,226.8888889,4.665523996
NM_033510,DISP2,8,7,12824,5040,7784,1112,630,1.544444444
NM_001145643,PHGR1,3,2,5402,438,4964,2482,146,11.33333333
NM_014952,BAHD1,7,6,27032,4533,22499,3749.833333,647.5714286,4.96337966
NM_033286,KNSTRN,9,8,11569,1766,9803,1225.375,196.2222222,5.550962627
NM_052849,C15orf57,4,3,12146,1899,10247,3415.666667,474.75,5.395997894
NM_001080792,C15orf57,4,3,12146,1714,10432,3477.333333,428.5,6.086347725
NM_001080791,C15orf57,4,3,12146,1924,10222,3407.333333,481,5.312889813
NM_152260,RPUSD2,3,2,5403,2119,3284,1642,706.3333333,1.549787636
NM_001289132,C15orf57,4,3,33718,1646,32072,10690.66667,411.5,19.48481166
NM_001286407,RPUSD2,3,2,5403,1936,3467,1733.5,645.3333333,1.790805785
NM_001164270,RAD51,9,8,37031,2186,34845,4355.625,242.8888889,15.94007319
NM_133487,RAD51,10,9,37031,2312,34719,3857.666667,231.2,15.01686851
NM_002875,RAD51,10,9,37031,2309,34722,3858,230.9,15.03767865
NM_001164269,RAD51,10,9,36980,2157,34823,3869.222222,215.7,16.14418173
NM_001130143,PPP1R14D,5,4,13266,878,12388,3097,175.6,14.10933941
NM_001130448,C15orf62,1,0,2491,2491,NA,NA,2491,NA
NM_001258421,ZFYVE19,11,10,7495,2087,5408,540.8,189.7272727,2.591279348
NM_001258420,ZFYVE19,10,9,7495,2079,5416,601.7777778,207.9,2.605098605
NM_018145,RMDN3,13,12,19374,2264,17110,1425.833333,174.1538462,7.557420495
NM_181642,SPINT1,11,10,13609,2485,11124,1112.4,225.9090909,4.476458753
NM_001032367,SPINT1,10,9,13212,2342,10870,1207.777778,234.2,4.641332195
NM_018163,DNAJC17,11,10,39611,1029,38582,3858.2,93.54545455,37.494655
NM_017726,PPP1R14D,4,3,13266,761,12505,4168.333333,190.25,16.43232589
NM_001077268,ZFYVE19,11,10,7495,2284,5211,521.1,207.6363636,2.281523643
NM_032850,ZFYVE19,12,11,7495,1954,5541,503.7272727,162.8333333,2.835721597
NM_005258,GCHFR,3,2,3628,716,2912,1456,238.6666667,4.067039106
NM_003710,SPINT1,11,10,13609,2437,11172,1117.2,221.5454545,4.58432499
NM_001142776,CHAC1,4,3,3083,1429,1654,551.3333333,357.25,1.157452764
NM_133639,RHOV,3,2,2077,1708,369,184.5,569.3333333,0.216042155
NM_024111,CHAC1,3,2,3083,1563,1520,760,521,0.972488804
NM_020857,VPS18,5,4,9547,3900,5647,1411.75,780,1.447948718
NM_019074,DLL4,11,10,9729,3431,6298,629.8,311.9090909,1.835616438
NM_152596,EXD1,10,9,48026,3004,45022,5002.444444,300.4,14.9873502
NM_001286441,EXD1,12,11,48026,3261,44765,4069.545455,271.75,13.72738424
NM_001243144,NUSAP1,9,8,48358,2274,46084,5760.5,252.6666667,20.26561126
NM_007280,OIP5,5,4,23355,1241,22114,5528.5,248.2,17.8195004
NM_016359,NUSAP1,11,10,48358,2465,45893,4589.3,224.0909091,18.6178499
NM_001243143,NUSAP1,11,10,48358,2420,45938,4593.8,220,18.98264463
NM_001243142,NUSAP1,11,10,48358,2459,45899,4589.9,223.5454545,18.66571777
NM_018454,NUSAP1,11,10,48358,2462,45896,4589.6,223.8181818,18.64175467
NM_002220,ITPKA,7,6,9703,1856,7847,1307.833333,265.1428571,4.227909483
NM_002344,LTK,20,19,10247,3147,7100,373.6842105,157.35,2.256116937
NM_206961,LTK,19,18,10247,2963,7284,404.6666667,155.9473684,2.458319271
NM_015138,RTF1,18,17,66461,5039,61422,3613.058824,279.9444444,12.18932328
NM_001135685,LTK,18,17,10247,2755,7492,440.7058824,153.0555556,2.719419238
NM_006293,TYRO3,19,18,20318,3990,16328,907.1111111,210,4.092230576
NM_001164273,MGA,24,23,109533,12066,97467,4237.695652,502.75,8.077821979
NM_001080541,MGA,23,22,109533,11438,98095,4458.863636,497.3043478,8.576237104
NM_016642,SPTBN5,68,67,45933,11791,34142,509.5820896,173.3970588,2.895598338
NM_001198588,JMJD7-PLA2G4B,24,23,20065,3204,16861,733.0869565,133.5,5.262484395
NM_001114632,JMJD7,8,7,9504,1430,8074,1153.428571,178.75,5.646153846
NM_001114633,PLA2G4B,20,19,9337,2755,6582,346.4210526,137.75,2.389110708
NM_005090,JMJD7-PLA2G4B,25,24,20065,3392,16673,694.7083333,135.68,4.915389151
NM_213600,PLA2G4F,20,19,15509,3512,11997,631.4210526,175.6,3.416002278
NM_178034,PLA2G4D,20,19,26873,3604,23269,1224.684211,180.2,6.456437292
NM_015497,TMEM87A,20,19,63134,3130,60004,3158.105263,156.5,19.17060703
NM_001110503,TMEM87A,7,6,16689,2791,13898,2316.333333,398.7142857,4.979577212
NM_001286487,TMEM87A,19,18,63134,3068,60066,3337,161.4736842,19.57822686
NM_024344,CAPN3,23,22,52819,3321,49498,2249.909091,144.3913043,14.90454682
NM_000070,CAPN3,24,23,52819,3340,49479,2151.26087,139.1666667,14.81407186
NM_173089,CAPN3,9,8,7540,1282,6258,782.25,142.4444444,4.881435257
NM_173088,CAPN3,13,12,9929,1656,8273,689.4166667,127.3846154,4.995772947
NM_173087,CAPN3,21,20,52819,3061,49758,2487.9,145.7619048,16.25547207
NM_173090,CAPN3,10,9,7540,1301,6239,693.2222222,130.1,4.795541891
NM_130798,SNAP23,7,6,37757,2489,35268,5878,355.5714286,14.169546
NM_003825,SNAP23,8,7,37757,2649,35108,5015.428571,331.125,13.25330313
NM_153260,LRRC57,6,5,6284,2421,3863,772.6,403.5,1.595621644
NM_138477,CDAN1,28,27,13659,4758,8901,329.6666667,169.9285714,1.87074401
NM_024956,TMEM62,14,13,51621,2782,48839,3756.846154,198.7142857,17.55535586
NM_012142,CCNDBP1,11,10,11911,3661,8250,825,332.8181818,2.253482655
NM_001114134,EPB42,13,12,23899,2463,21436,1786.333333,189.4615385,8.703207471
NM_000119,EPB42,13,12,23899,2553,21346,1778.833333,196.3846154,8.361143752
NM_201631,TGM5,13,12,34264,2780,31484,2623.666667,213.8461538,11.32517986
NM_001159280,ADAL,12,11,24201,4501,19700,1790.909091,375.0833333,4.376805154
NM_001012969,ADAL,10,9,19063,1945,17118,1902,194.5,8.801028278
NM_052955,TGM7,13,12,25976,2325,23651,1970.916667,178.8461538,10.17247312
NM_014793,LCMT2,1,0,2848,2848,NA,NA,2848,NA
NM_004245,TGM5,12,11,34264,2533,31731,2884.636364,211.0833333,12.52704303
NM_014444,TUBGCP4,18,17,36038,4196,31842,1873.058824,233.1111111,7.588655863
NM_152455,ZSCAN29,5,4,11890,5612,6278,1569.5,1122.4,1.118674269
NM_001286414,TUBGCP4,18,17,36038,4199,31839,1872.882353,233.2777778,7.582519648
NM_002373,MAP1A,6,5,14014,10281,3733,746.6,1713.5,0.363096975
NM_020990,CKMT1B,10,9,6354,1789,4565,507.2222222,178.9,2.551704863
NM_001190214,PPIP5K1,30,29,56793,5667,51126,1762.965517,188.9,9.021704606
NM_014659,PPIP5K1,29,28,51432,5590,45842,1637.214286,192.7586207,8.200715564
NM_001130859,PPIP5K1,29,28,56793,5667,51126,1825.928571,195.4137931,9.021704606
NM_001130858,PPIP5K1,31,30,56793,5749,51044,1701.466667,185.4516129,8.878761524
NM_172095,CATSPER2,13,12,18281,1960,16321,1360.083333,150.7692308,8.327040816
NM_001282309,CATSPER2,14,13,18285,1854,16431,1263.923077,132.4285714,8.862459547
NM_001015001,CKMT1A,10,9,6338,1789,4549,505.4444444,178.9,2.542761319
NM_054020,CATSPER2,13,12,18281,1954,16327,1360.583333,150.3076923,8.355680655
NM_172097,CATSPER2,5,4,9407,1669,7738,1934.5,333.8,4.636309167
NM_001282310,CATSPER2,13,12,18285,1768,16517,1376.416667,136,9.34219457
NM_024908,WDR76,13,12,41507,4040,37467,3122.25,310.7692308,9.274009901
NM_016400,HYPK,4,3,2152,1337,815,271.6666667,334.25,0.609573672
NM_025165,ELL3,11,10,4706,2124,2582,258.2,193.0909091,1.215630885
NM_001167941,WDR76,13,12,41507,3930,37577,3131.416667,302.3076923,9.561577608
NM_001199885,HYPK,3,2,2152,1280,872,436,426.6666667,0.68125
NM_001199878,SERF2,3,2,3714,2727,987,493.5,909,0.361936194
NM_001199877,SERF2,5,4,18995,3434,15561,3890.25,686.8,4.531450204
NM_001199875,SERF2,3,2,4115,3034,1081,540.5,1011.333333,0.35629532
NM_001199876,SERF2,3,2,4115,2923,1192,596,974.3333333,0.407800205
NM_001258031,SERINC4,12,11,5925,2506,3419,310.8181818,208.8333333,1.364325619
NM_005926,MFAP1,9,8,20220,2072,18148,2268.5,230.2222222,8.758687259
NM_001258032,SERINC4,11,10,5925,2334,3591,359.1,212.1818182,1.538560411
NM_001018108,SERF2,3,2,4249,3034,1215,607.5,1011.333333,0.400461437
NM_016396,CTDSPL2,13,12,99852,4887,94965,7913.75,375.9230769,19.43216697
NM_025137,SPG11,40,39,100984,7828,93156,2388.615385,195.7,11.90035769
NM_001284336,EIF3J,6,5,25737,2417,23320,4664,402.8333333,9.648324369
NM_003758,EIF3J,8,7,25737,2566,23171,3310.142857,320.75,9.030007794
NM_001160227,SPG11,38,37,100984,7487,93497,2526.945946,197.0263158,12.48791238
NM_001284335,EIF3J,7,6,25737,2403,23334,3889,343.2857143,9.710362047
NM_004048,B2M,4,3,6674,991,5683,1894.333333,247.75,5.734611504
NM_001145112,PATL2,16,15,11158,1967,9191,612.7333333,122.9375,4.672597865
NM_182985,TRIM69,7,6,31467,1908,29559,4926.5,272.5714286,15.49213836
NM_080745,TRIM69,6,5,31467,1430,30037,6007.4,238.3333333,21.0048951
NM_152448,C15orf43,7,6,22523,1282,21241,3540.166667,183.1428571,16.56864275
NM_001276268,DUOXA1,6,5,12513,2698,9815,1963,449.6666667,3.637879911
NM_001276267,DUOXA1,9,8,12512,3041,9471,1183.875,337.8888889,3.114436041
NM_001276266,DUOXA1,6,5,3972,1100,2872,574.4,183.3333333,2.610909091
NM_001276265,DUOXA1,7,6,5679,1502,4177,696.1666667,214.5714286,2.780958722
NM_001276264,DUOXA1,11,10,12497,1984,10513,1051.3,180.3636364,5.298891129
NM_014080,DUOX2,34,33,21509,6380,15129,458.4545455,187.6470588,2.371316614
NM_017434,DUOX1,35,34,35586,5714,29872,878.5882353,163.2571429,5.227861393
NM_144565,DUOXA1,11,10,12497,2014,10483,1048.3,183.0909091,5.205064548
NM_207581,DUOXA2,6,5,3780,1444,2336,467.2,240.6666667,1.617728532
NM_175940,DUOX1,34,33,35586,5521,30065,911.0606061,162.3823529,5.445571454
NM_004212,SLC28A2,18,17,23706,2481,21225,1248.529412,137.8333333,8.555018138
NM_024063,SPATA5L1,8,7,19099,2587,16512,2358.857143,323.375,6.382682644
NM_032413,C15orf48,4,3,2922,957,1965,655,239.25,2.053291536
NM_197955,C15orf48,5,4,2922,844,2078,519.5,168.8,2.462085308
NM_001482,GATM,9,8,17660,2595,15065,1883.125,288.3333333,5.80539499
NM_013309,SLC30A4,8,7,40324,4291,36033,5147.571429,536.375,8.397343277
NM_012388,BLOC1S6,5,4,22494,3946,18548,4637,789.2,4.700456158
NM_021199,SQRDL,10,9,56556,2013,54543,6060.333333,201.3,27.09538003
NM_001271213,SQRDL,11,10,60148,1821,58327,5832.7,165.5454545,32.03020319
NM_020858,SEMA6D,17,16,55736,5930,49806,3112.875,348.8235294,8.398988196
NM_024966,SEMA6D,13,12,46993,2303,44690,3724.166667,177.1538462,19.40512375
NM_153619,SEMA6D,18,17,55736,5927,49809,2929.941176,329.2777778,8.403745571
NM_153618,SEMA6D,19,18,55736,6118,49618,2756.555556,322,8.110166721
NM_153617,SEMA6D,18,17,55736,5949,49787,2928.647059,330.5,8.368969575
NM_153616,SEMA6D,17,16,55736,5891,49845,3115.3125,346.5294118,8.461212018
NM_016132,MYEF2,17,16,38931,5420,33511,2094.4375,318.8235294,6.182841328
NM_205850,SLC24A5,9,8,21422,1626,19796,2474.5,180.6666667,12.17466175
NM_001145668,CTXN2,2,1,12086,2697,9389,9389,1348.5,3.481275491
NM_000338,SLC12A1,27,26,97779,4736,93043,3578.576923,175.4074074,19.64590372
NM_001184832,SLC12A1,27,26,97779,4736,93043,3578.576923,175.4074074,19.64590372
NM_001194998,CEP152,27,26,73210,5664,67546,2597.923077,209.7777778,11.92549435
NM_014985,CEP152,26,25,73210,5495,67715,2708.6,211.3461538,12.32302093
NM_014335,EID1,1,0,2092,2092,NA,NA,2092,NA
NM_001143887,COPS2,13,12,30385,4121,26264,2188.666667,317,6.373210386
NM_004236,COPS2,13,12,30385,4100,26285,2190.416667,315.3846154,6.41097561
NM_002009,FGF7,4,3,64150,3940,60210,20070,985,15.28172589
NM_001144955,DTWD1,5,4,24109,2627,21482,5370.5,525.4,8.177388656
NM_020234,DTWD1,6,5,24109,2756,21353,4270.6,459.3333333,7.747822932
NM_001159629,SLC27A2,9,8,54198,2241,51957,6494.625,249,23.18473896
NM_002112,HDC,12,11,24018,2654,21364,1942.181818,221.1666667,8.049736247
NM_003645,SLC27A2,10,9,54198,2401,51797,5755.222222,240.1,21.57309454
NM_203494,USP50,7,6,46145,1399,44746,7457.666667,199.8571429,31.98427448
NM_032802,SPPL2A,15,14,58175,2018,56157,4011.214286,134.5333333,27.82804757
NM_001165257,SCG3,11,10,39675,3268,36407,3640.7,297.0909091,11.14045288
NM_153374,LYSMD2,3,2,15061,1695,13366,6683,565,7.885545723
NM_013243,SCG3,12,11,39675,3322,36353,3304.818182,276.8333333,10.94310656
NM_014548,TMOD2,10,9,64802,9194,55608,6178.666667,919.4,6.048292365
NM_001142885,TMOD2,9,8,64802,9085,55717,6964.625,1009.444444,6.132856357
NM_138792,LEO1,12,11,33778,2200,31578,2870.727273,183.3333333,14.35363636
NM_001286430,LEO1,10,9,33778,2018,31760,3528.888889,201.8,15.73835481
NM_020396,BCL2L10,2,1,3152,889,2263,2263,444.5,2.545556805
NM_002748,MAPK6,6,5,47053,4231,42822,8564.4,705.1666667,10.12101158
NM_006628,ARPP19,3,2,21783,5165,16618,8309,1721.666667,3.217424976
NM_001286495,FAM214A,12,11,70731,4241,66490,6044.545455,353.4166667,15.67790615
NM_004498,ONECUT1,2,1,33051,2120,30931,30931,1060,14.59009434
NM_001277176,WDR72,3,2,27364,4251,23113,11556.5,1417,5.43707363
NM_016304,RSL24D1,6,5,15721,1479,14242,2848.4,246.5,9.629479378
NM_183236,RAB27A,7,6,67945,3407,64538,10756.33333,486.7142857,18.9427649
NM_183234,RAB27A,7,6,67322,3447,63875,10645.83333,492.4285714,18.53060632
NM_004580,RAB27A,6,5,67430,3465,63965,12793,577.5,18.46031746
NM_001204451,CCPG1,10,9,53289,2581,50708,5634.222222,258.1,19.64664859
NM_001204450,CCPG1,9,8,53289,3729,49560,6195,414.3333333,13.29042639
NM_020739,CCPG1,8,7,53289,6857,46432,6633.142857,857.125,6.771474406
NM_004748,CCPG1,8,7,53155,7097,46058,6579.714286,887.125,6.489784416
NM_004855,PIGB,12,11,36715,2209,34506,3136.909091,184.0833333,15.62064282
NM_130810,DYX1C1,10,9,77928,2003,75925,8436.111111,200.3,37.90564154
NM_001033560,DYX1C1,9,8,90480,1802,88678,11084.75,200.2222222,49.2108768
NM_001033559,DYX1C1,9,8,77928,1896,76032,9504,210.6666667,40.10126582
NM_001284340,NEDD4,24,23,90214,7211,83003,3608.826087,300.4583333,11.51060879
NM_001284338,NEDD4,25,24,90214,7263,82951,3456.291667,290.52,11.42103814
NM_198400,NEDD4,22,21,90214,7044,83170,3960.47619,320.1818182,11.80721181
NM_001284339,NEDD4,25,24,90214,7215,82999,3458.291667,288.6,11.5036729
NM_198524,TEX9,13,12,80575,1572,79003,6583.583333,120.9230769,50.25636132
NM_001286449,TEX9,13,12,80575,1795,78780,6565,138.0769231,43.88857939
NM_001018102,POLR2M,4,3,11038,3840,7198,2399.333333,960,1.874479167
NM_015532,POLR2M,4,3,11038,4311,6727,2242.333333,1077.75,1.560426815
NM_170697,ALDH1A2,11,10,60675,3218,57457,5745.7,292.5454545,17.85487881
NM_001013843,SLTM,21,20,54610,4114,50496,2524.8,195.9047619,12.27418571
NM_024755,SLTM,21,20,54610,4168,50442,2522.1,198.4761905,12.10220729
NM_033195,LDHAL6B,1,0,1772,1772,NA,NA,1772,NA
NM_004701,CCNB2,9,8,19962,1558,18404,2300.5,173.1111111,11.81258023
NM_004492,GTF2A2,5,4,19478,1587,17891,4472.75,317.4,11.27347196
NM_004751,GCNT3,3,2,8230,2225,6005,3002.5,741.6666667,2.698876404
NM_004330,BNIP2,10,9,26582,2527,24055,2672.777778,252.7,9.519192719
NM_012182,FOXB1,2,1,1723,1461,262,262,730.5,0.179329227
NM_001276385,NARG2,9,8,28067,3892,24175,3021.875,432.4444444,6.211459404
NM_024611,NARG2,16,15,59553,7240,52313,3487.533333,452.5,7.225552486
NM_001018089,NARG2,16,15,59553,7080,52473,3498.2,442.5,7.411440678
NM_207322,C2CD4A,2,1,3942,3447,495,495,1723.5,0.143603133
NM_001007595,C2CD4B,2,1,1747,1578,169,169,789,0.107097592
NM_032857,LACTB,6,5,20267,1982,18285,3657,330.3333333,9.225529768
NM_000366,TPM1,10,9,23456,1298,22158,2462,129.8,17.07087827
NM_001288585,LACTB,5,4,9673,3012,6661,1665.25,602.4,2.211487384
NM_171846,LACTB,5,4,9673,3016,6657,1664.25,603.2,2.207228117
NM_001018020,TPM1,9,8,29277,1797,27480,3435,199.6666667,15.29215359
NM_001018008,TPM1,8,7,22197,1574,20623,2946.142857,196.75,13.10228717
NM_001018007,TPM1,9,8,29277,1797,27480,3435,199.6666667,15.29215359
NM_001018006,TPM1,9,8,29277,1797,27480,3435,199.6666667,15.29215359
NM_001018004,TPM1,9,8,29277,1797,27480,3435,199.6666667,15.29215359
NM_001018005,TPM1,10,9,23456,1250,22206,2467.333333,125,17.7648
NM_015920,RPS27L,4,3,4204,1088,3116,1038.666667,272,2.863970588
NM_016530,RAB8B,8,7,78247,4883,73364,10480.57143,610.375,15.02437026
NM_001218,CA12,11,10,58347,3986,54361,5436.1,362.3636364,13.63798294
NM_206925,CA12,10,9,58347,3952,54395,6043.888889,395.2,13.763917
NM_203373,FBXL22,2,1,5070,1521,3549,3549,760.5,2.333333333
NM_003099,SNX1,15,14,48352,8330,40022,2858.714286,555.3333333,4.804561825
NM_024798,SNX22,7,6,5766,3621,2145,357.5,517.2857143,0.592377796
NM_148955,SNX1,13,12,48352,8133,40219,3351.583333,625.6153846,4.945161687
NM_001242933,SNX1,15,14,48352,7856,40496,2892.571429,523.7333333,5.154786151
NM_000942,PPIB,5,4,7342,1033,6309,1577.25,206.6,6.107454017
NM_001014812,FAM96A,4,3,21451,1049,20402,6800.666667,262.25,19.44899905
NM_001289108,FAM96A,3,2,21451,3511,17940,8970,1170.333333,5.109655369
NM_032231,FAM96A,5,4,21451,1100,20351,5087.75,220,18.50090909
NM_016213,TRIP4,13,12,67501,2058,65443,5453.583333,158.3076923,31.79931973
NM_001029989,KIAA0101,3,2,16500,1333,15167,7583.5,444.3333333,11.37809452
NM_014736,KIAA0101,4,3,16500,1497,15003,5001,374.25,10.02204409
NM_002537,OAZ2,5,4,15691,1921,13770,3442.5,384.2,7.168141593
NM_194272,RBPMS2,8,7,35677,2002,33675,4810.714286,250.25,16.82067932
NM_025049,PIF1,13,12,10040,2702,7338,611.5,207.8461538,2.715766099
NM_001286497,PIF1,13,12,10040,2293,7747,645.5833333,176.3846154,3.378543393
NM_001286499,PIF1,13,12,10040,2726,7314,609.5,209.6923077,2.683052091
NM_001286496,PIF1,13,12,10040,2726,7314,609.5,209.6923077,2.683052091
NM_182703,ANKDD1A,15,14,46942,3127,43815,3129.642857,208.4666667,14.01183243
NM_001163692,UBAP1L,5,4,13357,1388,11969,2992.25,277.6,8.623198847
NM_016563,RASL12,5,4,14715,2583,12132,3033,516.6,4.696864111
NM_178859,SLC51B,4,3,8028,944,7084,2361.333333,236,7.504237288
NM_001101362,KBTBD13,1,0,3124,3124,NA,NA,3124,NA
NM_139242,MTFMT,9,8,28129,2755,25374,3171.75,306.1111111,9.210163339
NM_006660,CLPX,14,13,34781,2365,32416,2493.538462,168.9285714,13.70655391
NM_005707,PDCD7,5,4,16459,2856,13603,3400.75,571.2,4.762955182
NM_003613,CILP,9,8,15505,4477,11028,1378.5,497.4444444,2.463256645
NM_017851,PARP16,6,5,28583,2540,26043,5208.6,423.3333333,10.25314961
NM_020962,IGDCC4,20,19,41587,6505,35082,1846.421053,325.25,5.393082244
NM_016395,PTPLAD1,11,10,47868,3219,44649,4464.9,292.6363636,13.87045666
NM_001207059,VWA9,11,10,32533,2188,30345,3034.5,198.9090909,13.86882998
NM_001207058,VWA9,12,11,32533,2306,30227,2747.909091,192.1666667,13.10797918
NM_001254740,SLC24A1,7,6,13357,3537,9820,1636.666667,505.2857143,2.77636415
NM_001206836,RAB11A,5,4,22534,4839,17695,4423.75,967.8,3.656747262
NM_004663,RAB11A,5,4,22534,4934,17600,4400,986.8,3.567085529
NM_001143688,DIS3L,17,16,40318,3783,36535,2283.4375,222.5294118,9.657679091
NM_133375,DIS3L,17,16,40605,3702,36903,2306.4375,217.7647059,9.968395462
NM_017858,TIPIN,8,7,20048,1288,18760,2680,161,14.56521739
NM_001287823,ZWILCH,18,17,44403,3158,41245,2426.176471,175.4444444,13.06048132
NM_006049,SNAPC5,4,3,7482,789,6693,2231,197.25,8.482889734
NM_000968,RPL4,10,9,5542,1451,4091,454.5555556,145.1,2.819434873
NM_017975,ZWILCH,19,18,44403,3211,41192,2288.444444,169,12.82840237
NM_001287821,ZWILCH,19,18,44403,3306,41097,2283.166667,174,12.43103448
NM_001287822,ZWILCH,18,17,44403,3209,41194,2423.176471,178.2777778,12.83702088
NM_005585,SMAD6,4,3,79665,2882,76783,25594.33333,720.5,26.64226232
NM_001142861,SMAD6,4,3,73409,1289,72120,24040,322.25,55.95034911
NM_001145103,SMAD3,9,8,57176,5820,51356,6419.5,646.6666667,8.824054983
NM_001145104,SMAD3,7,6,29042,5451,23591,3931.833333,778.7142857,4.327829756
NM_001145102,SMAD3,9,8,69481,6009,63472,7934,667.6666667,10.56282243
NM_022784,IQCH,6,5,52425,1005,51420,10284,167.5,51.1641791
NM_001143936,C15orf61,2,1,6121,1299,4822,4822,649.5,3.71208622
NM_001258024,SKOR1,15,14,14134,2622,11512,822.2857143,174.8,4.390541571
NM_001031733,CALML4,4,3,15407,4498,10909,3636.333333,1124.5,2.425300133
NM_017882,CLN6,7,6,22752,2249,20503,3417.166667,321.2857143,9.116496221
NM_033429,CALML4,5,4,15407,4640,10767,2691.75,928,2.320474138
NM_001286695,CALML4,3,2,15407,4466,10941,5470.5,1488.666667,2.44984326
NM_001286694,CALML4,4,3,15407,4608,10799,3599.666667,1152,2.343532986
NM_015322,FEM1B,2,1,18064,7124,10940,10940,3562,1.535654127
NM_145658,SPESP1,2,1,16313,1433,14880,14880,716.5,10.38381019
NM_001104554,PAQR5,9,8,93236,5485,87751,10968.875,609.4444444,15.99835916
NM_213725,RPLP1,3,2,2727,440,2287,1143.5,146.6666667,5.197727273
NM_001003,RPLP1,4,3,2727,516,2211,737,129,4.284883721
NM_001008224,UACA,19,18,47729,7099,40630,2257.222222,373.6315789,5.723341316
NM_018357,LARP6,3,2,22743,2184,20559,10279.5,728,9.413461538
NM_197958,LARP6,2,1,2840,673,2167,2167,336.5,3.219910847
NM_001286679,LARP6,3,2,21936,1919,20017,10008.5,639.6666667,10.43095362
NM_020147,THAP10,3,2,11093,2050,9043,4521.5,683.3333333,4.411219512
NM_001102658,CT62,4,3,5258,1835,3423,1141,458.75,1.865395095
NM_014249,NR2E3,9,8,7711,2010,5703,712.875,223.3333333,2.837313433
NM_016346,NR2E3,8,7,4384,2116,2270,324.2857143,264.5,1.072778828
NM_001166340,SENP8,2,1,26714,1682,25032,25032,841,14.882283
NM_145204,SENP8,2,1,22682,1571,21111,21111,785.5,13.43793762
NM_001172111,SENP8,3,2,22682,1696,20986,10493,565.3333333,12.37382075
NM_001172110,SENP8,3,2,24067,1679,22388,11194,559.6666667,13.33412746
NM_001172109,SENP8,3,2,24121,1837,22284,11142,612.3333333,12.1306478
NM_052840,CELF6,13,12,35459,3413,32046,2670.5,262.5384615,9.389393495
NM_001172685,CELF6,11,10,21590,2865,18725,1872.5,260.4545455,6.535776614
NM_001172684,CELF6,12,11,35221,3093,32128,2920.727273,257.75,10.38732622
NM_002654,PKM,11,10,32359,2512,29847,2984.7,228.3636364,11.88176752
NM_182471,PKM,11,10,32359,2512,29847,2984.7,228.3636364,11.88176752
NM_182470,PKM,11,10,32359,2728,29631,2963.1,248,10.86180352
NM_001206796,PKM,12,11,32359,2850,29509,2682.636364,237.5,10.35403509
NM_001206797,PKM,10,9,32359,2289,30070,3341.111111,228.9,13.13674093
NM_020214,PARP6,23,22,30108,2649,27459,1248.136364,115.173913,10.36579841
NM_001206799,PKM,11,10,30695,2417,28278,2827.8,219.7272727,11.69962764
NM_001206798,PKM,11,10,32359,2537,29822,2982.2,230.6363636,11.75482854
NM_001080462,TMEM202,5,4,10042,1301,8741,2185.25,260.2,6.71867794
NM_000520,HEXA,14,13,32744,2451,30293,2330.230769,175.0714286,12.35944512
NM_018652,GOLGA6B,18,17,12702,3196,9506,559.1764706,177.5555556,2.974342929
NM_031284,ADPGK,7,6,32420,2566,29854,4975.666667,366.5714286,11.63445051
NM_005477,HCN4,8,7,49407,7236,42171,6024.428571,904.5,5.827943615
NM_025240,CD276,8,7,30239,2755,27484,3926.285714,344.375,9.976043557
NM_001024736,CD276,10,9,30239,3411,26828,2980.888889,341.1,7.865142187
NM_001039614,C15orf59,2,1,11677,1346,10331,10331,673,7.675334324
NM_153356,TBC1D21,11,10,15631,1260,14371,1437.1,114.5454545,11.40555556
NM_001286434,TBC1D21,10,9,15631,1151,14480,1608.888889,115.1,12.5803649
NM_001256677,STOML1,8,7,9132,2177,6955,993.5714286,272.125,3.194763436
NM_001256676,STOML1,7,6,11406,1859,9547,1591.166667,265.5714286,5.135556751
NM_001256675,STOML1,6,5,9132,1834,7298,1459.6,305.6666667,3.979280262
NM_001256674,STOML1,6,5,9132,1894,7238,1447.6,315.6666667,3.821541711
NM_001256673,STOML1,6,5,9132,1897,7235,1447,316.1666667,3.813916711
NM_001256672,STOML1,7,6,9132,2045,7087,1181.166667,292.1428571,3.465525672
NM_004809,STOML1,7,6,9132,2048,7084,1180.666667,292.5714286,3.458984375
NM_005576,LOXL1,7,6,25691,2368,23323,3887.166667,338.2857143,9.849239865
NM_001038640,GOLGA6A,18,17,12695,3194,9501,558.8823529,177.4444444,2.97463995
NM_001130138,ISLR2,4,3,6555,4265,2290,763.3333333,1066.25,0.536928488
NM_001130137,ISLR2,4,3,7149,4557,2592,864,1139.25,0.56879526
NM_001130136,ISLR2,4,3,7430,4821,2609,869.6666667,1205.25,0.54117403
NM_020851,ISLR2,3,2,6402,4389,2013,1006.5,1463,0.458646617
NM_201526,ISLR,2,1,2309,2113,196,196,1056.5,0.09275911
NM_001199042,STRA6,19,18,23414,3113,20301,1127.833333,163.8421053,6.52136203
NM_001199041,STRA6,19,18,28589,3009,25580,1421.111111,158.3684211,8.501163177
NM_001199040,STRA6,19,18,30240,2998,27242,1513.444444,157.7894737,9.086724483
NM_022369,STRA6,19,18,23414,2818,20596,1144.222222,148.3157895,7.308729595
NM_001142618,STRA6,19,18,23750,2864,20886,1160.333333,150.7368421,7.292597765
NM_001142620,STRA6,6,5,14644,1946,12698,2539.6,324.3333333,6.525179856
NM_001142619,STRA6,19,18,29565,2855,26710,1483.888889,150.2631579,9.355516637
NM_001142617,STRA6,19,18,29565,2882,26683,1482.388889,151.6842105,9.258501041
NM_005545,ISLR,2,1,3127,2297,830,830,1148.5,0.361340879
NM_000781,CYP11A1,9,8,29980,1940,28040,3505,215.5555556,14.45360825
NM_001099773,CYP11A1,9,8,28452,2013,26439,3304.875,223.6666667,13.13412817
NM_001287181,CCDC33,8,7,17602,2028,15574,2224.857143,253.5,7.679487179
NM_182791,CCDC33,9,8,17602,2131,15471,1933.875,236.7777778,7.259971844
NM_201265,UBL7,11,10,15213,1377,13836,1383.6,125.1818182,10.04793028
NM_032907,UBL7,11,10,15213,1448,13765,1376.5,131.6363636,9.50621547
NM_001286742,UBL7,12,11,15213,1560,13653,1241.181818,130,8.751923077
NM_001286741,UBL7,11,10,15213,1817,13396,1339.6,165.1818182,7.372592185
NM_001286740,UBL7,11,10,15213,1327,13886,1388.6,120.6363636,10.46420497
NM_001286739,UBL7,12,11,15213,1463,13750,1250,121.9166667,9.398496241
NM_001130028,CLK3,13,12,15209,2709,12500,1041.666667,208.3846154,4.6142488
NM_003992,CLK3,13,12,21831,1859,19972,1664.333333,143,10.74341044
NM_000761,CYP1A2,7,6,7759,3134,4625,770.8333333,447.7142857,1.47574984
NM_000499,CYP1A1,7,6,5996,2615,3381,563.5,373.5714286,1.29292543
NM_001127190,CSK,14,13,21116,2235,18881,1452.384615,159.6428571,8.44787472
NM_004383,CSK,13,12,21116,2753,18363,1530.25,211.7692308,6.670177988
NM_001289157,MPI,7,6,9448,2886,6562,1093.666667,412.2857143,2.273735274
NM_001030005,CPLX3,3,2,5187,2015,3172,1586,671.6666667,1.574193548
NM_004255,COX5A,5,4,17880,774,17106,4276.5,154.8,22.10077519
NM_002435,MPI,8,7,9448,3070,6378,911.1428571,383.75,2.07752443
NM_021819,LMAN1L,14,13,12907,1750,11157,858.2307692,125,6.375428571
NM_020447,FAM219B,5,4,7136,3555,3581,895.25,711,1.007313643
NM_005697,SCAMP2,9,8,28475,1300,27175,3396.875,144.4444444,20.90384615
NM_001289156,MPI,7,6,9448,2941,6507,1084.5,420.1428571,2.212512751
NM_001289155,MPI,7,6,9448,2860,6588,1098,408.5714286,2.303496503
NM_001099436,ULK3,16,15,7232,2788,4444,296.2666667,174.25,1.593974175
NM_001284364,ULK3,16,15,7232,2782,4450,296.6666667,173.875,1.599568656
NM_001284365,ULK3,16,15,7232,2711,4521,301.4,169.4375,1.667650314
NM_001178112,SCAMP5,8,7,25962,3465,22497,3213.857143,433.125,6.492640693
NM_001178111,SCAMP5,8,7,25962,3498,22464,3209.142857,437.25,6.421955403
NM_017793,RPP25,1,0,2334,2334,NA,NA,2334,NA
NM_021823,PPCDC,6,5,27142,2225,24917,4983.4,370.8333333,11.19865169
NM_138967,SCAMP5,7,6,25962,3414,22548,3758,487.7142857,6.60456942
NM_001164404,GOLGA6C,18,17,14899,5397,9502,558.9411765,299.8333333,1.760607745
NM_001145224,GOLGA6D,18,17,12968,3467,9501,558.8823529,192.6111111,2.740409576
NM_024608,NEIL1,10,9,8263,1906,6357,706.3333333,190.6,3.335257083
NM_006715,MAN2C1,26,25,12837,3307,9530,381.2,127.1923077,2.881765951
NM_015477,SIN3A,21,20,82208,6702,75506,3775.3,319.1428571,11.2661892
NM_001256552,NEIL1,10,9,7634,1830,5804,644.8888889,183,3.171584699
NM_001256495,MAN2C1,26,25,12837,3238,9599,383.96,124.5384615,2.96448425
NM_001256496,MAN2C1,24,23,12837,3008,9829,427.3478261,125.3333333,3.267619681
NM_001256494,MAN2C1,26,25,12837,3358,9479,379.16,129.1538462,2.822811197
NM_001145358,SIN3A,21,20,82369,6800,75569,3778.45,323.8095238,11.11308824
NM_001145357,SIN3A,21,20,86406,6625,79781,3989.05,315.4761905,12.04241509
NM_018285,IMP3,1,0,1240,1240,NA,NA,1240,NA
NM_153271,SNX33,2,1,9622,3235,6387,6387,1617.5,1.974343122
NM_001897,CSPG4,10,9,38528,8300,30228,3358.666667,830,3.641927711
NM_175881,ODF3L1,4,3,3710,1197,2513,837.6666667,299.25,2.099415205
NM_012170,FBXO22,6,5,27010,1723,25287,5057.4,287.1666667,14.67614626
NM_147188,FBXO22,7,6,31410,3489,27921,4653.5,498.4285714,8.002579536
NM_145805,ISL2,6,5,5671,1804,3867,773.4,300.6666667,2.143569845
NM_002902,RCN2,7,6,18641,2220,16421,2736.833333,317.1428571,7.396846847
NM_001271837,RCN2,8,7,18641,2275,16366,2338,284.375,7.193846154
NM_003978,PSTPIP1,15,14,42208,1870,40338,2881.285714,124.6666667,21.57112299
NM_005724,TSPAN3,7,6,27212,3860,23352,3892,551.4285714,6.049740933
NM_198902,TSPAN3,6,5,27212,3784,23428,4685.6,630.6666667,6.191331924
NM_001168412,TSPAN3,6,5,27212,3667,23545,4709,611.1666667,6.420779929
NM_032808,LINGO1,2,1,19342,2934,16408,16408,1467,5.592365372
NM_015079,TBC1D2B,13,12,82669,6028,76641,6386.75,463.6923077,12.71416722
NM_144572,TBC1D2B,13,12,82669,6080,76589,6382.416667,467.6923077,12.596875
NM_006383,CIB2,6,5,26931,1595,25336,5067.2,265.8333333,15.8846395
NM_001271889,CIB2,4,3,26931,1446,25485,8495,361.5,17.62448133
NM_001271888,CIB2,5,4,26931,1559,25372,6343,311.8,16.27453496
NM_001101404,SH2D7,6,5,11468,1898,9570,1914,316.3333333,5.042149631
NM_005530,IDH3A,11,10,21167,2676,18491,1849.1,243.2727273,6.909940209
NM_025234,WDR61,11,10,16364,1201,15163,1516.3,109.1818182,12.62531224
NM_018602,DNAJA4,8,7,18053,3194,14859,2122.714286,399.25,4.652160301
NM_001130183,DNAJA4,7,6,15980,2881,13099,2183.166667,411.5714286,4.546685179
NM_001130182,DNAJA4,7,6,17551,3054,14497,2416.166667,436.2857143,4.746889325
NM_004378,CRABP1,4,3,7908,776,7132,2377.333333,194,9.190721649
NM_001013619,HYKK,5,4,26108,1240,24868,6217,248,20.05483871
NM_002789,PSMA4,9,8,8818,1230,7588,948.5,136.6666667,6.169105691
NM_000745,CHRNA5,6,5,29751,3629,26122,5224.4,604.8333333,7.198126206
NM_001083612,HYKK,5,4,29811,853,28958,7239.5,170.6,33.94841735
NM_001102668,PSMA4,8,7,8818,1066,7752,1107.428571,133.25,7.272045028
NM_001102667,PSMA4,9,8,8818,1154,7664,958,128.2222222,6.641247834
NM_000750,CHRNB4,6,5,16953,2454,14499,2899.8,409,5.908312958
NM_001256567,CHRNB4,5,4,16953,1474,15479,3869.75,294.8,10.50135685
NM_014272,ADAMTS7,24,23,52230,5514,46716,2031.130435,229.75,8.472252448
NM_004390,CTSH,12,11,23330,1497,21833,1984.818182,124.75,14.58450234
NM_153815,RASGRF1,14,13,45715,4854,40861,3143.153846,346.7142857,8.418005768
NM_007364,TMED3,3,2,11700,1391,10309,5154.5,463.6666667,7.411214953
NM_001146341,ANKRD34C,2,1,15437,5426,10011,10011,2713,1.845005529
NM_015206,KIAA1024,4,3,39786,6746,33040,11013.33333,1686.5,4.897717166
NM_006441,MTHFS,3,2,53504,2339,51165,25582.5,779.6666667,21.87473279
NM_001199760,ST20-MTHFS,4,3,79561,2286,77275,25758.33333,571.5,33.80358705
NM_001199758,MTHFS,3,2,53740,2286,51454,25727,762,22.50831146
NM_001199757,ST20,3,2,24484,525,23959,11979.5,175,45.63619048
NM_001100879,ST20,3,2,16418,1014,15404,7702,338,15.1913215
NM_001100880,ST20,3,2,24484,547,23937,11968.5,182.3333333,43.76051188
NM_001114735,BCL2A1,3,2,10413,946,9467,4733.5,315.3333333,10.00739958
NM_004049,BCL2A1,2,1,10413,889,9524,9524,444.5,10.71316085
NM_001242919,ZFAND6,6,5,39979,1497,38482,7696.4,249.5,25.70607882
NM_001242917,ZFAND6,7,6,78827,1666,77161,12860.16667,238,46.31512605
NM_001242913,ZFAND6,8,7,78465,1693,76772,10967.42857,211.625,45.3467218
NM_001242912,ZFAND6,7,6,78827,1737,77090,12848.33333,248.1428571,44.38111687
NM_001242911,ZFAND6,6,5,78827,1657,77170,15434,276.1666667,46.57211829
NM_001242918,ZFAND6,5,4,78827,1542,77285,19321.25,308.4,50.11997406
NM_001242916,ZFAND6,7,6,65834,1666,64168,10694.66667,238,38.51620648
NM_001242915,ZFAND6,6,5,65834,1502,64332,12866.4,250.3333333,42.83089214
NM_001242914,ZFAND6,7,6,78235,1667,76568,12761.33333,238.1428571,45.93161368
NM_019006,ZFAND6,7,6,78827,1821,77006,12834.33333,260.1428571,42.28775398
NM_022566,MESDC1,1,0,3052,3052,NA,NA,3052,NA
NM_015154,MESDC2,3,2,14112,4246,9866,4933,1415.333333,2.323598681
NM_173528,C15orf26,7,6,14874,1582,13292,2215.333333,226,8.402022756
NM_181900,STARD5,6,5,11519,1322,10197,2039.4,220.3333333,7.713313162
NM_004513,IL16,7,6,15852,6084,9768,1628,869.1428571,1.605522682
NM_032246,MEX3B,2,1,4367,3532,835,835,1766,0.236409966
NM_001164465,GOLGA6L10,9,8,9358,4329,5029,628.625,481,1.161700162
NM_001199057,RPS17L,5,4,3706,490,3216,804,98,6.563265306
NM_198181,GOLGA6L9,9,8,9403,4383,5020,627.5,487,1.145334246
NM_001021,RPS17,5,4,3706,490,3216,804,98,6.563265306
NM_001282503,GOLGA6L20,9,8,9340,4320,5020,627.5,480,1.162037037
NM_001021,RPS17,5,4,3706,490,3216,804,98,6.563265306
NM_001199057,RPS17L,5,4,3706,490,3216,804,98,6.563265306
NM_001281806,FSD2,12,11,50707,6293,44414,4037.636364,524.4166667,7.05768314
NM_001281805,FSD2,13,12,50707,6411,44296,3691.333333,493.1538462,6.909374513
NM_001007122,FSD2,13,12,50707,6429,44278,3689.833333,494.5384615,6.88722974
NM_199330,HOMER2,9,8,103749,2001,101748,12718.5,222.3333333,50.84857571
NM_004839,HOMER2,9,8,103749,1968,101781,12722.625,218.6666667,51.7179878
NM_031452,FAM103A1,4,3,4856,1576,3280,1093.333333,394,2.081218274
NM_001160115,C15orf40,5,4,21024,557,20467,5116.75,111.4,36.74506284
NM_001160114,C15orf40,4,3,7250,984,6266,2088.666667,246,6.367886179
NM_001160113,C15orf40,3,2,3693,1001,2692,1346,333.6666667,2.689310689
NM_025238,BTBD1,8,7,50927,3298,47629,6804.142857,412.25,14.4417829
NM_001011885,BTBD1,7,6,50927,3209,47718,7953,458.4285714,14.87005298
NM_144597,C15orf40,4,3,7250,1704,5546,1848.666667,426,3.254694836
NM_001160116,C15orf40,4,3,22680,599,22081,7360.333333,149.75,36.86310518
NM_016073,HDGFRP3,6,5,69968,2440,67528,13505.6,406.6666667,27.67540984
NM_001144903,TM6SF1,9,8,29789,1825,27964,3495.5,202.7777778,15.32273973
NM_023003,TM6SF1,10,9,29789,1919,27870,3096.666667,191.9,14.52318916
NM_001717,BNC1,5,4,28815,4617,24198,6049.5,923.4,5.241065627
NM_001243531,UBE2Q2L,3,2,9745,501,9244,4622,167,18.4510978
NM_001267536,GOLGA6L4,12,11,9597,4167,5430,493.6363636,347.25,1.303095752
NM_181877,ZSCAN2,3,2,22700,3750,18950,9475,1250,5.053333333
NM_017894,ZSCAN2,3,2,5869,992,4877,2438.5,330.6666667,4.916330645
NM_001007072,ZSCAN2,3,2,15594,937,14657,7328.5,312.3333333,15.64247599
NM_001271919,SEC11A,5,4,46925,1292,45633,11408.25,258.4,35.31965944
NM_001271918,SEC11A,7,6,46925,1550,45375,7562.5,221.4285714,29.27419355
NM_021077,NMB,3,2,3444,1033,2411,1205.5,344.3333333,2.333978703
NM_001271922,SEC11A,5,4,46925,1354,45571,11392.75,270.8,33.65657312
NM_001271921,SEC11A,5,4,46925,1262,45663,11415.75,252.4,36.18304279
NM_001271920,SEC11A,7,6,46925,1452,45473,7578.833333,207.4285714,31.31749311
NM_014300,SEC11A,6,5,46925,1413,45512,9102.4,235.5,32.20948337
NM_205858,NMB,3,2,3444,1028,2416,1208,342.6666667,2.350194553
NM_201651,SLC28A1,7,6,11387,1360,10027,1671.166667,194.2857143,7.372794118
NM_020778,ALPK3,14,13,56804,10931,45873,3528.692308,780.7857143,4.196596835
NM_022480,KLHL25,3,2,35632,3684,31948,15974,1228,8.672095548
NM_022839,MRPS11,6,5,11179,1507,9672,1934.4,251.1666667,6.418049104
NM_017996,DET1,6,5,34200,2349,31851,6370.2,391.5,13.55938697
NM_001144074,DET1,5,4,34200,2278,31922,7980.5,455.6,14.01316945
NM_022163,MRPL46,4,3,7926,1004,6922,2307.333333,251,6.894422311
NM_176805,MRPS11,5,4,11179,1407,9772,2443,281.4,6.945273632
NM_002201,ISG20,4,3,16842,960,15882,5294,240,16.54375
NM_022767,AEN,4,3,10987,3120,7867,2622.333333,780,2.521474359
NM_178232,HAPLN3,5,4,18253,1898,16355,4088.75,379.6,8.616965227
NM_005928,MFGE8,8,7,14751,1997,12754,1822,249.625,6.38657987
NM_001114614,MFGE8,7,6,14751,1840,12911,2151.833333,262.8571429,7.016847826
NM_000326,RLBP1,9,8,11826,1761,10065,1258.125,195.6666667,5.715502555
NM_002693,POLG,23,22,18492,4471,14021,637.3181818,194.3913043,3.135987475
NM_018193,FANCI,37,36,73170,4606,68564,1904.555556,124.4864865,14.88580113
NM_001126131,POLG,23,22,18492,4459,14033,637.8636364,193.8695652,3.147118188
NM_001113378,FANCI,38,37,73170,4787,68383,1848.189189,125.9736842,14.28514727
NM_016321,RHCG,11,10,25206,1991,23215,2321.5,181,11.65996986
NM_152259,TICRR,22,21,52437,6691,45746,2178.380952,304.1363636,6.83694515
NM_020212,WDR93,17,16,52843,2426,50417,3151.0625,142.7058824,20.78194559
NM_001145311,PLIN1,9,8,15050,2902,12148,1518.5,322.4444444,4.186078567
NM_001284395,WDR93,17,16,52843,2342,50501,3156.3125,137.7647059,21.56319385
NM_002666,PLIN1,9,8,15050,2973,12077,1509.625,330.3333333,4.062226707
NM_018670,MESP1,2,1,1444,1164,280,280,582,0.240549828
NM_001271573,PEX11A,2,1,9255,2628,6627,6627,1314,2.521689498
NM_001271572,PEX11A,3,2,9255,2652,6603,3301.5,884,2.489819005
NM_003847,PEX11A,3,2,9255,2745,6510,3255,915,2.371584699
NM_001284396,WDR93,3,2,13682,1935,11747,5873.5,645,6.070801034
NM_005829,AP3S2,6,5,63788,5940,57848,11569.6,990,9.738720539
NM_001039958,MESP2,2,1,2395,1613,782,782,806.5,0.484810911
NM_001150,ANPEP,21,20,29948,3671,26277,1313.85,174.8095238,7.157995097
NM_001282380,C15orf38,6,5,16157,6494,9663,1932.6,1082.333333,1.487988913
NM_182616,C15orf38,6,5,16460,6105,10355,2071,1017.5,1.696150696
NM_002168,IDH2,11,10,18498,1742,16756,1675.6,158.3636364,9.618828932
NM_001289910,IDH2,11,10,16644,1588,15056,1505.6,144.3636364,9.481108312
NM_001033088,NGRN,3,2,6550,1352,5198,2599,450.6666667,3.844674556
NM_020210,SEMA4B,15,14,44742,3829,40913,2922.357143,255.2666667,10.68503526
NM_198925,SEMA4B,14,13,28332,3794,24538,1887.538462,271,6.46758039
NM_001013657,GDPGP1,4,3,7827,1355,6472,2157.333333,338.75,4.776383764
NM_006384,CIB1,7,6,3804,984,2820,470,140.5714286,2.865853659
NM_001277764,CIB1,7,6,3804,1104,2700,450,157.7142857,2.445652174
NM_001004309,ZNF774,4,3,9240,1842,7398,2466,460.5,4.016286645
NM_001143785,FES,17,16,11343,2439,8904,556.5,143.4705882,3.650676507
NM_001143784,FES,17,16,10732,2494,8238,514.875,146.7058824,3.303127506
NM_001143783,FES,17,16,10732,2530,8202,512.625,148.8235294,3.241897233
NM_006122,MAN2A2,22,21,18397,6291,12106,576.4761905,285.9545455,1.924336354
NM_198527,HDDC3,4,3,1653,1081,572,190.6666667,270.25,0.529139685
NM_002005,FES,19,18,11320,2802,8518,473.2222222,147.4736842,3.039971449
NM_001286451,HDDC3,4,3,1653,930,723,241,232.5,0.777419355
NM_002569,FURIN,16,15,14868,4260,10608,707.2,266.25,2.490140845
NM_001289823,FURIN,16,15,11921,4207,7714,514.2666667,262.9375,1.833610649
NM_001289824,FURIN,16,15,10582,4361,6221,414.7333333,272.5625,1.426507682
NM_199413,PRC1,14,13,28615,3162,25453,1957.923077,225.8571429,8.049652119
NM_001289148,VPS33B,22,21,24207,2726,21481,1022.904762,123.9090909,7.880044021
NM_001267580,PRC1,13,12,28615,2961,25654,2137.833333,227.7692308,8.663964877
NM_033544,RCCD1,9,8,8251,2776,5475,684.375,308.4444444,1.972262248
NM_001289149,VPS33B,22,21,24207,2745,21462,1022,124.7727273,7.818579235
NM_001017919,RCCD1,8,7,8251,2691,5560,794.2857143,336.375,2.066146414
NM_003981,PRC1,15,14,28615,3205,25410,1815,213.6666667,7.928237129
NM_018668,VPS33B,23,22,24207,2808,21399,972.6818182,122.0869565,7.620726496
NM_006011,ST8SIA2,6,5,74820,5632,69188,13837.6,938.6666667,12.28480114
NM_153040,C15orf32,3,2,29442,1729,27713,13856.5,576.3333333,16.02834008
NM_020211,RGMA,4,3,45809,3231,42578,14192.66667,807.75,13.17796348
NM_001166289,RGMA,4,3,30305,3082,27223,9074.333333,770.5,8.832900714
NM_001166288,RGMA,4,3,30305,3062,27243,9081,765.5,8.897126061
NM_001166287,RGMA,4,3,45118,3178,41940,13980,794.5,13.19697923
NM_001166286,RGMA,3,2,29755,3063,26692,13346,1021,8.714332354
NM_001166283,RGMA,4,3,30582,3204,27378,9126,801,8.54494382
NM_001159644,MCTP2,10,9,47332,2007,45325,5036.111111,200.7,22.5834579
NM_001145155,NR2F2,3,2,14337,3872,10465,5232.5,1290.666667,2.702737603
NM_021005,NR2F2,3,2,9383,5113,4270,2135,1704.333333,0.835126149
NM_001145157,NR2F2,3,2,6925,3965,2960,1480,1321.666667,0.746532156
NM_001145156,NR2F2,3,2,7700,3504,4196,2098,1168,1.197488584
NM_173499,SPATA8,3,2,2168,1026,1142,571,342,1.113060429
NM_183376,ARRDC4,8,7,13137,4075,9062,1294.571429,509.375,2.223803681
NM_182562,FAM169B,7,6,77222,3305,73917,12319.5,472.1428571,22.36520424
NM_001167902,PGPEP1L,5,4,39567,1488,38079,9519.75,297.6,25.59072581
NM_001102612,PGPEP1L,5,4,37428,1144,36284,9071,228.8,31.71678322
NM_015286,SYNM,5,4,30516,6423,24093,6023.25,1284.6,3.751050911
NM_145728,SYNM,4,3,30516,7358,23158,7719.333333,1839.5,3.147322642
NM_001130928,MEF2A,8,7,83448,5093,78355,11193.57143,636.625,15.38484194
NM_001040616,LINS,7,6,33019,2519,30500,5083.333333,359.8571429,12.10797936
NM_024708,ASB7,5,4,27661,1758,25903,6475.75,351.6,14.73435722
NM_203472,VIMP,7,6,6613,1424,5189,864.8333333,203.4285714,3.643960674
NM_003090,SNRPA1,9,8,13747,1068,12679,1584.875,118.6666667,11.87172285
NM_014918,CHSY1,3,2,76211,4553,71658,35829,1517.666667,15.73863387
NM_018445,VIMP,6,5,5340,1268,4072,814.4,211.3333333,3.211356467
NM_025141,TM2D3,5,4,10547,1334,9213,2303.25,266.8,6.906296852
NM_078474,TM2D3,6,5,10547,1413,9134,1826.8,235.5,6.464260439
NM_001005326,OR4F6,1,0,940,940,NA,NA,940,NA
NM_001001674,OR4F15,1,0,940,940,NA,NA,940,NA
NM_001004195,OR4F4,1,0,919,919,NA,NA,919,NA
NM_022845,CBFB,6,5,71910,3108,68802,13760.4,518,22.13706564
NM_001755,CBFB,6,5,71910,3139,68771,13754.2,523.1666667,21.90856961
NM_016309,LCMT1,11,10,66506,1381,65125,6512.5,125.5454545,47.15785663
NM_001032391,LCMT1,9,8,66506,1214,65292,8161.5,134.8888889,53.78253707
NM_001114,ADCY7,25,24,30224,6165,24059,1002.458333,246.6,3.902514193
NM_001286057,ADCY7,19,18,43991,2571,41420,2301.111111,135.3157895,16.11046285
NM_145254,TMEM170A,3,2,17663,1057,16606,8303,352.3333333,15.71050142
NM_001282416,ZSCAN10,5,4,10429,2476,7953,1988.25,495.2,3.212035541
NM_001282415,ZSCAN10,5,4,10429,2281,8148,2037,456.2,3.572117492
NM_001142334,RBFOX1,14,13,939532,4021,935511,71962.38462,287.2142857,232.6563044
NM_002528,NTHL1,6,5,8053,1073,6980,1396,178.8333333,6.505125815
NM_001142333,RBFOX1,15,14,1694210,4709,1689501,120678.6429,313.9333333,358.7812699
NM_018723,RBFOX1,16,15,1694210,4791,1689419,112627.9333,299.4375,352.6234607
NM_002582,PARN,24,23,194573,3107,191466,8324.608696,129.4583333,61.62407467
NM_001184999,KIAA0430,27,26,48799,7778,41021,1577.730769,288.0740741,5.273977886
NM_001184998,KIAA0430,27,26,48799,7787,41012,1577.384615,288.4074074,5.266726596
NM_001242992,PARN,23,22,194573,2968,191605,8709.318182,129.0434783,64.5569407
NM_032167,SNX29,21,20,597546,8185,589361,29468.05,389.7619048,72.00500916
NM_024997,ATF7IP2,12,11,97585,3677,93908,8537.090909,306.4166667,25.53929834
NM_014647,KIAA0430,27,26,48799,7787,41012,1577.384615,288.4074074,5.266726596
NM_001256160,ATF7IP2,12,11,97585,3653,93932,8539.272727,304.4166667,25.71366001
NM_001134477,PARN,24,23,194573,3024,191549,8328.217391,126,63.34292328
NM_001164579,C16orf52,3,2,76518,4445,72073,36036.5,1481.666667,16.2143982
NM_212535,PRKCB,17,16,384634,2728,381906,23869.125,160.4705882,139.994868
NM_002738,PRKCB,17,16,384634,8031,376603,23537.6875,472.4117647,46.89366206
NM_015092,SMG1,63,62,121553,16128,105425,1700.403226,256,6.536768353
NM_017539,DNAH3,62,61,226288,12413,213875,3506.147541,200.2096774,17.22992024
NM_001024401,SBK1,4,3,31332,4996,26336,8778.666667,1249,5.271417134
NM_001214909,ZNF48,3,2,4998,3343,1655,827.5,1114.333333,0.495064313
NM_145080,NSMCE1,8,7,43800,1070,42730,6104.285714,133.75,39.93457944
NM_152652,ZNF48,2,1,4691,3236,1455,1455,1618,0.449629172
NM_001214907,ZNF48,2,1,21796,2878,18918,18918,1439,6.573314802
NM_001214906,ZNF48,3,2,21798,2975,18823,9411.5,991.6666667,6.327058824
NM_032583,ABCC11,30,29,68268,4606,63662,2195.241379,153.5333333,13.82153713
NM_145186,ABCC11,29,28,68268,4491,63777,2277.75,154.862069,14.2010688
NM_033151,ABCC11,29,28,65362,4891,60471,2159.678571,168.6551724,12.3637293
NM_005682,GPR56,15,14,45036,3839,41197,2942.642857,255.9333333,10.73117999
NM_201524,GPR56,15,14,36527,3982,32545,2324.642857,265.4666667,8.173028629
NM_017839,LPCAT2,14,13,77671,5402,72269,5559.153846,385.8571429,13.37819326
NM_001145773,GPR56,14,13,36527,3874,32653,2511.769231,276.7142857,8.428755808
NM_001145772,GPR56,15,14,36527,4004,32523,2323.071429,266.9333333,8.122627373
NM_001145771,GPR56,15,14,36527,3996,32531,2323.642857,266.4,8.140890891
NM_001145770,GPR56,15,14,45036,3821,41215,2943.928571,254.7333333,10.78644334
NM_005611,RBL2,22,21,57211,4908,52303,2490.619048,223.0909091,10.65668297
NM_201525,GPR56,14,13,36527,3859,32668,2512.923077,275.6428571,8.465405545
NM_001797,CDH11,13,12,175238,3661,171577,14298.08333,281.6153846,46.86615679
NM_001796,CDH8,12,11,384826,4964,379862,34532.90909,413.6666667,76.52336825
NM_001011880,CLEC18B,13,12,12841,1956,10885,907.0833333,150.4615385,5.564928425
NM_004555,NFATC3,11,10,143895,6447,137448,13744.8,586.0909091,21.31968357
NM_173165,NFATC3,10,9,143895,6342,137553,15283.66667,634.2,21.68921476
NM_173163,NFATC3,11,10,143895,6432,137463,13746.3,584.7272727,21.37173507
NM_016373,WWOX,9,8,1113239,2474,1110765,138845.625,274.8888889,448.9753436
NM_138994,CNTNAP4,23,22,249402,4345,245057,11138.95455,188.9130435,56.39976985
NM_033401,CNTNAP4,24,23,281961,4890,277071,12046.56522,203.75,56.6607362
NM_001257,CDH13,14,13,1169818,4035,1165783,89675.61538,288.2142857,288.91772
NM_152342,CDYL2,7,6,200501,2242,198259,33043.16667,320.2857143,88.42952721
NM_001220488,CDH13,15,14,1169818,4142,1165676,83262.57143,276.1333333,281.4282955
NM_001220492,CDH13,6,5,554233,992,553241,110648.2,165.3333333,557.702621
NM_001220491,CDH13,5,4,554233,943,553290,138322.5,188.6,586.7338282
NM_001220490,CDH13,13,12,1169818,3825,1165993,97166.08333,294.2307692,304.8347712
NM_001220489,CDH13,13,12,1169818,3917,1165901,97158.41667,301.3076923,297.651519
NM_079837,BANP,13,12,125888,2298,123590,10299.16667,176.7692308,53.78154917
NM_031476,CRISPLD2,15,14,89531,4604,84927,6066.214286,306.9333333,18.446351
NM_001173541,BANP,12,11,125888,2222,123666,11242.36364,185.1666667,55.65526553
NM_001173539,BANP,13,12,125888,2340,123548,10295.66667,180,52.7982906
NM_001173540,BANP,13,12,125888,2316,123572,10297.66667,178.1538462,53.35578584
NM_001173543,BANP,14,13,107302,2452,104850,8065.384615,175.1428571,42.76101142
NM_001173542,BANP,13,12,117449,2388,115061,9588.416667,183.6923077,48.18299832
NM_017869,BANP,12,11,125888,2231,123657,11241.54545,185.9166667,55.42671448
NM_003502,AXIN1,11,10,65238,3671,61567,6156.7,333.7272727,16.77117952
NM_002434,MPG,5,4,7683,1294,6389,1597.25,258.8,4.9374034
NM_201412,LUC7L,10,9,40477,1460,39017,4335.222222,146,26.7239726
NM_022493,NARFL,11,10,11230,2102,9128,912.8,191.0909091,4.342530923
NM_021168,RAB40C,6,5,39102,2622,36480,7296,437,13.91304348
NM_001172666,RAB40C,7,6,39198,2521,36677,6112.833333,360.1428571,14.54859183
NM_001172665,RAB40C,7,6,39198,2578,36620,6103.333333,368.2857143,14.20480993
NM_001172663,RAB40C,7,6,39918,2726,37192,6198.666667,389.4285714,13.6434336
NM_022773,LMF1,11,10,117351,2616,114735,11473.5,237.8181818,43.85894495
NM_018032,LUC7L,9,8,40481,2091,38390,4798.75,232.3333333,18.35963654
NM_181050,AXIN1,10,9,65238,3562,61676,6852.888889,356.2,17.31499158
NM_014700,RAB11FIP3,14,13,96815,4266,92549,7119.153846,304.7142857,21.69456165
NM_001172664,RAB40C,7,6,39606,2618,36988,6164.666667,374,14.12834225
NM_001015054,MPG,4,3,8834,1043,7791,2597,260.75,7.469798658
NM_001015052,MPG,4,3,7683,1100,6583,2194.333333,275,5.984545455
NM_001009606,HS3ST6,2,1,6768,1064,5704,5704,532,5.360902256
NM_020825,CRAMP1L,20,19,63270,7693,55577,2925.105263,384.65,7.224359808
NM_001284501,NUBP2,8,7,6270,1589,4681,668.7142857,198.625,2.945877911
NM_001193388,UNKL,15,14,51517,5131,46386,3313.285714,342.0666667,9.040343013
NM_012225,NUBP2,7,6,6270,1398,4872,812,199.7142857,3.484978541
NM_014714,IFT140,31,30,101683,5299,96384,3212.8,170.9354839,18.18909228
NM_001284502,NUBP2,6,5,6270,1175,5095,1019,195.8333333,4.336170213
NM_001253726,KREMEN2,9,8,4169,1949,2220,277.5,216.5555556,1.139045664
NM_001253725,KREMEN2,8,7,4169,1869,2300,328.5714286,233.625,1.230604601
NM_020764,CASKIN1,20,19,19283,5715,13568,714.1052632,285.75,2.374103237
NM_001089,ABCA3,33,32,64870,6656,58214,1819.1875,201.6969697,8.74609375
NM_001261816,PDPK1,12,11,65228,7044,58184,5289.454545,587,8.2600795
NM_172229,KREMEN2,9,8,4169,2066,2103,262.875,229.5555556,1.017909003
NM_002613,PDPK1,14,13,65228,7257,57971,4459.307692,518.3571429,7.988287171
NM_001761,CCNF,17,16,29466,4304,25162,1572.625,253.1764706,5.846189591
NM_018992,KCTD5,6,5,26538,2469,24069,4813.8,411.5,9.748481166
NM_024507,KREMEN2,8,7,4169,1986,2183,311.8571429,248.25,1.099194361
NM_031268,PDPK1,11,10,65228,6873,58355,5835.5,624.8181818,8.490469955
NM_003454,ZNF200,5,4,12863,3392,9471,2367.75,678.4,2.792158019
NM_001079846,CREBBP,30,29,155067,10112,144955,4998.448276,337.0666667,14.33494858
NM_198088,ZNF200,5,4,13133,3311,9822,2455.5,662.2,2.966475385
NM_198087,ZNF200,5,4,13134,3184,9950,2487.5,636.8,3.125
NM_001116,ADCY9,11,10,153538,7738,145800,14580,703.4545455,18.84207806
NM_001145448,ZNF200,5,4,13133,3308,9825,2456.25,661.6,2.970072551
NM_001145447,ZNF200,5,4,12863,3389,9474,2368.5,677.8,2.795514901
NM_001145446,ZNF200,5,4,13134,3184,9950,2487.5,636.8,3.125
NM_004380,CREBBP,31,30,155067,10227,144840,4828,329.9032258,14.162511
NM_024589,ROGDI,11,10,5990,1752,4238,423.8,159.2727273,2.418949772
NM_001201479,CORO7-PAM16,31,30,76712,3689,73023,2434.1,119,19.79479534
NM_001201473,CORO7,26,25,62421,3608,58813,2352.52,138.7692308,16.30072062
NM_001199055,CDIP1,6,5,28141,2630,25511,5102.2,438.3333333,9.7
NM_001199054,CDIP1,6,5,27796,2779,25017,5003.4,463.1666667,9.00215905
NM_001199056,CDIP1,6,5,28141,2510,25631,5126.2,418.3333333,10.21155378
NM_001098514,C16orf89,8,7,22025,1557,20468,2924,194.625,13.14579319
NM_152459,C16orf89,8,7,22025,1915,20110,2872.857143,239.375,10.50130548
NM_013399,CDIP1,6,5,28141,2747,25394,5078.8,457.8333333,9.244266473
NM_002705,PPL,22,21,54630,6260,48370,2303.333333,284.5454545,7.726837061
NM_001142291,MGRN1,16,15,66152,6421,59731,3982.066667,401.3125,9.302445102
NM_001142290,MGRN1,17,16,66152,6488,59664,3729,381.6470588,9.196054254
NM_001142289,MGRN1,16,15,66152,3884,62268,4151.2,242.75,16.03192585
NM_015246,MGRN1,17,16,66152,3951,62201,3887.5625,232.4117647,15.74310301
NM_001201472,CORO7,28,27,62421,3811,58610,2170.740741,136.1071429,15.37916557
NM_024535,CORO7,28,27,62421,3865,58556,2168.740741,138.0357143,15.15032342
NM_145893,RBFOX1,14,13,380591,4169,376422,28955.53846,297.7857143,90.2907172
NM_145892,RBFOX1,13,12,380591,4037,376554,31379.5,310.5384615,93.27569978
NM_145891,RBFOX1,13,12,380591,4115,376476,31373,316.5384615,91.48869988
NM_020686,ABAT,16,15,109990,4830,105160,7010.666667,301.875,21.77225673
NM_000303,PMM2,8,7,51526,2331,49195,7027.857143,291.375,21.1046761
NM_003470,USP7,31,30,71392,5443,65949,2198.3,175.5806452,12.11629616
NM_001134407,GRIN2A,13,12,429000,14697,414303,34525.25,1130.538462,28.18963054
NM_001134408,GRIN2A,14,13,419394,4749,414645,31895.76923,339.2142857,87.3120657
NM_000833,GRIN2A,14,13,429348,14460,414888,31914.46154,1032.857143,28.69211618
NM_000246,CIITA,20,19,47787,4674,43113,2269.105263,233.7,9.224005135
NM_001079512,TVP23A,8,7,52090,3347,48743,6963.285714,418.375,14.56319092
NM_001286403,CIITA,18,17,47787,2920,44867,2639.235294,162.2222222,15.36541096
NM_001243403,CLEC16A,21,20,181858,3036,178822,8941.1,144.5714286,58.90052701
NM_015226,CLEC16A,23,22,237703,6914,230789,10490.40909,300.6086957,33.37995372
NM_144674,TEKT5,7,6,67443,1616,65827,10971.16667,230.8571429,40.7345297
NM_001286402,CIITA,20,19,47787,4677,43110,2268.947368,233.85,9.217447081
NM_015914,TXNDC11,12,11,63707,3059,60648,5513.454545,254.9166667,19.82608696
NM_001136473,LITAF,5,4,39230,2574,36656,9164,514.8,14.24087024
NM_001136472,LITAF,4,3,39230,2475,36755,12251.66667,618.75,14.85050505
NM_004862,LITAF,4,3,38653,2638,36015,12005,659.5,13.65238817
NM_018340,CPPED1,4,3,144090,6147,137943,45981,1536.75,22.44070278
NM_001145204,SHISA9,5,4,338798,6732,332066,83016.5,1346.4,49.3265003
NM_001099455,CPPED1,3,2,144090,5720,138370,69185,1906.666667,24.19055944
NM_014048,MKL2,17,16,195436,8651,186785,11674.0625,508.8823529,21.59114553
NM_005236,ERCC4,11,10,32193,6772,25421,2542.1,615.6363636,3.753839338
NM_001277325,NPIPA5,8,7,14672,1096,13576,1939.428571,137,12.38686131
NM_001277324,NPIPA2,8,7,14641,1096,13545,1935,137,12.35857664
NM_001277323,NPIPA3,8,7,14651,1106,13545,1935,138.25,12.24683544
NM_001142469,C16orf45,6,5,85995,2056,83939,16787.8,342.6666667,40.82636187
NM_014287,NOMO1,31,30,62373,4278,58095,1936.5,138,13.5799439
NM_001285447,PDXDC1,23,22,63597,4494,59103,2686.5,195.3913043,13.15153538
NM_001285445,PDXDC1,22,21,63369,4597,58772,2798.666667,208.9545455,12.78485969
NM_033201,C16orf45,6,5,153793,2237,151556,30311.2,372.8333333,67.74966473
NM_001285448,PDXDC1,22,21,63529,4506,59023,2810.619048,204.8181818,13.09875721
NM_015027,PDXDC1,23,22,63369,4682,58687,2667.590909,203.5652174,12.5346006
NM_001285449,PDXDC1,17,16,164388,2124,162264,10141.5,124.9411765,76.39548023
NM_001285444,PDXDC1,22,21,63369,4600,58769,2798.52381,209.0909091,12.77586957
NM_001285450,PDXDC1,14,13,54841,2311,52530,4040.769231,165.0714286,22.73041973
NM_001040114,MYH11,42,41,153897,6945,146952,3584.195122,165.3571429,21.15939525
NM_001040113,MYH11,43,42,153897,6985,146912,3497.904762,162.4418605,21.03249821
NM_001171,ABCC6,31,30,73908,5148,68760,2292,166.0645161,13.35664336
NM_022844,MYH11,42,41,153897,6963,146934,3583.756098,165.7857143,21.10211116
NM_002474,MYH11,41,40,153897,6923,146974,3674.35,168.8536585,21.22981366
NM_001004067,NOMO3,31,30,62281,4347,57934,1931.133333,140.2258065,13.3273522
NM_004996,ABCC1,31,30,193498,6594,186904,6230.133333,212.7096774,28.34455566
NM_022166,XYLT1,12,11,368559,9348,359211,32655.54545,779,38.42650834
NM_024847,TMC7,16,15,80008,4415,75593,5039.533333,275.9375,17.1218573
NM_016641,GDE1,6,5,20437,2943,17494,3498.8,490.5,5.94427455
NM_001160364,TMC7,16,15,79655,4513,75142,5009.466667,282.0625,16.65012187
NM_153208,IQCK,10,9,141083,2562,138521,15391.22222,256.2,54.06752537
NM_016524,SYT17,8,7,98918,1920,96998,13856.85714,240,50.51979167
NM_020314,C16orf62,31,30,145750,3925,141825,4727.5,126.6129032,36.13375796
NM_001144924,LOC81691,19,18,43225,2702,40523,2251.277778,142.2105263,14.99740933
NM_030941,LOC81691,20,19,43225,2796,40429,2127.842105,139.8,14.45958512
NM_001199053,LOC81691,20,19,43225,2908,40317,2121.947368,145.4,13.86416781
NM_017888,ACSM5,14,13,31427,2433,28994,2230.307692,173.7857143,11.91697493
NM_182617,ACSM2B,15,14,39614,2456,37158,2654.142857,163.7333333,15.12947883
NM_001105069,ACSM2B,14,13,39614,2420,37194,2861.076923,172.8571429,15.36942149
NM_001002911,GPR139,2,1,42059,1240,40819,40819,620,32.91854839
NM_001161683,OTOA,24,23,76302,3490,72812,3165.73913,145.4166667,20.86303725
NM_144672,OTOA,28,27,82217,3638,78579,2910.333333,129.9285714,21.59950522
NM_001288659,METTL9,5,4,60254,2918,57336,14334,583.6,19.64907471
NM_170664,OTOA,19,18,55768,2723,53045,2946.944444,143.3157895,19.48035255
NM_016025,METTL9,5,4,57999,3261,54738,13684.5,652.2,16.78564857
NM_001077180,METTL9,5,4,57999,3258,54741,13685.25,651.6,16.80202578
NM_001288660,METTL9,5,4,60254,2915,57339,14334.75,583,19.6703259
NM_001135865,NPIPB5,7,6,22999,3823,19176,3196,546.1428571,5.015956055
NM_013302,EEF2K,18,17,82476,7430,75046,4414.470588,412.7777778,10.10040377
NM_173615,VWA3A,34,33,64426,4634,59792,1811.878788,136.2941176,12.90289167
NM_033266,ERN2,22,21,23197,3642,19555,931.1904762,165.5454545,5.369302581
NM_001039,SCNN1G,13,12,34162,3512,30650,2554.166667,270.1538462,8.727220957
NM_000336,SCNN1B,13,12,79031,2610,76421,6368.416667,200.7692308,29.28007663
NM_005003,NDUFAB1,5,4,15306,672,14634,3658.5,134.4,21.77678571
NM_153603,COG7,17,16,64700,2954,61746,3859.125,173.7647059,20.90250508
NM_001258414,SLC5A11,15,14,65767,2084,63683,4548.785714,138.9333333,30.55806142
NM_014494,TNRC6A,25,24,96500,8447,88053,3668.875,337.88,10.42417426
NM_001258412,SLC5A11,15,14,65767,2309,63458,4532.714286,153.9333333,27.48289303
NM_001258413,SLC5A11,16,15,65767,2361,63406,4227.066667,147.5625,26.85556967
NM_001258411,SLC5A11,16,15,65767,2415,63352,4223.466667,150.9375,26.23271222
NM_052944,SLC5A11,16,15,65399,2371,63028,4201.866667,148.1875,26.58287642
NM_006040,HS3ST4,2,1,445664,3205,442459,442459,1602.5,138.0527301
NM_001109763,GSG1L,7,6,275982,4929,271053,45175.5,704.1428571,54.991479
NM_015171,XPO6,24,23,113943,4513,109430,4757.826087,188.0416667,24.24772878
NM_001520,GTF3C1,37,36,89319,7144,82175,2282.638889,193.0810811,11.50265957
NM_015202,KIAA0556,28,27,230226,6651,223575,8280.555556,237.5357143,33.61524583
NM_001270940,XPO6,25,24,113943,4650,109293,4553.875,186,23.50387097
NM_001286242,GTF3C1,37,36,89319,7069,82250,2284.722222,191.0540541,11.6353091
NM_001199142,EIF3C,21,20,47173,3280,43893,2194.65,156.1904762,13.3820122
NM_032815,NFATC2IP,8,7,15451,3866,11585,1655,483.25,2.996637351
NM_007245,ATXN2L,22,21,14191,4434,9757,464.6190476,201.5454545,2.200496166
NM_148415,ATXN2L,23,22,14191,3830,10361,470.9545455,166.5217391,2.705221932
NM_148414,ATXN2L,24,23,14191,4050,10141,440.9130435,168.75,2.503950617
NM_148416,ATXN2L,23,22,14191,3807,10384,472,165.5217391,2.72760704
NM_138414,CCDC101,10,9,37864,1161,36703,4078.111111,116.1,31.61326443
NM_017492,ATXN2L,23,22,14191,3884,10307,468.5,168.8695652,2.653707518
NM_145714,ATXN2L,23,22,14191,3861,10330,469.5454545,167.8695652,2.675472675
NM_001114099,SEZ6L2,17,16,28107,3325,24782,1548.875,195.5882353,7.453233083
NM_201575,SEZ6L2,17,16,28107,3535,24572,1535.75,207.9411765,6.95106082
NM_001114100,SEZ6L2,16,15,28107,3231,24876,1658.4,201.9375,7.699164345
NM_173618,INO80E,7,6,9583,1192,8391,1398.5,170.2857143,7.03942953
NM_012410,SEZ6L2,18,17,28107,3365,24742,1455.411765,186.9444444,7.352748886
NM_001243333,SEZ6L2,17,16,28107,3442,24665,1541.5625,202.4705882,7.165891923
NM_001243332,SEZ6L2,18,17,28107,3575,24532,1443.058824,198.6111111,6.862097902
NM_000632,ITGAM,30,29,72927,4772,68155,2350.172414,159.0666667,14.28227158
NM_001170634,FUS,15,14,14763,5131,9632,688,342.0666667,1.877216917
NM_001170937,FUS,15,14,14763,5122,9641,688.6428571,341.4666667,1.88227255
NM_001145808,ITGAM,30,29,72927,4775,68152,2350.068966,159.1666667,14.27267016
NM_004960,FUS,15,14,14763,5134,9629,687.7857143,342.2666667,1.875535645
NM_133443,GPT2,12,11,46895,3970,42925,3902.272727,330.8333333,10.81234257
NM_001142466,GPT2,12,11,46101,3886,42215,3837.727273,323.8333333,10.86335564
NM_001031835,PHKB,32,31,240226,5635,234591,7567.451613,176.09375,41.6310559
NM_030790,ITFG1,18,17,305719,2248,303471,17851.23529,124.8888889,134.9959964
NM_000293,PHKB,31,30,240226,5522,234704,7823.466667,178.1290323,42.50344078
NM_031490,LONP2,15,14,109198,4357,104841,7488.642857,290.4666667,24.06265779
NM_153029,N4BP1,7,6,71485,7113,64372,10728.66667,1016.142857,9.049908618
NM_015069,ZNF423,8,7,332136,4587,327549,46792.71429,573.375,71.40810988
NM_001040285,PAPD5,13,12,82392,7984,74408,6200.666667,614.1538462,9.319639279
NM_001040284,PAPD5,13,12,82392,8125,74267,6188.916667,625,9.140553846
NM_001281789,CNEP1R1,6,5,11884,2124,9760,1952,354,4.595103578
NM_001271620,ZNF423,8,7,367317,4697,362620,51802.85714,587.125,77.20246966
NM_144602,C16orf78,5,4,25513,976,24537,6134.25,195.2,25.14036885
NM_153261,CNEP1R1,7,6,11884,2176,9708,1618,310.8571429,4.461397059
NM_033119,NKD1,10,9,92532,8726,83806,9311.777778,872.6,9.604171442
NM_025134,CHD9,39,38,272471,11501,260970,6867.631579,294.8974359,22.69107034
NM_001146188,TOX3,8,7,109798,3131,106667,15238.14286,391.375,34.06802938
NM_001080430,TOX3,7,6,108890,3128,105762,17627,446.8571429,33.81138107
NM_001080432,FTO,9,8,410506,4301,406205,50775.625,477.8888889,94.44431528
NM_020988,GNAO1,9,8,166107,3341,162766,20345.75,371.2222222,48.71774918
NM_001172504,SLC6A2,14,13,49550,2872,46678,3590.615385,205.1428571,16.25278552
NM_001172502,SLC6A2,12,11,32119,3169,28950,2631.818182,264.0833333,9.135373935
NM_001190158,CES5A,14,13,109879,2272,107607,8277.461538,162.2857143,47.36223592
NM_018233,OGFOD1,13,12,25985,3033,22952,1912.666667,233.3076923,7.567424992
NM_001043,SLC6A2,14,13,47350,3565,43785,3368.076923,254.6428571,12.28190743
NM_138736,GNAO1,8,7,156862,6219,150643,21520.42857,777.375,24.22302621
NM_001172501,SLC6A2,15,14,48160,3902,44258,3161.285714,260.1333333,11.34238852
NM_152727,CPNE2,16,15,55425,2254,53171,3544.733333,140.875,23.58961846
NM_002996,CX3CL1,3,2,12544,3276,9268,4634,1092,2.829059829
NM_000078,CETP,16,15,21923,1733,20190,1346,108.3125,11.65031737
NM_001286085,CETP,15,14,21923,1552,20371,1455.071429,103.4666667,13.12564433
NM_002428,MMP15,10,9,21524,4447,17077,1897.444444,444.7,3.840116933
NM_001130099,KIFC3,19,18,39802,3358,36444,2024.666667,176.7368421,10.85288862
NM_001080492,PRSS54,7,6,15052,1817,13235,2205.833333,259.5714286,7.28398459
NM_016284,CNOT1,49,48,109942,8525,101417,2112.854167,173.9795918,11.89642229
NM_001297,CNGB1,33,32,88778,5678,83100,2596.875,172.0606061,14.63543501
NM_001896,CSNK2A2,12,11,39972,1670,38302,3482,139.1666667,22.93532934
NM_001265612,CNOT1,49,48,109942,8510,101432,2113.166667,173.6734694,11.91915394
NM_001130100,KIFC3,20,19,44312,3415,40897,2152.473684,170.75,11.97569546
NM_206999,CNOT1,31,30,86735,5252,81483,2716.1,169.4193548,15.51466108
NM_005550,KIFC3,19,18,44312,3385,40927,2273.722222,178.1578947,12.09069424
NM_001286130,CNGB1,33,32,88778,5660,83118,2597.4375,171.5151515,14.68515901
NM_001018159,NAE1,21,20,28100,1932,26168,1308.4,92,13.54451346
NM_001018160,NAE1,19,18,28100,1728,26372,1465.111111,90.94736842,15.26157407
NM_003869,CES2,12,11,10649,3950,6699,609,329.1666667,1.695949367
NM_198061,CES2,12,11,10649,3902,6747,613.3636364,325.1666667,1.729113275
NM_003905,NAE1,20,19,28100,1833,26267,1382.473684,91.65,14.33006001
NM_178818,CMTM4,5,4,81959,3419,78540,19635,683.8,22.97162913
NM_181521,CMTM4,4,3,81959,8121,73838,24612.66667,2030.25,9.092230021
NM_001286500,NAE1,20,19,28100,1842,26258,1382,92.1,14.25515744
NM_005796,NUTF2,5,4,24402,891,23511,5877.75,178.2,26.38720539
NM_020850,RANBP10,14,13,83552,5319,78233,6017.923077,379.9285714,14.70821583
NM_006565,CTCF,12,11,76780,3953,72827,6620.636364,329.4166667,18.42322287
NM_018296,LRRC36,14,13,58364,2415,55949,4303.769231,172.5,23.16728778
NM_022355,DPEP2,11,10,12130,1777,10353,1035.3,161.5454545,5.826111424
NM_001191022,CTCF,10,9,76780,2990,73790,8198.888889,299,24.67892977
NM_004691,ATP6V0D1,8,7,43174,1678,41496,5928,209.75,24.72943981
NM_024562,TANGO6,18,17,241578,4836,236742,13926,268.6666667,48.95409429
NM_012320,PLA2G15,6,5,15716,2729,12987,2597.4,454.8333333,4.758886039
NM_004360,CDH1,16,15,98251,4831,93420,6228,301.9375,19.33761126
NM_001793,CDH3,16,15,54808,4292,50516,3367.733333,268.25,11.76980429
NM_018667,SMPD3,9,8,90181,5278,84903,10612.875,586.4444444,16.0862069
NM_007014,WWP2,25,24,179459,4615,174844,7285.166667,184.6,37.88602384
NM_006750,SNTB2,7,6,121907,9778,112129,18688.16667,1396.857143,11.46747801
NM_030579,CYB5B,5,4,41671,4291,37380,9345,858.2,8.711256117
NM_182619,CLEC18A,13,12,13447,2334,11113,926.0833333,179.5384615,4.761353899
NM_138714,NFAT5,16,15,138702,13379,125323,8354.866667,836.1875,9.367142537
NM_001136214,CLEC18A,13,12,13644,2228,11416,951.3333333,171.3846154,5.123877917
NM_138713,NFAT5,15,14,138702,13316,125386,8956.142857,887.7333333,9.416191048
NM_001271197,CLEC18A,13,12,13363,2308,11055,921.25,177.5384615,4.789861352
NM_001270454,WWP2,24,23,179459,4561,174898,7604.26087,190.0416667,38.34641526
NM_001270455,WWP2,9,8,148123,2691,145432,18179,299,54.04384987
NM_001113178,NFAT5,15,14,138702,13313,125389,8956.357143,887.5333333,9.418538271
NM_006599,NFAT5,14,13,138702,13261,125441,9649.307692,947.2142857,9.459392203
NM_173214,NFAT5,15,14,138702,13324,125378,8955.571429,888.2666667,9.409936956
NM_015386,COG4,19,18,42987,2841,40146,2230.333333,149.5263158,14.13093981
NM_001195139,COG4,18,17,42987,2777,40210,2365.294118,154.2777778,14.4796543
NM_001198543,HYDIN,19,18,199313,3141,196172,10898.44444,165.3157895,62.45526902
NM_001198542,HYDIN,19,18,199313,3171,196142,10896.77778,166.8947368,61.85493535
NM_001172771,IL34,7,6,80789,1783,79006,13167.66667,254.7142857,44.31071228
NM_152456,IL34,7,6,80789,1786,79003,13167.16667,255.1428571,44.23460246
NM_018332,DDX19A,12,11,26459,2912,23547,2140.636364,242.6666667,8.086195055
NM_017558,HYDIN,20,19,203614,3738,199876,10519.78947,186.9,53.47137507
NM_018052,VAC14,19,18,113721,3115,110606,6144.777778,163.9473684,35.50754414
NM_001270974,HYDIN,86,85,423340,15832,407508,4794.211765,184.0930233,25.73951491
NM_005769,CHST4,2,1,12472,2126,10346,10346,1063,4.866415804
NM_015020,PHLPP2,19,18,79777,8334,71443,3969.055556,438.6315789,8.572474202
NM_001166395,CHST4,2,1,12341,2178,10163,10163,1089,4.66620753
NM_001270978,IST1,7,6,35146,3672,31474,5245.666667,524.5714286,8.571350763
NM_014761,IST1,10,9,35146,4043,31103,3455.888889,404.3,7.693049716
NM_001128,AP1G1,23,22,80073,6862,73211,3327.772727,298.3478261,10.66904693
NM_001289003,PHLPP2,18,17,70916,8479,62437,3672.764706,471.0555556,7.363722137
NM_001126102,HP,5,4,6449,1259,5190,1297.5,251.8,4.122319301
NM_001270976,IST1,11,10,36231,4163,32068,3206.8,378.4545455,7.703098727
NM_001270975,IST1,10,9,35146,4047,31099,3455.444444,404.7,7.684457623
NM_001270979,IST1,6,5,35146,3587,31559,6311.8,597.8333333,8.798160022
NM_001030007,AP1G1,24,23,80073,6872,73201,3182.652174,286.3333333,10.65206636
NM_005143,HP,7,6,6449,1438,5011,835.1666667,205.4285714,3.484700974
NM_001270977,IST1,9,8,35146,3953,31193,3899.125,439.2222222,7.890968884
NM_001164766,ZFHX3,9,8,275750,12785,262965,32870.625,1420.555556,20.56824404
NM_006885,ZFHX3,10,9,265490,16072,249418,27713.11111,1607.2,15.51879044
NM_030581,WDR59,26,25,111548,3689,107859,4314.36,141.8846154,29.23800488
NM_032268,ZNRF1,5,4,111979,4638,107341,26835.25,927.6,23.14381199
NM_012201,GLG1,27,26,159718,8317,151401,5823.115385,308.037037,18.20379945
NM_006324,CFDP1,7,6,139781,1286,138495,23082.5,183.7142857,107.6944012
NM_152649,MLKL,11,10,29038,2517,26521,2652.1,228.8181818,10.5367501
NM_001142497,MLKL,6,5,29038,1888,27150,5430,314.6666667,14.38029661
NM_001145667,GLG1,26,25,159718,9355,150363,6014.52,359.8076923,16.07300909
NM_001145666,GLG1,26,25,159718,8283,151435,6057.4,318.5769231,18.28262707
NM_199355,ADAMTS18,23,22,152988,5936,147052,6684.181818,258.0869565,24.77291105
NM_130791,WWOX,6,5,179268,965,178303,35660.6,160.8333333,184.7699482
NM_020927,VAT1L,9,8,191520,3775,187745,23468.125,419.4444444,49.73377483
NM_198390,CMIP,21,20,266594,4378,262216,13110.8,208.4761905,59.89401553
NM_022041,GAN,11,10,65234,4555,60679,6067.9,414.0909091,13.32140505
NM_030629,CMIP,21,20,216415,4152,212263,10613.15,197.7142857,51.12307322
NM_005792,MPHOSPH6,5,4,22064,1106,20958,5239.5,221.2,18.94936709
NM_002661,PLCG2,33,32,179002,4305,174697,5459.28125,130.4545455,40.58002323
NM_001272075,USP10,15,14,79974,3514,76460,5461.428571,234.2666667,21.75867957
NM_014861,ATP2C2,27,26,95662,3412,92250,3548.076923,126.3703704,27.03692849
NM_019065,NECAB2,13,12,34144,1619,32525,2710.416667,124.5384615,20.08956146
NM_001286527,ATP2C2,28,27,95662,3500,92162,3413.407407,125,26.332
NM_005153,USP10,14,13,79974,3392,76582,5890.923077,242.2857143,22.57724057
NM_003791,MBTPS1,23,22,63184,4403,58781,2671.863636,191.4347826,13.35021576
NM_016095,GINS2,5,4,11310,1185,10125,2531.25,237,8.544303797
NM_001286566,KIAA0513,12,11,66473,7395,59078,5370.727273,616.25,7.988911427
NM_014732,KIAA0513,13,12,66473,7419,59054,4921.166667,570.6923077,7.959832862
NM_001739,CA5A,7,6,48489,1091,47398,7899.666667,155.8571429,43.44454629
NM_001282683,FBXO31,10,9,65122,5728,59394,6599.333333,572.8,10.36906425
NM_020655,JPH3,5,4,95270,4007,91263,22815.75,801.4,22.77589219
NM_005187,CBFA2T3,12,11,102243,4384,97859,8896.272727,365.3333333,22.32185219
NM_175931,CBFA2T3,11,10,66347,4049,62298,6229.8,368.0909091,15.38602124
NM_032451,SPIRE2,15,14,42822,3259,39563,2825.928571,217.2666667,12.13961338
NM_001242885,AC137932.6,3,2,3979,1208,2771,1385.5,402.6666667,2.293874172
NM_004933,CDH15,14,13,23739,2873,20866,1605.076923,205.2142857,7.262791507
NM_014427,CPNE7,17,16,21480,2674,18806,1175.375,157.2941176,7.032909499
NM_013275,ANKRD11,13,12,222942,9323,213619,17801.58333,717.1538462,22.9131181
NM_001256183,ANKRD11,13,12,222942,9320,213622,17801.83333,716.9230769,22.92081545
NM_001256182,ANKRD11,14,13,222942,9395,213547,16426.69231,671.0714286,22.72985631
NM_004913,VPS9D1,15,14,13855,2764,11091,792.2142857,184.2666667,4.012662808
NM_153636,CPNE7,15,14,21480,2447,19033,1359.5,163.1333333,7.778095627
NM_016310,POLR3K,3,2,6655,827,5828,2914,275.6666667,7.047158404
NM_022450,RHBDF1,18,17,14573,3010,11563,680.1764706,167.2222222,3.841528239
NM_024571,SNRNP25,5,4,3842,1091,2751,687.75,218.2,2.521539872
NM_005331,HBQ1,3,2,847,656,191,95.5,218.6666667,0.291158537
NM_001243247,NPRL3,15,14,52895,2885,50010,3572.142857,192.3333333,17.33448873
NM_000558,HBA1,3,2,843,579,264,132,193,0.455958549
NM_005332,HBZ,3,2,1652,592,1060,530,197.3333333,1.790540541
NM_001039476,NPRL3,11,10,52895,2846,50049,5004.9,258.7272727,17.58573436
NM_000517,HBA2,3,2,865,608,257,128.5,202.6666667,0.422697368
NM_001243249,NPRL3,12,11,52895,2977,49918,4538,248.0833333,16.76788713
NM_001243248,NPRL3,13,12,52895,2946,49949,4162.416667,226.6153846,16.95485404
NM_001077350,NPRL3,14,13,52895,2747,50148,3857.538462,196.2142857,18.25555151
NM_001003938,HBM,3,2,796,513,283,141.5,171,0.55165692
NM_032039,ITFG3,13,12,31581,3226,28355,2362.916667,248.1538462,8.789522629
NM_001286486,RGS11,15,14,7645,2254,5391,385.0714286,150.2666667,2.391748004
NM_006849,PDIA2,11,10,4093,1737,2356,235.6,157.9090909,1.356361543
NM_003834,RGS11,17,16,7645,2432,5213,325.8125,143.0588235,2.143503289
NM_001176,ARHGDIG,6,5,2399,948,1451,290.2,158,1.530590717
NM_183337,RGS11,17,16,7645,2421,5224,326.5,142.4117647,2.157786039
NM_001286485,RGS11,16,15,7645,2387,5258,350.5333333,149.1875,2.202764977
NM_001284497,ITFG3,13,12,31581,3219,28362,2363.5,247.6153846,8.810810811
NM_020664,DECR2,9,8,10631,1592,9039,1129.875,176.8888889,5.677763819
NM_006428,MRPL28,6,5,3187,1146,2041,408.2,191,1.780977312
NM_001286440,NME4,5,4,3014,1328,1686,421.5,265.6,1.269578313
NM_001286438,NME4,6,5,3564,1191,2373,474.6,198.5,1.992443325
NM_001286439,NME4,6,5,3564,1200,2364,472.8,200,1.97
NM_021259,TMEM8A,13,12,11176,3669,7507,625.5833333,282.2307692,2.046061597
NM_005009,NME4,5,4,3564,1012,2552,638,202.4,2.52173913
NM_001286435,NME4,5,4,3564,1122,2442,610.5,224.4,2.176470588
NM_001286436,NME4,5,4,4001,1215,2786,696.5,243,2.293004115
NM_001286433,NME4,4,3,3564,909,2655,885,227.25,2.920792079
NM_145270,C16orf11,3,2,5109,2220,2889,1444.5,740,1.301351351
NM_148920,PIGQ,10,9,14170,2933,11237,1248.555556,293.3,3.831230822
NM_001142272,RAB11FIP3,12,11,47633,3218,44415,4037.727273,268.1666667,13.80205096
NM_005632,CAPN15,14,13,26782,4758,22024,1694.153846,339.8571429,4.628835645
NM_004204,PIGQ,11,10,14170,2996,11174,1117.4,272.3636364,3.729639519
NM_176677,NHLRC4,2,1,2465,2046,419,419,1023,0.204789834
NM_001040160,C16orf13,5,4,1941,798,1143,285.75,159.6,1.432330827
NM_001040161,C16orf13,3,2,1941,573,1368,684,191,2.387434555
NM_001040162,C16orf13,4,3,1941,634,1307,435.6666667,158.5,2.061514196
NM_024042,METRN,4,3,2309,1096,1213,404.3333333,274,1.106751825
NM_001278721,RHBDL1,7,6,2604,1245,1359,226.5,177.8571429,1.091566265
NM_001278720,RHBDL1,8,7,2604,1471,1133,161.8571429,183.875,0.770224337
NM_001040165,C16orf13,4,3,1941,737,1204,401.3333333,184.25,1.633649932
NM_023933,FAM173A,5,4,1450,879,571,142.75,175.8,0.64960182
NM_032366,C16orf13,6,5,1941,867,1074,214.8,144.5,1.238754325
NM_032304,HAGHL,8,7,2451,1360,1091,155.8571429,170,0.802205882
NM_032259,WDR24,9,8,5700,3174,2526,315.75,352.6666667,0.79584121
NM_145294,WDR90,41,40,18468,5582,12886,322.15,136.1463415,2.30849158
NM_138418,FAM195A,5,4,6627,915,5712,1428,183,6.242622951
NM_001031737,CCDC78,14,13,3893,1625,2268,174.4615385,116.0714286,1.395692308
NM_138769,RHOT2,19,18,6093,2561,3532,196.2222222,134.7894737,1.37914877
NM_001271285,FAM173A,4,3,1450,827,623,207.6666667,206.75,0.753325272
NM_053284,WFIKKN1,2,1,3106,1950,1156,1156,975,0.592820513
NM_005861,STUB1,7,6,2655,1609,1046,174.3333333,229.8571429,0.650093226
NM_153350,FBXL16,6,5,13327,3549,9778,1955.6,591.5,2.755142294
NM_001288710,C16orf13,5,4,1941,806,1135,283.75,161.2,1.408188586
NM_001005920,JMJD8,9,8,2774,2051,723,90.375,227.8888889,0.35251097
NM_022092,CHTF18,22,21,9454,3112,6342,302,141.4545455,2.037917738
NM_001177355,MSLN,18,17,8101,2126,5975,351.4705882,118.1111111,2.810442145
NM_001013638,PRR25,3,2,8420,1212,7208,3604,404,5.947194719
NM_013404,MSLN,17,16,7794,2153,5641,352.5625,126.6470588,2.620065026
NM_016541,GNG13,3,2,2694,987,1707,853.5,329,1.729483283
NM_058192,RPUSD1,6,5,3411,2056,1355,271,342.6666667,0.659046693
NM_005823,MSLN,18,17,8102,2187,5915,347.9411765,121.5,2.704618198
NM_014587,SOX8,3,2,5173,3052,2121,1060.5,1017.333333,0.694954128
NM_207419,C1QTNF8,5,4,8020,3411,4609,1152.25,682.2,1.351216652
NM_001053,SSTR5,1,0,2675,2675,NA,NA,2675,NA
NM_001172560,SSTR5,2,1,8700,2659,6041,6041,1329.5,2.271906732
NM_021098,CACNA1H,35,34,68533,8123,60410,1776.764706,232.0857143,7.436907546
NM_001005407,CACNA1H,34,33,68533,8104,60429,1831.181818,238.3529412,7.456688055
NM_024164,TPSB2,7,6,1851,1172,681,113.5,167.4285714,0.58105802
NM_012217,TPSD1,5,4,2223,860,1363,340.75,172,1.584883721
NM_012467,TPSG1,6,5,3605,1111,2494,498.8,185.1666667,2.244824482
NM_003294,TPSAB1,6,5,1879,1200,679,135.8,200,0.565833333
NM_032520,GNPTG,11,10,11454,1256,10198,1019.8,114.1818182,8.119426752
NM_001276414,UNKL,6,5,16480,4326,12154,2430.8,721,2.80952381
NM_001199099,BAIAP3,34,33,15838,4523,11315,342.8787879,133.0294118,2.501658191
NM_001199098,BAIAP3,34,33,15838,4538,11300,342.4242424,133.4705882,2.490083737
NM_001199097,BAIAP3,34,33,15838,4607,11231,340.3333333,135.5,2.437812025
NM_001199096,BAIAP3,33,32,13246,4556,8690,271.5625,138.0606061,1.90737489
NM_003933,BAIAP3,34,33,14939,4715,10224,309.8181818,138.6764706,2.168398727
NM_194261,UBE2I,7,6,17867,2839,15028,2504.666667,405.5714286,5.293413174
NM_194260,UBE2I,7,6,17867,2987,14880,2480,426.7142857,4.981586876
NM_194259,UBE2I,8,7,17393,3125,14268,2038.285714,390.625,4.56576
NM_001286464,BAIAP3,34,33,15838,4658,11180,338.7878788,137,2.400171748
NM_003345,UBE2I,7,6,17393,2867,14526,2421,409.5714286,5.06662016
NM_001193389,UNKL,6,5,16480,3980,12500,2500,663.3333333,3.140703518
NM_001001410,TSR3,6,5,2634,1210,1424,284.8,201.6666667,1.176859504
NM_001272051,C16orf91,2,1,1058,980,78,78,490,0.079591837
NM_016111,TELO2,21,20,17110,3349,13761,688.05,159.4761905,4.108987758
NM_001013658,PTX4,3,2,2530,1425,1105,552.5,475,0.775438596
NM_001287,CLCN7,25,24,30153,4251,25902,1079.25,170.04,6.093154552
NM_001143980,CCDC154,17,16,10103,2208,7895,493.4375,129.8823529,3.575634058
NM_001114331,CLCN7,24,23,30153,4178,25975,1129.347826,174.0833333,6.217089517
NM_001037125,UNKL,6,5,16417,1406,15011,3002.2,234.3333333,10.67638691
NM_024600,TMEM204,3,2,21925,1857,20068,10034,619,10.80667744
NM_001256541,TMEM204,4,3,26841,1637,25204,8401.333333,409.25,15.39645693
NM_080861,SPSB3,7,6,5870,1551,4319,719.8333333,221.5714286,2.784655061
NM_023936,MRPS34,3,2,1246,1006,240,120,335.3333333,0.238568588
NM_002513,NME3,5,4,1391,1019,372,93,203.8,0.365063788
NM_015133,MAPK8IP3,32,31,64099,5656,58443,1885.258065,176.75,10.33292079
NM_144570,HN1L,5,4,23797,3688,20109,5027.25,737.6,5.452548807
NM_001257370,EME2,8,7,3012,1148,1864,266.2857143,143.5,1.62369338
NM_001040439,MAPK8IP3,31,30,64099,5637,58462,1948.733333,181.8387097,10.37111939
NM_031208,FAHD1,1,0,1685,1685,NA,NA,1685,NA
NM_001163560,MEIOB,14,13,38197,1898,36299,2792.230769,135.5714286,19.12486828
NM_005326,HAGH,9,8,18093,1523,16570,2071.25,169.2222222,10.87984242
NM_001146006,IGFALS,2,1,3322,2202,1120,1120,1101,0.50862852
NM_001142398,FAHD1,2,1,12980,1585,11395,11395,792.5,7.189274448
NM_001286249,HAGH,8,7,18093,1413,16680,2382.857143,176.625,11.80467091
NM_152764,MEIOB,13,12,38115,1728,36387,3032.25,132.9230769,21.05729167
NM_001040427,HAGH,10,9,18093,1620,16473,1830.333333,162,10.16851852
NM_004970,IGFALS,2,1,3322,2088,1234,1234,1044,0.590996169
NM_001018104,FAHD1,3,2,12980,1705,11275,5637.5,568.3333333,6.612903226
NM_016332,MSRB1,4,3,5062,1371,3691,1230.333333,342.75,2.692195478
NM_001130012,SLC9A3R2,7,6,12160,2201,9959,1659.833333,314.4285714,4.524761472
NM_001099456,NPW,2,1,1237,1018,219,219,509,0.215127701
NM_002952,RPS2,7,6,2767,949,1818,303,135.5714286,1.915700738
NM_006453,TBL3,22,21,6689,2616,4073,193.952381,118.9090909,1.556957187
NM_001252076,SLC9A3R2,6,5,5764,1784,3980,796,297.3333333,2.230941704
NM_178167,ZNF598,14,13,12171,3383,8792,676.3076923,241.6428571,2.598876737
NM_001267721,NOXO1,8,7,2634,1641,993,141.8571429,205.125,0.60511883
NM_001252075,SLC9A3R2,6,5,5764,1811,3953,790.6,301.8333333,2.182771949
NM_001252073,SLC9A3R2,6,5,5764,1817,3947,789.4,302.8333333,2.17226197
NM_144603,NOXO1,8,7,2634,1626,1008,144,203.25,0.619926199
NM_005061,RPL3L,10,9,10101,1539,8562,951.3333333,153.9,5.563352827
NM_005262,GFER,3,2,3602,2412,1190,595,804,0.493366501
NM_004785,SLC9A3R2,7,6,12160,2168,9992,1665.333333,309.7142857,4.608856089
NM_004209,SYNGR3,4,3,4332,2055,2277,759,513.75,1.108029197
NM_004548,NDUFB10,4,3,2461,701,1760,586.6666667,175.25,2.510699001
NM_174903,RNF151,4,3,2103,800,1303,434.3333333,200,1.62875
NM_172168,NOXO1,8,7,2634,1644,990,141.4285714,205.5,0.602189781
NM_172167,NOXO1,8,7,2634,1629,1005,143.5714286,203.625,0.61694291
NM_001077183,TSC2,40,39,40725,5471,35254,903.9487179,136.775,6.443794553
NM_032271,TRAF7,21,20,22333,3688,18645,932.25,175.6190476,5.055585683
NM_001009944,PKD1,46,45,47190,14184,33006,733.4666667,308.3478261,2.326988156
NM_000548,TSC2,42,41,40725,5674,35051,854.902439,135.0952381,6.177476207
NM_014353,RAB26,9,8,5492,1633,3859,482.375,181.4444444,2.363135334
NM_000296,PKD1,46,45,47190,14181,33009,733.5333333,308.2826087,2.327691982
NM_001114382,TSC2,41,40,40725,5604,35121,878.025,136.6829268,6.267130621
NM_001286627,RNPS1,6,5,15298,1917,13381,2676.2,319.5,6.98017736
NM_001199175,MLST8,9,8,4242,1918,2324,290.5,213.1111111,1.211678832
NM_001199174,MLST8,9,8,3688,1730,1958,244.75,192.2222222,1.131791908
NM_001199173,MLST8,9,8,4242,1891,2351,293.875,210.1111111,1.243257536
NM_001042371,PGP,2,1,3221,3138,83,83,1569,0.026449968
NM_022372,MLST8,9,8,4242,1921,2321,290.125,213.4444444,1.208224883
NM_006711,RNPS1,8,7,14772,2115,12657,1808.142857,264.375,5.984397163
NM_001919,ECI1,7,6,11731,1058,10673,1778.833333,151.1428571,10.0879017
NM_001374,DNASE1L2,7,6,2246,1333,913,152.1666667,190.4285714,0.68492123
NM_001178029,ECI1,7,6,11731,1007,10724,1787.333333,143.8571429,10.64945382
NM_080594,RNPS1,8,7,15298,2249,13049,1864.142857,281.125,5.802134282
NM_182563,BRICD5,6,5,1817,1037,780,156,172.8333333,0.75216972
NM_001286625,RNPS1,8,7,14223,2054,12169,1738.428571,256.75,5.924537488
NM_001286626,RNPS1,7,6,15298,2060,13238,2206.333333,294.2857143,6.426213592
NM_001288776,E4F1,14,13,12256,2613,9643,741.7692308,186.6428571,3.690394183
NM_001288778,E4F1,12,11,12256,2132,10124,920.3636364,177.6666667,4.748592871
NM_004424,E4F1,14,13,12256,2665,9591,737.7692308,190.3571429,3.598874296
NM_025108,C16orf59,10,9,4851,1638,3213,357,163.8,1.961538462
NM_020705,TBC1D24,7,6,30589,6584,24005,4000.833333,940.5714286,3.645959903
NM_001198569,ATP6V0C,4,3,6499,1025,5474,1824.666667,256.25,5.340487805
NM_001048212,CEMP1,1,0,1375,1375,NA,NA,1375,NA
NM_001694,ATP6V0C,3,2,6355,1183,5172,2586,394.3333333,4.371935757
NM_006181,NTN3,6,5,2648,1992,656,131.2,332,0.329317269
NM_001145815,AMDHD2,11,10,10594,2088,8506,850.6,189.8181818,4.073754789
NM_001199107,TBC1D24,8,7,30589,6603,23986,3426.571429,825.375,3.632591246
NM_015944,AMDHD2,10,9,9371,1595,7776,864,159.5,4.87523511
NM_007108,TCEB2,4,3,5884,994,4890,1630,248.5,4.919517103
NM_001270452,PRSS21,6,5,4561,1142,3419,683.8,190.3333333,2.993870403
NM_031948,PRSS27,6,5,8131,1468,6663,1332.6,244.6666667,4.538828338
NM_152891,PRSS33,6,5,2756,1700,1056,211.2,283.3333333,0.621176471
NM_145252,ZG16B,4,3,2114,832,1282,427.3333333,208,1.540865385
NM_016333,SRRM2,15,14,19085,9368,9717,694.0714286,624.5333333,1.037254483
NM_001135086,PRSS41,5,4,6649,962,5687,1421.75,192.4,5.911642412
NM_144957,PRSS21,6,5,4561,1132,3429,685.8,188.6666667,3.029151943
NM_144956,PRSS21,6,5,4561,1168,3393,678.6,194.6666667,2.904965753
NM_207013,TCEB2,5,4,5884,606,5278,1319.5,121.2,8.709570957
NM_006799,PRSS21,6,5,4561,1174,3387,677.4,195.6666667,2.885008518
NM_020912,FLYWCH1,9,8,28180,2545,25635,3204.375,282.7777778,10.07269155
NM_022119,PRSS22,6,5,5445,1392,4053,810.6,232,2.911637931
NM_032296,FLYWCH1,10,9,39231,5002,34229,3803.222222,500.2,6.843062775
NM_001142499,FLYWCH2,4,3,16189,937,15252,5084,234.25,16.27748132
NM_001142500,FLYWCH2,4,3,16189,1027,15162,5054,256.75,14.76338851
NM_138439,FLYWCH2,4,3,16189,1031,15158,5052.666667,257.75,14.70223084
NM_001142350,THOC6,12,11,3726,1297,2429,220.8181818,108.0833333,1.872783346
NM_182687,PKMYT1,9,8,7750,2218,5532,691.5,246.4444444,2.494138864
NM_021195,CLDN6,2,1,3477,1372,2105,2105,686,1.53425656
NM_020982,CLDN9,1,0,2051,2051,NA,NA,2051,NA
NM_022468,MMP25,10,9,14044,3561,10483,1164.777778,356.1,2.943836001
NM_001288665,HCFC1R1,5,4,1668,931,737,184.25,186.2,0.791621912
NM_001288666,HCFC1R1,4,3,1668,740,928,309.3333333,185,1.254054054
NM_001288667,HCFC1R1,3,2,1668,1002,666,333,334,0.664670659
NM_001288668,HCFC1R1,4,3,1668,909,759,253,227.25,0.834983498
NM_001284512,PAQR4,2,1,4246,2573,1673,1673,1286.5,0.650213758
NM_001012632,IL32,7,6,4007,963,3044,507.3333333,137.5714286,3.160955348
NM_001012631,IL32,8,7,4357,1165,3192,456,145.625,2.739914163
NM_001012634,IL32,6,5,4031,903,3128,625.6,150.5,3.464008859
NM_001258451,PKMYT1,9,8,7750,2044,5706,713.25,227.1111111,2.791585127
NM_001258450,PKMYT1,9,8,7750,1973,5777,722.125,219.2222222,2.928028383
NM_004221,IL32,7,6,4357,1097,3260,543.3333333,156.7142857,2.971741112
NM_024339,THOC6,13,12,3726,1433,2293,191.0833333,110.2307692,1.600139567
NM_001012635,IL32,6,5,4058,898,3160,632,149.6666667,3.518930958
NM_152341,PAQR4,3,2,4246,2796,1450,725,932,0.518597997
NM_016639,TNFRSF12A,4,3,2072,1036,1036,345.3333333,259,1
NM_001012718,IL32,7,6,4357,1100,3257,542.8333333,157.1428571,2.960909091
NM_032805,ZSCAN10,5,4,3968,2468,1500,375,493.6,0.607779579
NM_001103175,CCDC64B,9,8,7676,1820,5856,732,202.2222222,3.217582418
NM_004203,PKMYT1,9,8,7750,2180,5570,696.25,242.2222222,2.555045872
NM_001284513,PAQR4,3,2,4149,2302,1847,923.5,767.3333333,0.802345786
NM_001284511,PAQR4,3,2,4246,2679,1567,783.5,893,0.584919746
NM_001002017,HCFC1R1,3,2,1668,951,717,358.5,317,0.753943218
NM_017885,HCFC1R1,4,3,1668,1009,659,219.6666667,252.25,0.653121903
NM_001002018,HCFC1R1,5,4,1668,798,870,217.5,159.6,1.090225564
NM_001012636,IL32,5,4,3885,885,3000,750,177,3.389830508
NM_001012633,IL32,8,7,4357,927,3430,490,115.875,3.700107875
NM_012360,OR1F1,1,0,940,940,NA,NA,940,NA
NM_001278158,ZNF205,7,6,7940,2318,5622,937,331.1428571,2.425366695
NM_003456,ZNF205,7,6,7957,2067,5890,981.6666667,295.2857143,2.849540397
NM_001042428,ZNF205,7,6,7957,1999,5958,993,285.5714286,2.980490245
NM_001134655,ZNF213,6,5,7673,3271,4402,880.4,545.1666667,1.345765821
NM_004220,ZNF213,6,5,7750,3290,4460,892,548.3333333,1.3556231
NM_000243,MEFV,10,9,14601,3509,11092,1232.444444,350.9,3.161014534
NM_033208,TIGD7,2,1,6633,3432,3201,3201,1716,0.932692308
NM_005741,ZNF263,6,5,7974,3291,4683,936.6,548.5,1.422971741
NM_012368,OR2C1,1,0,1037,1037,NA,NA,1037,NA
NM_001198536,MEFV,9,8,14601,3050,11551,1443.875,338.8888889,3.787213115
NM_153028,ZNF75A,6,5,13145,2130,11015,2203,355,5.171361502
NM_024845,NAA60,7,6,28973,2657,26316,4386,379.5714286,9.904403463
NM_001083600,NAA60,7,6,28973,2635,26338,4389.666667,376.4285714,9.99544592
NM_003450,ZNF174,3,2,8176,2487,5689,2844.5,829,2.287494974
NM_001190476,MTRNR2L4,1,0,1232,1232,NA,NA,1232,NA
NM_001284528,ZSCAN32,4,3,18986,2792,16194,5398,698,5.800143266
NM_152457,ZNF597,4,3,7382,1777,5605,1868.333333,444.25,3.154192459
NM_017810,ZSCAN32,6,5,18986,3077,15909,3181.8,512.8333333,5.170295743
NM_001032292,ZNF174,3,2,3855,1578,2277,1138.5,526,1.442965779
NM_001284529,ZSCAN32,3,2,18986,2238,16748,8374,746,7.483467382
NM_001083601,NAA60,8,7,43297,2686,40611,5801.571429,335.75,15.11950856
NM_001284527,ZSCAN32,7,6,18986,3180,15806,2634.333333,454.2857143,4.970440252
NM_178844,NLRC3,21,20,38358,6419,31941,1597.05,305.6666667,4.976008724
NM_001080524,C16orf90,3,2,1939,907,1032,516,302.3333333,1.137816979
NM_032444,SLX4,15,14,30403,7306,23097,1649.785714,487.0666667,3.161374213
NM_015041,CLUAP1,12,11,38108,4157,33951,3086.454545,346.4166667,8.167187876
NM_024793,CLUAP1,8,7,29159,3611,25548,3649.714286,451.375,7.075048463
NM_001272049,TRAP1,17,16,59562,2154,57408,3588,126.7058824,26.65181058
NM_005223,DNASE1,9,8,5158,3107,2051,256.375,345.2222222,0.660122304
NM_016292,TRAP1,18,17,59562,2314,57248,3367.529412,128.5555556,24.73984443
NM_003223,TFAP4,7,6,15816,2147,13669,2278.166667,306.7142857,6.366557988
NM_001098814,SRL,6,5,52708,4220,48488,9697.6,703.3333333,11.49004739
NM_032575,GLIS2,6,5,7375,3711,3664,732.8,618.5,0.98733495
NM_016069,PAM16,5,4,11123,589,10534,2633.5,117.8,17.88455008
NM_138440,VASN,2,1,11682,2808,8874,8874,1404,3.16025641
NM_002134,HMOX2,6,5,34009,1737,32272,6454.4,289.5,18.57915947
NM_001135110,DNAJA3,11,10,30971,2656,28315,2831.5,241.4545455,10.66076807
NM_001127205,HMOX2,6,5,14491,1759,12732,2546.4,293.1666667,7.238203525
NM_020677,NMRAL1,6,5,13203,1368,11835,2367,228,8.651315789
NM_001286271,HMOX2,5,4,34009,1609,32400,8100,321.8,20.13673089
NM_001286267,HMOX2,7,6,34009,1859,32150,5358.333333,265.5714286,17.29424422
NM_001127206,HMOX2,6,5,35646,1734,33912,6782.4,289,19.55709343
NM_001127204,HMOX2,7,6,34009,1856,32153,5358.833333,265.1428571,17.32381466
NM_005147,DNAJA3,12,11,30971,2774,28197,2563.363636,231.1666667,10.16474405
NM_001286270,HMOX2,8,7,14530,2137,12393,1770.428571,267.125,5.799251287
NM_001286269,HMOX2,7,6,34009,1837,32172,5362,262.4285714,17.51333696
NM_001286268,HMOX2,6,5,34009,1915,32094,6418.8,319.1666667,16.75926893
NM_001286516,DNAJA3,9,8,30971,2305,28666,3583.25,256.1111111,12.43644252
NM_145253,UBALD1,3,2,6045,1416,4629,2314.5,472,3.269067797
NM_001145011,C16orf96,16,15,43829,3442,40387,2692.466667,215.125,11.73358512
NM_001154458,Sep-12,9,8,10909,1395,9514,1189.25,155,6.820071685
NM_133450,ANKS3,18,17,37654,2682,34972,2057.176471,149,13.03952274
NM_001253791,SMIM22,6,5,8037,845,7192,1438.4,140.8333333,8.511242604
NM_001253790,SMIM22,5,4,8096,1037,7059,1764.75,207.4,6.807135969
NM_021646,ZNF500,6,5,16353,3258,13095,2619,543,4.019337017
NM_032349,NUDT16L1,3,2,2168,1353,815,407.5,451,0.602365115
NM_001242929,ANKS3,15,14,37869,2287,35582,2541.571429,152.4666667,15.55837341
NM_001253794,SMIM22,4,3,1115,623,492,164,155.75,0.789727127
NM_001253793,SMIM22,4,3,1115,608,507,169,152,0.833881579
NM_144605,Sep-12,10,9,10909,1534,9375,1041.666667,153.4,6.111473272
NM_139170,C16orf71,10,9,15110,2716,12394,1377.111111,271.6,4.563328424
NM_001193452,NUDT16L1,3,2,2168,1423,745,372.5,474.3333333,0.523541813
NM_001079514,UBN1,18,17,34772,6311,28461,1674.176471,350.6111111,4.50974489
NM_032569,GLYR1,16,15,44101,3748,40353,2690.2,234.25,10.76654216
NM_001288656,UBN1,17,16,34023,5654,28369,1773.0625,332.5882353,5.017509728
NM_016256,NAGPA,10,9,9099,2219,6880,764.4444444,221.9,3.100495719
NM_014692,SEC14L5,16,15,60840,6472,54368,3624.533333,404.5,8.400494438
NM_019109,ALG1,13,12,15572,3947,11625,968.75,303.6153846,2.945274892
NM_001289029,FAM86A,6,5,13522,2229,11293,2258.6,371.5,5.066397488
NM_201400,FAM86A,8,7,13522,2414,11108,1586.857143,301.75,4.601491301
NM_201598,FAM86A,7,6,13522,2311,11211,1868.5,330.1428571,4.85114669
NM_001146336,TMEM114,2,1,2726,646,2080,2080,323,3.219814241
NM_024109,METTL22,11,10,24554,1581,22973,2297.3,143.7272727,14.53067679
NM_001127448,ABAT,16,15,63861,4924,58937,3929.133333,307.75,11.96933387
NM_015421,TMEM186,2,1,2470,1450,1020,1020,725,0.703448276
NM_000663,ABAT,16,15,71608,5602,66006,4400.4,350.125,11.78257765
NM_001278266,CARHSP1,4,3,8870,2822,6048,2016,705.5,2.143160879
NM_001278265,CARHSP1,4,3,8870,2846,6024,2008,711.5,2.116654954
NM_001278262,CARHSP1,5,4,8870,2937,5933,1483.25,587.4,2.020088526
NM_001278260,CARHSP1,5,4,16072,2839,13233,3308.25,567.8,4.661148292
NM_001042476,CARHSP1,4,3,15461,3030,12431,4143.666667,757.5,4.102640264
NM_001286457,USP7,31,30,44637,5312,39325,1310.833333,171.3548387,7.403049699
NM_014316,CARHSP1,4,3,16072,2724,13348,4449.333333,681,4.900146843
NM_001278264,CARHSP1,4,3,14488,2854,11634,3878,713.5,4.076384022
NM_001278263,CARHSP1,4,3,15421,2712,12709,4236.333333,678,4.68620944
NM_001278261,CARHSP1,5,4,15779,2978,12801,3200.25,595.6,4.298522498
NM_001286458,USP7,32,31,44637,5488,39149,1262.870968,171.5,7.13356414
NM_014117,C16orf72,4,3,28020,3983,24037,8012.333333,995.75,6.034898318
NM_001424,EMP2,5,4,52262,5186,47076,11769,1037.2,9.07751639
NM_001278506,NUBP1,10,9,25567,1264,24303,2700.333333,126.4,19.22705696
NM_002484,NUBP1,11,10,25567,1298,24269,2426.9,118,18.6972265
NM_014015,DEXI,2,1,13511,1503,12008,12008,751.5,7.989354624
NM_001286358,PRM2,2,1,846,678,168,168,339,0.247787611
NM_001286356,PRM2,2,1,846,729,117,117,364.5,0.160493827
NM_003745,SOCS1,2,1,1767,1218,549,549,609,0.450738916
NM_005425,TNP2,2,1,1448,599,849,849,299.5,1.41736227
NM_002762,PRM2,2,1,846,685,161,161,342.5,0.235036496
NM_002761,PRM1,2,1,501,411,90,90,205.5,0.218978102
NM_021247,PRM3,1,0,310,310,NA,NA,310,NA
NM_001286357,PRM2,2,1,846,610,236,236,305,0.386885246
NM_001286359,PRM2,2,1,846,732,114,114,366,0.155737705
NM_152308,RMI2,2,1,6308,1434,4874,4874,717,3.39888424
NM_003498,SNN,2,1,10728,3295,7433,7433,1647.5,2.255842185
NM_014153,ZC3H7A,23,22,46674,3839,42835,1947.045455,166.9130435,11.15785361
NM_015659,RSL1D1,9,8,17389,5144,12245,1530.625,571.5555556,2.380443235
NM_002094,GSPT1,15,14,47842,7168,40674,2905.285714,477.8666667,5.674386161
NM_001130007,GSPT1,15,14,48536,7189,41347,2953.357143,479.2666667,5.751425789
NM_001130006,GSPT1,15,14,47842,7165,40677,2905.5,477.6666667,5.67718074
NM_001192,TNFRSF17,3,2,2963,997,1966,983,332.3333333,1.971915747
NM_001145205,SHISA9,2,1,10032,4182,5850,5850,2091,1.398852224
NM_016561,BFAR,8,7,36427,3051,33376,4768,381.375,10.93936414
NM_003561,PLA2G10,4,3,22123,1001,21122,7040.666667,250.25,21.1008991
NM_001277324,NPIPA2,8,7,14637,1096,13541,1934.428571,137,12.35492701
NM_001277323,NPIPA3,8,7,14647,1106,13541,1934.428571,138.25,12.24321881
NM_006985,NPIPA1,8,7,14633,1110,13523,1931.857143,138.75,12.18288288
NM_173474,NTAN1,10,9,18228,1229,16999,1888.777778,122.9,13.83157038
NM_018427,RRN3,18,17,34281,3764,30517,1795.117647,209.1111111,8.1075983
NM_001270767,NTAN1,8,7,18228,1058,17170,2452.857143,132.25,16.22873346
NM_001270766,NTAN1,9,8,18228,1125,17103,2137.875,125,15.20266667
NM_001128423,MPV17L,4,3,13934,2313,11621,3873.666667,578.25,5.024210981
NM_173803,MPV17L,3,2,13934,2241,11693,5846.5,747,5.217759929
NM_017668,NDE1,9,8,76127,3229,72898,9112.25,358.7777778,22.57602973
NM_001143979,NDE1,10,9,83086,3944,79142,8793.555556,394.4,20.06643002
NM_144600,FOPNL,5,4,22872,2255,20617,5154.25,451,9.142793792
NM_001079528,ABCC6,2,1,2286,720,1566,1566,360,2.175
NM_001282511,NPIPA8,8,7,14729,1167,13562,1937.428571,145.875,11.62125107
NM_001282507,NPIPA7,8,7,14729,1167,13562,1937.428571,145.875,11.62125107
NM_001282511,NPIPA8,8,7,14745,1167,13578,1939.714286,145.875,11.63496144
NM_001282507,NPIPA7,8,7,14745,1167,13578,1939.714286,145.875,11.63496144
NM_173614,NOMO2,31,30,62254,4284,57970,1932.333333,138.1935484,13.53174603
NM_001004060,NOMO2,32,31,62254,3954,58300,1880.645161,123.5625,14.74456247
NM_015161,ARL6IP1,6,5,9868,2270,7598,1519.6,378.3333333,3.347136564
NM_001030009,RPS15A,5,4,7381,482,6899,1724.75,96.4,14.31327801
NM_001019,RPS15A,5,4,7381,548,6833,1708.25,109.6,12.4689781
NM_016138,COQ7,6,5,12502,2667,9835,1967,444.5,3.687664042
NM_001190983,COQ7,6,5,12180,2616,9564,1912.8,436,3.655963303
NM_001034841,ITPRIPL2,1,0,7700,7700,NA,NA,7700,NA
NM_001256720,CLEC19A,5,4,25166,2499,22667,5666.75,499.8,9.070428171
NM_001261841,TMC5,22,21,81418,4893,76525,3644.047619,222.4090909,15.63968935
NM_024780,TMC5,18,17,42664,3704,38960,2291.764706,205.7777778,10.51835853
NM_001105249,TMC5,21,20,88379,4763,83616,4180.8,226.8095238,17.55532228
NM_001105248,TMC5,22,21,88379,4938,83441,3973.380952,224.4545455,16.89773188
NM_001199022,CCP110,15,14,29551,5459,24092,1720.857143,363.9333333,4.413262502
NM_014711,CCP110,15,14,29551,5516,24035,1716.785714,367.7333333,4.357324148
NM_001012991,KNOP1,5,4,11820,1955,9865,2466.25,391,5.046035806
NM_016235,GPRC5B,4,3,25860,2849,23011,7670.333333,712.25,8.076869077
NM_001278614,UMOD,12,11,19829,2589,17240,1567.272727,215.75,6.658941676
NM_003361,UMOD,11,10,19829,2489,17340,1734,226.2727273,6.966653274
NM_001502,GP2,11,10,17026,2433,14593,1459.3,221.1818182,5.997944924
NM_001007242,GP2,10,9,17026,1991,15035,1670.555556,199.1,7.551481668
NM_174924,PDILT,12,11,45543,2139,43404,3945.818182,178.25,20.29172511
NM_001008389,UMOD,11,10,19829,2426,17403,1740.3,220.5454545,7.173536686
NM_001007241,GP2,11,10,17026,2001,15025,1502.5,181.9090909,7.508745627
NM_001007240,GP2,12,11,17026,2443,14583,1325.727273,203.5833333,5.969300041
NM_001010845,ACSM2A,15,14,36134,2979,33155,2368.214286,198.6,11.12957368
NM_052956,ACSM1,13,12,68021,2064,65957,5496.416667,158.7692308,31.95591085
NM_202000,ACSM3,9,8,22328,1578,20750,2593.75,175.3333333,13.1495564
NM_080663,ERI2,11,10,26282,1490,24792,2479.2,135.4545455,16.63892617
NM_017736,THUMPD1,4,3,8212,4417,3795,1265,1104.25,0.859180439
NM_001142725,ERI2,9,8,10135,3512,6623,827.875,390.2222222,1.885820046
NM_005622,ACSM3,14,13,33169,2147,31022,2386.307692,153.3571429,14.4489986
NM_001128302,LYRM1,4,3,24255,1400,22855,7618.333333,350,16.325
NM_001128301,LYRM1,5,4,24255,1633,22622,5655.5,326.6,13.85303123
NM_173475,DCUN1D3,3,2,42167,2871,39296,19648,957,13.687217
NM_020424,LYRM1,4,3,24773,1564,23209,7736.333333,391,14.83951407
NM_003460,ZP2,19,18,14097,2285,11812,656.2222222,120.2631579,5.169365427
NM_020422,TMEM159,5,4,22027,1912,20115,5028.75,382.4,10.52039749
NM_001014444,CRYM,9,8,44567,1241,43326,5415.75,137.8888889,34.91216761
NM_145865,ANKS4B,2,1,18736,2908,15828,15828,1454,5.442916094
NM_001888,CRYM,10,9,44567,1516,43051,4783.444444,151.6,28.39775726
NM_130464,NPIPB3,12,11,23205,3632,19575,1779.545455,302.6666667,5.389592511
NM_005849,IGSF6,6,5,11384,1050,10334,2066.8,175,9.841904762
NM_003366,UQCRC2,14,13,30061,1688,28373,2182.538462,120.5714286,16.80864929
NM_173806,PDZD9,3,2,17247,1083,16164,8082,361,14.92520776
NM_001258035,POLR3E,20,19,37730,3677,34053,1792.263158,183.85,9.261082404
NM_001258033,POLR3E,21,20,37730,3689,34041,1702.05,175.6666667,9.227703985
NM_001802,CDR2,5,4,28683,2707,25976,6494,541.4,9.595862579
NM_018119,POLR3E,21,20,37730,3752,33978,1698.9,178.6666667,9.055970149
NM_001258036,POLR3E,20,19,37730,3625,34105,1795,181.25,9.408275862
NM_001258034,POLR3E,20,19,37730,3643,34087,1794.052632,182.15,9.356848751
NM_006043,HS3ST2,2,1,101801,1954,99847,99847,977,51.09877175
NM_020718,USP31,16,15,87865,10714,77151,5143.4,669.625,7.200952025
NM_019116,UBFD1,7,6,16850,4938,11912,1985.333333,705.4285714,2.412312677
NM_001083614,EARS2,9,8,35364,3971,31393,3924.125,441.2222222,7.905565349
NM_015044,GGA2,17,16,46954,5990,40964,2560.25,352.3529412,6.838731219
NM_032486,DCTN5,6,5,32383,7335,25048,5009.6,1222.5,3.414860259
NM_001199743,DCTN5,6,5,32383,7365,25018,5003.6,1227.5,3.396877122
NM_024675,PALB2,13,12,38197,4071,34126,2843.833333,313.1538462,8.382706952
NM_001199011,DCTN5,3,2,9784,690,9094,4547,230,13.17971014
NM_005030,PLK1,10,9,11489,2179,9310,1034.444444,217.9,4.272602111
NM_022097,CHP2,7,6,4326,2389,1937,322.8333333,341.2857143,0.810799498
NM_006539,CACNG3,4,3,106865,2707,104158,34719.33333,676.75,38.47728112
NM_032626,RBBP6,3,2,9816,1766,8050,4025,588.6666667,4.558323896
NM_006910,RBBP6,18,17,33277,6854,26423,1554.294118,380.7777778,3.855121097
NM_018703,RBBP6,17,16,33277,6751,26526,1657.875,397.1176471,3.929195675
NM_018054,ARHGAP17,19,18,95996,3294,92702,5150.111111,173.3684211,28.14268367
NM_001006634,ARHGAP17,20,19,95996,3529,92467,4866.684211,176.45,26.20204024
NM_001169,AQP8,6,5,11970,1314,10656,2131.2,219,8.109589041
NM_001012981,ZKSCAN2,7,6,21535,7133,14402,2400.333333,1019,2.019066312
NM_001145545,C16orf82,1,0,2270,2270,NA,NA,2270,NA
NM_024773,KDM8,8,7,18284,2479,15805,2257.857143,309.875,6.375554659
NM_001145348,KDM8,8,7,17795,2529,15266,2180.857143,316.125,6.036378015
NM_001257406,IL4R,10,9,50871,3566,47305,5256.111111,356.6,13.26556366
NM_001257997,IL4R,10,9,50871,3561,47310,5256.666667,356.1,13.28559393
NM_001257407,IL4R,11,10,50871,3811,47060,4706,346.4545455,12.34846497
NM_000418,IL4R,11,10,50871,3700,47171,4717.1,336.3636364,12.74891892
NM_181078,IL21R,9,8,49882,4858,45024,5628,539.7777778,9.268011527
NM_021798,IL21R,9,8,24786,4505,20281,2535.125,500.5555556,4.501886792
NM_181079,IL21R,10,9,49882,5000,44882,4986.888889,500,8.9764
NM_144675,GSG1L,6,5,100630,4544,96086,19217.2,757.3333333,21.14568662
NM_001199142,EIF3C,21,20,46874,3283,43591,2179.55,156.3333333,13.2777947
NM_001282524,NPIPB6,7,6,20344,1412,18932,3155.333333,201.7142857,13.40793201
NM_001099661,EIF3CL,21,20,24264,3074,21190,1059.5,146.3809524,6.893298634
NM_001037808,EIF3C,21,20,24308,3163,21145,1057.25,150.6190476,6.685109074
NM_001267574,EIF3C,20,19,24308,3251,21057,1108.263158,162.55,6.477083974
NM_003752,EIF3C,21,20,24308,3114,21194,1059.7,148.2857143,6.806037251
NM_001286478,EIF3C,21,20,24308,3084,21224,1061.2,146.8571429,6.881971466
NM_001286105,CLN3,13,12,14804,1730,13074,1089.5,133.0769231,7.557225434
NM_001042483,NUPR1,3,2,1835,915,920,460,305,1.005464481
NM_145659,IL27,5,4,7474,1049,6425,1606.25,209.8,6.124880839
NM_012385,NUPR1,3,2,1835,861,974,487,287,1.131242741
NM_018690,APOBR,4,3,4323,3796,527,175.6666667,949,0.138830348
NM_000086,CLN3,15,14,14805,1892,12913,922.3571429,126.1333333,6.825052854
NM_001042432,CLN3,16,15,15025,1929,13096,873.0666667,120.5625,6.78900985
NM_001286104,CLN3,15,14,15024,1855,13169,940.6428571,123.6666667,7.099191375
NM_001286109,CLN3,14,13,25431,1805,23626,1817.384615,128.9285714,13.08919668
NM_001286110,CLN3,14,13,14804,1811,12993,999.4615385,129.3571429,7.174489232
NM_001054,SULT1A2,8,7,5129,1059,4070,581.4285714,132.375,3.843248347
NM_001055,SULT1A1,8,7,4459,1248,3211,458.7142857,156,2.572916667
NM_177530,SULT1A1,8,7,3743,1404,2339,334.1428571,175.5,1.665954416
NM_177534,SULT1A1,7,6,3743,1602,2141,356.8333333,228.8571429,1.336454432
NM_177528,SULT1A2,8,7,4539,1332,3207,458.1428571,166.5,2.407657658
NM_177529,SULT1A1,8,7,4459,1279,3180,454.2857143,159.875,2.486317435
NM_177536,SULT1A1,6,5,18001,1283,16718,3343.6,213.8333333,13.03039751
NM_001099661,EIF3CL,21,20,24270,3071,21199,1059.95,146.2380952,6.902963204
NM_001037808,EIF3C,21,20,24314,3160,21154,1057.7,150.4761905,6.694303797
NM_001267574,EIF3C,20,19,24314,3248,21066,1108.736842,162.4,6.485837438
NM_003752,EIF3C,21,20,24314,3111,21203,1060.15,148.1428571,6.81549341
NM_001286478,EIF3C,21,20,24314,3081,21233,1061.65,146.7142857,6.891593638
NM_001287250,NPIPB9,7,6,20390,1412,18978,3163,201.7142857,13.44050992
NM_001287251,NPIPB9,8,7,20390,1499,18891,2698.714286,187.375,12.6024016
NM_024816,RABEP2,13,12,20792,2293,18499,1541.583333,176.3846154,8.067597034
NM_003321,TUFM,10,9,3999,2081,1918,213.1111111,208.1,0.921672273
NM_001178098,CD19,15,14,7410,1973,5437,388.3571429,131.5333333,2.755701977
NM_173201,ATP2A1,22,21,26023,3516,22507,1071.761905,159.8181818,6.401308305
NM_001770,CD19,15,14,7410,1970,5440,388.5714286,131.3333333,2.76142132
NM_001145812,SH2B1,10,9,10240,3145,7095,788.3333333,314.5,2.255961844
NM_001145797,SH2B1,10,9,10458,3099,7359,817.6666667,309.9,2.37463698
NM_001145795,SH2B1,9,8,10458,2945,7513,939.125,327.2222222,2.551103565
NM_001145796,SH2B1,10,9,10458,3046,7412,823.5555556,304.6,2.43335522
NM_015503,SH2B1,9,8,10222,4875,5347,668.375,541.6666667,1.096820513
NM_004320,ATP2A1,23,22,26023,3559,22464,1021.090909,154.7391304,6.311885361
NM_001286075,ATP2A1,21,20,24468,3206,21262,1063.1,152.6666667,6.631940112
NM_032038,SPNS1,12,11,9775,2225,7550,686.3636364,185.4166667,3.393258427
NM_014387,LAT,11,10,5719,1754,3965,396.5,159.4545455,2.26054732
NM_001142451,SPNS1,11,10,9775,2068,7707,770.7,188,3.726789168
NM_001142450,SPNS1,13,12,9775,2139,7636,636.3333333,164.5384615,3.569892473
NM_001142449,SPNS1,10,9,9775,2001,7774,863.7777778,200.1,3.885057471
NM_001142448,SPNS1,13,12,9775,1989,7786,648.8333333,153,3.914529915
NM_001014988,LAT,12,11,5719,1665,4054,368.5454545,138.75,2.434834835
NM_001014987,LAT,12,11,5719,1668,4051,368.2727273,139,2.428657074
NM_001014989,LAT,13,12,5959,1461,4498,374.8333333,112.3846154,3.07871321
NM_001031827,BOLA2,3,2,1373,1015,358,179,338.3333333,0.35270936
NM_001039182,BOLA2B,3,2,1373,1015,358,179,338.3333333,0.35270936
NM_024044,SLX1B,6,5,3725,1176,2549,509.8,196,2.167517007
NM_177552,SULT1A3,8,7,5096,1405,3691,527.2857143,175.625,2.627046263
NM_001014999,SLX1A,6,5,3725,1176,2549,509.8,196,2.167517007
NM_001017390,SULT1A4,8,7,5096,1405,3691,527.2857143,175.625,2.627046263
NM_001015000,SLX1A,5,4,3725,833,2892,723,166.6,3.471788715
NM_178044,SLX1B,5,4,3725,833,2892,723,166.6,3.471788715
NM_001030288,SPN,2,1,7554,6941,613,613,3470.5,0.088315805
NM_014298,QPRT,4,3,18875,1558,17317,5772.333333,389.5,11.11489089
NM_003123,SPN,2,1,7285,6908,377,377,3454,0.054574406
NM_001276276,MAZ,3,2,4648,1639,3009,1504.5,546.3333333,1.835875534
NM_001276275,MAZ,6,5,5089,2372,2717,543.4,395.3333333,1.14544688
NM_001042539,MAZ,6,5,4648,2782,1866,373.2,463.6666667,0.670740474
NM_001256443,PRRT2,2,1,3795,3158,637,637,1579,0.201709943
NM_001256442,PRRT2,3,2,3795,2732,1063,531.5,910.6666667,0.38909224
NM_007317,KIF22,14,13,14674,2134,12540,964.6153846,152.4285714,5.87628866
NM_006319,CDIPT,6,5,4934,1912,3022,604.4,318.6666667,1.580543933
NM_152338,ZG16,4,3,3410,1811,1599,533,452.75,0.882937604
NM_002383,MAZ,5,4,4648,2556,2092,523,511.2,0.818466354
NM_001256270,KIF22,14,13,14419,2271,12148,934.4615385,162.2142857,5.349185381
NM_017458,MVP,15,14,27647,2940,24707,1764.785714,196,8.403741497
NM_001256269,KIF22,15,14,14674,2184,12490,892.1428571,145.6,5.718864469
NM_024516,PAGR1,3,2,6290,3828,2462,1231,1276,0.643155695
NM_005115,MVP,15,14,27647,2899,24748,1767.714286,193.2666667,8.536736806
NM_175900,C16orf54,2,1,3556,2598,958,958,1299,0.368745189
NM_145239,PRRT2,4,3,3795,2571,1224,408,642.75,0.476079347
NM_001286586,CDIPT,6,5,4934,1827,3107,621.4,304.5,1.70060208
NM_001286585,CDIPT,5,4,4934,1776,3158,789.5,355.2,1.778153153
NM_001252043,TAOK2,17,16,14540,4628,9912,619.5,272.2352941,2.141745895
NM_001197323,HIRIP3,6,5,3777,2116,1661,332.2,352.6666667,0.784971645
NM_003609,HIRIP3,7,6,3777,3055,722,120.3333333,436.4285714,0.236333879
NM_194280,TMEM219,6,5,11024,1002,10022,2004.4,167,10.00199601
NM_181718,ASPHD1,3,2,5232,1481,3751,1875.5,493.6666667,2.532748143
NM_178863,KCTD13,6,5,19890,1723,18167,3633.4,287.1666667,10.54381892
NM_016151,TAOK2,16,15,14540,4966,9574,638.2666667,310.375,1.927909787
NM_001083613,TMEM219,6,5,11024,1005,10019,2003.8,167.5,9.969154229
NM_004783,TAOK2,19,18,18396,4679,13717,762.0555556,246.2631579,2.931609318
NM_002720,PPP4C,9,8,9313,1340,7973,996.625,148.8888889,5.95
NM_001282068,DOC2A,11,10,6836,2043,4793,479.3,185.7272727,2.346059716
NM_001282062,DOC2A,12,11,8084,2117,5967,542.4545455,176.4166667,2.818611242
NM_003586,DOC2A,11,10,5568,2077,3491,349.1,188.8181818,1.6807896
NM_024307,GDPD3,10,9,8749,1108,7641,849,110.8,6.896209386
NM_001282063,DOC2A,12,11,5909,2079,3830,348.1818182,173.25,1.842231842
NM_031478,FAM57B,5,4,6440,1924,4516,1129,384.8,2.347193347
NM_031477,YPEL3,4,3,3888,1592,2296,765.3333333,398,1.442211055
NM_001040056,MAPK3,7,6,6474,1181,5293,882.1666667,168.7142857,4.481795089
NM_000034,ALDOA,14,13,17332,2404,14928,1148.307692,171.7142857,6.209650582
NM_001127617,ALDOA,9,8,5925,1621,4304,538,180.1111111,2.655151141
NM_002746,MAPK3,9,8,9206,1885,7321,915.125,209.4444444,3.883819629
NM_001243177,ALDOA,10,9,4749,1743,3006,334,174.3,1.724612737
NM_001109659,C16orf92,4,3,1370,819,551,183.6666667,204.75,0.672771673
NM_001109660,C16orf92,4,3,1370,899,471,157,224.75,0.523915462
NM_001145524,YPEL3,5,4,3902,945,2957,739.25,189,3.129100529
NM_001109891,MAPK3,8,7,9206,1752,7454,1064.857143,219,4.25456621
NM_004608,TBX6,9,8,6092,1811,4281,535.125,201.2222222,2.363887355
NM_184043,ALDOA,9,8,6143,1560,4583,572.875,173.3333333,2.937820513
NM_184041,ALDOA,9,8,4749,1588,3161,395.125,176.4444444,1.990554156
NM_001031827,BOLA2,3,2,1373,1015,358,179,338.3333333,0.35270936
NM_001039182,BOLA2B,3,2,1373,1015,358,179,338.3333333,0.35270936
NM_024044,SLX1B,6,5,3725,1176,2549,509.8,196,2.167517007
NM_001193333,CORO1A,12,11,5668,1945,3723,338.4545455,162.0833333,1.914138817
NM_177552,SULT1A3,8,7,5103,1409,3694,527.7142857,176.125,2.62171753
NM_007074,CORO1A,11,10,5668,1826,3842,384.2,166,2.104052574
NM_001014999,SLX1A,6,5,3725,1176,2549,509.8,196,2.167517007
NM_001017390,SULT1A4,8,7,5103,1409,3694,527.7142857,176.125,2.62171753
NM_001015000,SLX1A,5,4,3725,833,2892,723,166.6,3.471788715
NM_178044,SLX1B,5,4,3725,833,2892,723,166.6,3.471788715
NM_013292,MYLPF,7,6,3189,662,2527,421.1666667,94.57142857,3.817220544
NM_052838,Sep-01,12,11,4719,1604,3115,283.1818182,133.6666667,1.94201995
NM_006110,CD2BP2,7,6,4597,3428,1169,194.8333333,489.7142857,0.341015169
NM_001243646,CD2BP2,6,5,4170,3504,666,133.2,584,0.190068493
NM_015527,TBC1D10B,9,8,13102,3297,9805,1225.625,366.3333333,2.973915681
NM_002209,ITGAL,31,30,50525,5240,45285,1509.5,169.0322581,8.642175573
NM_012248,SEPHS2,1,0,2352,2352,NA,NA,2352,NA
NM_024096,DCTPP1,3,2,6356,1123,5233,2616.5,374.3333333,4.659839715
NM_016643,ZNF771,3,2,11183,1458,9725,4862.5,486,6.670096022
NM_024671,ZNF768,2,1,2590,2317,273,273,1158.5,0.117824773
NM_001142305,ZNF771,3,2,11183,1445,9738,4869,481.6666667,6.739100346
NM_001114380,ITGAL,29,28,50525,4986,45539,1626.392857,171.9310345,9.133373446
NM_138447,ZNF689,3,2,7830,3557,4273,2136.5,1185.666667,1.201293225
NM_145271,ZNF688,3,2,2711,1830,881,440.5,610,0.481420765
NM_001172679,ZNF764,3,2,4559,2796,1763,881.5,932,0.630543634
NM_024031,PRR14,12,11,5495,2130,3365,305.9090909,177.5,1.579812207
NM_023931,ZNF747,2,1,3417,2373,1044,1044,1186.5,0.439949431
NM_152458,ZNF785,3,2,5100,3268,1832,916,1089.333333,0.560587515
NM_033410,ZNF764,3,2,4559,2799,1760,880,933,0.628795999
NM_001024683,ZNF688,3,2,2711,1142,1569,784.5,380.6666667,1.373905429
NM_001207033,RNF40,20,19,14697,6036,8661,455.8421053,301.8,1.434890656
NM_006662,SRCAP,34,33,40990,10508,30482,923.6969697,309.0588235,2.900837457
NM_001256829,LOC100862671,3,2,5007,2103,2904,1452,701,1.380884451
NM_014771,RNF40,20,19,14697,6039,8658,455.6842105,301.95,1.433681073
NM_001207034,RNF40,18,17,14697,5737,8960,527.0588235,318.7222222,1.561791877
NM_001014979,C16orf93,9,8,4823,1554,3269,408.625,172.6666667,2.103603604
NM_000294,PHKG2,10,9,12879,5520,7359,817.6666667,552,1.333152174
NM_001195620,C16orf93,4,3,2209,1216,993,331,304,0.816611842
NM_001080417,ZNF629,3,2,8755,6090,2665,1332.5,2030,0.437602627
NM_001172432,PHKG2,11,10,12879,2362,10517,1051.7,214.7272727,4.452582557
NM_001105079,FBRS,12,11,6355,2823,3532,321.0909091,235.25,1.251151258
NM_001256932,LOC730183,2,1,787,584,203,203,292,0.34760274
NM_001286572,RNF40,20,19,14020,5400,8620,453.6842105,270,1.596296296
NM_001330,CTF1,3,2,6955,1667,5288,2644,555.6666667,3.172165567
NM_001142544,CTF1,3,2,6955,1664,5291,2645.5,554.6666667,3.1796875
NM_001286526,BCL7C,6,5,60263,2000,58263,11652.6,333.3333333,29.1315
NM_004765,BCL7C,6,5,6509,1088,5421,1084.2,181.3333333,4.982536765
NM_025193,HSD3B7,7,6,3956,2192,1764,294,313.1428571,0.804744526
NM_001142778,HSD3B7,6,5,3956,2028,1928,385.6,338,0.950690335
NM_004604,STX4,11,10,6678,1491,5187,518.7,135.5454545,3.478873239
NM_001282351,FBXL19,11,10,25730,3675,22055,2205.5,334.0909091,6.001360544
NM_001142777,HSD3B7,6,5,3956,2221,1735,347,370.1666667,0.781179649
NM_152288,ORAI3,2,1,5856,2190,3666,3666,1095,1.673972603
NM_001272095,STX4,10,9,6678,1626,5052,561.3333333,162.6,3.10701107
NM_001272096,STX4,12,11,7074,1514,5560,505.4545455,126.1666667,3.672391017
NM_001099784,FBXL19,11,10,24210,3807,20403,2040.3,346.0909091,5.359338061
NM_052874,STX1B,10,9,21254,4554,16700,1855.555556,455.4,3.667105841
NM_014712,SETD1A,19,18,27368,6466,20902,1161.222222,340.3157895,3.232601299
NM_024706,ZNF668,3,2,13479,2772,10707,5353.5,924,3.862554113
NM_001172670,ZNF668,3,2,4247,2399,1848,924,799.6666667,0.770320967
NM_001122957,BCKDK,11,10,4499,2232,2267,226.7,202.9090909,1.015681004
NM_024006,VKORC1,3,2,4103,1001,3102,1551,333.6666667,3.098901099
NM_182958,KAT8,10,9,13731,1833,11898,1322,183.3,6.490998363
NM_001039503,PRSS53,11,10,5387,2039,3348,334.8,185.3636364,1.641981363
NM_032188,KAT8,11,10,13731,1540,12191,1219.1,140,7.916233766
NM_001172669,ZNF668,4,3,4247,2514,1733,577.6666667,628.5,0.689339698
NM_173502,PRSS36,15,14,11170,2854,8316,594,190.2666667,2.913805186
NM_002773,PRSS8,6,5,4399,1946,2453,490.6,324.3333333,1.26053443
NM_001258291,PRSS36,14,13,11170,2544,8626,663.5384615,181.7142857,3.39072327
NM_001258290,PRSS36,15,14,11170,2839,8331,595.0714286,189.2666667,2.934483973
NM_001271926,BCKDK,10,9,4499,2141,2358,262,214.1,1.101354507
NM_014699,ZNF646,3,2,9092,6211,2881,1440.5,2070.333333,0.463854452
NM_001172668,ZNF668,3,2,12656,2868,9788,4894,956,3.412831241
NM_005881,BCKDK,12,11,4499,2140,2359,214.4545455,178.3333333,1.102336449
NM_206824,VKORC1,2,1,4103,890,3213,3213,445,3.61011236
NM_152901,PYDC1,2,1,1114,530,584,584,265,1.101886792
NM_145182,PYCARD,2,1,1292,718,574,574,359,0.799442897
NM_013258,PYCARD,3,2,1292,776,516,258,258.6666667,0.664948454
NM_001008274,TRIM72,7,6,11170,2159,9011,1501.833333,308.4285714,4.173691524
NM_000887,ITGAX,30,29,27865,4733,23132,797.6551724,157.7666667,4.887386436
NM_001286375,ITGAX,31,30,27865,4163,23702,790.0666667,134.2903226,5.693490271
NM_001136509,ZNF843,2,1,7465,2015,5450,5450,1007.5,2.70471464
NM_005353,ITGAD,30,29,33195,3942,29253,1008.724138,131.4,7.420852359
NM_005205,COX6A2,3,2,699,443,256,128,147.6666667,0.577878104
NM_024742,ARMC5,4,3,8173,4677,3496,1165.333333,1169.25,0.747487706
NM_001042454,TGFB1I1,11,10,5807,1815,3992,399.2,165,2.199449036
NM_003041,SLC5A2,14,13,7654,2287,5367,412.8461538,163.3571429,2.346742457
NM_016633,AHSP,3,2,923,509,414,207,169.6666667,0.813359528
NM_022744,C16orf58,13,12,18946,2826,16120,1343.333333,217.3846154,5.704175513
NM_001105247,ARMC5,6,5,8173,3621,4552,910.4,603.5,1.257111295
NM_001164719,TGFB1I1,11,10,5754,1784,3970,397,162.1818182,2.225336323
NM_015927,TGFB1I1,11,10,4757,1814,2943,294.3,164.9090909,1.622381477
NM_001288767,ARMC5,8,7,8896,3503,5393,770.4285714,437.875,1.539537539
NM_001130913,ZNF720,5,4,48338,2779,45559,11389.75,555.8,16.39402663
NM_003414,ZNF267,4,3,43552,3272,40280,13426.66667,818,12.31051345
NM_001265588,ZNF267,5,4,43552,3424,40128,10032,684.8,11.71962617
NM_001243722,TP53TG3D,2,1,2595,1421,1174,1174,710.5,0.826178747
NM_016212,TP53TG3,2,1,2601,1431,1170,1170,715.5,0.817610063
NM_001205259,TP53TG3C,2,1,1976,806,1170,1170,403,1.451612903
NM_001205265,TP53TG3B,2,1,2601,1808,793,793,904,0.438606195
NM_001205260,TP53TG3C,2,1,1976,1183,793,793,591.5,0.67032967
NM_001267813,TP53TG3,2,1,2601,1808,793,793,904,0.438606195
NM_001099687,TP53TG3B,2,1,2601,1431,1170,1170,715.5,0.817610063
NM_016212,TP53TG3,2,1,2596,1426,1170,1170,713,0.820476858
NM_016212,TP53TG3,2,1,2601,1431,1170,1170,715.5,0.817610063
NM_001205259,TP53TG3C,2,1,1976,806,1170,1170,403,1.451612903
NM_001205265,TP53TG3B,2,1,2596,1803,793,793,901.5,0.439822518
NM_001205265,TP53TG3B,2,1,2601,1808,793,793,904,0.438606195
NM_001205260,TP53TG3C,2,1,1976,1183,793,793,591.5,0.67032967
NM_001205260,TP53TG3C,2,1,1976,1183,793,793,591.5,0.67032967
NM_001205259,TP53TG3C,2,1,1976,806,1170,1170,403,1.451612903
NM_001267813,TP53TG3,2,1,2596,1803,793,793,901.5,0.439822518
NM_001267813,TP53TG3,2,1,2601,1808,793,793,904,0.438606195
NM_001099687,TP53TG3B,2,1,2596,1426,1170,1170,713,0.820476858
NM_001099687,TP53TG3B,2,1,2601,1431,1170,1170,715.5,0.817610063
NM_024745,SHCBP1,13,12,40845,3245,37600,3133.333333,249.6153846,11.58705701
NM_014321,ORC6,7,6,8750,1635,7115,1185.833333,233.5714286,4.351681957
NM_018206,VPS35,17,16,29557,3302,26255,1640.9375,194.2352941,7.951241672
NM_182493,MYLK3,13,12,46029,8011,38018,3168.166667,616.2307692,4.745724629
NM_001001436,C16orf87,4,3,29117,1387,27730,9243.333333,346.75,19.99279019
NM_005880,DNAJA2,9,8,18353,3057,15296,1912,339.6666667,5.003598299
NM_001201477,NETO2,9,8,62507,3680,58827,7353.375,408.8888889,15.98559783
NM_018092,NETO2,9,8,62507,3701,58806,7350.75,411.2222222,15.88921913
NM_033226,ABCC12,29,28,63799,5197,58602,2092.928571,179.2068966,11.27612084
NM_001006610,SIAH1,2,1,5340,2385,2955,2955,1192.5,1.238993711
NM_003031,SIAH1,2,1,24777,2005,22772,22772,1002.5,11.35760599
NM_004352,CBLN1,3,2,3915,2437,1478,739,812.3333333,0.606483381
NM_182922,HEATR3,15,14,39496,2623,36873,2633.785714,174.8666667,14.05756767
NM_001173984,BRD7,17,16,49918,2329,47589,2974.3125,137,20.43323315
NM_013263,BRD7,17,16,49918,2326,47592,2974.5,136.8235294,20.46087704
NM_182854,SNX20,4,3,8380,1559,6821,2273.666667,389.75,4.375240539
NM_001144972,SNX20,4,3,15055,2201,12854,4284.666667,550.25,5.840072694
NM_153337,SNX20,4,3,15055,3308,11747,3915.666667,827,3.551088271
NM_001042355,CYLD,18,17,59887,8585,51302,3017.764706,476.9444444,5.975771695
NM_022162,NOD2,12,11,35939,4497,31442,2858.363636,374.75,6.991772293
NM_015247,CYLD,20,19,59887,8733,51154,2692.315789,436.65,5.857551815
NM_001042412,CYLD,18,17,59819,8609,51210,3012.352941,478.2777778,5.948426066
NM_002968,SALL1,3,2,15299,5146,10153,5076.5,1715.333333,1.972988729
NM_001127892,SALL1,3,2,14624,5256,9368,4684,1752,1.782343988
NM_001242473,C16orf97,6,5,47585,454,47131,9426.2,75.66666667,103.8127753
NM_001207030,LOC643802,2,1,1769,1346,423,423,673,0.314264487
NM_001012398,AKTIP,10,9,11980,2232,9748,1083.111111,223.2,4.367383513
NM_022476,AKTIP,10,9,11980,2203,9777,1086.333333,220.3,4.438039038
NM_015272,RPGRIP1L,27,26,103955,6209,97746,3759.461538,229.962963,15.74263166
NM_001127897,RPGRIP1L,25,24,103955,5967,97988,4082.833333,238.68,16.42165242
NM_024336,IRX3,4,3,3168,2312,856,285.3333333,578,0.370242215
NM_005853,IRX5,3,2,3286,2065,1221,610.5,688.3333333,0.591283293
NM_001252197,IRX5,3,2,3286,2062,1224,612,687.3333333,0.593598448
NM_024335,IRX6,6,5,6203,2335,3868,773.6,389.1666667,1.656531049
NM_001127891,MMP2,13,12,25114,3392,21722,1810.166667,260.9230769,6.403891509
NM_004530,MMP2,13,12,27507,3539,23968,1997.333333,272.2307692,6.772534614
NM_032330,CAPNS2,1,0,1010,1010,NA,NA,1010,NA
NM_001143685,CES5A,13,12,29218,2187,27031,2252.583333,168.2307692,12.35985368
NM_145024,CES5A,12,11,29218,2036,27182,2471.090909,169.6666667,13.35068762
NM_001266,CES1,14,13,30313,2020,28293,2176.384615,144.2857143,14.00643564
NM_001025195,CES1,14,13,30313,2026,28287,2175.923077,144.7142857,13.96199408
NM_001025194,CES1,14,13,30313,2023,28290,2176.153846,144.5,13.98418191
NM_007006,NUDT21,7,6,22215,4414,17801,2966.833333,630.5714286,4.032850023
NM_001144,AMFR,14,13,64088,3614,60474,4651.846154,258.1428571,16.73325955
NM_031885,BBS2,17,16,35751,2831,32920,2057.5,166.5294118,11.62839986
NM_032935,MT4,3,2,3910,297,3613,1806.5,99,12.16498316
NM_005950,MT1G,3,2,1326,399,927,463.5,133,2.323308271
NM_005947,MT1B,3,2,1307,383,924,462,127.6666667,2.412532637
NM_005951,MT1H,3,2,1317,400,917,458.5,133.3333333,2.2925
NM_005952,MT1X,3,2,1728,407,1321,660.5,135.6666667,3.245700246
NM_005949,MT1F,3,2,1362,444,918,459,148,2.067567568
NM_005946,MT1A,3,2,1423,399,1024,512,133,2.56641604
NM_005954,MT3,3,2,1735,585,1150,575,195,1.965811966
NM_005953,MT2A,3,2,933,422,511,255.5,140.6666667,1.210900474
NM_176870,MT1M,3,2,1366,443,923,461.5,147.6666667,2.083521445
NM_175617,MT1E,3,2,1441,509,932,466,169.6666667,1.831041257
NM_014669,NUP93,22,21,114846,2943,111903,5328.714286,133.7727273,38.02344546
NM_001242796,NUP93,20,19,61450,2895,58555,3081.842105,144.75,20.22625216
NM_001242795,NUP93,20,19,63159,2946,60213,3169.105263,147.3,20.4389002
NM_001272103,HERPUD1,8,7,11793,1773,10020,1431.428571,221.625,5.65143824
NM_000339,SLC12A3,26,25,50645,5593,45052,1802.08,215.1153846,8.055068836
NM_014685,HERPUD1,8,7,11793,1930,9863,1409,241.25,5.110362694
NM_001126108,SLC12A3,26,25,50645,5566,45079,1803.16,214.0769231,8.098993891
NM_001126107,SLC12A3,26,25,50645,5590,45055,1802.2,215,8.059928444
NM_001010989,HERPUD1,8,7,11793,1927,9866,1409.428571,240.875,5.119875454
NM_032206,NLRC5,48,47,66452,6772,59680,1269.787234,141.0833333,8.812758417
NM_024946,FAM192A,7,6,33600,2855,30745,5124.166667,407.8571429,10.76882662
NM_133368,RSPRY1,15,14,52708,2084,50624,3616,138.9333333,24.29174664
NM_002990,CCL22,3,2,7409,2921,4488,2244,973.6666667,1.536460116
NM_012106,ARL2BP,6,5,8509,2106,6403,1280.6,351,3.040360874
NM_015993,PLLP,4,3,28577,1501,27076,9025.333333,375.25,18.03864091
NM_032940,POLR2C,9,8,9372,1813,7559,944.875,201.4444444,4.169332598
NM_020312,COQ9,9,8,13852,1698,12154,1519.25,188.6666667,7.157832744
NM_018110,DOK4,9,8,14517,2759,11758,1469.75,306.5555556,4.261689018
NM_020313,CIAPIN1,9,8,19284,2114,17170,2146.25,234.8888889,8.122043519
NM_002987,CCL17,4,3,11297,619,10678,3559.333333,154.75,17.25040388
NM_033212,CCDC102A,9,8,24389,2438,21951,2743.875,270.8888889,9.00369155
NM_153837,GPR114,12,11,34501,3772,30729,2793.545455,314.3333333,8.146606575
NM_005886,KATNB1,20,19,21504,2666,18838,991.4736842,133.3,7.066016504
NM_032269,CCDC135,18,17,36656,2929,33727,1983.941176,162.7222222,11.51485149
NM_001289162,CCDC135,19,18,36656,3061,33595,1866.388889,161.1052632,10.97517151
NM_001289163,CCDC135,17,16,36656,2733,33923,2120.1875,160.7647059,12.41236736
NM_001145774,GPR56,15,14,25739,4058,21681,1548.642857,270.5333333,5.342779694
NM_170776,GPR97,12,11,21135,2682,18453,1677.545455,223.5,6.880313199
NM_001278081,LOC388282,5,4,6284,1294,4992,1248,258.8,3.857805255
NM_199456,TEPP,8,7,11680,1548,10132,1447.428571,193.5,6.545219638
NM_199046,TEPP,8,7,11680,1629,10051,1435.857143,203.625,6.170042971
NM_001195302,USB1,6,5,20252,2239,18013,3602.6,373.1666667,8.045109424
NM_001135639,CNGB1,13,12,16442,1645,14797,1233.083333,126.5384615,8.995136778
NM_020807,ZNF319,2,1,5191,4222,969,969,2111,0.22951208
NM_001204911,USB1,4,3,12199,3117,9082,3027.333333,779.25,2.91369907
NM_024598,USB1,7,6,20252,2294,17958,2993,327.7142857,7.828247602
NM_013242,C16orf80,6,5,15801,1297,14504,2900.8,216.1666667,11.18272938
NM_014157,CCDC113,9,8,33896,5275,28621,3577.625,586.1111111,5.425781991
NM_001142302,CCDC113,8,7,33896,5112,28784,4112,639,5.630672926
NM_001126129,GINS3,4,3,13752,2395,11357,3785.666667,598.75,4.741962422
NM_022770,GINS3,3,2,13752,2277,11475,5737.5,759,5.039525692
NM_001126130,GINS3,2,1,13752,2042,11710,11710,1021,5.734573947
NM_024860,SETD6,9,8,5050,2916,2134,266.75,324,0.731824417
NM_001160305,SETD6,8,7,5050,2987,2063,294.7142857,373.375,0.690659525
NM_001242836,NDRG4,14,13,13478,3183,10295,791.9230769,227.3571429,3.234370091
NM_001242835,NDRG4,15,14,13478,3223,10255,732.5,214.8666667,3.181818182
NM_001242834,NDRG4,14,13,13478,3237,10241,787.7692308,231.2142857,3.16373185
NM_001242833,NDRG4,15,14,13478,3274,10204,728.8571429,218.2666667,3.116676848
NM_001130487,NDRG4,16,15,49531,3576,45955,3063.666667,223.5,12.85095078
NM_020465,NDRG4,16,15,49976,3351,46625,3108.333333,209.4375,13.91375709
NM_022910,NDRG4,16,15,48799,3448,45351,3023.4,215.5,13.15284223
NM_018231,SLC38A7,12,11,18378,2785,15593,1417.545455,232.0833333,5.598922801
NM_002080,GOT2,10,9,27228,2472,24756,2750.666667,247.2,10.01456311
NM_001286220,GOT2,9,8,27228,2342,24886,3110.75,260.2222222,10.62596072
NM_001282301,LOC729159,1,0,1310,1310,NA,NA,1310,NA
NM_001795,CDH5,12,11,38166,4140,34026,3093.272727,345,8.21884058
NM_001272050,TK2,10,9,41824,4898,36926,4102.888889,489.8,7.538995508
NM_001172645,TK2,9,8,42411,5069,37342,4667.75,563.2222222,7.366739002
NM_001172643,TK2,10,9,42290,4688,37602,4178,468.8,8.020904437
NM_001271935,TK2,8,7,42290,4517,37773,5396.142857,564.625,8.362408678
NM_004614,TK2,10,9,42411,5124,37287,4143,512.4,7.276932084
NM_001172644,TK2,9,8,42411,5048,37363,4670.375,560.8888889,7.401545166
NM_001271934,TK2,11,10,42411,5220,37191,3719.1,474.5454545,7.124712644
NM_001197225,BEAN1,5,4,66234,1157,65077,16269.25,231.4,56.24632671
NM_001197224,BEAN1,5,4,66234,1161,65073,16268.25,232.2,56.04909561
NM_001178020,BEAN1,5,4,55547,2919,52628,13157,583.8,18.02946214
NM_001136106,BEAN1,4,3,55547,2811,52736,17578.66667,702.75,18.76058342
NM_016951,CKLF,4,3,13726,892,12834,4278,223,14.38789238
NM_001202509,CKLF-CMTM1,3,2,26574,638,25936,12968,212.6666667,40.65203762
NM_001204098,CKLF-CMTM1,4,3,26574,719,25855,8618.333333,179.75,35.9596662
NM_001204099,CKLF-CMTM1,4,3,26574,798,25776,8592,199.5,32.30075188
NM_001040138,CKLF,4,3,13726,695,13031,4343.666667,173.75,18.74964029
NM_001199317,CMTM2,3,2,8828,906,7922,3961,302,8.74392936
NM_016326,CKLF,2,1,13726,635,13091,13091,317.5,20.61574803
NM_181641,CKLF,3,2,13726,795,12931,6465.5,265,16.26540881
NM_181640,CKLF,3,2,13726,732,12994,6497,244,17.75136612
NM_181269,CMTM1,4,3,12746,771,11975,3991.666667,192.75,15.53177691
NM_181270,CMTM1,4,3,12746,755,11991,3997,188.75,15.88211921
NM_181268,CMTM1,4,3,12690,1050,11640,3880,262.5,11.08571429
NM_144601,CMTM3,6,5,9569,2116,7453,1490.6,352.6666667,3.52221172
NM_144673,CMTM2,4,3,8828,1066,7762,2587.333333,266.5,7.281425891
NM_052999,CMTM1,4,3,12690,1066,11624,3874.666667,266.5,10.9043152
NM_181553,CMTM3,5,4,9230,1951,7279,1819.75,390.2,3.730907227
NM_181296,CMTM1,2,1,12746,495,12251,12251,247.5,24.74949495
NM_181283,CMTM1,3,2,12746,595,12151,6075.5,198.3333333,20.42184874
NM_181272,CMTM1,3,2,12746,611,12135,6067.5,203.6666667,19.8608838
NM_181271,CMTM1,3,2,12746,629,12117,6058.5,209.6666667,19.26391097
NM_006141,DYNC1LI2,13,12,30728,4349,26379,2198.25,334.5384615,6.065532306
NM_001136505,CCDC79,19,18,46646,2465,44181,2454.5,129.7368421,17.92332657
NM_001286157,DYNC1LI2,12,11,30728,4117,26611,2419.181818,343.0833333,6.463687151
NM_016062,FAM96B,5,4,2370,704,1666,416.5,140.8,2.366477273
NM_001204746,CDH16,17,16,10864,2680,8184,511.5,157.6470588,3.053731343
NM_001204745,CDH16,18,17,10864,2855,8009,471.1176471,158.6111111,2.80525394
NM_001204744,CDH16,18,17,10864,2906,7958,468.1176471,161.4444444,2.738472127
NM_005182,CA7,7,6,9769,1559,8210,1368.333333,222.7142857,5.26619628
NM_020786,PDP2,2,1,10621,7032,3589,3589,3516,0.510381115
NM_001014435,CA7,7,6,9210,1707,7503,1250.5,243.8571429,4.39543058
NM_001128850,RRAD,5,4,3859,1481,2378,594.5,296.2,1.605671843
NM_004062,CDH16,18,17,10864,2972,7892,464.2352941,165.1111111,2.655450875
NM_004165,RRAD,5,4,3859,1472,2387,596.75,294.4,1.621603261
NM_001185177,CES3,13,12,13922,3899,10023,835.25,299.9230769,2.570659143
NM_173815,CES4A,12,11,21169,2294,18875,1715.909091,191.1666667,8.227986051
NM_024922,CES3,13,12,13922,3908,10014,834.5,300.6153846,2.562436029
NM_001190202,CES4A,10,9,9245,1985,7260,806.6666667,198.5,3.65743073
NM_001190201,CES4A,12,11,9245,2177,7068,642.5454545,181.4166667,3.246669729
NM_001185176,CES3,6,5,7676,3185,4491,898.2,530.8333333,1.410047096
NM_001276319,NOL3,6,5,5242,1893,3349,669.8,315.5,1.769149498
NM_001276311,NOL3,4,3,1886,1392,494,164.6666667,348,0.354885057
NM_001276309,NOL3,4,3,5242,1400,3842,1280.666667,350,2.744285714
NM_001276307,NOL3,6,5,5242,1542,3700,740,257,2.399481193
NM_001040715,KIAA0895L,7,6,8380,3407,4973,828.8333333,486.7142857,1.459641914
NM_024712,ELMO3,20,19,4901,2532,2369,124.6842105,126.6,0.935624013
NM_025187,C16orf70,16,15,38529,2857,35672,2378.133333,178.5625,12.48582429
NM_001040667,HSF4,15,14,6562,2619,3943,281.6428571,174.6,1.505536464
NM_001538,HSF4,15,14,6562,2529,4033,288.0714286,168.6,1.594701463
NM_178516,EXOC3L1,14,13,5827,2511,3316,255.0769231,179.3571429,1.320589407
NM_001950,E2F4,10,9,6755,2110,4645,516.1111111,211,2.201421801
NM_018378,FBXL8,3,2,4188,1602,2586,1293,534,1.61423221
NM_033309,B3GNT9,2,1,2899,2707,192,192,1353.5,0.070927226
NM_001276312,NOL3,6,5,5242,1893,3349,669.8,315.5,1.769149498
NM_001185057,NOL3,4,3,1886,1506,380,126.6666667,376.5,0.252324037
NM_003946,NOL3,4,3,1886,1516,370,123.3333333,379,0.244063325
NM_003789,TRADD,5,4,5725,1487,4238,1059.5,297.4,2.850033625
NM_014187,TMEM208,6,5,2168,800,1368,273.6,133.3333333,1.71
NM_012163,LRRC29,7,6,19681,1476,18205,3034.166667,210.8571429,12.33401084
NM_013241,FHOD1,22,21,18135,3876,14259,679,176.1818182,3.67879257
NM_015432,PLEKHG4,21,20,11992,6824,5168,258.4,324.952381,0.757327081
NM_001100915,KCTD19,16,15,37270,2927,34343,2289.533333,182.9375,11.7331739
NM_001129729,PLEKHG4,22,21,9916,4500,5416,257.9047619,204.5454545,1.203555556
NM_001129727,PLEKHG4,23,22,11329,4614,6715,305.2272727,200.6086957,1.455353273
NM_001129731,PLEKHG4,20,19,9913,4501,5412,284.8421053,225.05,1.202399467
NM_001129728,PLEKHG4,22,21,10355,4589,5766,274.5714286,208.5909091,1.256482894
NM_004594,SLC9A5,16,15,23241,3751,19490,1299.333333,234.4375,5.195947747
NM_001004055,LRRC29,7,6,19861,1311,18550,3091.666667,187.2857143,14.1495042
NM_001161575,LRRC36,11,10,37853,2142,35711,3571.1,194.7272727,16.67180205
NM_016140,TPPP3,5,4,3730,1156,2574,643.5,231.2,2.226643599
NM_013304,ZDHHC1,11,10,22019,2020,19999,1999.9,183.6363636,9.90049505
NM_015964,TPPP3,4,3,3730,1064,2666,888.6666667,266,2.505639098
NM_000196,HSD11B2,5,4,6420,1887,4533,1133.25,377.4,2.402225755
NM_001138,AGRP,4,3,1244,768,476,158.6666667,192,0.619791667
NM_024519,FAM65A,22,21,17976,4131,13845,659.2857143,187.7727273,3.351488744
NM_001193522,FAM65A,22,21,17973,4140,13833,658.7142857,188.1818182,3.341304348
NM_001193524,FAM65A,22,21,9328,4166,5162,245.8095238,189.3636364,1.239078253
NM_001193523,FAM65A,22,21,17153,4253,12900,614.2857143,193.3181818,3.033153068
NM_001082487,ACD,12,11,3305,2030,1275,115.9090909,169.1666667,0.628078818
NM_001082486,ACD,12,11,3305,2078,1227,111.5454545,173.1666667,0.590471607
NM_032140,ENKD1,7,6,3780,1545,2235,372.5,220.7142857,1.446601942
NM_030819,GFOD2,3,2,44839,2078,42761,21380.5,692.6666667,20.57795958
NM_016948,PARD6A,3,2,1832,1266,566,283,422,0.447077409
NM_001013838,RLTPR,38,37,12444,4517,7927,214.2432432,118.8684211,1.754925836
NM_001243650,GFOD2,2,1,38656,5297,33359,33359,2648.5,6.297715688
NM_001012984,C16orf86,4,3,1946,1273,673,224.3333333,318.25,0.528672427
NM_001037281,PARD6A,3,2,1832,1263,569,284.5,421,0.450514648
NM_022914,ACD,12,11,3305,2069,1236,112.3636364,172.4166667,0.597390043
NM_025082,CENPT,16,15,19303,2361,16942,1129.466667,147.5625,7.175772978
NM_018430,TSNAXIP1,16,15,21192,2691,18501,1233.4,168.1875,6.875139353
NM_020457,THAP11,1,0,1887,1887,NA,NA,1887,NA
NM_001288994,TSNAXIP1,11,10,21192,2046,19146,1914.6,186,9.357771261
NM_001288993,TSNAXIP1,13,12,21192,2372,18820,1568.333333,182.4615385,7.934232715
NM_001288992,TSNAXIP1,12,11,21192,2244,18948,1722.545455,187,8.443850267
NM_001288991,TSNAXIP1,14,13,21192,2293,18899,1453.769231,163.7857143,8.242040994
NM_001288990,TSNAXIP1,16,15,21192,2502,18690,1246,156.375,7.470023981
NM_001907,CTRL,7,6,2307,1189,1118,186.3333333,169.8571429,0.940285955
NM_006742,PSKH1,3,2,36408,3484,32924,16462,1161.333333,9.450057405
NM_198443,NRN1L,3,2,1492,636,856,428,212,1.34591195
NM_001145961,SLC12A4,24,23,25222,4771,20451,889.173913,198.7916667,4.286522742
NM_000229,LCAT,6,5,4230,1360,2870,574,226.6666667,2.110294118
NM_005072,SLC12A4,24,23,25222,4789,20433,888.3913043,199.5416667,4.266652746
NM_002801,PSMB10,8,7,2375,1014,1361,194.4285714,126.75,1.342209073
NM_022357,DPEP3,10,9,4888,1748,3140,348.8888889,174.8,1.796338673
NM_001145964,SLC12A4,24,23,23406,4659,18747,815.0869565,194.125,4.023824855
NM_001145963,SLC12A4,24,23,20593,4668,15925,692.3913043,194.5,3.411525278
NM_001145962,SLC12A4,23,22,25222,4693,20529,933.1363636,204.0434783,4.374387385
NM_014329,EDC4,29,28,11493,4840,6653,237.6071429,166.8965517,1.374586777
NM_001129758,DPEP3,10,9,4888,1745,3143,349.2222222,174.5,1.801146132
NM_001282442,LOC100131303,2,1,2477,1187,1290,1290,593.5,1.086773378
NM_017803,DUS2,17,16,56381,2342,54039,3377.4375,137.7647059,23.07386849
NM_018380,DDX28,1,0,2595,2595,NA,NA,2595,NA
NM_001271763,DUS2,15,14,56381,2235,54146,3867.571429,149,24.22639821
NM_001271762,DUS2,16,15,56381,2261,54120,3608,141.3125,23.93631137
NM_024939,ESRP2,15,14,7688,4036,3652,260.8571429,269.0666667,0.904856293
NM_001076785,SLC7A6,12,11,37309,6368,30941,2812.818182,530.6666667,4.858825377
NM_032178,SLC7A6OS,5,4,10352,1634,8718,2179.5,326.8,5.335373317
NM_001184824,PRMT7,17,16,46294,2197,44097,2756.0625,129.2352941,20.07146108
NM_019023,PRMT7,19,18,46294,2484,43810,2433.888889,130.7368421,17.63687601
NM_003983,SLC7A6,11,10,37309,6280,31029,3102.9,570.9090909,4.940923567
NM_133458,ZFP90,4,3,27380,4388,22992,7664,1097,5.239744758
NM_001199280,HAS3,4,3,12105,4291,7814,2604.666667,1072.75,1.821020741
NM_001039690,CHTF8,4,3,14583,2928,11655,3885,732,3.980532787
NM_032830,CIRH1A,17,16,36440,2271,34169,2135.5625,133.5882353,15.0457948
NM_138612,HAS3,4,3,12492,1195,11297,3765.666667,298.75,9.453556485
NM_005329,HAS3,4,3,10129,4223,5906,1968.666667,1055.75,1.398531849
NM_001040146,CHTF8,4,3,14161,2901,11260,3753.333333,725.25,3.8814202
NM_032382,COG8,6,5,11004,2501,8503,1700.6,416.8333333,3.399840064
NM_013245,VPS4A,11,10,13661,2187,11474,1147.4,198.8181818,5.246456333
NM_001199434,NIP7,4,3,3600,2182,1418,472.6666667,545.5,0.649862511
NM_005652,TERF2,10,9,30429,2993,27436,3048.444444,299.3,9.166722352
NM_016101,NIP7,5,4,3600,2324,1276,319,464.8,0.549053356
NM_022341,PDF,2,1,1976,1160,816,816,580,0.703448276
NM_144676,TMED6,4,3,8565,944,7621,2540.333333,236,8.07309322
NM_173215,NFAT5,14,13,129724,5325,124399,9569.153846,380.3571429,23.36131455
NM_001025434,NQO1,5,4,17231,2482,14749,3687.25,496.4,5.942385173
NM_000903,NQO1,6,5,17231,2597,14634,2926.8,432.8333333,5.634963419
NM_001286137,NQO1,4,3,17269,2417,14852,4950.666667,604.25,6.144807613
NM_014062,NOB1,9,8,13116,1784,11332,1416.5,198.2222222,6.352017937
NM_001025433,NQO1,5,4,17231,2494,14737,3684.25,498.8,5.908981556
NM_199424,WWP2,14,13,16760,3696,13064,1004.923077,264,3.534632035
NM_001270453,WWP2,21,20,103006,4248,98758,4937.9,202.2857143,23.24811676
NM_017990,PDPR,19,18,47657,8018,39639,2202.166667,422,4.943751559
NM_173619,CLEC18C,12,11,12872,1982,10890,990,165.1666667,5.49445005
NM_058219,EXOSC6,1,0,1701,1701,NA,NA,1701,NA
NM_007242,DDX19B,12,11,34675,1841,32834,2984.909091,153.4166667,17.83487235
NM_001257175,DDX19B,9,8,34675,1642,33033,4129.125,182.4444444,20.11753959
NM_001257172,DDX19B,11,10,39037,1672,37365,3736.5,152,22.34748804
NM_001257174,DDX19B,10,9,44067,1782,42285,4698.333333,178.2,23.72895623
NM_001257173,DDX19B,11,10,39001,1829,37172,3717.2,166.2727273,20.32367414
NM_001014451,DDX19B,11,10,34675,1747,32928,3292.8,158.8181818,18.84831139
NM_001014449,DDX19B,10,9,34675,1736,32939,3659.888889,173.6,18.97407834
NM_001605,AARS,21,20,37117,3365,33752,1687.6,160.2380952,10.03031204
NM_006927,ST3GAL2,7,6,59655,4457,55198,9199.666667,636.7142857,12.38456361
NM_145059,FUK,24,23,25681,3931,21750,945.6521739,163.7916667,5.532943271
NM_012426,SF3B3,26,25,53882,9746,44136,1765.44,374.8461538,4.528627129
NM_001172772,IL34,7,6,36692,1769,34923,5820.5,252.7142857,19.74166196
NM_138383,MTSS1L,15,14,24849,4992,19857,1418.357143,332.8,3.977764423
NM_001740,CALB2,11,10,31728,1481,30247,3024.7,134.6363636,20.42336259
NM_007088,CALB2,9,8,31728,1385,30343,3792.875,153.8888889,21.90830325
NM_018348,CMTR2,3,2,7308,4174,3134,1567,1391.333333,0.750838524
NM_001099642,CMTR2,3,2,7114,4030,3084,1542,1343.333333,0.765260546
NM_006961,ZNF19,6,5,15280,2749,12531,2506.2,458.1666667,4.558384867
NM_145911,ZNF23,6,5,14616,3245,11371,2274.2,540.8333333,3.504160247
NM_001271329,MARVELD3,3,2,15814,2088,13726,6863,696,6.573754789
NM_001017967,MARVELD3,3,2,15814,2251,13563,6781.5,750.3333333,6.025322079
NM_000353,TAT,12,11,10246,2769,7477,679.7272727,230.75,2.700252799
NM_052858,MARVELD3,3,2,10054,2688,7366,3683,896,2.740327381
NM_001201556,ZNF821,7,6,24512,1840,22672,3778.666667,262.8571429,12.32173913
NM_001201554,ZNF821,7,6,24512,1881,22631,3771.833333,268.7142857,12.03136629
NM_001201553,ZNF821,7,6,23863,1992,21871,3645.166667,284.5714286,10.97941767
NM_017530,ZNF821,6,5,23863,1865,21998,4399.6,310.8333333,11.79517426
NM_001137675,ATXN1L,3,2,11344,7889,3455,1727.5,2629.666667,0.437951578
NM_001201552,ZNF821,8,7,24512,2008,22504,3214.857143,251,11.20717131
NM_001361,DHODH,9,8,16675,2436,14239,1779.875,270.6666667,5.845238095
NM_181536,PKD1L3,30,29,70438,5225,65213,2248.724138,174.1666667,12.48095694
NM_020995,HPR,5,4,14022,1247,12775,3193.75,249.4,10.24458701
NM_031293,PMFBP1,21,20,53070,3458,49612,2480.6,164.6666667,14.3470214
NM_001160213,PMFBP1,22,21,53355,3697,49658,2364.666667,168.0454545,13.43197187
NM_014003,DHX38,27,26,19198,4481,14717,566.0384615,165.962963,3.284311538
NM_017853,TXNL4B,4,3,8785,2545,6240,2080,636.25,2.451866405
NM_001142318,TXNL4B,4,3,9461,2394,7067,2355.666667,598.5,2.951963241
NM_001142317,TXNL4B,4,3,9014,2496,6518,2172.666667,624,2.611378205
NM_207385,C16orf47,4,3,17811,1311,16500,5500,327.75,12.58581236
NM_002811,PSMD7,7,6,9515,1677,7838,1306.333333,239.5714286,4.673822302
NM_018124,RFWD3,13,12,45484,4965,40519,3376.583333,381.9230769,8.160926485
NM_024306,FA2H,7,6,61875,2434,59441,9906.833333,347.7142857,24.4211175
NM_153688,ZFP1,4,3,23713,3292,20421,6807,823,6.203219927
NM_153486,LDHD,11,10,4914,2083,2831,283.1,189.3636364,1.359097456
NM_194436,LDHD,11,10,4914,2014,2900,290,183.0909091,1.439920556
NM_001025200,CTRB2,7,6,3080,897,2183,363.8333333,128.1428571,2.433667781
NM_001170720,BCAR1,8,7,36920,2934,33986,4855.142857,366.75,11.58350375
NM_001170718,BCAR1,7,6,36979,3272,33707,5617.833333,467.4285714,10.30165037
NM_001170717,BCAR1,7,6,22600,3301,19299,3216.5,471.5714286,5.846410179
NM_001170716,BCAR1,7,6,37781,3185,34596,5766,455,10.86216641
NM_001170715,BCAR1,7,6,39025,3228,35797,5966.166667,461.1428571,11.08952912
NM_001170719,BCAR1,7,6,19298,3362,15936,2656,480.2857143,4.740035693
NM_001170714,BCAR1,8,7,36979,3524,33455,4779.285714,440.5,9.493473326
NM_014567,BCAR1,7,6,22600,3247,19353,3225.5,463.8571429,5.960271019
NM_001906,CTRB1,7,6,5940,879,5061,843.5,125.5714286,5.757679181
NM_001170721,BCAR1,6,5,10054,3459,6595,1319,576.5,1.906620411
NM_024533,CHST5,3,2,6642,3253,3389,1694.5,1084.333333,1.041807562
NM_007285,GABARAPL2,4,3,11532,1006,10526,3508.666667,251.5,10.46322068
NM_021615,CHST6,3,2,21906,6888,15018,7509,2296,2.180313589
NM_001077416,TMEM231,6,5,18171,3008,15163,3032.6,501.3333333,5.040890957
NM_001077418,TMEM231,7,6,18171,2912,15259,2543.166667,416,5.240041209
NM_012091,ADAT1,11,10,24976,3556,21420,2142,323.2727273,6.023622047
NM_001130089,KARS,15,14,19965,2208,17757,1268.357143,147.2,8.042119565
NM_018975,TERF2IP,3,2,9708,2181,7527,3763.5,727,3.451169188
NM_005548,KARS,14,13,19965,2027,17938,1379.846154,144.7857143,8.849531327
NM_014940,MON1B,6,5,8729,3338,5391,1078.2,556.3333333,1.615038945
NM_001129979,SYCE1L,11,10,13629,888,12741,1274.1,80.72727273,14.34797297
NM_001286639,MON1B,5,4,8729,3010,5719,1429.75,602,1.9
NM_001286640,MON1B,4,3,8729,2851,5878,1959.333333,712.75,2.061732725
NM_001243661,NUDT7,3,2,19770,962,18808,9404,320.6666667,19.55093555
NM_001243657,NUDT7,5,4,19770,1217,18553,4638.25,243.4,15.24486442
NM_001243660,NUDT7,4,3,19770,1077,18693,6231,269.25,17.35654596
NM_001105663,NUDT7,4,3,19770,1122,18648,6216,280.5,16.62032086
NM_005752,CLEC3A,3,2,9560,1941,7619,3809.5,647,3.925296239
NM_001244755,CLEC3A,2,1,3017,1719,1298,1298,859.5,0.755090169
NM_130844,WWOX,1,0,771,771,NA,NA,771,NA
NM_001031804,MAF,1,0,6879,6879,NA,NA,6879,NA
NM_005360,MAF,2,1,6879,2649,4230,4230,1324.5,1.596828992
NM_130897,DYNLRB2,4,3,9689,501,9188,3062.666667,125.25,18.33932136
NM_004483,GCSH,5,4,14430,1543,12887,3221.75,308.6,8.35191186
NM_001100873,C16orf46,4,3,23772,1915,21857,7285.666667,478.75,11.41357702
NM_152337,C16orf46,4,3,16289,1632,14657,4885.666667,408,8.981004902
NM_018455,CENPN,7,6,16386,1456,14930,2488.333333,208,10.25412088
NM_001270473,CENPN,10,9,24989,4594,20395,2266.111111,459.4,4.439486286
NM_001100625,CENPN,11,10,26608,2273,24335,2433.5,206.6363636,10.70611527
NM_001100624,CENPN,11,10,24989,4655,20334,2033.4,423.1818182,4.36820623
NM_020188,CMC2,4,3,30805,734,30071,10023.66667,183.5,40.96866485
NM_001270474,CENPN,10,9,24989,4552,20437,2270.777778,455.2,4.489674868
NM_015251,ATMIN,4,3,11495,4870,6625,2208.333333,1217.5,1.36036961
NM_001278425,PKD1L2,32,31,80485,5749,74736,2410.83871,179.65625,12.99982606
NM_001278423,PKD1L2,7,6,11074,1527,9547,1591.166667,218.1428571,6.252128356
NM_052892,PKD1L2,43,42,119493,7666,111827,2662.547619,178.2790698,14.5873989
NM_001076780,PKD1L2,18,17,50082,3444,46638,2743.411765,191.3333333,13.54181185
NM_017429,BCMO1,11,10,52453,2438,50015,5001.5,221.6363636,20.5147662
NM_145168,SDR42E1,3,2,13844,2778,11066,5533,926,3.983441325
NM_002153,HSD17B2,5,4,63283,1439,61844,15461,287.8,42.97706741
NM_001537,HSBP1,4,3,5101,1993,3108,1036,498.25,1.559458103
NM_182981,OSGIN1,6,5,13112,1946,11166,2233.2,324.3333333,5.737923947
NM_012213,MLYCD,5,4,17059,2200,14859,3714.75,440,6.754090909
NM_001080442,SLC38A8,10,9,32375,1318,31057,3450.777778,131.8,23.56373293
NM_001243158,TAF1C,11,10,9225,3374,5851,585.1,306.7272727,1.73414345
NM_001146051,HSDL1,7,6,23058,3510,19548,3258,501.4285714,5.569230769
NM_031463,HSDL1,6,5,23058,3674,19384,3876.8,612.3333333,5.275993468
NM_172347,KCNG4,3,2,18617,2766,15851,7925.5,922,5.73065799
NM_001243157,TAF1C,12,11,9225,3514,5711,519.1818182,292.8333333,1.625213432
NM_178452,DNAAF1,12,11,32661,2448,30213,2746.636364,204,12.34191176
NM_001243160,TAF1C,12,11,9225,3692,5533,503,307.6666667,1.49864572
NM_001243159,TAF1C,14,13,9225,3849,5376,413.5384615,274.9285714,1.396726422
NM_001243156,TAF1C,15,14,9225,3883,5342,381.5714286,258.8666667,1.375740407
NM_139353,TAF1C,15,14,9225,3719,5506,393.2857143,247.9333333,1.480505512
NM_001145400,ADAD2,10,9,6051,2068,3983,442.5555556,206.8,1.926015474
NM_139174,ADAD2,11,10,6051,2315,3736,373.6,210.4545455,1.613822894
NM_005679,TAF1C,14,13,9225,3960,5265,405,282.8571429,1.329545455
NM_021197,WFDC1,7,6,35147,1481,33666,5611,211.5714286,22.73193788
NM_001282466,WFDC1,7,6,35147,1477,33670,5611.666667,211,22.79620853
NM_001282467,WFDC1,7,6,35147,1474,33673,5612.166667,210.5714286,22.84464043
NM_020947,TLDC1,8,7,28324,5039,23285,3326.428571,629.875,4.620956539
NM_021149,COTL1,4,3,52500,1862,50638,16879.33333,465.5,27.19548872
NM_024731,KLHL36,5,4,13787,2174,11613,2903.25,434.8,5.341766329
NM_001145548,ZDHHC7,9,8,37076,3282,33794,4224.25,364.6666667,10.29677026
NM_017740,ZDHHC7,8,7,37076,3170,33906,4843.714286,396.25,10.69589905
NM_198491,FAM92B,8,7,14151,1905,12246,1749.428571,238.125,6.428346457
NM_001286565,KIAA0513,13,12,31012,7777,23235,1936.25,598.2307692,2.987655908
NM_001278184,GSE1,15,14,62972,7273,55699,3978.5,484.8666667,7.658325313
NM_014615,GSE1,16,15,62972,7493,55479,3698.6,468.3125,7.404110503
NM_001134473,GSE1,15,14,64785,7219,57566,4111.857143,481.2666667,7.974234659
NM_001142288,EMC8,4,3,20919,1872,19047,6349,468,10.17467949
NM_206967,C16orf74,4,3,43567,901,42666,14222,225.25,47.35405105
NM_006067,EMC8,5,4,20919,1968,18951,4737.75,393.6,9.629573171
NM_001861,COX4I1,5,4,7436,829,6607,1651.75,165.8,7.969843185
NM_002163,IRF8,9,8,23439,2670,20769,2596.125,296.6666667,7.778651685
NM_001159377,MTHFSD,8,7,25061,3046,22015,3145,380.75,7.22751149
NM_022764,MTHFSD,8,7,25061,3043,22018,3145.428571,380.375,7.235622741
NM_001159378,MTHFSD,8,7,25061,3046,22015,3145,380.75,7.22751149
NM_001159380,MTHFSD,8,7,25029,3010,22019,3145.571429,376.25,7.315282392
NM_001159379,MTHFSD,8,7,25061,3043,22018,3145.428571,380.375,7.235622741
NM_001451,FOXF1,2,1,3939,2564,1375,1375,1282,0.536271451
NM_005251,FOXC2,1,0,1682,1682,NA,NA,1682,NA
NM_005250,FOXL1,1,0,3191,3191,NA,NA,3191,NA
NM_001195124,C16orf95,7,6,14623,1163,13460,2243.333333,166.1428571,11.57351677
NM_024735,FBXO31,9,8,56808,5979,50829,6353.625,664.3333333,8.50125439
NM_001256917,C16orf95,5,4,14623,981,13642,3410.5,196.2,13.90621814
NM_001195125,C16orf95,5,4,14624,978,13646,3411.5,195.6,13.95296524
NM_022818,MAP1LC3B,4,3,12581,2292,10289,3429.666667,573,4.489092496
NM_015144,ZCCHC14,13,12,85610,6924,78686,6557.166667,532.6153846,11.36424032
NM_001271605,JPH3,2,1,1763,1204,559,559,602,0.464285714
NM_001271604,JPH3,2,1,1763,1053,710,710,526.5,0.674264008
NM_017566,KLHDC4,12,11,58182,1942,56240,5112.727273,161.8333333,28.95983522
NM_001184856,KLHDC4,11,10,58182,1848,56334,5633.4,168,30.48376623
NM_001184854,KLHDC4,10,9,58182,1766,56416,6268.444444,176.6,31.94563986
NM_003486,SLC7A5,10,9,39473,4553,34920,3880,455.3,7.669668351
NM_001127464,ZNF469,2,1,13288,13205,83,83,6602.5,0.006285498
NM_153813,ZFPM1,10,9,81562,3251,78311,8701.222222,325.1,24.08828053
NM_000101,CYBA,6,5,7797,729,7068,1413.6,121.5,9.695473251
NM_002461,MVD,10,9,11149,1805,9344,1038.222222,180.5,5.176731302
NM_013278,IL17C,3,2,1883,1048,835,417.5,349.3333333,0.796755725
NM_144604,ZC3H18,18,17,61585,3745,57840,3402.352941,208.0555556,15.44459279
NM_001142864,PIEZO1,51,50,69628,7884,61744,1234.88,154.5882353,7.831557585
NM_001171816,RNF166,6,5,7124,2466,4658,931.6,411,1.888888889
NM_001171815,RNF166,5,4,9899,1616,8283,2070.75,323.2,5.125618812
NM_178841,RNF166,6,5,9928,1889,8039,1607.8,314.8333333,4.255690842
NM_178310,SNAI3,3,2,8794,1716,7078,3539,572,4.124708625
NM_001012762,CTU2,14,13,8897,1678,7219,555.3076923,119.8571429,4.302145411
NM_001012759,CTU2,15,14,8897,1738,7159,511.3571429,115.8666667,4.119102417
NM_000485,APRT,5,4,2467,812,1655,413.75,162.4,2.03817734
NM_000512,GALNS,14,13,43234,2377,40857,3142.846154,169.7857143,17.18847286
NM_001080487,PABPN1L,7,6,3322,1314,2008,334.6666667,187.7142857,1.528158295
NM_030928,CDT1,10,9,5482,2685,2797,310.7777778,268.5,1.041713222
NM_016209,TRAPPC2L,5,4,4016,634,3382,845.5,126.8,5.334384858
NM_001030018,APRT,5,4,2467,678,1789,447.25,135.6,2.638643068
NM_001284316,ACSF3,9,8,62039,2897,59142,7392.75,321.8888889,20.41491198
NM_001243279,ACSF3,11,10,62039,3762,58277,5827.7,342,15.49096225
NM_001127214,ACSF3,10,9,62039,3588,58451,6494.555556,358.8,16.29069119
NM_174917,ACSF3,11,10,62039,3758,58281,5828.1,341.6363636,15.50851517
NM_001201407,ZNF778,7,6,11856,3615,8241,1373.5,516.4285714,2.27966805
NM_001242757,SLC22A31,8,7,4362,1868,2494,356.2857143,233.5,1.335117773
NM_182531,ZNF778,6,5,11856,3530,8326,1665.2,588.3333333,2.358640227
NM_199367,SPG7,10,9,29326,2312,27014,3001.555556,231.2,11.68425606
NM_001243131,RPL13,7,6,6174,4365,1809,301.5,623.5714286,0.41443299
NM_001243130,RPL13,6,5,6174,4448,1726,345.2,741.3333333,0.388039568
NM_033251,RPL13,5,4,6120,4677,1443,360.75,935.4,0.30853111
NM_003119,SPG7,17,16,49371,3099,46272,2892,182.2941176,14.93126815
NM_000977,RPL13,6,5,6174,4505,1669,333.8,750.8333333,0.370477248
NM_001083314,CHMP1A,6,5,13356,2409,10947,2189.4,401.5,4.544209215
NM_001271908,SPATA33,3,2,12656,1413,11243,5621.5,471,7.956829441
NM_001160367,CDK10,13,12,9698,1773,7925,660.4166667,136.3846154,4.469825155
NM_152339,SPATA2L,3,2,5358,2342,3016,1508,780.6666667,1.287788215
NM_002768,CHMP1A,7,6,13356,2430,10926,1821,347.1428571,4.496296296
NM_052988,CDK10,13,12,9698,1811,7887,657.25,139.3076923,4.355052457
NM_052987,CDK10,13,12,9698,1639,8059,671.5833333,126.0769231,4.917022575
NM_001271910,SPATA33,3,2,12656,1493,11163,5581.5,497.6666667,7.476892163
NM_001271909,SPATA33,2,1,12413,1550,10863,10863,775,7.008387097
NM_001271907,SPATA33,3,2,12656,1495,11161,5580.5,498.3333333,7.465551839
NM_001128141,DPEP1,11,10,25125,1659,23466,2346.6,150.8181818,14.14466546
NM_001098533,CDK10,13,12,9698,1755,7943,661.9166667,135,4.525925926
NM_004413,DPEP1,11,10,17841,1747,16094,1609.4,158.8181818,9.212364053
NM_153025,SPATA33,3,2,12716,1442,11274,5637,480.6666667,7.818307906
NM_000135,FANCA,43,42,79108,5503,73605,1752.5,127.9767442,13.37543158
NM_001113525,ZNF276,11,10,19382,4631,14751,1475.1,421,3.185273159
NM_152287,ZNF276,11,10,19941,4621,15320,1532,420.0909091,3.315299719
NM_001018112,FANCA,11,10,18300,1667,16633,1663.3,151.5454545,9.977804439
NM_001286167,FANCA,43,42,79108,5507,73601,1752.404762,128.0697674,13.36499001
NM_017702,DEF8,6,5,10637,922,9715,1943,153.6666667,10.53687636
NM_002386,MC1R,1,0,3100,3100,NA,NA,3100,NA
NM_001242822,DEF8,6,5,10637,919,9718,1943.6,153.1666667,10.57453754
NM_001242821,DEF8,5,4,10637,824,9813,2453.25,164.8,11.90898058
NM_001242820,DEF8,14,13,19331,3898,15433,1187.153846,278.4285714,3.959209851
NM_001242819,DEF8,12,11,18642,3518,15124,1374.909091,293.1666667,4.299033542
NM_001242818,DEF8,13,12,19331,3657,15674,1306.166667,281.3076923,4.286026798
NM_001242817,DEF8,12,11,19331,3522,15809,1437.181818,293.5,4.488642817
NM_001242816,DEF8,13,12,19331,3627,15704,1308.666667,279,4.329749104
NM_145039,CENPBD1,1,0,3059,3059,NA,NA,3059,NA
NM_014972,TCF25,18,17,37800,2277,35523,2089.588235,126.5,15.60079051
NM_207514,DEF8,13,12,19331,3782,15549,1295.75,290.9230769,4.111316764
NM_001197181,TUBB3,4,3,14090,1830,12260,4086.666667,457.5,6.699453552
NM_006086,TUBB3,4,3,12820,1773,11047,3682.333333,443.25,6.230682459
NM_001042610,DBNDD1,4,3,14692,2165,12527,4175.666667,541.25,5.786143187
NM_001098173,PRDM7,10,9,19366,3232,16134,1792.666667,323.2,4.991955446
NM_001286209,GAS8,11,10,25344,3211,22133,2213.3,291.9090909,6.892868265
NM_001481,GAS8,11,10,22373,3196,19177,1917.7,290.5454545,6.000312891
NM_001214,C16orf3,1,0,995,995,NA,NA,995,NA
NM_001286208,GAS8,10,9,22373,3263,19110,2123.333333,326.3,5.856573705
NM_001286205,GAS8,11,10,22373,3319,19054,1905.4,301.7272727,5.740885809
NM_001288709,DBNDD1,4,3,15268,2324,12944,4314.666667,581,5.569707401
NM_024043,DBNDD1,4,3,5258,2085,3173,1057.666667,521.25,1.521822542
NM_001288708,DBNDD1,5,4,15268,2438,12830,3207.5,487.6,5.262510254
NM_080284,ABCA6,39,38,63170,5335,57835,1521.973684,136.7948718,10.84067479
NM_003620,PPM1D,6,5,66098,4783,61315,12263,797.1666667,12.81936023
NM_001256012,MYH10,43,42,156558,7805,148753,3541.738095,181.5116279,19.05868033
NM_005964,MYH10,41,40,156558,7710,148848,3721.2,188.0487805,19.30583658
NM_001256095,MYH10,42,41,156558,7738,148820,3629.756098,184.2380952,19.23235978
NM_003342,UBE2G1,6,5,97459,4214,93245,18649,702.3333333,22.12743237
NM_001256828,SMG6,11,10,177010,3252,173758,17375.8,295.6363636,53.43111931
NM_001256827,SMG6,12,11,206362,3496,202866,18442.36364,291.3333333,58.02803204
NM_017575,SMG6,19,18,243938,5987,237951,13219.5,315.1052632,39.74461333
NM_178518,TMEM102,3,2,2238,1976,262,131,658.6666667,0.132591093
NM_001159746,ABR,23,22,183860,5627,178233,8101.5,244.6521739,31.67460459
NM_001083585,RABEP1,18,17,103576,5321,98255,5779.705882,295.6111111,18.465514
NM_021962,ABR,23,22,176512,5412,171100,7777.272727,235.3043478,31.61492979
NM_004703,RABEP1,19,18,103576,5421,98155,5453.055556,285.3157895,18.10643793
NM_153604,MYOCD,13,12,103060,8433,94627,7885.583333,648.6923077,11.2210364
NM_001372,DNAH9,69,68,371319,13819,357500,5257.352941,200.2753623,25.87017874
NM_001146312,MYOCD,14,13,103060,8578,94482,7267.846154,612.7142857,11.01445558
NM_004853,STX8,8,7,325489,976,324513,46359,122,332.4928279
NM_001033551,TOM1L2,14,13,128964,5672,123292,9484,405.1428571,21.73695346
NM_001282417,SLC5A10,15,14,70017,2216,67801,4842.928571,147.7333333,30.59611913
NM_001288786,TOM1L2,15,14,128964,5751,123213,8800.928571,383.4,21.4246218
NM_001042450,SLC5A10,15,14,68528,2107,66421,4744.357143,140.4666667,31.52396773
NM_152351,SLC5A10,15,14,68528,2155,66373,4740.928571,143.6666667,30.79953596
NM_001243439,SPECC1,15,14,305425,4026,301399,21528.5,268.4,74.86313959
NM_001082968,TOM1L2,15,14,128964,5823,123141,8795.785714,388.2,21.14734673
NM_001270649,SLC5A10,14,13,68528,1998,66530,5117.692308,142.7142857,33.2982983
NM_001270648,SLC5A10,14,13,68528,2025,66503,5115.615385,144.6428571,32.84098765
NM_001288789,TOM1L2,13,12,128964,5464,123500,10291.66667,420.3076923,22.60248902
NM_001288788,TOM1L2,12,11,128964,5466,123498,11227.09091,455.5,22.59385291
NM_001288787,TOM1L2,14,13,128964,5687,123277,9482.846154,406.2142857,21.67698259
NM_020889,PHF12,9,8,39348,2966,36382,4547.75,329.5555556,12.26635199
NM_183377,ASIC2,10,9,279902,3452,276450,30716.66667,345.2,80.08400927
NM_001076680,LYRM9,4,3,15071,1485,13586,4528.666667,371.25,9.148821549
NM_001145053,EFCAB5,15,14,144771,3760,141011,10072.21429,250.6666667,37.50292553
NM_198529,EFCAB5,23,22,166849,5155,161694,7349.727273,224.1304348,31.36644035
NM_001033561,PHF12,15,14,46239,4490,41749,2982.071429,299.3333333,9.298218263
NM_001094,ASIC2,10,9,1143721,2700,1141021,126780.1111,270,422.6003704
NM_025248,SRCIN1,19,18,75926,7069,68857,3825.388889,372.0526316,9.740698826
NM_001991,EZH1,21,20,44780,4667,40113,2005.65,222.2380952,8.595028927
NM_198839,ACACA,60,59,324977,10723,314254,5326.338983,178.7166667,29.30653735
NM_005801,EIF1,4,3,2773,1330,1443,481,332.5,1.084962406
NM_198834,ACACA,56,55,324977,10045,314932,5726.036364,179.375,31.35211548
NM_198838,ACACA,55,54,214767,9792,204975,3795.833333,178.0363636,20.93290441
NM_198837,ACACA,54,53,214767,9680,205087,3869.566038,179.2592593,21.18667355
NM_198836,ACACA,56,55,274134,9612,264522,4809.490909,171.6428571,27.51997503
NM_003079,SMARCE1,11,10,20129,2432,17697,1769.7,221.0909091,7.276726974
NM_002055,GFAP,9,8,9928,3095,6833,854.125,343.8888889,2.207754443
NM_005910,MAPT,12,11,133953,5822,128131,11648.27273,485.1666667,22.00807283
NM_001203252,MAPT,11,10,133953,5728,128225,12822.5,520.7272727,22.38564944
NM_003204,NFE2L1,6,5,13223,4880,8343,1668.6,813.3333333,1.709631148
NM_016835,MAPT,14,13,133953,6775,127178,9782.923077,483.9285714,18.77166052
NM_016834,MAPT,10,9,133953,5646,128307,14256.33333,564.6,22.72529224
NM_016841,MAPT,9,8,133953,5552,128401,16050.125,616.8888889,23.12698127
NM_017643,MBTD1,17,16,82643,5399,77244,4827.75,317.5882353,14.30709391
NM_001242376,GFAP,7,6,5887,2192,3695,615.8333333,313.1428571,1.685675182
NM_001203251,MAPT,10,9,133953,5640,128313,14257,564,22.75053191
NM_001123067,MAPT,11,10,133953,5734,128219,12821.9,521.2727273,22.36117893
NM_001131019,GFAP,8,7,5887,1839,4048,578.2857143,229.875,2.201196302
NM_001123066,MAPT,15,14,133953,6830,127123,9080.214286,455.3333333,18.6124451
NM_138962,MSI2,14,13,423370,1595,421775,32444.23077,113.9285714,264.4357367
NM_153228,ANKFN1,17,16,329173,2443,326730,20420.625,143.7058824,133.7413017
NM_012329,MMD,7,6,29369,2730,26639,4439.833333,390,9.757875458
NM_024612,DHX40,18,17,42829,3685,39144,2302.588235,204.7222222,10.62252374
NM_001166301,DHX40,17,16,42829,3453,39376,2461,203.1176471,11.40341732
NM_170721,MSI2,10,9,376172,2153,374019,41557.66667,215.3,173.7199257
NM_199340,LRRC37A3,14,13,64417,5679,58738,4518.307692,405.6428571,10.34301814
NM_001199165,CEP112,27,26,556556,3432,553124,21274,127.1111111,161.1666667
NM_032043,BRIP1,20,19,184375,8186,176189,9273.105263,409.3,21.52321036
NM_007372,DDX42,19,18,45130,4030,41100,2283.333333,212.1052632,10.19851117
NM_145036,CEP112,27,26,556331,3545,552786,21261,131.2962963,155.9339915
NM_203499,DDX42,18,17,45130,3958,41172,2421.882353,219.8888889,10.40222335
NM_014405,CACNG4,4,3,68540,3434,65106,21702,858.5,18.95923122
NM_001100875,Mar-10,11,10,105341,3068,102273,10227.3,278.9090909,33.33539765
NM_001288779,Mar-10,12,11,107069,3264,103805,9436.818182,272,31.80300245
NM_152598,Mar-10,11,10,107069,3149,103920,10392,286.2727273,33.00095268
NM_001288780,Mar-10,11,10,103478,3483,99995,9999.5,316.6363636,28.70944588
NM_203506,GRB2,5,4,87635,3186,84449,21112.25,637.2,26.50627746
NM_012121,CDC42EP4,2,1,28382,3103,25279,25279,1551.5,8.146632291
NM_002086,GRB2,6,5,87634,3309,84325,16865,551.5,25.48352977
NM_022066,UBE2O,18,17,63677,5373,58304,3429.647059,298.5,10.8512935
NM_153209,KIF19,20,19,29610,3663,25947,1365.631579,183.15,7.083538084
NM_020761,RPTOR,34,33,421550,6890,414660,12565.45455,202.6470588,60.18287373
NM_005993,TBCD,39,38,191124,4471,186653,4911.921053,114.6410256,41.74748378
NM_001163034,RPTOR,30,29,421550,6412,415138,14315.10345,213.7333333,64.74391765
NM_173628,DNAH17,81,80,153700,13804,139896,1748.7,170.4197531,10.13445378
NM_015721,GEMIN4,2,1,7842,3743,4099,4099,1871.5,1.095110874
NM_001190413,RPH3AL,8,7,140455,2499,137956,19708,312.375,55.20448179
NM_001190412,RPH3AL,9,8,140455,2676,137779,17222.375,297.3333333,51.48692078
NM_001190411,RPH3AL,9,8,140455,2587,137868,17233.5,287.4444444,53.29261693
NM_022463,NXN,8,7,180447,3032,177415,25345,379,58.51418206
NM_001282149,ABR,18,17,75630,4793,70837,4166.882353,266.2777778,14.77926142
NM_006987,RPH3AL,10,9,140455,2764,137691,15299,276.4,49.8158466
NM_001256847,ABR,8,7,28325,3603,24722,3531.714286,450.375,6.861504302
NM_001092,ABR,22,21,105584,5085,100499,4785.666667,231.1363636,19.76381514
NM_018289,VPS53,18,17,182565,2712,179853,10579.58824,150.6666667,66.31747788
NM_001013672,C17orf97,2,1,4341,1841,2500,2500,920.5,1.357957632
NM_001128159,VPS53,22,21,206190,13128,193062,9193.428571,596.7272727,14.70612431
NM_001282326,SMG6,7,6,28924,4250,24674,4112.333333,607.1428571,5.805647059
NM_006224,PITPNA,12,11,44829,3653,41176,3743.272727,304.4166667,11.27183137
NM_006445,PRPF8,43,42,34255,7338,26917,640.8809524,170.6511628,3.668165713
NM_052928,SMYD4,11,10,50348,4345,46003,4600.3,395,10.58757192
NM_024086,METTL16,10,9,95854,5763,90091,10010.11111,576.3,15.6326566
NM_018128,TSR1,15,14,14698,4895,9803,700.2142857,326.3333333,2.002655771
NM_015085,RAP1GAP2,25,24,241305,6688,234617,9775.708333,267.52,35.08029306
NM_021947,SRR,8,7,21307,2485,18822,2688.857143,310.625,7.574245473
NM_001100398,RAP1GAP2,24,23,241305,6642,234663,10202.73913,276.75,35.33017164
NM_002208,ITGAE,31,30,86620,3892,82728,2757.6,125.5483871,21.25590956
NM_013276,SHPK,7,6,28062,3845,24217,4036.166667,549.2857143,6.298309493
NM_015113,ZZEF1,55,54,138516,11450,127066,2353.074074,208.1818182,11.09746725
NM_002558,P2RX1,12,11,20077,2876,17201,1563.727273,239.6666667,5.980876217
NM_014389,PELP1,17,16,32955,3691,29264,1829,217.1176471,7.928474668
NM_014520,MYBBP1A,26,25,16492,4594,11898,475.92,176.6923077,2.589899869
NM_002663,PLD2,25,24,16333,3521,12812,533.8333333,140.84,3.638738995
NM_001243108,PLD2,25,24,16333,3488,12845,535.2083333,139.52,3.682626147
NM_001105538,MYBBP1A,27,26,16492,4132,12360,475.3846154,153.037037,2.991287512
NM_001278241,PELP1,19,18,32955,3544,29411,1633.944444,186.5263158,8.298814898
NM_005022,PFN1,3,2,3438,1368,2070,1035,456,1.513157895
NM_001671,ASGR1,9,8,6134,1512,4622,577.75,168,3.056878307
NM_016060,MED31,4,3,8323,1660,6663,2221,415,4.013855422
NM_031220,PITPNM3,20,19,105296,7171,98125,5164.473684,358.55,13.68358667
NM_001197216,ASGR1,8,7,6134,1394,4740,677.1428571,174.25,3.400286944
NM_001165966,PITPNM3,19,18,105296,7062,98234,5457.444444,371.6842105,13.91022373
NM_153357,SLC16A11,4,3,2295,1807,488,162.6666667,451.75,0.270060874
NM_153230,FBXO39,4,3,11415,1671,9744,3248,417.75,5.831238779
NM_001143991,WRAP53,11,10,16064,1839,14225,1422.5,167.1818182,7.735182164
NM_001143990,WRAP53,11,10,17433,1829,15604,1560.4,166.2727273,8.531437944
NM_020877,DNAH2,85,84,114021,13590,100431,1195.607143,159.8823529,7.390066225
NM_015670,SENP3,12,11,9980,2506,7476,679.6363636,208.8333333,2.983240223
NM_018081,WRAP53,10,9,15155,1973,13182,1464.666667,197.3,6.681196148
NM_001143992,WRAP53,11,10,15155,1888,13267,1326.7,171.6363636,7.027012712
NM_004822,NTN1,7,6,222460,5961,216499,36083.16667,851.5714286,36.31924174
NM_201433,GAS7,14,13,287944,8225,279719,21516.84615,587.5,34.00838906
NM_201432,GAS7,14,13,126140,8195,117945,9072.692308,585.3571429,14.39231239
NM_001130831,GAS7,14,13,115699,8038,107661,8281.615385,574.1428571,13.39400348
NM_017533,MYH4,40,39,26270,6055,20215,518.3333333,151.375,3.338563171
NM_001267576,USP43,15,14,84151,4164,79987,5713.357143,277.6,19.20917387
NM_003802,MYH13,41,40,72141,6033,66108,1652.7,147.1463415,10.95773247
NM_003644,GAS7,10,9,48842,7783,41059,4562.111111,778.3,5.275472183
NM_153210,USP43,15,14,84151,4179,79972,5712.285714,278.6,19.13663556
NM_001173462,SHISA6,5,4,322642,7363,315279,78819.75,1472.6,42.81936711
NM_001173461,SHISA6,4,3,322642,7266,315376,105125.3333,1816.5,43.40434902
NM_207386,SHISA6,6,5,322642,7421,315221,63044.2,1236.833333,42.47688991
NM_001004313,TMEM220,6,5,17009,3098,13911,2782.2,516.3333333,4.490316333
NM_001281435,MAP2K4,12,11,123015,3885,119130,10830,323.75,30.66409266
NM_003010,MAP2K4,11,10,123015,3851,119164,11916.4,350.0909091,30.943651
NM_004662,DNAH9,15,14,86848,3162,83686,5977.571429,210.8,26.46616066
NM_014859,ARHGAP44,21,20,202133,4277,197856,9892.8,203.6666667,46.26046294
NM_006042,HS3ST3A1,2,1,106240,2529,103711,103711,1264.5,41.00869909
NM_001303,COX10,7,6,139279,3009,136270,22711.66667,429.8571429,45.28747092
NM_145301,TVP23C,6,5,61369,1620,59749,11949.8,270,36.88209877
NM_001135036,TVP23C,6,5,26653,4233,22420,4484,705.5,5.296480038
NM_001204478,TVP23C-CDRT4,7,6,127615,2916,124699,20783.16667,416.5714286,42.76371742
NM_001113567,FAM211A,4,3,50188,2823,47365,15788.33333,705.75,16.77825009
NM_001190440,NCOR1,45,44,164547,9331,155216,3527.636364,207.3555556,16.63444433
NM_000676,ADORA2B,2,1,30981,1887,29094,29094,943.5,15.41812401
NM_006311,NCOR1,46,45,185468,9840,175628,3902.844444,213.9130435,17.84837398
NM_181716,CENPV,5,4,10966,1169,9797,2449.25,233.8,8.380667237
NM_014695,CCDC144A,18,17,84674,5846,78828,4636.941176,324.7777778,13.48409169
NM_207387,FAM211A,3,2,50188,2706,47482,23741,902,17.54693274
NM_004278,PIGL,7,6,109066,1159,107907,17984.5,165.5714286,93.10353753
NM_007169,PEMT,7,6,76870,1015,75855,12642.5,145,74.73399015
NM_015134,MPRIP,23,22,149890,10983,138907,6313.954545,477.5217391,12.64745516
NM_148173,PEMT,7,6,71904,902,71002,11833.66667,128.8571429,78.71618625
NM_148172,PEMT,7,6,86142,1023,85119,14186.5,146.1428571,83.20527859
NM_030665,RAI1,6,5,129980,7666,122314,24462.8,1277.666667,15.95538742
NM_201274,MPRIP,24,23,149890,11047,138843,6036.652174,460.2916667,12.56838961
NM_001199125,COPS3,12,11,34076,1828,32248,2931.636364,152.3333333,17.64113786
NM_001267552,PEMT,8,7,86142,1055,85087,12155.28571,131.875,80.65118483
NM_001267551,PEMT,7,6,86142,957,85185,14197.5,136.7142857,89.01253918
NM_003653,COPS3,12,11,34681,1875,32806,2982.363636,156.25,17.49653333
NM_017758,ALKBH5,4,3,26402,3437,22965,7655,859.25,6.681699156
NM_144775,SMCR8,2,1,12778,8312,4466,4466,4156,0.537295476
NM_024052,GID4,6,5,29109,4238,24871,4974.2,706.3333333,5.86857008
NM_001243475,B9D1,7,6,40630,935,39695,6615.833333,133.5714286,42.45454545
NM_152904,SPECC1,8,7,152410,4981,147429,21061.28571,622.625,29.59827344
NM_001033555,SPECC1,13,12,158767,3874,154893,12907.75,298,39.98270521
NM_001033553,SPECC1,15,14,227739,3967,223772,15983.71429,264.4666667,56.40836904
NM_003876,TMEM11,2,1,16647,1398,15249,15249,699,10.90772532
NM_014238,KSR1,21,20,151684,4512,147172,7358.6,214.8571429,32.6179078
NM_016231,NLK,11,10,153718,3549,150169,15016.9,322.6363636,42.31304593
NM_003170,SUPT6H,37,36,39949,5914,34035,945.4166667,159.8378378,5.754988164
NM_001288634,FAM222B,3,2,56459,4251,52208,26104,1417,12.28134557
NM_001077498,FAM222B,3,2,86863,4182,82681,41340.5,1394,19.77068388
NM_001288631,FAM222B,4,3,86863,4354,82509,27503,1088.5,18.95016077
NM_001288632,FAM222B,5,4,86863,4266,82597,20649.25,853.2,19.36169714
NM_001288633,FAM222B,4,3,86863,4259,82604,27534.66667,1064.75,19.39516318
NM_001288635,FAM222B,4,3,86863,4231,82632,27544,1057.75,19.53013472
NM_001288636,FAM222B,6,5,86863,4257,82606,16521.2,709.5,19.40474513
NM_001288637,FAM222B,5,4,86863,4222,82641,20660.25,844.4,19.57389863
NM_001288638,FAM222B,5,4,86863,4154,82709,20677.25,830.8,19.91068849
NM_001288639,FAM222B,4,3,86863,4105,82758,27586,1026.25,20.16029233
NM_001288640,FAM222B,3,2,86863,4070,82793,41396.5,1356.666667,20.34226044
NM_018182,FAM222B,4,3,86863,4217,82646,27548.66667,1054.25,19.59829263
NM_025142,TAOK1,18,17,160980,11655,149325,8783.823529,647.5,12.81209781
NM_001282130,SSH2,8,7,256318,1017,255301,36471.57143,127.125,251.0334317
NM_001282129,SSH2,16,15,304291,9499,294792,19652.8,593.6875,31.03400358
NM_001282131,SSH2,7,6,87522,964,86558,14426.33333,137.7142857,89.79045643
NM_033389,SSH2,15,14,304103,9229,294874,21062.42857,615.2666667,31.95080724
NM_020791,TAOK1,20,19,160980,12101,148879,7835.736842,605.05,12.30303281
NM_024683,TEFM,4,3,7287,1343,5944,1981.333333,335.75,4.425912137
NM_001007025,GOSR1,9,8,49408,5218,44190,5523.75,579.7777778,8.468761978
NM_004871,GOSR1,9,8,49408,5224,44184,5523,580.4444444,8.457886677
NM_001007024,GOSR1,9,8,49408,5240,44168,5521,582.2222222,8.429007634
NM_000267,NF1,57,56,282752,12419,270333,4827.375,217.877193,21.76769466
NM_001042492,NF1,58,57,282752,12483,270269,4741.561404,215.2241379,21.65096531
NM_032932,RAB11FIP4,15,14,146592,8640,137952,9853.714286,576,15.96666667
NM_015355,SUZ12,16,15,64015,4493,59522,3968.133333,280.8125,13.24771867
NM_002544,OMG,2,1,2714,1897,817,817,948.5,0.430680021
NM_001128147,NF1,15,14,127839,2954,124885,8920.357143,196.9333333,42.27657414
NM_001033568,RHOT1,21,20,83319,3374,79945,3997.25,160.6666667,23.69442798
NM_001033566,RHOT1,20,19,83319,3277,80042,4212.736842,163.85,24.42538908
NM_002815,PSMD11,14,13,38858,3911,34947,2688.230769,279.3571429,8.935566351
NM_018307,RHOT1,19,18,83319,3153,80166,4453.666667,165.9473684,25.42530923
NM_001270482,PSMD11,13,12,38858,4031,34827,2902.25,310.0769231,8.639791615
NM_015194,MYO1D,22,21,384276,5204,379072,18051.04762,236.5454545,72.8424289
NM_001288758,RHOT1,21,20,83319,3375,79944,3997.2,160.7142857,23.68711111
NM_001288755,RHOT1,19,18,83319,3149,80170,4453.888889,165.7368421,25.45887583
NM_001288754,RHOT1,20,19,83319,3250,80069,4214.157895,162.5,24.63661538
NM_001033567,RHOT1,20,19,83319,3278,80041,4212.684211,163.9,24.4176327
NM_001282,AP2B1,21,20,139156,5742,133414,6670.7,273.4285714,23.23476141
NM_152270,SLFN11,5,4,23393,5004,18389,4597.25,1000.8,3.674860112
NM_145898,CCL23,4,3,4911,579,4332,1444,144.75,7.481865285
NM_139285,GAS2L2,6,5,8369,3020,5349,1069.8,503.3333333,1.771192053
NM_001104590,SLFN11,7,6,23393,5113,18280,3046.666667,730.4285714,3.575200469
NM_001104589,SLFN11,6,5,23393,5122,18271,3654.2,853.6666667,3.567161265
NM_001104588,SLFN11,7,6,23393,5201,18192,3032,743,3.497788887
NM_001104587,SLFN11,7,6,23393,5283,18110,3018.333333,754.7142857,3.427976528
NM_005064,CCL23,4,3,4911,630,4281,1427,157.5,6.795238095
NM_001030006,AP2B1,22,21,139156,5785,133371,6351,262.9545455,23.05462403
NM_025109,MYO19,23,22,39708,3824,35884,1631.090909,166.2608696,9.383891213
NM_001163735,MYO19,27,26,39708,4428,35280,1356.923077,164,7.967479675
NM_012138,AATF,12,11,107998,2153,105845,9622.272727,179.4166667,49.16163493
NM_001163545,SYNRG,21,20,94588,7955,86633,4331.65,378.8095238,10.89038341
NM_198882,SYNRG,22,21,94588,8028,86560,4121.904762,364.9090909,10.78226208
NM_133439,TADA2A,11,10,58447,1315,57132,5713.2,119.5454545,43.44638783
NM_001163547,SYNRG,20,19,94588,7573,87015,4579.736842,378.65,11.49016242
NM_007247,SYNRG,22,21,94588,8193,86395,4114.047619,372.4090909,10.54497742
NM_001488,TADA2A,16,15,69916,1856,68060,4537.333333,116,36.67025862
NM_080550,SYNRG,20,19,94588,7921,86667,4561.421053,396.05,10.94142154
NM_001163546,SYNRG,20,19,94588,7786,86802,4568.526316,389.3,11.14847162
NM_001163544,SYNRG,21,20,94588,7958,86630,4331.5,378.952381,10.88590098
NM_001166105,TADA2A,16,15,70251,1648,68603,4573.533333,103,41.62803398
NM_001008777,FBXO47,11,10,30972,2313,28659,2865.9,210.2727273,12.39040208
NM_020405,PLXDC1,14,13,88348,6266,82082,6314,447.5714286,13.09958506
NM_032875,FBXL20,15,14,149014,10396,138618,9901.285714,693.0666667,13.33378222
NM_017748,CWC25,10,9,24918,3113,21805,2422.777778,311.3,7.00449727
NM_001184906,FBXL20,14,13,149014,10299,138715,10670.38462,735.6428571,13.46878338
NM_012481,IKZF3,8,7,106475,9675,96800,13828.57143,1209.375,10.00516796
NM_001289937,ERBB2,26,25,28686,4420,24266,970.64,170,5.490045249
NM_004448,ERBB2,27,26,28686,4674,24012,923.5384615,173.1111111,5.137355584
NM_183232,IKZF3,6,5,106475,9439,97036,19407.2,1573.166667,10.28032631
NM_183230,IKZF3,7,6,106475,9557,96918,16153,1365.285714,10.14104845
NM_183231,IKZF3,6,5,106475,9388,97087,19417.4,1564.666667,10.34160631
NM_183228,IKZF3,7,6,106475,9506,96969,16161.5,1358,10.20082053
NM_133264,WIPF2,8,7,62867,5533,57334,8190.571429,691.625,10.36219049
NM_002809,PSMD3,12,11,17194,2199,14995,1363.181818,183.25,6.81900864
NM_183229,IKZF3,7,6,106475,9557,96918,16153,1365.285714,10.14104845
NM_001257408,IKZF3,7,6,106475,9572,96903,16150.5,1367.428571,10.12358964
NM_001257411,IKZF3,6,5,106475,9244,97231,19446.2,1540.666667,10.51828213
NM_001257412,IKZF3,5,4,106475,9126,97349,24337.25,1825.2,10.66721455
NM_001257410,IKZF3,7,6,106475,9413,97062,16177,1344.714286,10.31148412
NM_001257409,IKZF3,6,5,106475,9454,97021,19404.2,1575.666667,10.2624286
NM_001257414,IKZF3,5,4,106475,9270,97205,24301.25,1854,10.48597627
NM_001257413,IKZF3,4,3,106475,9008,97467,32489,2252,10.82004885
NM_001005862,ERBB2,30,29,40580,4902,35678,1230.275862,163.4,7.278253774
NM_001289936,ERBB2,31,30,40580,4954,35626,1187.533333,159.8064516,7.191360517
NM_001284514,IKZF3,9,8,106475,9802,96673,12084.125,1089.111111,9.862579065
NM_001284515,IKZF3,8,7,106475,9633,96842,13834.57143,1204.125,10.05315063
NM_030966,KRTAP1-3,1,0,972,972,NA,NA,972,NA
NM_181539,KRT26,8,7,5923,1738,4185,597.8571429,217.25,2.407940161
NM_021939,FKBP10,10,9,10509,2893,7616,846.2222222,289.3,2.632561355
NM_003150,STAT3,24,23,75172,4972,70200,3052.173913,207.1666667,14.11906677
NM_001130021,ATP6V0A1,22,21,63737,4162,59575,2836.904762,189.1818182,14.31403172
NM_001130020,ATP6V0A1,21,20,63737,4164,59573,2978.65,198.2857143,14.30667627
NM_031421,TTC25,11,10,30782,2094,28688,2868.8,190.3636364,13.70009551
NM_012448,STAT5B,19,18,77231,5113,72118,4006.555556,269.1052632,14.10483082
NM_139276,STAT3,24,23,75172,4997,70175,3051.086957,208.2083333,14.04342606
NM_213662,STAT3,24,23,75064,4839,70225,3053.26087,201.625,14.51229593
NM_001070,TUBG1,11,10,5900,1962,3938,393.8,178.3636364,2.007135576
NM_005177,ATP6V0A1,21,20,63737,4143,59594,2979.7,197.2857143,14.38426261
NM_000342,SLC4A1,20,19,19746,4973,14773,777.5263158,248.65,2.970641464
NM_004160,PYY,7,6,51732,1059,50673,8445.5,151.2857143,47.84985836
NM_024819,DCAKD,5,4,37773,2132,35641,8910.25,426.4,16.71716698
NM_001128631,DCAKD,5,4,28325,2019,26306,6576.5,403.8,13.02922239
NM_001288654,DCAKD,5,4,37773,2135,35638,8909.5,427,16.69227166
NM_001288655,DCAKD,5,4,28181,2067,26114,6528.5,413.4,12.63376875
NM_001145148,CRHR1,12,11,51550,2547,49003,4454.818182,212.25,19.23949745
NM_001145147,CRHR1,12,11,51550,2469,49081,4461.909091,205.75,19.87889834
NM_001145146,CRHR1,14,13,51550,2678,48872,3759.384615,191.2857143,18.24943988
NM_014798,PLEKHM1,12,11,54882,5311,49571,4506.454545,442.5833333,9.333647147
NM_001256299,CRHR1,15,14,215486,2712,212774,15198.14286,180.8,78.45648968
NM_004382,CRHR1,13,12,51550,2590,48960,4080,199.2307692,18.9034749
NM_003954,MAP3K14,16,15,53928,4483,49445,3296.333333,280.1875,11.02944457
NM_006178,NSF,21,20,166795,4002,162793,8139.65,190.5714286,40.67791104
NM_001113738,ARL17A,4,3,26897,5275,21622,7207.333333,1318.75,4.098957346
NM_001039083,ARL17B,4,3,22372,750,21622,7207.333333,187.5,28.82933333
NM_015443,KANSL1,15,14,162992,5066,157926,11280.42857,337.7333333,31.17370707
NM_016632,ARL17A,5,4,62665,855,61810,15452.5,171,72.29239766
NM_001103154,ARL17B,4,3,62223,492,61731,20577,123,125.4695122
NM_001193466,KANSL1,15,14,162886,5364,157522,11251.57143,357.6,29.36651752
NM_001193465,KANSL1,16,15,195460,5148,190312,12687.46667,321.75,36.96814297
NM_003110,SP2,7,6,32809,3119,29690,4948.333333,445.5714286,9.519076627
NM_001114091,CDC27,19,18,71356,5629,65727,3651.5,296.2631579,11.67649671
NM_006310,NPEPPS,23,22,92200,4362,87838,3992.636364,189.6521739,20.13709308
NM_002265,KPNB1,22,21,33802,4294,29508,1405.142857,195.1818182,6.871914299
NM_001256,CDC27,19,18,71356,5611,65745,3652.5,295.3157895,11.71716272
NM_001195192,EFCAB13,22,21,106751,3552,103199,4914.238095,161.4545455,29.05377252
NM_000212,ITGB3,15,14,58871,4909,53962,3854.428571,327.2666667,10.99246282
NM_152347,EFCAB13,25,24,117352,3975,113377,4724.041667,159,28.52251572
NM_001276453,KPNB1,21,20,32444,3968,28476,1423.8,188.952381,7.17641129
NM_001261393,CALCOCO2,12,11,34259,3568,30691,2790.090909,297.3333333,8.601737668
NM_001261390,CALCOCO2,14,13,34259,3768,30491,2345.461538,269.1428571,8.092091295
NM_001075099,SKAP1,13,12,296794,1586,295208,24600.66667,122,186.1336696
NM_001261395,CALCOCO2,12,11,34259,3504,30755,2795.909091,292,8.777111872
NM_005831,CALCOCO2,13,12,34259,3695,30564,2547,284.2307692,8.271718539
NM_003726,SKAP1,13,12,296794,1589,295205,24600.41667,122.2307692,185.780365
NM_001261391,CALCOCO2,14,13,34259,3759,30500,2346.153846,268.5,8.113860069
NM_030802,FAM117A,8,7,53833,2369,51464,7352,296.125,21.72393415
NM_003563,SPOP,11,10,79281,3049,76232,7623.2,277.1818182,25.00229583
NM_002507,NGFR,6,5,19729,3426,16303,3260.6,571,4.758610625
NM_001007230,SPOP,12,11,79281,3031,76250,6931.818182,252.5833333,25.15671396
NM_001007227,SPOP,11,10,79281,2979,76302,7630.2,270.8181818,25.61329305
NM_001007226,SPOP,12,11,79281,3102,76179,6925.363636,258.5,24.55802708
NM_001007229,SPOP,11,10,79281,2978,76303,7630.3,270.7272727,25.62222968
NM_001007228,SPOP,10,9,79281,2926,76355,8483.888889,292.6,26.09535202
NM_001130527,SPAG9,30,29,158693,8273,150420,5186.896552,275.7666667,18.18203795
NM_001130528,SPAG9,30,29,158693,8303,150390,5185.862069,276.7666667,18.11273034
NM_001258373,SPATA20,17,16,8765,2791,5974,373.375,164.1764706,2.140451451
NM_001258372,SPATA20,16,15,8765,2687,6078,405.2,167.9375,2.262002233
NM_022827,SPATA20,17,16,8765,2736,6029,376.8125,160.9411765,2.203581871
NM_003971,SPAG9,29,28,158693,8260,150433,5372.607143,284.8275862,18.2122276
NM_003786,ABCC3,31,30,56847,5197,51650,1721.666667,167.6451613,9.938426015
NM_001082534,CA10,10,9,529705,2945,526760,58528.88889,294.5,178.8658744
NM_001082533,CA10,10,9,529489,3380,526109,58456.55556,338,155.6535503
NM_020178,CA10,9,8,528460,3253,525207,65650.875,361.4444444,161.4531202
NM_002126,HLF,4,3,60107,5603,54504,18168,1400.75,9.727645904
NM_178509,STXBP4,18,17,195325,6064,189261,11133,336.8888889,31.21058707
NM_003488,AKAP1,11,10,36159,3979,32180,3218,361.7272727,8.087459161
NM_003647,DGKE,12,11,34578,7780,26798,2436.181818,648.3333333,3.444473008
NM_001242903,AKAP1,12,11,35629,4299,31330,2848.181818,358.25,7.287741335
NM_001242902,AKAP1,12,11,35572,4026,31546,2867.818182,335.5,7.835568803
NM_017763,RNF43,10,9,63895,4567,59328,6592,456.7,12.99058463
NM_001271875,CUEDC1,11,10,94082,3632,90450,9045,330.1818182,24.90363436
NM_014906,PPM1E,7,6,229312,6552,222760,37126.66667,936,33.998779
NM_001201457,TEX14,33,32,135380,4979,130401,4075.03125,150.8787879,26.19019884
NM_031272,TEX14,32,31,135380,4840,130540,4210.967742,151.25,26.97107438
NM_001005404,YPEL2,5,4,70044,5237,64807,16201.75,1047.4,12.37483292
NM_001005207,TRIM37,25,24,124268,3643,120625,5026.041667,145.72,33.11144661
NM_018304,PRR11,10,9,51212,6483,44729,4969.888889,648.3,6.899429277
NM_015294,TRIM37,24,23,108707,4540,104167,4529,189.1666667,22.94427313
NM_198393,TEX14,33,32,135380,4961,130419,4075.59375,150.3333333,26.28885305
NM_006380,APPBP2,13,12,83093,6512,76581,6381.75,500.9230769,11.75998157
NM_032582,USP32,34,33,214897,7060,207837,6298.090909,207.6470588,29.43866856
NM_001282476,APPBP2,12,11,83093,6422,76671,6970.090909,535.1666667,11.93880411
NM_030938,VMP1,12,11,133091,2186,130905,11900.45455,182.1666667,59.88334858
NM_001099432,BCAS3,25,24,715029,3634,711395,29641.45833,145.36,195.7608696
NM_017679,BCAS3,24,23,715029,3588,711441,30932.21739,149.5,198.2834448
NM_001284333,TLK2,23,22,136457,5525,130932,5951.454545,240.2173913,23.69809955
NM_006852,TLK2,22,21,136457,5461,130996,6237.904762,248.2272727,23.98754807
NM_005121,MED13,30,29,122679,10495,112184,3868.413793,349.8333333,10.68928061
NM_001284363,TLK2,20,19,134369,5105,129264,6803.368421,255.25,25.32105779
NM_025185,TANC2,25,24,418171,11772,406399,16933.29167,470.88,34.52251104
NM_203351,MAP3K3,17,16,73871,4843,69028,4314.25,284.8823529,14.25314887
NM_002401,MAP3K3,16,15,73871,4749,69122,4608.133333,296.8125,14.55506422
NM_001278920,KCNH6,13,12,23396,3663,19733,1644.416667,281.7692308,5.387114387
NM_001278919,KCNH6,13,12,23396,3796,19600,1633.333333,292,5.163329821
NM_030779,KCNH6,14,13,23396,3905,19491,1499.307692,278.9285714,4.991293214
NM_173092,KCNH6,15,14,25645,3032,22613,1615.214286,202.1333333,7.458113456
NM_138363,CEP95,20,19,30906,2709,28197,1484.052632,135.45,10.40863787
NM_001433,ERN1,22,21,87114,4027,83087,3956.52381,183.0454545,20.63248075
NM_022739,SMURF2,19,18,117653,3885,113768,6320.444444,204.4736842,29.28391248
NM_001288732,TEX2,12,11,115892,5113,110779,10070.81818,426.0833333,21.66614512
NM_001288733,TEX2,12,11,83325,5105,78220,7110.909091,425.4166667,15.3222331
NM_018469,TEX2,12,11,115892,5134,110758,10068.90909,427.8333333,21.57343202
NM_006572,GNA13,4,3,47515,6315,41200,13733.33333,1578.75,6.524148852
NM_001037325,CEP112,7,6,191005,1318,189687,31614.5,188.2857143,143.9203338
NM_001081955,RGS9,19,18,90367,2534,87833,4879.611111,133.3684211,34.66179953
NM_001165933,RGS9,17,16,73326,1675,71651,4478.1875,98.52941176,42.77671642
NM_003835,RGS9,19,18,90367,2543,87824,4879.111111,133.8421053,34.53558789
NM_001282425,GNA13,4,3,46487,6005,40482,13494,1501.25,6.741382182
NM_000042,APOH,8,7,17411,1209,16202,2314.571429,151.125,13.40115798
NM_145811,CACNG5,5,4,8006,931,7075,1768.75,186.2,7.599355532
NM_002737,PRKCA,17,16,507938,8787,499151,31196.9375,516.8823529,56.80562194
NM_182641,BPTF,28,27,158716,10942,147774,5473.111111,390.7857143,13.50520929
NM_014877,HELZ,33,32,174767,13863,160904,5028.25,420.0909091,11.60672293
NM_012417,PITPNC1,9,8,319984,6257,313727,39215.875,695.2222222,50.14016302
NM_004459,BPTF,30,29,158716,10893,147823,5097.344828,363.1,13.57045809
NM_181671,PITPNC1,10,9,319984,6377,313607,34845.22222,637.7,49.17782656
NM_001243746,FAM20A,12,11,65840,4513,61327,5575.181818,376.0833333,13.58896521
NM_017565,FAM20A,11,10,65840,4286,61554,6155.4,389.6363636,14.36164256
NM_017983,WIPI1,13,12,36233,1937,34296,2858,149,17.70573051
NM_014960,ARSG,12,11,161679,2782,158897,14445.18182,231.8333333,57.11610352
NM_001267727,ARSG,12,11,129366,2611,126755,11523.18182,217.5833333,48.5465339
NM_080283,ABCA9,39,38,86365,6340,80025,2105.921053,162.5641026,12.62223975
NM_001278433,PRKAR1A,11,10,119808,4316,115492,11549.2,392.3636364,26.75903614
NM_002758,MAP2K6,12,11,127634,1881,125753,11432.09091,156.75,66.8543328
NM_080282,ABCA10,40,39,96810,6371,90439,2318.948718,159.275,14.19541673
NM_001159770,SLC39A11,10,9,446770,2792,443978,49330.88889,279.2,159.0179083
NM_139177,SLC39A11,10,9,446770,2771,443999,49333.22222,277.1,160.2306027
NM_032646,TTYH2,14,13,48463,3459,45004,3461.846154,247.0714286,13.01069673
NM_001144952,SDK2,45,44,309706,10767,298939,6794.068182,239.2666667,27.76437262
NM_001288610,HN1,5,4,18052,1662,16390,4097.5,332.4,9.861612515
NM_001002032,HN1,4,3,19442,1595,17847,5949,398.75,11.18934169
NM_001002033,HN1,6,5,19442,1711,17731,3546.2,285.1666667,10.36294565
NM_001126122,SLC25A19,7,6,16471,1575,14896,2482.666667,225,9.457777778
NM_001126121,SLC25A19,8,7,16471,1666,14805,2115,208.25,8.886554622
NM_001288611,HN1,5,4,19442,1619,17823,4455.75,323.8,11.00864731
NM_181449,CD300E,4,3,13877,3529,10348,3449.333333,882.25,2.932275432
NM_178128,FADS6,6,5,16234,2058,14176,2835.2,343,6.888241011
NM_001288609,HN1,5,4,19002,2299,16703,4175.75,459.8,7.265332753
NM_004252,SLC9A3R1,6,5,20750,2022,18728,3745.6,337,9.262116716
NM_016185,HN1,5,4,19442,1615,17827,4456.75,323,11.03839009
NM_021734,SLC25A19,8,7,16471,1650,14821,2117.285714,206.25,8.982424242
NM_014230,SRP68,16,15,33753,2866,30887,2059.133333,179.125,10.77704117
NM_001080419,UNK,16,15,40968,3879,37089,2472.6,242.4375,9.561484919
NM_004524,LLGL2,25,24,49509,3530,45979,1915.791667,141.2,13.02521246
NM_001080542,FBF1,29,28,30503,3891,26612,950.4285714,134.1724138,6.839372912
NM_002766,PRPSAP1,10,9,43364,2369,40995,4555,236.9,17.30476995
NM_001260502,SRP68,15,14,33753,2751,31002,2214.428571,183.4,11.2693566
NM_052916,RNF157,19,18,97858,4910,92948,5163.777778,258.4210526,18.93034623
NM_004259,RECQL5,20,19,40346,3733,36613,1927,186.65,9.807929279
NM_001003716,RECQL5,8,7,17477,2869,14608,2086.857143,358.625,5.091669571
NM_001003715,RECQL5,9,8,17477,2403,15074,1884.25,267,6.272992093
NM_001031803,LLGL2,26,25,49509,3574,45935,1837.4,137.4615385,12.85254617
NM_001015002,LLGL2,10,9,39023,1416,37607,4178.555556,141.6,26.55861582
NM_001113492,Sep-09,12,11,212707,4012,208695,18972.27273,334.3333333,52.01769691
NM_001113491,Sep-09,12,11,219188,3837,215351,19577.36364,319.75,56.12483711
NM_001204410,SEC14L1,18,17,127948,5600,122348,7196.941176,311.1111111,21.84785714
NM_001204408,SEC14L1,20,19,128458,3380,125078,6583.052632,169,37.00532544
NM_001081461,JMJD6,7,6,13969,5430,8539,1423.166667,775.7142857,1.572559853
NM_006640,Sep-09,11,10,181083,4468,176615,17661.5,406.1818182,39.52887198
NM_006456,ST6GALNAC2,9,8,20686,2114,18572,2321.5,234.8888889,8.785241249
NM_001163075,C17orf99,5,4,19932,1095,18837,4709.25,219,17.20273973
NM_001142640,TNRC6C,22,21,104600,9793,94807,4514.619048,445.1363636,9.681098744
NM_024419,PGS1,10,9,45906,2201,43705,4856.111111,220.1,19.85688323
NM_018996,TNRC6C,21,20,104600,9684,94916,4745.8,461.1428571,9.801321768
NM_017456,CYTH1,13,12,108248,3321,104927,8743.916667,255.4615385,31.59500151
NM_025090,USP36,20,19,44006,5254,38752,2039.578947,262.7,7.375713742
NM_001082575,RBFOX3,15,14,426805,3005,423800,30271.42857,200.3333333,141.031614
NM_004762,CYTH1,13,12,108248,3324,104924,8743.666667,255.6923077,31.56558363
NM_001256071,RNF213,68,67,137923,21125,116798,1743.253731,310.6617647,5.528899408
NM_019020,TBC1D16,12,11,103517,10958,92559,8414.454545,913.1666667,8.446705603
NM_020954,RNF213,17,16,60604,5341,55263,3453.9375,314.1764706,10.34693878
NM_014740,EIF4A3,12,11,11971,1746,10225,929.5454545,145.5,5.856242841
NM_017921,NPLOC4,17,16,80227,4398,75829,4739.3125,258.7058824,17.24170077
NM_006340,BAIAP2,15,14,82287,3367,78920,5637.142857,224.4666667,23.43926344
NM_017451,BAIAP2,15,14,82287,2909,79378,5669.857143,193.9333333,27.28704022
NM_017450,BAIAP2,14,13,75367,3202,72165,5551.153846,228.7142857,22.53747658
NM_014984,AZI1,26,25,33360,3645,29715,1188.6,140.1923077,8.152263374
NM_001144888,BAIAP2,14,13,82287,3320,78967,6074.384615,237.1428571,23.78524096
NM_001080519,BAHCC1,27,26,59820,10204,49616,1908.307692,377.9259259,4.862406899
NM_178520,TMEM105,3,2,19404,3322,16082,8041,1107.333333,4.841059603
NM_001009811,AZI1,25,24,33360,3536,29824,1242.666667,141.44,8.43438914
NM_139062,CSNK1D,10,9,31059,3779,27280,3031.111111,377.9,7.218840963
NM_024083,ASPSCR1,16,15,39858,1859,37999,2533.266667,116.1875,20.44055944
NM_198082,CCDC57,17,16,111345,3014,108331,6770.6875,177.2941176,35.94260119
NM_001893,CSNK1D,9,8,31059,3714,27345,3418.125,412.6666667,7.362681745
NM_001251888,ASPSCR1,17,16,39858,2142,37716,2357.25,126,17.60784314
NM_024648,OGFOD3,9,8,29429,4309,25120,3140,478.7777778,5.829658854
NM_004514,FOXK2,9,8,84891,5271,79620,9952.5,585.6666667,15.10529311
NM_175902,OGFOD3,10,9,29429,4523,24906,2767.333333,452.3,5.50652222
NM_001009905,B3GNTL1,13,12,108021,1396,106625,8885.416667,107.3846154,76.37893983
NM_003585,DOC2B,6,5,25412,1080,24332,4866.4,180,22.52962963
NM_001242780,LOC100506388,3,2,2285,1020,1265,632.5,340,1.240196078
NM_182705,FAM101B,2,1,5962,3622,2340,2340,1811,0.646051905
NM_024792,FAM57A,5,4,10230,2085,8145,2036.25,417,3.90647482
NM_016080,GLOD4,9,8,23024,1846,21178,2647.25,205.1111111,11.4723727
NM_018146,RNMTL1,4,3,10230,1805,8425,2808.333333,451.25,4.667590028
NM_001205319,NXN,8,7,64800,2689,62111,8873,336.125,23.09817776
NM_013337,TIMM22,4,3,5035,1677,3358,1119.333333,419.25,2.002385212
NM_001164405,BHLHA9,1,0,709,709,NA,NA,709,NA
NM_006761,YWHAE,6,5,55724,1833,53891,10778.2,305.5,29.40043644
NM_172367,TUSC5,3,2,21326,3599,17727,8863.5,1199.666667,4.925534871
NM_016823,CRK,3,2,34916,3228,31688,15844,1076,9.816604709
NM_130766,INPP5K,13,12,22313,3226,19087,1590.583333,248.1538462,5.916615003
NM_001135642,INPP5K,14,13,22313,3386,18927,1455.923077,241.8571429,5.589781453
NM_001080779,MYO1C,32,31,28523,4984,23539,759.3225806,155.75,4.722913323
NM_033375,MYO1C,32,31,27494,4768,22726,733.0967742,149,4.76635906
NM_016532,INPP5K,12,11,22313,2994,19319,1756.272727,249.5,6.45257181
NM_001080950,MYO1C,32,31,21573,4753,16820,542.5806452,148.53125,3.538817589
NM_005206,CRK,3,2,34916,3058,31858,15929,1019.333333,10.41792021
NM_145350,SCARF1,11,10,11933,3459,8474,847.4,314.4545455,2.449840995
NM_031430,RILP,8,7,3949,1799,2150,307.1428571,224.875,1.195108394
NM_001284498,SLC43A2,15,14,59123,8428,50695,3621.071429,561.8666667,6.015068818
NM_152346,SLC43A2,14,13,59634,8213,51421,3955.461538,586.6428571,6.260927797
NM_003693,SCARF1,11,10,11933,3496,8437,843.7,317.8181818,2.413329519
NM_001284499,SLC43A2,10,9,35782,7864,27918,3102,786.4,3.550101729
NM_001163811,WDR81,10,9,14061,3330,10731,1192.333333,333,3.222522523
NM_001164407,TLCD2,4,3,7580,5905,1675,558.3333333,1476.25,0.283657917
NM_001163809,WDR81,10,9,13770,6879,6891,765.6666667,687.9,1.00174444
NM_001163673,WDR81,10,9,22078,3194,18884,2098.222222,319.4,5.912335629
NM_002615,SERPINF1,8,7,15602,1541,14061,2008.714286,192.625,9.124594419
NM_001165921,SERPINF2,9,8,12431,2101,10330,1291.25,233.4444444,4.91670633
NM_001165920,SERPINF2,10,9,12241,2272,9969,1107.666667,227.2,4.387764085
NM_000934,SERPINF2,10,9,12431,2294,10137,1126.333333,229.4,4.418918919
NM_152348,WDR81,11,10,22078,3832,18246,1824.6,348.3636364,4.761482255
NM_002945,RPA1,17,16,69577,4362,65215,4075.9375,256.5882353,14.95071068
NM_001383,DPH1,13,12,13296,2208,11088,924,169.8461538,5.02173913
NM_006497,HIC1,2,1,4590,3159,1431,1431,1579.5,0.452991453
NM_080822,OVCA2,2,1,1450,1078,372,372,539,0.345083488
NM_001098202,HIC1,2,1,3379,3056,323,323,1528,0.105693717
NM_178568,RTN4RL1,2,1,90209,3166,87043,87043,1583,27.49305117
NM_020310,MNT,6,5,16906,4848,12058,2411.6,808,2.487211221
NM_014853,SGSM2,24,23,43544,4891,38653,1680.565217,203.7916667,7.902882846
NM_001098509,SGSM2,23,22,43542,4753,38789,1763.136364,206.6521739,8.160950978
NM_000430,PAFAH1B1,11,10,91988,5625,86363,8636.3,511.3636364,15.35342222
NM_015229,CLUH,26,25,22249,5250,16999,679.96,201.9230769,3.237904762
NM_014566,OR1D5,1,0,940,940,NA,NA,940,NA
NM_002548,OR1D2,1,0,940,940,NA,NA,940,NA
NM_012352,OR1A2,1,0,931,931,NA,NA,931,NA
NM_014565,OR1A1,1,0,931,931,NA,NA,931,NA
NM_003555,OR1G1,1,0,943,943,NA,NA,943,NA
NM_002551,OR3A2,1,0,1086,1086,NA,NA,1086,NA
NM_002550,OR3A1,1,0,949,949,NA,NA,949,NA
NM_001128085,ASPA,7,6,25298,1358,23940,3990,194,17.62886598
NM_003554,OR1E2,1,0,973,973,NA,NA,973,NA
NM_032598,SPATA22,9,8,31737,1474,30263,3782.875,163.7777778,20.5312076
NM_001170696,SPATA22,8,7,31838,1282,30556,4365.142857,160.25,23.83463339
NM_001170695,SPATA22,9,8,31838,1412,30426,3803.25,156.8888889,21.54815864
NM_001170697,SPATA22,9,8,31822,1418,30404,3800.5,157.5555556,21.44146685
NM_001170699,SPATA22,8,7,31763,1553,30210,4315.714286,194.125,19.45267225
NM_001170698,SPATA22,9,8,31795,1433,30362,3795.25,159.2222222,21.18771807
NM_000049,ASPA,6,5,23406,1424,21982,4396.4,237.3333333,15.43679775
NM_012373,OR3A3,1,0,967,967,NA,NA,967,NA
NM_003553,OR1E1,1,0,946,946,NA,NA,946,NA
NM_145068,TRPV3,18,17,47495,6128,41367,2433.352941,340.4444444,6.750489556
NM_080706,TRPV1,15,14,27433,4431,23002,1643,295.4,5.191153239
NM_080705,TRPV1,16,15,30387,4106,26281,1752.066667,256.625,6.40063322
NM_080704,TRPV1,17,16,43967,4181,39786,2486.625,245.9411765,9.515905286
NM_018727,TRPV1,16,15,31598,4063,27535,1835.666667,253.9375,6.77701206
NM_001258205,TRPV3,18,17,47495,6131,41364,2433.176471,340.6111111,6.746697113
NM_031965,GSG2,1,0,2797,2797,NA,NA,2797,NA
NM_001031681,CTNS,13,12,26637,4055,22582,1881.833333,311.9230769,5.56892725
NM_004937,CTNS,12,11,26637,4443,22194,2017.636364,370.25,4.995273464
NM_001204698,TAX1BP3,3,2,5788,1308,4480,2240,436,3.425076453
NM_001204520,P2RX5,11,10,23178,2247,20931,2093.1,204.2727273,9.315086782
NM_001204519,P2RX5,12,11,23178,2317,20861,1896.454545,193.0833333,9.003452741
NM_014604,TAX1BP3,4,3,5788,1387,4401,1467,346.75,3.173035328
NM_002561,P2RX5,12,11,23178,2320,20858,1896.181818,193.3333333,8.990517241
NM_175080,P2RX5,11,10,23178,2244,20934,2093.4,204,9.328877005
NM_001014764,EMC6,2,1,948,864,84,84,432,0.097222222
NM_031298,EMC6,2,1,948,751,197,197,375.5,0.262316911
NM_001114118,C17orf85,13,12,39502,8197,31305,2608.75,630.5384615,3.819080151
NM_032294,CAMKK1,16,15,32722,3570,29152,1943.466667,223.125,8.165826331
NM_172206,CAMKK1,16,15,30422,3516,26906,1793.733333,219.75,7.652445961
NM_172207,CAMKK1,16,15,27888,2474,25414,1694.266667,154.625,10.27243331
NM_005173,ATP2A3,21,20,40597,4747,35850,1792.5,226.047619,7.552138193
NM_174954,ATP2A3,23,22,40597,4895,35702,1622.818182,212.826087,7.293564862
NM_174958,ATP2A3,23,22,40597,4256,36341,1651.863636,185.0434783,8.538768797
NM_174957,ATP2A3,21,20,40597,4744,35853,1792.65,225.9047619,7.557546374
NM_174956,ATP2A3,22,21,40597,4849,35748,1702.285714,220.4090909,7.372241699
NM_174955,ATP2A3,22,21,40597,4836,35761,1702.904762,219.8181818,7.394747725
NM_174953,ATP2A3,23,22,40597,4908,35689,1622.227273,213.3913043,7.271597392
NM_144611,CYB5D2,4,3,14531,2002,12529,4176.333333,500.5,6.258241758
NM_001254755,CYB5D2,4,3,14082,1311,12771,4257,327.75,9.741418764
NM_001254756,CYB5D2,4,3,14535,1314,13221,4407,328.5,10.06164384
NM_016376,ANKFY1,25,24,100611,7984,92627,3859.458333,319.36,11.60157816
NM_001257999,ANKFY1,25,24,100479,8186,92293,3845.541667,327.44,11.27449304
NM_001124758,SPNS2,13,12,41101,4362,36739,3061.583333,335.5384615,8.422512609
NM_182538,SPNS3,12,11,54282,1905,52377,4761.545455,158.75,27.49448819
NM_198501,SMTNL2,8,7,24340,1945,22395,3199.285714,243.125,11.51413882
NM_001140,ALOX15,14,13,10748,2698,8050,619.2307692,192.7142857,2.983691623
NM_001114974,SMTNL2,8,7,23782,2293,21489,3069.857143,286.625,9.371565635
NM_001122890,GGT6,4,3,3671,2649,1022,340.6666667,662.25,0.385805965
NM_001288703,GGT6,4,3,3671,2059,1612,537.3333333,514.75,0.782904322
NM_001288704,GGT6,3,2,3671,1962,1709,854.5,654,0.871049949
NM_153338,GGT6,3,2,3671,2552,1119,559.5,850.6666667,0.438479624
NM_001288702,GGT6,4,3,3671,2667,1004,334.6666667,666.75,0.376452943
NM_199004,ARRB2,14,13,11008,1888,9120,701.5384615,134.8571429,4.830508475
NM_022059,CXCL16,6,5,6401,2334,4067,813.4,389,1.742502142
NM_032265,ZMYND15,13,12,6106,2320,3786,315.5,178.4615385,1.631896552
NM_002798,PSMB6,6,5,2361,858,1503,300.6,143,1.751748252
NM_001267822,ZMYND15,14,13,6106,2462,3644,280.3076923,175.8571429,1.480097482
NM_001144941,VMO1,2,1,1151,654,497,497,327,0.759938838
NM_001144940,VMO1,3,2,1151,751,400,200,250.3333333,0.532623169
NM_001144939,VMO1,3,2,1151,807,344,172,269,0.426270136
NM_001100812,CXCL16,5,4,5421,1456,3965,991.25,291.2,2.723214286
NM_001136046,ZMYND15,14,13,6106,2438,3668,282.1538462,174.1428571,1.504511895
NM_001257330,ARRB2,15,14,11008,1970,9038,645.5714286,131.3333333,4.587817259
NM_001257331,ARRB2,14,13,11008,1924,9084,698.7692308,137.4285714,4.721413721
NM_001257329,ARRB2,15,14,11008,1803,9207,657.6428571,120.2,5.106489185
NM_001257328,ARRB2,15,14,11008,1997,9011,643.6428571,133.1333333,4.512268403
NM_001270481,PSMB6,6,5,2361,878,1483,296.6,146.3333333,1.689066059
NM_004313,ARRB2,15,14,11008,1934,9074,648.1428571,128.9333333,4.691830403
NM_003963,TM4SF5,5,4,11321,713,10608,2652,142.6,14.87798036
NM_182566,VMO1,3,2,1151,771,380,190,257,0.492866407
NM_001001683,MED11,3,2,2175,833,1342,671,277.6666667,1.611044418
NM_001014985,GLTPD2,4,3,1632,1226,406,135.3333333,306.5,0.331158238
NM_015716,MINK1,31,30,64723,4937,59786,1992.866667,159.2580645,12.10978327
NM_000080,CHRNE,12,11,5307,2472,2835,257.7272727,206,1.14684466
NM_001024937,MINK1,32,31,64723,4989,59734,1926.903226,155.90625,11.97314091
NM_000173,GP1BA,2,1,2735,2503,232,232,1251.5,0.092688773
NM_001165418,SLC25A11,7,6,3038,1666,1372,228.6666667,238,0.823529412
NM_170663,MINK1,32,31,64723,4962,59761,1927.774194,155.0625,12.04373237
NM_003562,SLC25A11,8,7,3038,1820,1218,174,227.5,0.669230769
NM_015528,RNF167,10,9,4889,1718,3171,352.3333333,171.8,1.845750873
NM_001145536,C17orf107,3,2,3281,3085,196,98,1028.333333,0.063533225
NM_001165417,SLC25A11,8,7,3038,1787,1251,178.7142857,223.375,0.70005596
NM_153827,MINK1,32,31,64723,5049,59674,1924.967742,157.78125,11.81897405
NM_213726,INCA1,8,7,9482,1391,8091,1155.857143,173.875,5.816678648
NM_001104577,SLC52A1,5,4,2832,2420,412,103,484,0.170247934
NM_001167987,INCA1,8,7,9482,1274,8208,1172.571429,159.25,6.442700157
NM_001167986,INCA1,9,8,9482,1562,7920,990,173.5555556,5.070422535
NM_001167985,INCA1,8,7,9482,1229,8253,1179,153.625,6.715215622
NM_001171167,CAMTA2,23,22,19380,4875,14505,659.3181818,211.9565217,2.975384615
NM_001171166,CAMTA2,21,20,19675,4415,15260,763,210.2380952,3.456398641
NM_001171168,CAMTA2,22,21,19380,4804,14576,694.0952381,218.3636364,3.034138218
NM_001976,ENO3,12,11,6044,1539,4505,409.5454545,128.25,2.927225471
NM_006612,KIF1C,23,22,30453,7940,22513,1023.318182,345.2173913,2.835390428
NM_017986,SLC52A1,5,4,2832,2386,446,111.5,477.2,0.186923722
NM_015099,CAMTA2,23,22,19675,4533,15142,688.2727273,197.0869565,3.340392676
NM_001193503,ENO3,10,9,6044,1366,4678,519.7777778,136.6,3.424597365
NM_053013,ENO3,12,11,6044,1497,4547,413.3636364,124.75,3.03740815
NM_004890,SPAG7,7,6,8613,1032,7581,1263.5,147.4285714,7.345930233
NM_032530,ZNF594,2,1,12349,4879,7470,7470,2439.5,1.531051445
NM_014519,ZNF232,5,4,17368,2083,15285,3821.25,416.6,7.337974076
NM_004505,USP6,30,29,46639,8001,38638,1332.344828,266.7,4.829146357
NM_153018,ZFP3,2,1,17917,4997,12920,12920,2498.5,2.585551331
NM_207103,SCIMP,5,4,25941,2428,23513,5878.25,485.6,9.684102142
NM_001271842,SCIMP,5,4,25941,2407,23534,5883.5,481.4,9.777316161
NM_001033002,RPAIN,7,6,13381,1686,11695,1949.166667,240.8571429,6.93653618
NM_020162,DHX33,12,11,28150,5630,22520,2047.272727,469.1666667,4
NM_002532,NUP88,17,16,33715,2512,31203,1950.1875,147.7647059,12.42157643
NM_001199699,DHX33,11,10,28150,5468,22682,2268.2,497.0909091,4.148134601
NM_001160266,RPAIN,5,4,13381,1479,11902,2975.5,295.8,8.047329277
NM_001160244,RPAIN,6,5,13381,1544,11837,2367.4,257.3333333,7.666450777
NM_001160246,RPAIN,4,3,13381,1366,12015,4005,341.5,8.795754026
NM_001160243,RPAIN,6,5,10026,2660,7366,1473.2,443.3333333,2.769172932
NM_001212,C1QBP,6,5,6374,1169,5205,1041,194.8333333,4.452523524
NM_014922,NLRP1,16,15,70396,5497,64899,4326.6,343.5625,11.80625796
NM_024039,MIS12,3,2,3919,2538,1381,690.5,846,0.544129236
NM_033007,NLRP1,15,14,70396,5406,64990,4642.142857,360.4,12.0218276
NM_033006,NLRP1,16,15,70396,5539,64857,4323.8,346.1875,11.70915328
NM_033004,NLRP1,17,16,70396,5630,64766,4047.875,331.1764706,11.50373002
NM_001033053,NLRP1,16,15,83115,5114,78001,5200.066667,319.625,15.25244427
NM_001258218,MIS12,2,1,4438,2301,2137,2137,1150.5,0.928726641
NM_001258220,MIS12,2,1,4438,2037,2401,2401,1018.5,1.178694158
NM_001258219,MIS12,3,2,4438,2432,2006,1003,810.6666667,0.824835526
NM_001258217,MIS12,3,2,4438,2696,1742,871,898.6666667,0.646142433
NM_001162371,LOC728392,2,1,1574,1495,79,79,747.5,0.052842809
NM_016041,DERL2,7,6,11883,1131,10752,1792,161.5714286,9.5066313
NM_015253,WSCD1,9,8,53815,5830,47985,5998.125,647.7777778,8.230703259
NM_019013,FAM64A,6,5,6652,1550,5102,1020.4,258.3333333,3.291612903
NM_001285400,AIPL1,6,5,11464,2913,8551,1710.2,485.5,2.935461723
NM_001195228,FAM64A,5,4,6652,1504,5148,1287,300.8,3.42287234
NM_014336,AIPL1,6,5,11464,2979,8485,1697,496.5,2.848271232
NM_001285402,AIPL1,6,5,11397,2970,8427,1685.4,495,2.837373737
NM_001285401,AIPL1,6,5,11464,2907,8557,1711.4,484.5,2.943584451
NM_001285403,AIPL1,5,4,9149,1423,7726,1931.5,284.6,5.429374561
NM_001285399,AIPL1,6,5,11464,2943,8521,1704.2,490.5,2.895344886
NM_001033055,AIPL1,5,4,11464,2798,8666,2166.5,559.6,3.097212294
NM_001033054,AIPL1,5,4,11464,2789,8675,2168.75,557.8,3.110433847
NM_032731,TXNDC17,4,3,3641,2079,1562,520.6666667,519.75,0.751322751
NM_014804,KIAA0753,19,18,62604,4704,57900,3216.666667,247.5789474,12.30867347
NM_001105520,C17orf100,1,0,1560,1560,NA,NA,1560,NA
NM_017523,XAF1,7,6,19810,3631,16179,2696.5,518.7142857,4.455797301
NM_199139,XAF1,6,5,19810,3573,16237,3247.4,595.5,4.544360481
NM_001143838,SLC13A5,11,10,28710,3162,25548,2554.8,287.4545455,8.079696395
NM_177550,SLC13A5,12,11,28710,3301,25409,2309.909091,275.0833333,7.697364435
NM_001284509,SLC13A5,12,11,28710,3250,25460,2314.545455,270.8333333,7.833846154
NM_001284510,SLC13A5,11,10,28710,3171,25539,2553.9,288.2727273,8.053926206
NM_053285,TEKT1,8,7,31762,1421,30341,4334.428571,177.625,21.35186488
NM_201566,SLC16A13,4,3,4048,1752,2296,765.3333333,438,1.310502283
NM_181844,BCL6B,9,8,6594,3534,3060,382.5,392.6666667,0.865874363
NM_001142799,C17orf49,5,4,2789,802,1987,496.75,160.4,2.47755611
NM_001142798,C17orf49,6,5,2789,909,1880,376,151.5,2.068206821
NM_001004333,RNASEK,3,2,2118,814,1304,652,271.3333333,1.601965602
NM_000697,ALOX12,14,13,14673,2372,12301,946.2307692,169.4285714,5.185919056
NM_174893,C17orf49,6,5,2789,905,1884,376.8,150.8333333,2.081767956
NM_006344,CLEC10A,9,8,5746,1708,4038,504.75,189.7777778,2.364168618
NM_001201352,ASGR2,9,8,13491,1450,12041,1505.125,161.1111111,8.304137931
NM_080914,ASGR2,8,7,12990,1210,11780,1682.857143,151.25,9.73553719
NM_080913,ASGR2,9,8,13491,1393,12098,1512.25,154.7777778,8.684852836
NM_080912,ASGR2,9,8,13491,1553,11938,1492.25,172.5555556,7.687057308
NM_182906,CLEC10A,9,8,5746,1780,3966,495.75,197.7777778,2.228089888
NM_001181,ASGR2,9,8,13491,1465,12026,1503.25,162.7777778,8.20887372
NM_015982,YBX2,9,8,6307,1592,4715,589.375,176.8888889,2.961683417
NM_015343,CTDNEP1,9,8,8355,1789,6566,820.75,198.7777778,3.670206819
NM_203415,ELP5,9,8,7889,1322,6567,820.875,146.8888889,4.967473525
NM_001185023,CLDN7,3,2,3044,1927,1117,558.5,642.3333333,0.579657499
NM_001033859,ACADVL,19,18,5438,2245,3193,177.3888889,118.1578947,1.422271715
NM_001128827,DLG4,20,19,27720,3465,24255,1276.578947,173.25,7
NM_024297,PHF23,5,4,4480,2042,2438,609.5,408.4,1.193927522
NM_007278,GABARAP,4,3,2017,897,1120,373.3333333,224.25,1.248606466
NM_001270448,ACADVL,19,18,5438,2386,3052,169.5555556,125.5789474,1.279128248
NM_001270447,ACADVL,21,20,8144,2249,5895,294.75,107.0952381,2.621164962
NM_015362,ELP5,9,8,7741,1429,6312,789,158.7777778,4.417074878
NM_001365,DLG4,22,21,30161,4344,25817,1229.380952,197.4545455,5.943139963
NM_001042,SLC2A4,11,10,6315,3160,3155,315.5,287.2727273,0.998417722
NM_001143775,CTDNEP1,8,7,8091,1721,6370,910,215.125,3.701336432
NM_000018,ACADVL,20,19,5438,2312,3126,164.5263158,115.6,1.352076125
NM_001185022,CLDN7,5,4,3292,1447,1845,461.25,289.4,1.275051831
NM_001307,CLDN7,4,3,3044,2013,1031,343.6666667,503.25,0.512170889
NM_004422,DVL2,15,14,9204,3031,6173,440.9285714,202.0666667,2.036621577
NM_203413,ELP5,7,6,7741,2213,5528,921.3333333,316.1428571,2.497966561
NM_203414,ELP5,8,7,7741,1516,6225,889.2857143,189.5,4.106200528
NM_001284518,PHF23,5,4,3904,1926,1978,494.5,385.2,1.026998962
NM_001284517,PHF23,5,4,4480,1841,2639,659.75,368.2,1.433460076
NM_001002914,KCTD11,1,0,3056,3056,NA,NA,3056,NA
NM_001143760,EIF5A,6,5,5466,1262,4204,840.8,210.3333333,3.331220285
NM_001143761,EIF5A,6,5,4496,1290,3206,641.2,215,2.485271318
NM_020795,NLGN2,7,6,11683,4653,7030,1171.666667,664.7142857,1.510853213
NM_198154,TMEM95,7,6,2043,1176,867,144.5,168,0.737244898
NM_001005408,NEURL4,29,28,13689,5210,8479,302.8214286,179.6551724,1.627447217
NM_032442,NEURL4,29,28,13689,5216,8473,302.6071429,179.862069,1.624424847
NM_152766,TMEM256,4,3,1159,485,674,224.6666667,121.25,1.389690722
NM_001251902,TNK1,13,12,8801,2935,5866,488.8333333,225.7692308,1.998637138
NM_001970,EIF5A,6,5,4928,1361,3567,713.4,226.8333333,2.62086701
NM_001143762,EIF5A,6,5,4090,1346,2744,548.8,224.3333333,2.038632987
NM_020360,PLSCR3,8,7,5117,2077,3040,434.2857143,259.625,1.463649494
NM_001201576,PLSCR3,8,7,5117,1969,3148,449.7142857,246.125,1.598781107
NM_199339,SPEM1,3,2,1274,985,289,144.5,328.3333333,0.293401015
NM_014716,ACAP1,22,21,14947,2530,12417,591.2857143,115,4.907905138
NM_004489,GPS2,11,10,2682,1168,1514,151.4,106.1818182,1.296232877
NM_003985,TNK1,13,12,8801,2920,5881,490.0833333,224.6153846,2.014041096
NM_175734,C17orf74,3,2,1953,1652,301,150.5,550.6666667,0.18220339
NM_001198624,TNFSF13,6,5,3318,1506,1812,362.4,251,1.203187251
NM_001128833,ZBTB4,4,3,20261,5870,14391,4797,1467.5,2.451618399
NM_020899,ZBTB4,4,3,24885,5946,18939,6313,1486.5,3.185166498
NM_003808,TNFSF13,6,5,3318,2282,1036,207.2,380.3333333,0.45398773
NM_003809,TNFSF12,7,6,8834,1393,7441,1240.166667,199,5.341708543
NM_172087,TNFSF13,5,4,3318,2233,1085,271.25,446.6,0.485893417
NM_000937,POLR2A,29,28,30239,6767,23472,838.2857143,233.3448276,3.468597606
NM_001198623,TNFSF13,5,4,3318,2197,1121,280.25,439.4,0.510241238
NM_001102614,SLC35G6,2,1,1664,1197,467,467,598.5,0.390142022
NM_001198622,TNFSF13,5,4,3318,2200,1118,279.5,440,0.508181818
NM_000747,CHRNB1,11,10,12528,2448,10080,1008,222.5454545,4.117647059
NM_004112,FGF11,5,4,5564,2720,2844,711,544,1.045588235
NM_172089,TNFSF12-TNFSF13,11,10,12552,1875,10677,1067.7,170.4545455,5.6944
NM_172088,TNFSF13,7,6,3318,2102,1216,202.6666667,300.2857143,0.57849667
NM_001276696,TP53,12,11,19150,2736,16414,1492.181818,228,5.999269006
NM_006942,SOX15,2,1,1992,1396,596,596,698,0.426934097
NM_001276760,TP53,11,10,19150,2602,16548,1654.8,236.5454545,6.35972329
NM_001276697,TP53,7,6,7093,2278,4815,802.5,325.4285714,2.113696225
NM_001276695,TP53,12,11,19150,2663,16487,1498.818182,221.9166667,6.191137814
NM_001276699,TP53,8,7,7093,2339,4754,679.1428571,292.375,2.032492518
NM_001204510,EIF4A1,11,10,6302,1826,4476,447.6,166,2.451259584
NM_001040059,CD68,6,5,2625,1780,845,169,296.6666667,0.474719101
NM_133491,SAT2,6,5,1640,969,671,134.2,161.5,0.69246646
NM_004860,FXR2,17,16,23669,3004,20665,1291.5625,176.7058824,6.879161119
NM_001251,CD68,6,5,2626,1862,764,152.8,310.3333333,0.410311493
NM_001678,ATP1B2,7,6,6837,3339,3498,583,477,1.047619048
NM_001416,EIF4A1,11,10,6302,1888,4414,441.4,171.6363636,2.337923729
NM_001126118,TP53,10,9,19150,2718,16432,1825.777778,271.8,6.045621781
NM_001276761,TP53,11,10,19150,2599,16551,1655.1,236.2727273,6.368218546
NM_001276698,TP53,8,7,7093,2412,4681,668.7142857,301.5,1.940713101
NM_000546,TP53,11,10,19150,2602,16548,1654.8,236.5454545,6.35972329
NM_001126117,TP53,8,7,7093,2339,4754,679.1428571,292.375,2.032492518
NM_001126112,TP53,11,10,19150,2599,16551,1655.1,236.2727273,6.368218546
NM_001126116,TP53,8,7,7093,2412,4681,668.7142857,301.5,1.940713101
NM_001126114,TP53,12,11,19150,2736,16414,1492.181818,228,5.999269006
NM_001040,SHBG,8,7,3291,1327,1964,280.5714286,165.875,1.480030143
NM_001126115,TP53,7,6,7093,2278,4815,802.5,325.4285714,2.113696225
NM_001126113,TP53,12,11,19150,2663,16487,1498.818182,221.9166667,6.191137814
NM_004870,MPDU1,7,6,4564,1625,2939,489.8333333,232.1428571,1.808615385
NM_001289113,SHBG,8,7,5416,1320,4096,585.1428571,165,3.103030303
NM_001289115,SHBG,7,6,5416,1111,4305,717.5,158.7142857,3.874887489
NM_001146279,SHBG,8,7,3291,1273,2018,288.2857143,159.125,1.585231736
NM_001146280,SHBG,7,6,3291,1118,2173,362.1666667,159.7142857,1.943649374
NM_001146281,SHBG,6,5,3291,980,2311,462.2,163.3333333,2.358163265
NM_001289116,SHBG,8,7,3291,1235,2056,293.7142857,154.375,1.664777328
NM_001289114,SHBG,8,7,19321,1183,18138,2591.142857,147.875,15.33220626
NM_001406,EFNB3,5,4,6175,3224,2951,737.75,644.8,0.915322581
NM_005852,CHD3,39,38,23908,7262,16646,438.0526316,186.2051282,2.292206004
NM_001037144,CNTROB,19,18,17797,4162,13635,757.5,219.0526316,3.276069198
NM_021210,TRAPPC1,4,3,1606,823,783,261,205.75,0.951397327
NM_032356,NAA38,2,1,1171,1001,170,170,500.5,0.16983017
NM_001080424,KDM6B,22,21,14885,6726,8159,388.5238095,305.7272727,1.213053821
NM_001005273,CHD3,40,39,23908,7365,16543,424.1794872,184.125,2.246164291
NM_203411,TMEM88,2,1,1035,876,159,159,438,0.181506849
NM_144607,CYB5D1,4,3,4538,3750,788,262.6666667,937.5,0.210133333
NM_053051,CNTROB,19,18,17797,4096,13701,761.1666667,215.5789474,3.344970703
NM_001166621,TRAPPC1,5,4,1656,764,892,223,152.8,1.167539267
NM_004732,KCNAB3,14,13,7578,2472,5106,392.7692308,176.5714286,2.065533981
NM_001005271,CHD3,40,39,27954,7394,20560,527.1794872,184.85,2.780632946
NM_001141,ALOX15B,14,13,10095,2729,7366,566.6153846,194.9285714,2.6991572
NM_000180,GUCY2D,20,19,17672,3643,14029,738.3684211,182.15,3.850947022
NM_001039131,ALOX15B,12,11,10095,2505,7590,690,208.75,3.02994012
NM_001039130,ALOX15B,13,12,10095,2641,7454,621.1666667,203.1538462,2.822415752
NM_001139,ALOX12B,15,14,15069,2517,12552,896.5714286,167.8,4.986889154
NM_032580,HES7,4,3,3504,1671,1833,611,417.75,1.096947935
NM_017622,C17orf59,1,0,1915,1915,NA,NA,1915,NA
NM_002616,PER1,23,22,11967,4732,7235,328.8636364,205.7391304,1.528951817
NM_183065,TMEM107,5,4,3419,1762,1657,414.25,352.4,0.940408627
NM_032354,TMEM107,5,4,3419,1780,1639,409.75,356,0.920786517
NM_001165960,ALOXE3,16,15,23018,3413,19605,1307,213.3125,5.744213302
NM_014232,VAMP2,5,4,3830,2160,1670,417.5,432,0.773148148
NM_001256834,AURKB,8,7,5897,1232,4665,666.4285714,154,3.786525974
NM_004217,AURKB,9,8,5897,1306,4591,573.875,145.1111111,3.515313936
NM_021628,ALOXE3,16,15,22644,3249,19395,1293,203.0625,5.969529086
NM_001165967,HES7,4,3,3504,1686,1818,606,421.5,1.078291815
NM_001284526,AURKB,9,8,5897,1309,4588,573.5,145.4444444,3.504965623
NM_025099,CTC1,23,22,23276,7095,16181,735.5,308.4782609,2.280620155
NM_025014,ARHGEF15,16,15,11696,4156,7540,502.6666667,259.75,1.814244466
NM_201520,SLC25A35,6,5,7090,2791,4299,859.8,465.1666667,1.540308133
NM_016492,RANGRF,5,4,1442,859,583,145.75,171.8,0.678696158
NM_012393,PFAS,28,27,21215,5413,15802,585.2592593,193.3214286,2.919268428
NM_001177801,RANGRF,4,3,1442,1082,360,120,270.5,0.33271719
NM_001177802,RANGRF,3,2,1442,1169,273,136.5,389.6666667,0.233532934
NM_173728,ARHGEF15,16,15,12280,4220,8060,537.3333333,263.75,1.909952607
NM_153007,ODF4,3,2,6177,1152,5025,2512.5,384,4.361979167
NM_213597,KRBA2,2,1,2887,1966,921,921,983,0.468463886
NM_001025579,NDEL1,10,9,32327,2443,29884,3320.444444,244.3,12.23250102
NM_000987,RPL26,4,3,5733,586,5147,1715.666667,146.5,8.783276451
NM_030808,NDEL1,9,8,32327,2407,29920,3740,267.4444444,12.4304113
NM_001146684,RNF222,3,2,7123,3069,4054,2027,1023,1.32095145
NM_001158261,CCDC42,6,5,14910,1164,13746,2749.2,194,11.80927835
NM_144681,CCDC42,7,6,14910,1387,13523,2253.833333,198.1428571,9.749819755
NM_001010855,PIK3R6,20,19,64941,3060,61881,3256.894737,153,20.22254902
NM_001128076,SPDYE4,6,5,5455,929,4526,905.2,154.8333333,4.871905274
NM_152599,MFSD6L,1,0,2241,2241,NA,NA,2241,NA
NM_001142633,PIK3R5,19,18,86798,4515,82283,4571.277778,237.6315789,18.22436323
NM_014308,PIK3R5,19,18,33603,4452,29151,1619.5,234.3157895,6.547843666
NM_001251853,PIK3R5,18,17,86798,4360,82438,4849.294118,242.2222222,18.90779817
NM_001251855,PIK3R5,18,17,86798,4339,82459,4850.529412,241.0555556,19.00414842
NM_001251852,PIK3R5,18,17,86798,4398,82400,4847.058824,244.3333333,18.73578899
NM_001251851,PIK3R5,19,18,86798,4577,82221,4567.833333,240.8947368,17.96395019
NM_145054,WDR16,14,13,66834,2207,64627,4971.307692,157.6428571,29.28273675
NM_001080556,WDR16,13,12,66834,2002,64832,5402.666667,154,32.38361638
NM_001220493,DHRS7C,6,5,19865,1012,18853,3770.6,168.6666667,18.62944664
NM_001105571,DHRS7C,6,5,19865,1009,18856,3771.2,168.1666667,18.68780971
NM_002903,RCVRN,3,2,7659,1178,6481,3240.5,392.6666667,5.501697793
NM_004246,GLP2R,13,12,63643,1675,61968,5164,128.8461538,36.9958209
NM_002472,MYH8,40,39,31627,6078,25549,655.1025641,151.95,4.203520895
NM_005963,MYH1,40,39,26234,6060,20174,517.2820513,151.5,3.329042904
NM_017534,MYH2,40,39,28554,6126,22428,575.0769231,153.15,3.661116552
NM_001100112,MYH2,40,39,28477,6126,22351,573.1025641,153.15,3.648547176
NM_002470,MYH3,41,40,28785,6079,22706,567.65,148.2682927,3.735153808
NM_004589,SCO1,6,5,17238,1760,15478,3095.6,293.3333333,8.794318182
NM_020233,ADPRM,4,3,13950,1522,12428,4142.666667,380.5,8.165571616
NM_001101387,PIRT,2,1,15628,3468,12160,12160,1734,3.506343714
NM_144680,ZNF18,9,8,19929,2776,17153,2144.125,308.4444444,6.179034582
NM_173717,ELAC2,24,23,26454,3825,22629,983.8695652,159.375,5.916078431
NM_018127,ELAC2,24,23,26454,3828,22626,983.7391304,159.5,5.910658307
NM_001165962,ELAC2,23,22,26454,3707,22747,1033.954545,161.173913,6.136228756
NM_001007530,CDRT15,3,2,979,570,409,204.5,190,0.71754386
NM_006041,HS3ST3B1,2,1,44988,2034,42954,42954,1017,21.1179941
NM_001281456,PMP22,5,4,35582,1862,33720,8430,372.4,18.10955961
NM_001281455,PMP22,5,4,32814,1827,30987,7746.75,365.4,16.96059113
NM_000304,PMP22,5,4,35582,1866,33716,8429,373.2,18.06859593
NM_153322,PMP22,4,3,31069,1744,29325,9775,436,16.81479358
NM_153321,PMP22,5,4,32814,1823,30991,7747.75,364.6,17
NM_031898,TEKT3,9,8,37831,1793,36038,4504.75,199.2222222,20.09927496
NM_001204477,CDRT4,4,3,31595,2502,29093,9697.666667,625.5,11.62789768
NM_006382,CDRT1,12,11,31043,2775,28268,2569.818182,231.25,10.18666667
NM_006470,TRIM16,9,8,54915,2910,52005,6500.625,323.3333333,17.87113402
NM_001282540,CDRT1,13,12,54224,3223,51001,4250.083333,247.9230769,15.82407695
NM_001130842,ZNF286A,6,5,21211,5464,15747,3149.4,910.6666667,2.881954612
NM_020652,ZNF286A,6,5,21211,5551,15660,3132,925.1666667,2.821113313
NM_001288642,ZNF286A,6,5,21211,5391,15820,3164,898.5,2.934520497
NM_178571,TBC1D26,15,14,12509,1884,10625,758.9285714,125.6,5.639596603
NM_001288648,ZNF286A,5,4,21211,5290,15921,3980.25,1058,3.009640832
NM_001288645,ZNF286A,6,5,21211,5610,15601,3120.2,935,2.780926916
NM_001288644,ZNF286A,4,3,21211,5115,16096,5365.333333,1278.75,3.146823069
NM_001288643,ZNF286A,5,4,21211,5231,15980,3995,1046.2,3.054865227
NM_001288646,ZNF286A,6,5,21211,5523,15688,3137.6,920.5,2.840485244
NM_001288647,ZNF286A,5,4,21211,5407,15804,3951,1081.4,2.922877751
NM_001288649,ZNF286A,4,3,21211,5110,16101,5367,1277.5,3.150880626
NM_001042698,ZSWIM7,6,5,23133,1883,21250,4250,313.8333333,11.28518322
NM_001271420,TTC19,10,9,30031,3646,26385,2931.666667,364.6,7.236697751
NM_001042697,ZSWIM7,5,4,23133,2012,21121,5280.25,402.4,10.49751491
NM_017775,TTC19,10,9,30031,3509,26522,2946.888889,350.9,7.558278712
NM_001190438,NCOR1,19,18,103071,3119,99952,5552.888889,164.1578947,32.04616864
NM_001281720,UBB,2,1,1650,865,785,785,432.5,0.907514451
NM_001281719,UBB,2,1,1457,1019,438,438,509.5,0.42983317
NM_001281718,UBB,2,1,1406,1021,385,385,510.5,0.377081293
NM_001281717,UBB,2,1,1282,1061,221,221,530.5,0.208294062
NM_001281716,UBB,2,1,1954,1090,864,864,545,0.79266055
NM_016113,TRPV2,15,14,21463,2823,18640,1331.428571,188.2,6.602904711
NM_018955,UBB,2,1,1950,1234,716,716,617,0.580226904
NM_020653,ZNF287,6,5,18891,4284,14607,2921.4,714,3.409663866
NM_020787,ZNF624,6,5,33121,4250,28871,5774.2,708.3333333,6.793176471
NM_012452,TNFRSF13B,5,4,33006,1363,31643,7910.75,272.6,23.21570066
NM_144606,FLCN,8,7,16019,1749,14270,2038.571429,218.625,8.15894797
NM_144997,FLCN,14,13,24977,3700,21277,1636.692308,264.2857143,5.750540541
NM_178836,PLD6,2,1,5339,2579,2760,2760,1289.5,1.070182241
NM_020201,NT5M,5,4,44299,1593,42706,10676.5,318.6,26.80853735
NM_018019,MED9,2,1,16236,2224,14012,14012,1112,6.300359712
NM_001199989,RASD1,2,1,1958,1674,284,284,837,0.169653524
NM_001243312,SMCR9,3,2,4072,546,3526,1763,182,6.457875458
NM_016084,RASD1,2,1,1958,1748,210,210,874,0.1201373
NM_001005291,SREBF1,20,19,25664,5021,20643,1086.473684,251.05,4.111332404
NM_004176,SREBF1,19,18,25664,4930,20734,1151.888889,259.4736842,4.205679513
NM_145691,ATPAF2,8,7,21148,1560,19588,2798.285714,195,12.55641026
NM_001130092,LRRC48,13,12,35017,2060,32957,2746.416667,158.4615385,15.99854369
NM_031294,LRRC48,14,13,44064,2080,41984,3229.538462,148.5714286,20.18461538
NM_001130090,LRRC48,15,14,44064,2170,41894,2992.428571,144.6666667,19.30599078
NM_001130091,LRRC48,14,13,35017,2150,32867,2528.230769,153.5714286,15.28697674
NM_001388,DRG2,13,12,20120,2010,18110,1509.166667,154.6153846,9.009950249
NM_016239,MYO15A,65,64,71098,11928,59170,924.53125,183.5076923,4.960596915
NM_004140,LLGL1,23,22,19254,4247,15007,682.1363636,184.6521739,3.533553096
NM_002018,FLII,30,29,14101,4387,9714,334.9655172,146.2333333,2.214269432
NM_001256265,FLII,29,28,14101,4221,9880,352.8571429,145.5517241,2.340677565
NM_001256264,FLII,30,29,13741,4208,9533,328.7241379,140.2666667,2.265446768
NM_001144900,MIEF2,4,3,5249,2523,2726,908.6666667,630.75,1.08045977
NM_139162,MIEF2,4,3,5249,2597,2652,884,649.25,1.021178283
NM_004618,TOP3A,19,18,41088,4135,36953,2052.944444,217.6315789,8.936638452
NM_148886,MIEF2,4,3,4673,2445,2228,742.6666667,611.25,0.911247444
NM_001281786,SHMT1,11,10,35705,2448,33257,3325.7,222.5454545,13.58537582
NM_148918,SHMT1,11,10,35705,2447,33258,3325.8,222.4545455,13.59133633
NM_001145127,EVPLL,11,10,11883,2002,9881,988.1,182,4.935564436
NM_004169,SHMT1,12,11,35705,2565,33140,3012.727273,213.75,12.92007797
NM_001040078,LGALS9C,11,10,18162,1730,16432,1643.2,157.2727273,9.498265896
NM_001039397,TBC1D28,10,9,8900,1988,6912,768,198.8,3.476861167
NM_001145045,ZNF286B,5,4,23832,5333,18499,4624.75,1066.6,3.468779299
NM_001037330,TRIM16L,5,4,14031,1987,12044,3011,397.4,6.061399094
NM_001267586,FBXW10,13,12,35338,3296,32042,2670.166667,253.5384615,9.721480583
NM_001267585,FBXW10,14,13,35338,3456,31882,2452.461538,246.8571429,9.225115741
NM_016078,TVP23B,7,6,25446,1796,23650,3941.666667,256.5714286,13.16815145
NM_001243941,PRPSAP2,10,9,73220,1881,71339,7926.555556,188.1,37.92610314
NM_001243940,PRPSAP2,10,9,65819,1689,64130,7125.555556,168.9,37.96921255
NM_001243936,PRPSAP2,10,9,74989,1847,73142,8126.888889,184.7,39.60043313
NM_002767,PRPSAP2,12,11,73220,2032,71188,6471.636364,169.3333333,35.03346457
NM_001243942,PRPSAP2,11,10,74989,1915,73074,7307.4,174.0909091,38.15874674
NM_001039999,FAM83G,6,5,33681,2936,30745,6149,489.3333333,10.47173025
NM_006613,GRAP,5,4,26348,2038,24310,6077.5,407.6,11.92836114
NM_001129778,GRAPL,4,3,31368,971,30397,10132.33333,242.75,31.30484037
NM_001243473,B9D1,6,5,19565,1169,18396,3679.2,194.8333333,15.73652695
NM_015681,B9D1,7,6,19565,935,18630,3105,133.5714286,19.92513369
NM_001102664,EPN2,8,7,99340,3784,95556,13650.85714,473,25.25264271
NM_014964,EPN2,11,10,99340,4846,94494,9449.4,440.5454545,19.49938093
NM_148921,EPN2,10,9,99340,4674,94666,10518.44444,467.4,20.25374412
NM_002404,MFAP4,6,5,3779,1858,1921,384.2,309.6666667,1.033907427
NM_139034,MAPK7,7,6,5085,2858,2227,371.1666667,408.2857143,0.779216235
NM_139033,MAPK7,7,6,5825,3157,2668,444.6666667,451,0.845106113
NM_139032,MAPK7,5,4,5825,2752,3073,768.25,550.4,1.116642442
NM_007148,RNF112,14,13,6100,3242,2858,219.8461538,231.5714286,0.881554596
NM_002749,MAPK7,7,6,5085,2946,2139,356.5,420.8571429,0.726069246
NM_001198695,MFAP4,6,5,3779,1967,1812,362.4,327.8333333,0.921199797
NM_018242,SLC47A1,17,16,45181,3296,41885,2617.8125,193.8823529,12.70782767
NM_001031806,ALDH3A2,11,10,28842,3834,25008,2500.8,348.5454545,6.522691706
NM_001256663,SLC47A2,18,17,38417,2307,36110,2124.117647,128.1666667,15.65236238
NM_000691,ALDH3A1,11,10,10450,1789,8661,866.1,162.6363636,4.841252096
NM_001135168,ALDH3A1,10,9,7476,1938,5538,615.3333333,193.8,2.857585139
NM_001135167,ALDH3A1,11,10,7629,1784,5845,584.5,162.1818182,3.276345291
NM_001099646,SLC47A2,17,16,38417,2264,36153,2259.5625,133.1764706,15.96863958
NM_000382,ALDH3A2,10,9,28846,3712,25134,2792.666667,371.2,6.771012931
NM_152908,SLC47A2,17,16,38417,2372,36045,2252.8125,139.5294118,15.1960371
NM_001142610,ULK2,28,27,97098,3926,93172,3450.814815,140.2142857,23.73204279
NM_014683,ULK2,27,26,97098,9166,87932,3382,339.4814815,9.593279511
NM_007202,AKAP10,15,14,73406,3956,69450,4960.714286,263.7333333,17.55561173
NM_001033554,SPECC1,6,5,83438,4888,78550,15710,814.6666667,16.06996727
NM_001243438,SPECC1,6,5,83438,4897,78541,15708.2,816.1666667,16.03859506
NM_001042685,LGALS9B,11,10,17674,1254,16420,1642,114,13.09409888
NM_001190790,CDRT15L2,2,1,1189,1050,139,139,525,0.132380952
NM_001004306,CCDC144NL,4,3,32747,2810,29937,9979,702.5,10.65373665
NM_015276,USP22,13,12,43448,5233,38215,3184.583333,402.5384615,7.302694439
NM_015510,DHRS7B,7,6,65046,1848,63198,10533,264,34.19805195
NM_145109,MAP2K3,12,11,30585,2330,28255,2568.636364,194.1666667,12.12660944
NM_152914,C17orf103,3,2,14396,4788,9608,4804,1596,2.006683375
NM_002756,MAP2K3,12,11,27205,2072,25133,2284.818182,172.6666667,12.12982625
NM_021012,KCNJ12,3,2,43482,5233,38249,19124.5,1744.333333,7.309191668
NM_001194958,KCNJ18,3,2,12036,2201,9835,4917.5,733.6666667,4.468423444
NM_001113434,C17orf51,2,1,23372,7914,15458,15458,3957,1.95324741
NM_001190452,MTRNR2L1,1,0,1556,1556,NA,NA,1556,NA
NM_015626,WSB1,9,8,19541,2841,16700,2087.5,315.6666667,5.878211897
NM_134265,WSB1,7,6,19541,2401,17140,2856.666667,343,7.138692212
NM_009587,LGALS9,11,10,18414,1775,16639,1663.9,161.3636364,9.374084507
NM_002308,LGALS9,10,9,18414,1678,16736,1859.555556,167.8,9.973778308
NM_000625,NOS2,27,26,43765,4233,39532,1520.461538,156.7777778,9.339003071
NM_021137,TNFAIP1,7,6,11489,3816,7673,1278.833333,545.1428571,2.010744235
NM_015584,POLDIP2,11,10,10946,2731,8215,821.5,248.2727273,3.008055657
NM_080669,SLC46A1,6,5,11571,6495,5078,1015.6,1082.5,0.781832179
NM_001080837,SEBOX,3,2,977,668,309,154.5,222.6666667,0.46257485
NM_015077,SARM1,10,9,29374,7303,22073,2452.555556,730.3,3.022456525
NM_152464,TMEM199,6,5,4404,1455,2949,589.8,242.5,2.026804124
NM_001267778,IFT20,4,3,7166,778,6388,2129.333333,194.5,8.210796915
NM_001267774,IFT20,6,5,7166,1121,6045,1209,186.8333333,5.39250669
NM_014573,TMEM97,3,2,9592,2571,7021,3510.5,857,2.73084403
NM_001242366,SLC46A1,5,4,11571,6410,5163,1290.75,1282,0.805460218
NM_001267777,IFT20,6,5,7166,844,6322,1264.4,140.6666667,7.490521327
NM_001267776,IFT20,5,4,7166,883,6283,1570.75,176.6,7.115515289
NM_001267775,IFT20,6,5,7166,920,6246,1249.2,153.3333333,6.789130435
NM_000638,VTN,8,7,3076,1685,1391,198.7142857,210.625,0.825519288
NM_174887,IFT20,6,5,7166,1002,6164,1232.8,167,6.151696607
NM_003593,FOXN1,8,7,14218,2705,11513,1644.714286,338.125,4.256192237
NM_001145975,SLC13A2,12,11,24136,2516,21620,1965.454545,209.6666667,8.593004769
NM_003984,SLC13A2,12,11,24136,2369,21767,1978.818182,197.4166667,9.188265091
NM_006923,SDF2,3,2,13818,1568,12250,6125,522.6666667,7.8125
NM_006461,SPAG5,24,23,21475,3832,17643,767.0869565,159.6666667,4.604123173
NM_033198,PIGS,12,11,18483,2885,15598,1418,240.4166667,5.406585789
NM_001174103,SGK494,12,11,6231,3791,2440,221.8181818,315.9166667,0.643629649
NM_014680,KIAA0100,39,38,30721,7474,23247,611.7631579,191.6410256,3.11038266
NM_054035,UNC119,4,3,5923,1655,4268,1422.666667,413.75,2.578851964
NM_005165,ALDOC,9,8,3820,1660,2160,270,184.4444444,1.301204819
NM_005148,UNC119,5,4,5923,1389,4534,1133.5,277.8,3.264218862
NM_001287207,SGK494,12,11,6378,3938,2440,221.8181818,328.1666667,0.61960386
NM_001160407,TLCD1,4,3,2585,892,1693,564.3333333,223,1.897982063
NM_001142624,RAB34,11,10,3989,1301,2688,268.8,118.2727273,2.066102998
NM_031934,RAB34,10,9,3611,1776,1835,203.8888889,177.6,1.033220721
NM_001144942,RAB34,10,9,3611,1752,1859,206.5555556,175.2,1.061073059
NM_138463,TLCD1,4,3,1866,1025,841,280.3333333,256.25,0.820487805
NM_152465,PROCA1,4,3,8340,1251,7089,2363,312.75,5.666666667
NM_178170,NEK8,15,14,13954,2873,11081,791.5,191.5333333,3.856943961
NM_000984,RPL23A,5,4,4376,975,3401,850.25,195,3.488205128
NM_001256281,NARR,3,2,1899,842,1057,528.5,280.6666667,1.255344418
NM_001256278,RAB34,9,8,3989,1152,2837,354.625,128,2.462673611
NM_001256277,RAB34,11,10,3989,1459,2530,253,132.6363636,1.734064428
NM_001256276,RAB34,10,9,3989,1392,2597,288.5555556,139.2,1.86566092
NM_001144943,RAB34,11,10,3989,1325,2664,266.4,120.4545455,2.010566038
NM_001142625,RAB34,10,9,3989,1109,2880,320,110.9,2.596934175
NM_004295,TRAF4,7,6,6955,2909,4046,674.3333333,415.5714286,1.390855964
NM_144683,DHRS13,5,4,5292,1926,3366,841.5,385.2,1.747663551
NM_005702,ERAL1,10,9,6031,1835,4196,466.2222222,183.5,2.286648501
NM_004475,FLOT2,11,10,18360,2643,15717,1571.7,240.2727273,5.946651532
NM_016518,PIPOX,8,7,14320,2420,11900,1700,302.5,4.917355372
NM_178860,SEZ6,17,16,51136,4229,46907,2931.6875,248.7647059,11.09174746
NM_001098635,SEZ6,17,16,51136,4213,46923,2932.6875,247.8235294,11.13766912
NM_203318,MYO18A,41,40,106881,7579,99302,2482.55,184.8536585,13.10225623
NM_078471,MYO18A,42,41,106881,7625,99256,2420.878049,181.547619,13.01718033
NM_004740,TIAF1,1,0,2090,2090,NA,NA,2090,NA
NM_020772,NUFIP2,4,3,38314,10884,27430,9143.333333,2721,2.520213157
NM_005208,CRYBA1,6,5,7629,796,6833,1366.6,132.6666667,8.584170854
NM_198147,ABHD15,2,1,6355,3357,2998,2998,1678.5,0.893059279
NM_138349,TP53I13,7,6,4438,1460,2978,496.3333333,208.5714286,2.039726027
NM_014030,GIT1,20,19,16125,3753,12372,651.1578947,187.65,3.29656275
NM_001085454,GIT1,21,20,16125,3781,12344,617.2,180.047619,3.264744777
NM_032854,CORO6,10,9,6669,2407,4262,473.5555556,240.7,1.770668882
NM_152345,ANKRD13B,15,14,21254,3188,18066,1290.428571,212.5333333,5.666875784
NM_032141,NSRP1,7,6,69670,2522,67148,11191.33333,360.2857143,26.62490087
NM_001045,SLC6A4,15,14,41651,6621,35030,2502.142857,441.4,5.29074158
NM_001261467,NSRP1,6,5,69670,2427,67243,13448.6,404.5,27.70622167
NM_206832,TMIGD1,7,6,17701,1208,16493,2748.833333,172.5714286,13.6531457
NM_000386,BLMH,12,11,43973,2549,41424,3765.818182,212.4166667,16.25107885
NM_001199775,CPD,21,20,89181,8426,80755,4037.75,401.2380952,9.584025635
NM_001304,CPD,21,20,90735,9064,81671,4083.55,431.6190476,9.010481024
NM_015594,TBC1D29,5,4,3927,673,3254,813.5,134.6,4.835066865
NM_015986,CRLF3,8,7,42078,2949,39129,5589.857143,368.625,13.26856562
NM_024857,ATAD5,23,22,63274,6265,57009,2591.318182,272.3913043,9.099600958
NM_001184992,RNF135,6,5,28975,2226,26749,5349.8,371,12.01662174
NM_018404,ADAP2,11,10,37459,2760,34699,3469.9,250.9090909,12.57210145
NM_032322,RNF135,5,4,28973,2158,26815,6703.75,431.6,12.42585728
NM_197939,RNF135,4,3,28973,1994,26979,8993,498.5,13.53009027
NM_006495,EVI2B,2,1,10344,1997,8347,8347,998.5,4.179769654
NM_014210,EVI2A,2,1,5341,2871,2470,2470,1435.5,0.860327412
NM_001003927,EVI2A,3,2,5341,3013,2328,1164,1004.333333,0.772651842
NM_018405,COPRS,4,3,7444,941,6503,2167.666667,235.25,6.910733262
NM_018428,UTP6,19,18,38541,2084,36457,2025.388889,109.6842105,17.493762
NM_052888,LRRC37B,12,11,32366,3039,29327,2666.090909,253.25,9.650213886
NM_022344,C17orf75,10,9,13770,4593,9177,1019.666667,459.3,1.998040496
NM_138328,RHBDL3,9,8,58487,4670,53817,6727.125,518.8888889,11.52398287
NM_001098507,ZNF207,12,11,20313,2335,17978,1634.363636,194.5833333,7.699357602
NM_003457,ZNF207,11,10,20313,2286,18027,1802.7,207.8181818,7.885826772
NM_001032293,ZNF207,11,10,20313,2241,18072,1807.2,203.7272727,8.064257028
NM_003885,CDK5R1,2,1,4168,3856,312,312,1928,0.080912863
NM_001033504,TMEM98,7,6,13741,1726,12015,2002.5,246.5714286,6.961181924
NM_173847,SPACA3,5,4,6012,824,5188,1297,164.8,6.296116505
NM_015544,TMEM98,8,7,13741,1803,11938,1705.428571,225.375,6.621186911
NM_006273,CCL7,3,2,2028,818,1210,605,272.6666667,1.479217604
NM_002986,CCL11,3,2,2514,928,1586,793,309.3333333,1.709051724
NM_002982,CCL2,3,2,1926,750,1176,588,250,1.568
NM_002981,CCL1,3,2,2907,597,2310,1155,199,3.869346734
NM_005408,CCL13,3,2,2160,854,1306,653,284.6666667,1.529274005
NM_005623,CCL8,3,2,2357,1253,1104,552,417.6666667,0.881085395
NM_207454,C17orf102,2,1,5248,3999,1249,1249,1999.5,0.312328082
NM_207313,TMEM132E,10,9,58571,4379,54192,6021.333333,437.9,12.37542818
NM_006584,CCT6B,14,13,33652,1912,31740,2441.538462,136.5714286,16.60041841
NM_052857,ZNF830,1,0,1658,1658,NA,NA,1658,NA
NM_001193530,CCT6B,13,12,33652,1776,31876,2656.333333,136.6153846,17.9481982
NM_001193529,CCT6B,13,12,33652,1800,31852,2654.333333,138.4615385,17.69555556
NM_002311,LIG3,20,19,22676,3123,19553,1029.105263,156.15,6.260967019
NM_013975,LIG3,20,19,24573,3742,20831,1096.368421,187.1,5.566809193
NM_001017368,RFFL,7,6,54630,4128,50502,8417,589.7142857,12.23401163
NM_017559,FNDC8,4,3,9122,1359,7763,2587.666667,339.75,5.712288447
NM_001014445,NLE1,12,11,10931,2696,8235,748.6363636,224.6666667,3.054525223
NM_001267052,UNC45B,20,19,41530,5690,35840,1886.315789,284.5,6.298769772
NM_133629,RAD51D,7,6,20079,2075,18004,3000.666667,296.4285714,8.676626506
NM_173167,UNC45B,20,19,41530,5699,35831,1885.842105,284.95,6.287243376
NM_002878,RAD51D,10,9,20079,2414,17665,1962.777778,241.4,7.317729909
NM_001033576,UNC45B,20,19,41530,5693,35837,1886.157895,284.65,6.29492359
NM_152462,SLC35G3,1,0,1875,1875,NA,NA,1875,NA
NM_001142571,RAD51D,10,9,20079,2474,17605,1956.111111,247.4,7.116006467
NM_018096,NLE1,13,12,10995,2626,8369,697.4166667,202,3.18697639
NM_144975,SLFN5,5,4,24677,4652,20025,5006.25,930.4,4.304600172
NM_001195790,SLFN12L,4,3,12818,1771,11047,3682.333333,442.75,6.237718803
NM_018042,SLFN12,4,3,21604,2534,19070,6356.666667,633.5,7.525651144
NM_144682,SLFN13,6,5,13743,8475,5268,1053.6,1412.5,0.62159292
NM_001289009,SLFN12,4,3,22256,2469,19787,6595.666667,617.25,8.01417578
NM_000286,PEX12,3,2,3844,2686,1158,579,895.3333333,0.431124348
NM_001129820,SLFN14,4,3,9968,2886,7082,2360.666667,721.5,2.453915454
NM_033315,RASL10B,4,3,11863,3198,8665,2888.333333,799.5,2.709505941
NM_002985,CCL5,3,2,8883,1232,7651,3825.5,410.6666667,6.210227273
NM_024302,MMP28,8,7,29766,2472,27294,3899.142857,309,11.04126214
NM_152781,C17orf66,15,14,13937,1984,11953,853.7857143,132.2666667,6.024697581
NM_145272,C17orf50,3,2,4184,1034,3150,1575,344.6666667,3.046421663
NM_003487,TAF15,16,15,37789,2198,35591,2372.733333,137.375,16.19244768
NM_001032278,MMP28,3,2,17133,1024,16109,8054.5,341.3333333,15.73144531
NM_001278736,CCL5,4,3,8883,1315,7568,2522.666667,328.75,5.75513308
NM_139215,TAF15,16,15,37789,2207,35582,2372.133333,137.9375,16.12233802
NM_001163125,RDM1,3,2,7823,548,7275,3637.5,182.6666667,13.27554745
NM_001163124,RDM1,3,2,12220,713,11507,5753.5,237.6666667,16.13884993
NM_001163120,RDM1,4,3,12697,815,11882,3960.666667,203.75,14.5791411
NM_001199951,LYZL6,5,4,9182,950,8232,2058,190,8.665263158
NM_032965,CCL15,4,3,4468,1084,3384,1128,271,3.121771218
NM_032963,CCL14,3,2,3074,509,2565,1282.5,169.6666667,5.039292731
NM_032962,CCL14,4,3,3074,558,2516,838.6666667,139.5,4.508960573
NM_145654,RDM1,7,6,12697,1172,11525,1920.833333,167.4285714,9.833617747
NM_001034836,RDM1,5,4,8300,820,7480,1870,164,9.12195122
NM_020426,LYZL6,4,3,5039,928,4111,1370.333333,232,4.429956897
NM_001163130,RDM1,6,5,12220,1070,11150,2230,178.3333333,10.42056075
NM_001163122,RDM1,5,4,12220,970,11250,2812.5,194,11.59793814
NM_001163121,RDM1,6,5,12697,1072,11625,2325,178.6666667,10.84421642
NM_004590,CCL16,3,2,4990,1500,3490,1745,500,2.326666667
NM_002988,CCL18,3,2,7200,773,6427,3213.5,257.6666667,8.314359638
NM_002984,CCL4,3,2,1796,670,1126,563,223.3333333,1.680597015
NM_002983,CCL3,3,2,1905,799,1106,553,266.3333333,1.384230288
NM_021006,CCL3L1,3,2,1890,786,1104,552,262,1.404580153
NM_001123392,TBC1D3H,14,13,10969,2149,8820,678.4615385,153.5,4.104234528
NM_001001437,CCL3L3,3,2,1881,777,1104,552,259,1.420849421
NM_207007,CCL4L2,3,2,1808,661,1147,573.5,220.3333333,1.735249622
NM_001001435,CCL4L1,3,2,1808,661,1147,573.5,220.3333333,1.735249622
NM_001001417,TBC1D3B,14,13,10929,2128,8801,677,152,4.135808271
NM_021006,CCL3L1,3,2,1890,786,1104,552,262,1.404580153
NM_001001437,CCL3L3,3,2,1881,777,1104,552,259,1.420849421
NM_207007,CCL4L2,3,2,1808,661,1147,573.5,220.3333333,1.735249622
NM_001001435,CCL4L1,3,2,1808,661,1147,573.5,220.3333333,1.735249622
NM_001040282,TBC1D3G,14,13,10930,2132,8798,676.7692308,152.2857143,4.126641651
NM_001281433,ZNHIT3,5,4,9196,929,8267,2066.75,185.8,8.898815931
NM_001281432,ZNHIT3,5,4,12685,2069,10616,2654,413.8,5.13098115
NM_001123392,TBC1D3H,14,13,10946,2149,8797,676.6923077,153.5,4.093531875
NM_001281434,ZNHIT3,3,2,9196,793,8403,4201.5,264.3333333,10.5964691
NM_004773,ZNHIT3,5,4,9196,963,8233,2058.25,192.6,8.549325026
NM_024835,GGNBP2,14,13,45541,2859,42682,3283.230769,204.2142857,14.92899615
NM_024308,DHRS11,7,6,9009,1605,7404,1234,229.2857143,4.613084112
NM_024864,MRM1,5,4,7384,1838,5546,1386.5,367.6,3.017410229
NM_178517,PIGW,2,1,3749,2257,1492,1492,1128.5,0.661054497
NM_001033580,MYO19,12,11,22390,2253,20137,1830.636364,187.75,8.93786063
NM_005568,LHX1,5,4,7145,3436,3709,927.25,687.2,1.079452852
NM_173625,C17orf78,7,6,16679,1869,14810,2468.333333,267,7.924023542
NM_007026,DUSP14,3,2,23639,1511,22128,11064,503.6666667,14.64460622
NM_007010,DDX52,15,14,31132,3837,27295,1949.642857,255.8,7.11363044
NM_001165923,HNF1B,9,8,58664,2767,55897,6987.125,307.4444444,20.20130105
NM_000458,HNF1B,9,8,58664,2845,55819,6977.375,316.1111111,19.62003515
NM_032258,TBC1D3F,14,13,10914,2093,8821,678.5384615,149.5,4.214524606
NM_001123391,TBC1D3,14,13,11140,2319,8821,678.5384615,165.6428571,3.803794739
NM_001123392,TBC1D3H,14,13,10970,2149,8821,678.5384615,153.5,4.10469986
NM_001001418,TBC1D3C,14,13,10950,2129,8821,678.5384615,152.0714286,4.143259746
NM_032258,TBC1D3F,14,13,10914,2093,8821,678.5384615,149.5,4.214524606
NM_001123391,TBC1D3,14,13,11140,2319,8821,678.5384615,165.6428571,3.803794739
NM_001123392,TBC1D3H,14,13,10970,2149,8821,678.5384615,153.5,4.10469986
NM_001001418,TBC1D3C,14,13,10950,2129,8821,678.5384615,152.0714286,4.143259746
NM_032351,MRPL45,8,7,26114,1713,24401,3485.857143,214.125,14.24460012
NM_001278279,MRPL45,7,6,26114,1562,24552,4092,223.1428571,15.71830986
NM_014598,SOCS7,10,9,53841,7988,45853,5094.777778,798.8,5.740235353
NM_001004334,GPR179,11,10,18202,7991,10211,1021.1,726.4545455,1.277812539
NM_001199417,ARHGAP23,24,23,83910,5930,77980,3390.434783,247.0833333,13.15008432
NM_001130677,C17orf96,1,0,3230,3230,NA,NA,3230,NA
NM_001136498,CISD3,4,3,5350,2640,2710,903.3333333,660,1.026515152
NM_003559,PIP4K2B,10,9,34216,5742,28474,3163.777778,574.2,4.958899338
NM_007144,PCGF2,11,10,14410,2615,11795,1179.5,237.7272727,4.510516252
NM_005937,MLLT6,20,19,24185,7520,16665,877.1052632,376,2.216090426
NM_002795,PSMB3,6,5,11520,802,10718,2143.6,133.6666667,13.36408978
NM_006148,LASP1,7,6,51913,4116,47797,7966.166667,588,11.61248785
NM_000978,RPL23,5,4,3734,582,3152,788,116.4,5.41580756
NM_001271608,LASP1,6,5,51913,4030,47883,9576.6,671.6666667,11.88163772
NM_001080465,C17orf98,3,2,6303,569,5734,2867,189.6666667,10.07732865
NM_199248,CACNB1,13,12,20569,1767,18802,1566.833333,135.9230769,10.64063384
NM_199247,CACNB1,13,12,20569,1902,18667,1555.583333,146.3076923,9.814405889
NM_000723,CACNB1,14,13,24249,3756,20493,1576.384615,268.2857143,5.456070288
NM_001143968,ARL5C,6,5,9269,947,8322,1664.4,157.8333333,8.787750792
NM_198993,STAC2,11,10,15253,3288,11965,1196.5,298.9090909,3.638990268
NM_000981,RPL19,6,5,4446,738,3708,741.6,123,5.024390244
NM_004774,MED1,17,16,46991,8165,38826,2426.625,480.2941176,4.755174525
NM_015083,CDK12,14,13,73056,8270,64786,4983.538462,590.7142857,7.833857316
NM_016507,CDK12,14,13,73056,8297,64759,4981.461538,592.6428571,7.805110281
NM_001242464,PPP1R1B,7,6,8129,1426,6703,1117.166667,203.7142857,4.70056101
NM_032192,PPP1R1B,7,6,9703,1851,7852,1308.666667,264.4285714,4.242031334
NM_006160,NEUROD2,2,1,4156,3034,1122,1122,1517,0.369808833
NM_006804,STARD3,15,14,27123,2849,24274,1733.857143,189.9333333,8.52018252
NM_181505,PPP1R1B,7,6,8129,1510,6619,1103.166667,215.7142857,4.383443709
NM_002686,PNMT,3,2,2024,961,1063,531.5,320.3333333,1.106139438
NM_033419,PGAP3,8,7,16937,2695,14242,2034.571429,336.875,5.284601113
NM_001165938,STARD3,14,13,27123,2794,24329,1871.461538,199.5714286,8.707587688
NM_001165937,STARD3,15,14,27123,2849,24274,1733.857143,189.9333333,8.52018252
NM_003673,TCAP,2,1,1210,965,245,245,482.5,0.25388601
NM_001289938,ERBB2,18,17,29575,2579,26996,1588,143.2777778,10.46762311
NM_005310,GRB7,15,14,9378,2277,7101,507.2142857,151.8,3.118577075
NM_001030002,GRB7,15,14,8964,2122,6842,488.7142857,141.4666667,3.224316682
NM_032339,MIEN1,4,3,1381,758,623,207.6666667,189.5,0.821899736
NM_001242443,GRB7,15,14,7320,2267,5053,360.9285714,151.1333333,2.228936921
NM_001242442,GRB7,15,14,8516,2206,6310,450.7142857,147.0666667,2.86038078
NM_001284516,IKZF3,3,2,20512,9240,11272,5636,3080,1.21991342
NM_001165959,GSDMB,10,9,14057,1573,12484,1387.111111,157.3,7.936427209
NM_018530,GSDMB,8,7,12947,1634,11313,1616.142857,204.25,6.923500612
NM_198844,ZPBP2,7,6,9696,2198,7498,1249.666667,314,3.411282985
NM_001165958,GSDMB,11,10,14057,1610,12447,1244.7,146.3636364,7.731055901
NM_001195545,LRRC3C,2,1,3262,880,2382,2382,440,2.706818182
NM_178171,GSDMA,12,11,14795,2176,12619,1147.181818,181.3333333,5.799172794
NM_001042471,GSDMB,10,9,14057,1570,12487,1387.444444,157,7.953503185
NM_199321,ZPBP2,8,7,9696,2265,7431,1061.571429,283.125,3.280794702
NM_139280,ORMDL3,4,3,6590,2143,4447,1482.333333,535.75,2.075128325
NM_014815,MED24,26,25,35541,3741,31800,1272,143.8846154,8.500400962
NM_003250,THRA,10,9,31054,2543,28511,3167.888889,254.3,11.21156115
NM_001178147,CSF3,4,3,2454,1479,975,325,369.75,0.659229209
NM_001190918,THRA,10,9,31054,2426,28628,3180.888889,242.6,11.80049464
NM_199334,THRA,9,8,27224,2398,24826,3103.25,266.4444444,10.35279399
NM_001267797,MED24,25,24,35541,3701,31840,1326.666667,148.04,8.603080249
NM_000759,CSF3,5,4,2454,1597,857,214.25,319.4,0.536631183
NM_021724,NR1D1,8,7,7943,2783,5160,737.1428571,347.875,1.854114265
NM_001079518,MED24,25,24,35541,3723,31818,1325.75,148.92,8.546333602
NM_001190919,THRA,10,9,31676,2524,29152,3239.111111,252.4,11.54992076
NM_172220,CSF3,4,3,2454,1488,966,322,372,0.649193548
NM_172219,CSF3,5,4,2454,1588,866,216.5,317.6,0.54534005
NM_007359,CASC3,14,13,31926,4194,27732,2133.230769,299.5714286,6.61230329
NM_001012241,MSL1,10,9,14257,3830,10427,1158.555556,383,2.722454308
NM_016339,RAPGEFL1,15,14,17666,3742,13924,994.5714286,249.4666667,3.72100481
NM_000964,RARA,9,8,48474,3293,45181,5647.625,365.8888889,13.72031582
NM_001254,CDC6,12,11,15269,3065,12204,1109.454545,255.4166667,3.981729201
NM_001145301,RARA,9,8,39424,3405,36019,4502.375,378.3333333,10.57826725
NM_001145302,RARA,7,6,39424,3112,36312,6052,444.5714286,11.66838046
NM_152219,GJD3,1,0,4042,4042,NA,NA,4042,NA
NM_001024809,RARA,8,7,15626,3485,12141,1734.428571,435.625,3.483787661
NM_032865,TNS4,13,12,25776,4085,21691,1807.583333,314.2307692,5.309914321
NM_001067,TOP2A,35,34,29431,5788,23643,695.3823529,165.3714286,4.084830684
NM_001552,IGFBP4,4,3,14308,2240,12068,4022.666667,560,5.3875
NM_001838,CCR7,3,2,11716,2187,9529,4764.5,729,4.357110197
NM_152349,KRT222,6,5,9546,1741,7805,1561,290.1666667,4.483055715
NM_019016,KRT24,8,7,5761,1889,3872,553.1428571,236.125,2.049761779
NM_181534,KRT25,8,7,7313,1678,5635,805,209.75,3.358164482
NM_001195387,TMEM99,3,2,17184,2060,15124,7562,686.6666667,7.341747573
NM_001195386,TMEM99,3,2,17091,2076,15015,7507.5,692,7.23265896
NM_000223,KRT12,8,7,6034,2000,4034,576.2857143,250,2.017
NM_145274,TMEM99,3,2,17154,2068,15086,7543,689.3333333,7.294970986
NM_000421,KRT10,8,7,4496,2148,2348,335.4285714,268.5,1.09310987
NM_019010,KRT20,8,7,9356,1813,7543,1077.571429,226.625,4.160507446
NM_181537,KRT27,8,7,5728,1620,4108,586.8571429,202.5,2.535802469
NM_181535,KRT28,8,7,7765,1700,6065,866.4285714,212.5,3.567647059
NM_031959,KRTAP3-2,1,0,695,695,NA,NA,695,NA
NM_031958,KRTAP3-1,1,0,594,594,NA,NA,594,NA
NM_031957,KRTAP1-5,1,0,1177,1177,NA,NA,1177,NA
NM_015515,KRT23,9,8,14949,2219,12730,1591.25,246.5555556,5.736818387
NM_213656,KRT39,7,6,8477,1703,6774,1129,243.2857143,3.977686436
NM_033185,KRTAP3-3,1,0,705,705,NA,NA,705,NA
NM_001257305,KRTAP1-4,1,0,450,450,NA,NA,450,NA
NM_182497,KRT40,9,8,9421,1947,7474,934.25,216.3333333,3.838726246
NM_001282433,KRT23,8,7,14949,1690,13259,1894.142857,211.25,7.84556213
NM_031960,KRTAP4-8,1,0,1143,1143,NA,NA,1143,NA
NM_031854,KRTAP4-12,1,0,1076,1076,NA,NA,1076,NA
NM_032524,KRTAP4-4,1,0,1079,1079,NA,NA,1079,NA
NM_030967,KRTAP1-1,1,0,904,904,NA,NA,904,NA
NM_001123387,KRTAP2-1,1,0,774,774,NA,NA,774,NA
NM_001146041,KRTAP4-9,1,0,1101,1101,NA,NA,1101,NA
NM_033188,KRTAP4-5,1,0,880,880,NA,NA,880,NA
NM_033184,KRTAP2-4,1,0,765,765,NA,NA,765,NA
NM_033059,KRTAP4-11,1,0,1174,1174,NA,NA,1174,NA
NM_033032,KRTAP2-2,1,0,714,714,NA,NA,714,NA
NM_033061,KRTAP4-7,1,0,939,939,NA,NA,939,NA
NM_030976,KRTAP4-6,1,0,1056,1056,NA,NA,1056,NA
NM_001165252,KRTAP2-3,1,0,853,853,NA,NA,853,NA
NM_031963,KRTAP9-8,1,0,988,988,NA,NA,988,NA
NM_031962,KRTAP9-3,1,0,993,993,NA,NA,993,NA
NM_031961,KRTAP9-2,1,0,1006,1006,NA,NA,1006,NA
NM_030975,KRTAP9-9,1,0,982,982,NA,NA,982,NA
NM_001277332,KRTAP9-7,1,0,511,511,NA,NA,511,NA
NM_033191,KRTAP9-4,1,0,968,968,NA,NA,968,NA
NM_033187,KRTAP4-3,1,0,943,943,NA,NA,943,NA
NM_033062,KRTAP4-2,1,0,764,764,NA,NA,764,NA
NM_033060,KRTAP4-1,2,1,797,741,56,56,370.5,0.075573549
NM_001190460,KRTAP9-1,1,0,754,754,NA,NA,754,NA
NM_001277331,KRTAP9-6,1,0,484,484,NA,NA,484,NA
NM_031964,KRTAP17-1,1,0,780,780,NA,NA,780,NA
NM_002279,KRT33B,7,6,6308,1614,4694,782.3333333,230.5714286,2.908302354
NM_002277,KRT31,7,6,3869,1602,2267,377.8333333,228.8571429,1.415106117
NM_004138,KRT33A,7,6,4721,1293,3428,571.3333333,184.7142857,2.651198763
NM_021013,KRT34,7,6,4717,1720,2997,499.5,245.7142857,1.74244186
NM_001257309,KRTAP29-1,1,0,1027,1027,NA,NA,1027,NA
NM_001146182,KRTAP16-1,1,0,1555,1555,NA,NA,1555,NA
NM_003770,KRT37,7,6,4015,1725,2290,381.6666667,246.4285714,1.327536232
NM_002276,KRT19,6,5,4774,1477,3297,659.4,246.1666667,2.232227488
NM_002274,KRT13,7,6,4634,1696,2938,489.6666667,242.2857143,1.732311321
NM_002280,KRT35,8,7,4453,1679,2774,396.2857143,209.875,1.652173913
NM_002278,KRT32,7,6,7875,2012,5863,977.1666667,287.4285714,2.914015905
NM_002275,KRT15,8,7,5275,1848,3427,489.5714286,231,1.854437229
NM_006771,KRT38,7,6,4977,2844,2133,355.5,406.2857143,0.75
NM_003771,KRT36,7,6,3730,1651,2079,346.5,235.8571429,1.259236826
NM_153490,KRT13,8,7,4634,1723,2911,415.8571429,215.375,1.689495067
NM_000526,KRT14,8,7,4618,1644,2974,424.8571429,205.5,1.809002433
NM_000226,KRT9,8,7,6218,2297,3921,560.1428571,287.125,1.707009142
NM_000422,KRT17,8,7,5192,1582,3610,515.7142857,197.75,2.281921618
NM_005557,KRT16,8,7,3050,1725,1325,189.2857143,215.625,0.768115942
NM_001079871,HAP1,10,9,12009,3869,8140,904.4444444,386.9,2.103902817
NM_001079870,HAP1,10,9,12009,3893,8116,901.7777778,389.3,2.084767531
NM_006455,LEPREL4,8,7,10248,2610,7638,1091.142857,326.25,2.926436782
NM_002230,JUP,14,13,32107,3522,28585,2198.846154,251.5714286,8.1161272
NM_177977,HAP1,11,10,12009,3945,8064,806.4,358.6363636,2.044106464
NM_000805,GAST,3,2,3645,473,3172,1586,157.6666667,6.706131078
NM_021991,JUP,15,14,32107,3226,28881,2062.928571,215.0666667,8.952572846
NM_198830,ACLY,28,27,52095,4351,47744,1768.296296,155.3928571,10.97310963
NM_052935,NT5C3B,9,8,11191,1431,9760,1220,159,6.820405311
NM_152467,KLHL10,5,4,10558,2014,8544,2136,402.8,4.242303873
NM_001096,ACLY,29,28,52095,4382,47713,1704.035714,151.1034483,10.88840712
NM_018143,KLHL11,2,1,11832,2328,9504,9504,1164,4.082474227
NM_003315,DNAJC7,14,13,41278,2092,39186,3014.307692,149.4285714,18.73135755
NM_001144766,DNAJC7,14,13,40746,1860,38886,2991.230769,132.8571429,20.90645161
NM_033133,CNP,4,3,10997,5226,5771,1923.666667,1306.5,1.104286261
NM_001001349,NKIRAS2,4,3,8064,2390,5674,1891.333333,597.5,2.374058577
NM_001242704,ZNF385C,8,7,12452,2604,9848,1406.857143,325.5,3.78187404
NM_001144929,NKIRAS2,5,4,5571,2379,3192,798,475.8,1.341740227
NM_001144928,NKIRAS2,4,3,5571,2307,3264,1088,576.75,1.414824447
NM_001144927,NKIRAS2,4,3,5571,2494,3077,1025.666667,623.5,1.233761026
NM_017595,NKIRAS2,4,3,5571,2475,3096,1032,618.75,1.250909091
NM_001142623,GHDC,10,9,5447,2545,2902,322.4444444,254.5,1.140275049
NM_012285,KCNH4,17,16,24388,3940,20448,1278,231.7647059,5.189847716
NM_201434,RAB5C,7,6,30070,1822,28248,4708,260.2857143,15.50384193
NM_021078,KAT2A,18,17,8255,3130,5125,301.4705882,173.8888889,1.637380192
NM_032484,GHDC,10,9,5447,2456,2991,332.3333333,245.6,1.217833876
NM_033194,HSPB9,1,0,617,617,NA,NA,617,NA
NM_024119,DHX58,14,13,11331,2631,8700,669.2307692,187.9285714,3.30672748
NM_001142622,GHDC,10,9,5447,2339,3108,345.3333333,233.9,1.32877298
NM_001524,HCRT,2,1,1394,579,815,815,289.5,1.407599309
NM_001252039,RAB5C,7,6,30070,1921,28149,4691.5,274.4285714,14.65330557
NM_004583,RAB5C,6,5,30070,1704,28366,5673.2,284,16.64671362
NM_003152,STAT5A,20,19,24397,4320,20077,1056.684211,216,4.647453704
NM_001288720,STAT5A,18,17,23888,4136,19752,1161.882353,229.7777778,4.775628627
NM_001288718,STAT5A,19,18,24077,4419,19658,1092.111111,232.5789474,4.448517764
NM_001288719,STAT5A,18,17,23888,4139,19749,1161.705882,229.9444444,4.771442377
NM_012232,PTRF,2,1,20873,3636,17237,17237,1818,4.740649065
NM_198204,MLX,8,7,6145,2408,3737,533.8571429,301,1.551910299
NM_025233,COASY,9,8,4209,2566,1643,205.375,285.1111111,0.640296181
NM_000263,NAGLU,6,5,8517,2788,5729,1145.8,464.6666667,2.054878049
NM_001042529,COASY,10,9,4209,2175,2034,226,217.5,0.935172414
NM_013290,PSMC3IP,8,7,5523,1429,4094,584.8571429,178.625,2.864940518
NM_198205,MLX,7,6,6145,2317,3828,638,331,1.652136383
NM_178126,FAM134C,9,8,29921,3818,26103,3262.875,424.2222222,6.836825563
NM_001256016,PSMC3IP,9,8,5523,1485,4038,504.75,165,2.719191919
NM_001256015,PSMC3IP,8,7,5523,1598,3925,560.7142857,199.75,2.456195244
NM_001256014,PSMC3IP,7,6,5408,1440,3968,661.3333333,205.7142857,2.755555556
NM_001042532,COASY,11,10,4209,2308,1901,190.1,209.8181818,0.823656846
NM_000413,HSD17B1,6,5,3250,2237,1013,202.6,372.8333333,0.452838623
NM_170607,MLX,8,7,6145,2570,3575,510.7142857,321.25,1.391050584
NM_016556,PSMC3IP,8,7,5523,1465,4058,579.7142857,183.125,2.76996587
NM_024927,PLEKHH3,13,12,9117,3074,6043,503.5833333,236.4615385,1.96584255
NM_016602,CCR10,2,1,2427,1246,1181,1181,623,0.947833066
NM_016437,TUBG2,11,10,7760,1829,5931,593.1,166.2727273,3.242755604
NM_003632,CNTNAP1,24,23,17381,5478,11903,517.5217391,228.25,2.172873311
NM_005854,RAMP2,4,3,1850,790,1060,353.3333333,197.5,1.341772152
NM_032353,VPS25,6,5,6166,1108,5058,1011.6,184.6666667,4.564981949
NM_032387,WNK4,19,18,16437,4197,12240,680,220.8947368,2.916368835
NM_173478,CNTD1,7,6,12753,3284,9469,1578.166667,469.1428571,2.883373934
NM_009590,AOC2,4,3,6117,2669,3448,1149.333333,667.25,1.291869614
NM_003734,AOC3,4,3,6948,4036,2912,970.6666667,1009,0.721506442
NM_001158,AOC2,4,3,6117,2588,3529,1176.333333,647,1.363601236
NM_001267045,PSME3,13,12,10620,3777,6843,570.25,290.5384615,1.811755361
NM_001277732,AOC3,4,3,4889,2398,2491,830.3333333,599.5,1.038782319
NM_001277731,AOC3,3,2,6948,3905,3043,1521.5,1301.666667,0.779257362
NM_001040431,COA3,2,1,1109,810,299,299,405,0.369135802
NM_005789,PSME3,11,10,10620,3448,7172,717.2,313.4545455,2.080046404
NM_003766,BECN1,12,11,14162,2155,12007,1091.545455,179.5833333,5.571693735
NM_176863,PSME3,11,10,10620,3487,7133,713.3,317,2.045597935
NM_001142653,PTGES3L,6,5,12442,1913,10529,2105.8,318.8333333,5.503920544
NM_001142654,PTGES3L,6,5,12442,1898,10544,2108.8,316.3333333,5.555321391
NM_001261430,PTGES3L,7,6,12442,2013,10429,1738.166667,287.5714286,5.18082464
NM_025267,PTGES3L-AARSD1,17,16,29479,1807,27672,1729.5,106.2941176,15.31377975
NM_001270397,G6PC,5,4,13638,4089,9549,2387.25,817.8,2.335289802
NM_001261434,AARSD1,12,11,13974,1376,12598,1145.272727,114.6666667,9.155523256
NM_000988,RPL27,5,4,4527,495,4032,1008,99,8.145454545
NM_000151,G6PC,5,4,13638,4166,9472,2368,833.2,2.273643783
NM_001136042,PTGES3L-AARSD1,17,16,30004,2191,27813,1738.3125,128.8823529,12.69420356
NM_173079,RUNDC1,5,4,13127,3833,9294,2323.5,766.6,2.424732585
NM_007294,BRCA1,23,22,81190,7230,73960,3361.818182,314.3478261,10.22959889
NM_007297,BRCA1,22,21,81158,7137,74021,3524.809524,324.4090909,10.37144458
NM_007298,BRCA1,22,21,79822,3704,76118,3624.666667,168.3636364,20.55021598
NM_006373,VAT1,6,5,7839,2764,5075,1015,460.6666667,1.836107091
NM_007300,BRCA1,24,23,81190,7294,73896,3212.869565,303.9166667,10.13106663
NM_007299,BRCA1,22,21,81158,3805,77353,3683.47619,172.9545455,20.32930355
NM_005533,IFI35,7,6,7736,1257,6479,1079.833333,179.5714286,5.15433572
NM_005440,RND2,5,4,6802,4157,2645,661.25,831.4,0.636276161
NM_005899,NBR1,21,20,40463,4619,35844,1792.2,219.952381,7.760121238
NM_031858,NBR1,21,20,41198,4995,36203,1810.15,237.8571429,7.247847848
NM_031862,NBR1,21,20,41211,4676,36535,1826.75,222.6666667,7.813301967
NM_145041,TMEM106A,9,8,7697,2804,4893,611.625,311.5555556,1.745007133
NM_001661,ARL4D,2,1,2153,1587,566,566,793.5,0.356647763
NM_001261439,ETV4,5,4,2594,1579,1015,253.75,315.8,0.642811906
NM_001261438,ETV4,12,11,18096,2160,15936,1448.727273,180,7.377777778
NM_001261437,ETV4,12,11,18591,2331,16260,1478.181818,194.25,6.975546976
NM_001986,ETV4,13,12,18096,2272,15824,1318.666667,174.7692308,6.964788732
NM_001079675,ETV4,13,12,18591,2443,16148,1345.666667,187.9230769,6.609905853
NM_004941,DHX8,23,22,40348,4223,36125,1642.045455,183.6086957,8.554345252
NM_001040002,MEOX1,4,3,21506,2172,19334,6444.666667,543,8.901473297
NM_013999,MEOX1,2,1,21175,2143,19032,19032,1071.5,8.881007933
NM_004527,MEOX1,3,2,21175,2317,18858,9429,772.3333333,8.13897281
NM_025237,SOST,2,1,5059,2302,2757,2757,1151,1.197654214
NM_001168323,CD300LG,6,5,11088,1303,9785,1957,217.1666667,7.509593246
NM_001168322,CD300LG,7,6,11088,1406,9682,1613.666667,200.8571429,6.886201991
NM_001136483,C17orf105,6,5,4253,833,3420,684,138.8333333,4.105642257
NM_145273,CD300LG,7,6,16483,2793,13690,2281.666667,399,4.901539563
NM_001932,MPP3,20,19,32382,2855,29527,1554.052632,142.75,10.34220665
NM_001168324,CD300LG,6,5,10614,1002,9612,1922.4,167,9.592814371
NM_004090,DUSP3,3,2,12881,4125,8756,4378,1375,2.122666667
NM_001278381,MPP2,14,13,32585,4956,27629,2125.307692,354,5.574858757
NM_001278376,MPP2,12,11,25266,4241,21025,1911.363636,353.4166667,4.95755718
NM_001278375,MPP2,12,11,26205,4367,21838,1985.272727,363.9166667,5.00068697
NM_001278373,MPP2,12,11,32585,4557,28028,2548,379.75,6.150537634
NM_001278371,MPP2,12,11,34354,4258,30096,2736,354.8333333,7.068107093
NM_001278370,MPP2,13,12,34354,4323,30031,2502.583333,332.5384615,6.946796206
NM_002722,PPY,4,3,1663,461,1202,400.6666667,115.25,2.607375271
NM_001278374,MPP2,12,11,32585,4502,28083,2553,375.1666667,6.237894269
NM_001278372,MPP2,14,13,32585,4695,27890,2145.384615,335.3571429,5.940362087
NM_005374,MPP2,13,12,32585,4622,27963,2330.25,355.5384615,6.049978364
NM_032376,TMEM101,4,3,3791,1543,2248,749.3333333,385.75,1.456902139
NM_152344,LSM12,6,5,32986,2490,30496,6099.2,415,12.24738956
NM_005474,HDAC5,27,26,46895,5351,41544,1597.846154,198.1851852,7.763782471
NM_138387,G6PC3,6,5,5616,1584,4032,806.4,264,2.545454545
NM_001015053,HDAC5,27,26,46895,5354,41541,1597.730769,198.2962963,7.758871871
NM_153006,NAGS,7,6,4406,2079,2327,387.8333333,297,1.119288119
NM_020218,ATXN7L3,12,11,6358,3626,2732,248.3636364,302.1666667,0.753447325
NM_080863,ASB16,5,4,8379,2144,6235,1558.75,428.8,2.908115672
NM_001076683,UBTF,20,19,15851,4623,11228,590.9473684,231.15,2.428725936
NM_001171251,C17orf53,10,9,20572,2732,17840,1982.222222,273.2,6.530014641
NM_024107,TMUB2,3,2,4747,1925,2822,1411,641.6666667,1.465974026
NM_024032,C17orf53,10,9,20572,2735,17837,1981.888889,273.5,6.521755027
NM_014233,UBTF,21,20,14642,4821,9821,491.05,229.5714286,2.037129226
NM_001098833,ATXN7L3,12,11,6358,3605,2753,250.2727273,300.4166667,0.763661581
NM_001076684,UBTF,20,19,14642,4709,9933,522.7894737,235.45,2.109365046
NM_001076674,TMUB2,4,3,4747,1994,2753,917.6666667,498.5,1.380641926
NM_177441,TMUB2,3,2,4527,2426,2101,1050.5,808.6666667,0.866034625
NM_016016,SLC25A39,12,11,5226,1598,3628,329.8181818,133.1666667,2.270337922
NM_006695,RUNDC3A,11,10,9313,1869,7444,744.4,169.9090909,3.982878545
NM_001144825,RUNDC3A,11,10,10113,2058,8055,805.5,187.0909091,3.913994169
NM_198475,FAM171A2,8,7,10136,2642,7494,1070.571429,330.25,2.836487509
NM_002087,GRN,13,12,7981,2318,5663,471.9166667,178.3076923,2.443054357
NM_001144826,RUNDC3A,11,10,9313,1854,7459,745.9,168.5454545,4.023193096
NM_001143780,SLC25A39,12,11,5226,1622,3604,327.6363636,135.1666667,2.221948212
NM_000419,ITGA2B,30,29,17325,3364,13961,481.4137931,112.1333333,4.150118906
NM_001002909,GPATCH8,8,7,108314,7027,101287,14469.57143,878.375,14.41397467
NM_001466,FZD2,1,0,3820,3820,NA,NA,3820,NA
NM_025104,DBF4B,15,14,43662,1829,41833,2988.071429,121.9333333,22.87206124
NM_002390,ADAM11,27,26,22648,4429,18219,700.7307692,164.037037,4.113569655
NM_145663,DBF4B,14,13,43662,3090,40572,3120.923077,220.7142857,13.13009709
NM_001145080,C17orf104,8,7,19405,4688,14717,2102.428571,586,3.139291809
NM_144609,CCDC43,5,4,12362,2143,10219,2554.75,428.6,4.768548763
NM_001099225,CCDC43,4,3,12362,2083,10279,3426.333333,520.75,4.934709554
NM_001080383,GJC1,3,2,32365,7643,24722,12361,2547.666667,3.234593746
NM_005497,GJC1,3,2,31793,7647,24146,12073,2549,3.157578135
NM_001258398,CCDC103,4,3,3969,1737,2232,744,434.25,1.284974093
NM_001258397,CCDC103,4,3,3969,1799,2170,723.3333333,449.75,1.206225681
NM_001258396,CCDC103,4,3,3969,1736,2233,744.3333333,434,1.286290323
NM_001258395,CCDC103,4,3,3969,1722,2247,749,430.5,1.304878049
NM_016438,HIGD1B,3,2,2580,638,1942,971,212.6666667,3.043887147
NM_001258353,EFTUD2,28,27,49083,4332,44751,1657.444444,154.7142857,10.33033241
NM_001271880,HIGD1B,4,3,4129,555,3574,1191.333333,138.75,6.43963964
NM_001142605,EFTUD2,27,26,49340,4085,45255,1740.576923,151.2962963,11.07833537
NM_001258354,EFTUD2,28,27,49340,4165,45175,1673.148148,148.75,10.84633854
NM_001258399,CCDC103,4,3,3969,1756,2213,737.6666667,439,1.260250569
NM_213607,CCDC103,4,3,3969,1752,2217,739,438,1.265410959
NM_004247,EFTUD2,28,27,49340,4195,45145,1672.037037,149.8214286,10.76162098
NM_001264573,KIF18B,15,14,23002,4304,18698,1335.571429,286.9333333,4.344330855
NM_001265577,KIF18B,16,15,23002,4042,18960,1264,252.625,4.690747155
NM_006688,C1QL1,2,1,8585,1502,7083,7083,751,4.715712383
NM_024722,ACBD4,9,8,8531,2030,6501,812.625,225.5555556,3.202463054
NM_021079,NMT1,12,11,47704,4896,42808,3891.636364,408,8.743464052
NM_001135707,ACBD4,10,9,7314,1510,5804,644.8888889,151,3.843708609
NM_001135706,ACBD4,10,9,8531,1915,6616,735.1111111,191.5,3.454830287
NM_001135705,ACBD4,10,9,8531,1877,6654,739.3333333,187.7,3.545018647
NM_133373,PLCD3,15,14,20885,3474,17411,1243.642857,231.6,5.011801957
NM_001135704,ACBD4,12,11,11578,2042,9536,866.9090909,170.1666667,4.66993144
NM_144608,HEXIM2,4,3,9144,1334,7810,2603.333333,333.5,5.854572714
NM_006460,HEXIM1,1,0,4786,4786,NA,NA,4786,NA
NM_005892,FMNL1,27,26,25393,3988,21405,823.2692308,147.7037037,5.367352056
NM_152343,SPATA32,5,4,7721,1289,6432,1608,257.8,4.989914663
NM_199282,ARHGAP27,17,16,31746,3667,28079,1754.9375,215.7058824,7.657212981
NM_001282290,ARHGAP27,17,16,36397,4259,32138,2008.625,250.5294118,7.545902794
NM_174919,ARHGAP27,4,3,3566,1381,2185,728.3333333,345.25,1.582186821
NM_175882,SPPL2C,1,0,2184,2184,NA,NA,2184,NA
NM_001007532,STH,1,0,446,446,NA,NA,446,NA
NM_014834,LRRC37A,14,13,42665,5191,37474,2882.615385,370.7857143,7.219032942
NM_001006607,LRRC37A2,14,13,42940,5189,37751,2903.923077,370.6428571,7.275197533
NM_001288813,ARL17A,4,3,52635,2173,50462,16820.66667,543.25,23.22227335
NM_001113738,ARL17A,4,3,26968,5277,21691,7230.333333,1319.25,4.110479439
NM_001288811,ARL17A,5,4,52635,2250,50385,12596.25,450,22.39333333
NM_001288812,ARL17A,5,4,71043,753,70290,17572.5,150.6,93.34661355
NM_016632,ARL17A,5,4,63022,855,62167,15541.75,171,72.70994152
NM_030753,WNT3,5,4,56256,3360,52896,13224,672,15.74285714
NM_003396,WNT9B,4,3,25471,1468,24003,8001,367,16.35081744
NM_203400,RPRML,1,0,1094,1094,NA,NA,1094,NA
NM_001012511,GOSR2,5,4,13721,2225,11496,2874,445,5.166741573
NM_054022,GOSR2,7,6,18249,1476,16773,2795.5,210.8571429,11.36382114
NM_004287,GOSR2,6,5,18249,3325,14924,2984.8,554.1666667,4.488421053
NM_001288811,ARL17A,3,2,11129,1852,9277,4638.5,617.3333333,5.009179266
NM_001288813,ARL17A,2,1,1799,1775,24,24,887.5,0.013521127
NM_002476,MYL4,7,6,14333,862,13471,2245.166667,123.1428571,15.62761021
NM_001002841,MYL4,8,7,14619,916,13703,1957.571429,114.5,14.95960699
NM_013351,TBX21,6,5,12877,2578,10299,2059.8,429.6666667,3.994957331
NM_014726,TBKBP1,9,8,16801,4143,12658,1582.25,460.3333333,3.055273956
NM_199262,SP6,2,1,10962,3796,7166,7166,1898,1.887776607
NM_145255,MRPL10,5,4,8271,1754,6517,1629.25,350.8,3.715507412
NM_148887,MRPL10,6,5,8271,1853,6418,1283.6,308.8333333,3.463572585
NM_145798,OSBPL7,23,22,14416,3679,10737,488.0454545,159.9565217,2.918456102
NM_033413,LRRC46,8,7,6088,1930,4158,594,241.25,2.154404145
NM_001145023,SCRN2,7,6,3654,1841,1813,302.1666667,263,0.984790875
NM_001258248,SP6,2,1,6238,3807,2431,2431,1903.5,0.638560546
NM_138355,SCRN2,8,7,3654,1575,2079,297,196.875,1.32
NM_018129,PNPO,7,6,7787,3472,4315,719.1666667,496,1.242799539
NM_001278198,CDK5RAP3,13,12,10832,2807,8025,668.75,215.9230769,2.858924118
NM_001278197,CDK5RAP3,14,13,11260,2009,9251,711.6153846,143.5,4.604778497
NM_024320,PRR15L,2,1,5911,1519,4392,4392,759.5,2.891375905
NM_016429,COPZ2,9,8,11621,912,10709,1338.625,101.3333333,11.74232456
NM_001278217,CDK5RAP3,13,12,10832,2719,8113,676.0833333,209.1538462,2.98381758
NM_001278216,CDK5RAP3,12,11,10832,2933,7899,718.0909091,244.4166667,2.693146949
NM_176096,CDK5RAP3,14,13,10832,2010,8822,678.6153846,143.5714286,4.389054726
NM_006807,CBX1,5,4,31148,2427,28721,7180.25,485.4,11.83395138
NM_013323,SNX11,7,6,15160,2322,12838,2139.666667,331.7142857,5.528854436
NM_152244,SNX11,8,7,15187,2410,12777,1825.285714,301.25,5.301659751
NM_001127228,CBX1,5,4,31471,2237,29234,7308.5,447.4,13.06839517
NM_002146,HOXB3,4,3,25580,3622,21958,7319.333333,905.5,6.062396466
NM_002145,HOXB2,2,1,2376,1604,772,772,802,0.481296758
NM_002144,HOXB1,2,1,1467,1016,451,451,508,0.443897638
NM_024015,HOXB4,2,1,2876,2035,841,841,1017.5,0.413267813
NM_002147,HOXB5,2,1,2486,1823,663,663,911.5,0.363686231
NM_024017,HOXB9,2,1,5318,2702,2616,2616,1351,0.968171725
NM_024016,HOXB8,2,1,2595,1825,770,770,912.5,0.421917808
NM_018952,HOXB6,4,3,9237,1680,7557,2519,420,4.498214286
NM_004502,HOXB7,2,1,3790,1368,2422,2422,684,1.770467836
NM_001130918,TTLL6,16,15,54878,3470,51408,3427.2,216.875,14.81498559
NM_032391,PRAC1,2,1,802,385,417,417,192.5,1.083116883
NM_001282276,PRAC2,2,1,1068,513,555,555,256.5,1.081871345
NM_001282275,PRAC2,2,1,1592,579,1013,1013,289.5,1.749568221
NM_006361,HOXB13,2,1,3986,3038,948,948,1519,0.3120474
NM_173623,TTLL6,9,8,32095,2551,29544,3693,283.4444444,11.58134065
NM_023079,UBE2Z,7,6,20693,3133,17560,2926.666667,447.5714286,5.60485158
NM_007241,SNF8,8,7,14697,1221,13476,1925.142857,152.625,11.03685504
NM_004123,GIP,6,5,10039,717,9322,1864.4,119.5,13.0013947
NM_005175,ATP5G1,5,4,3086,651,2435,608.75,130.2,3.740399386
NM_001002027,ATP5G1,5,4,3086,581,2505,626.25,116.2,4.311531842
NM_001160423,IGF2BP1,13,12,58735,8365,50370,4197.5,643.4615385,6.021518231
NM_006546,IGF2BP1,15,14,58735,8784,49951,3567.928571,585.6,5.686589253
NM_001143804,PHOSPHO1,3,2,7398,2176,5222,2611,725.3333333,2.399816176
NM_001198755,GNGT2,4,3,3168,1027,2141,713.6666667,256.75,2.084712756
NM_001159388,B4GALNT2,11,10,37531,1830,35701,3570.1,166.3636364,19.50874317
NM_031498,GNGT2,4,3,3149,1044,2105,701.6666667,261,2.016283525
NM_001159387,B4GALNT2,11,10,37222,1817,35405,3540.5,165.1818182,19.48541552
NM_153446,B4GALNT2,11,10,37024,2032,34992,3499.2,184.7272727,17.22047244
NM_016428,ABI3,8,7,13000,2117,10883,1554.714286,264.625,5.140765234
NM_178500,PHOSPHO1,3,2,7398,2049,5349,2674.5,683,2.610541728
NM_001198756,GNGT2,4,3,3168,917,2251,750.3333333,229.25,2.45474373
NM_001198754,GNGT2,4,3,4342,1000,3342,1114,250,3.342
NM_001135186,ABI3,8,7,13000,2099,10901,1557.285714,262.375,5.193425441
NM_014897,ZNF652,6,5,73269,11353,61916,12383.2,1892.166667,5.453712675
NM_001145365,ZNF652,6,5,72910,11498,61412,12282.4,1916.333333,5.3411028
NM_001281497,PHB,6,5,10859,1516,9343,1868.6,252.6666667,6.16292876
NM_001281496,PHB,7,6,10812,1916,8896,1482.666667,273.7142857,4.643006263
NM_002634,PHB,7,6,10859,1868,8991,1498.5,266.8571429,4.813169165
NM_001281715,PHB,8,7,10859,1961,8898,1271.142857,245.125,4.537480877
NM_007225,NXPH3,2,1,7875,5554,2321,2321,2777,0.417897011
NM_005827,SLC35B1,9,8,7019,1620,5399,674.875,180,3.332716049
NM_001278784,SLC35B1,9,8,7019,1595,5424,678,177.2222222,3.400626959
NM_007067,KAT7,15,14,40479,3661,36818,2629.857143,244.0666667,10.05681508
NM_001199155,KAT7,14,13,40479,3570,36909,2839.153846,255,10.33865546
NM_170685,TAC4,5,4,9710,680,9030,2257.5,136,13.27941176
NM_001242791,FLJ45513,3,2,2929,2103,826,413,701,0.39277223
NM_001077506,TAC4,5,4,9710,662,9048,2262,132.4,13.66767372
NM_001077505,TAC4,3,2,9710,567,9143,4571.5,189,16.12522046
NM_001077504,TAC4,4,3,9710,601,9109,3036.333333,150.25,15.15640599
NM_001077503,TAC4,4,3,9710,628,9082,3027.333333,157,14.46178344
NM_001199158,KAT7,12,11,40479,3151,37328,3393.454545,262.5833333,11.84639797
NM_001199157,KAT7,13,12,40479,3329,37150,3095.833333,256.0769231,11.15950736
NM_001199156,KAT7,13,12,40479,3242,37237,3103.083333,249.3846154,11.48581123
NM_001934,DLX4,2,1,2195,1765,430,430,882.5,0.243626062
NM_138281,DLX4,3,2,5763,2013,3750,1875,671,1.862891207
NM_005220,DLX3,3,2,5221,2605,2616,1308,868.3333333,1.004222649
NM_002611,PDK2,11,10,16096,2668,13428,1342.8,242.5454545,5.032983508
NM_002204,ITGA3,26,25,34511,5053,29458,1178.32,194.3461538,5.829804077
NM_001199898,PDK2,12,11,16634,2707,13927,1266.090909,225.5833333,5.144809752
NM_001199900,PDK2,4,3,11098,984,10114,3371.333333,246,10.27845528
NM_032595,PPP1R9B,10,9,16778,4058,12720,1413.333333,405.8,3.134549039
NM_001199899,PDK2,11,10,15676,2505,13171,1317.1,227.7272727,5.257884232
NM_001257359,SAMD14,10,9,18575,3226,15349,1705.444444,322.6,4.757904526
NM_005501,ITGA3,25,24,34511,4910,29601,1233.375,196.4,6.028716904
NM_174920,SAMD14,11,10,18575,3311,15264,1526.4,301,4.610087587
NM_001135697,SGCA,8,7,9929,1069,8860,1265.714286,133.625,8.288119738
NM_001168215,TMEM92,6,5,10081,2773,7308,1461.6,462.1666667,2.63541291
NM_000023,SGCA,10,9,9929,1443,8486,942.8888889,144.3,5.880803881
NM_000088,COL1A1,51,50,17545,5978,11567,231.34,117.2156863,1.93492807
NM_153229,TMEM92,5,4,7060,2737,4323,1080.75,547.4,1.579466569
NM_016504,MRPL27,4,3,5336,707,4629,1543,176.75,6.54738331
NM_152463,EME1,9,8,8241,2324,5917,739.625,258.2222222,2.546041308
NM_018509,LRRC59,7,6,16322,2922,13400,2233.333333,417.4285714,4.585900068
NM_022167,XYLT2,11,10,15155,3612,11543,1154.3,328.3636364,3.195736434
NM_001166131,EME1,9,8,8241,2363,5878,734.75,262.5555556,2.48751587
NM_025149,ACSF2,16,15,48689,2261,46428,3095.2,141.3125,20.53427687
NM_017957,EPN3,10,9,11065,3937,7128,792,393.7,1.810515621
NM_018346,RSAD1,9,8,7148,2508,4640,580,278.6666667,1.850079745
NM_032133,MYCBPAP,19,18,23119,3209,19910,1106.111111,168.8947368,6.204425055
NM_001267,CHAD,4,3,4376,1699,2677,892.3333333,424.75,1.575632725
NM_001288972,ACSF2,16,15,48689,2178,46511,3100.733333,136.125,21.35491276
NM_001288968,ACSF2,17,16,48689,2337,46352,2897,137.4705882,19.83397518
NM_001288970,ACSF2,15,14,48689,2131,46558,3325.571429,142.0666667,21.8479587
NM_001288969,ACSF2,16,15,48689,2222,46467,3097.8,138.875,20.91224122
NM_001288971,ACSF2,14,13,48689,1934,46755,3596.538462,138.1428571,24.17528438
NM_018896,CACNA1G,38,37,66405,8284,58121,1570.837838,218,7.016055046
NM_001256360,CACNA1G,35,34,66405,7894,58511,1720.911765,225.5428571,7.412085128
NM_001256359,CACNA1G,36,35,66405,7922,58483,1670.942857,220.0555556,7.382352941
NM_198383,CACNA1G,36,35,66405,8069,58336,1666.742857,224.1388889,7.229644318
NM_198379,CACNA1G,35,34,66405,8044,58361,1716.5,229.8285714,7.255221283
NM_198396,CACNA1G,36,35,66405,8180,58225,1663.571429,227.2222222,7.11797066
NM_198385,CACNA1G,37,36,66405,8148,58257,1618.25,220.2162162,7.149852725
NM_198384,CACNA1G,36,35,66405,8003,58402,1668.628571,222.3055556,7.297513432
NM_198380,CACNA1G,36,35,66405,8114,58291,1665.457143,225.3888889,7.184002958
NM_198378,CACNA1G,35,34,66405,7969,58436,1718.705882,227.6857143,7.332915046
NM_198377,CACNA1G,37,36,66405,8250,58155,1615.416667,222.972973,7.049090909
NM_198376,CACNA1G,35,34,66405,7663,58742,1727.705882,218.9428571,7.665666188
NM_198388,CACNA1G,34,33,66405,7878,58527,1773.545455,231.7058824,7.42916984
NM_001256333,CACNA1G,37,36,66405,7767,58638,1628.833333,209.9189189,7.549633063
NM_001256330,CACNA1G,35,34,66405,7867,58538,1721.705882,224.7714286,7.440955892
NM_001144070,ABCC3,12,11,33072,1897,31175,2834.090909,158.0833333,16.43384291
NM_001256361,CACNA1G,35,34,66405,7888,58517,1721.088235,225.3714286,7.418483773
NM_001256332,CACNA1G,35,34,66405,7831,58574,1722.764706,223.7428571,7.479759928
NM_001256331,CACNA1G,35,34,66405,7846,58559,1722.323529,224.1714286,7.463548305
NM_001256329,CACNA1G,36,35,66405,7901,58504,1671.542857,219.4722222,7.404632325
NM_001256328,CACNA1G,35,34,66405,7927,58478,1719.941176,226.4857143,7.377065725
NM_001256327,CACNA1G,36,35,66405,7982,58423,1669.228571,221.7222222,7.319343523
NM_001256326,CACNA1G,36,35,66405,8012,58393,1668.371429,222.5555556,7.288192711
NM_001256325,CACNA1G,36,35,66405,8024,58381,1668.028571,222.8888889,7.275797607
NM_001256324,CACNA1G,36,35,66405,8093,58312,1666.057143,224.8055556,7.205239096
NM_001256334,CACNA1G,36,35,66405,7733,58672,1676.342857,214.8055556,7.587223587
NM_198387,CACNA1G,34,33,66405,7899,58506,1772.909091,232.3235294,7.406760349
NM_198386,CACNA1G,35,34,66405,7948,58457,1719.323529,227.0857143,7.354932058
NM_198382,CACNA1G,35,34,66405,7933,58472,1719.764706,226.6571429,7.370729863
NM_016424,LUC7L3,10,9,33148,3527,29621,3291.222222,352.7,8.398355543
NM_006107,LUC7L3,11,10,33148,2023,31125,3112.5,183.9090909,15.38556599
NM_052855,ANKRD40,5,4,14721,4174,10547,2636.75,834.8,2.526832774
NM_001243885,TOB1,2,1,4130,2034,2096,2096,1017,1.030481809
NM_001243877,TOB1,3,2,5754,2224,3530,1765,741.3333333,1.587230216
NM_005749,TOB1,2,1,4130,2237,1893,1893,1118.5,0.84622262
NM_175575,WFIKKN2,2,1,7106,3756,3350,3350,1878,0.891906283
NM_001251971,SPAG9,27,26,84796,7967,76829,2954.961538,295.0740741,9.643404042
NM_001018139,NME2,5,4,5245,671,4574,1143.5,134.2,6.816691505
NM_001018137,NME2,5,4,6311,855,5456,1364,171,6.38128655
NM_001018136,NME1-NME2,8,7,18210,1083,17127,2446.714286,135.375,15.81440443
NM_198175,NME1,6,5,8532,1037,7495,1499,172.8333333,7.227579556
NM_000269,NME1,5,4,8532,816,7716,1929,163.2,9.455882353
NM_001018138,NME2,4,3,5024,712,4312,1437.333333,178,6.056179775
NM_002512,NME2,5,4,5474,834,4640,1160,166.8,5.563549161
NM_001198682,NME2,4,3,5474,720,4754,1584.666667,180,6.602777778
NM_016001,UTP18,14,13,37397,1898,35499,2730.692308,135.5714286,18.70337197
NM_001243552,C17orf112,4,3,2134,839,1295,431.6666667,209.75,1.543504172
NM_032559,KIF2B,1,0,2336,2336,NA,NA,2336,NA
NM_005486,TOM1L1,16,15,61278,2356,58922,3928.133333,147.25,25.00933786
NM_001162862,COX11,4,3,7499,816,6683,2227.666667,204,8.18995098
NM_001162861,COX11,4,3,7499,830,6669,2223,207.5,8.034939759
NM_004375,COX11,4,3,7499,2419,5080,1693.333333,604.75,2.100041339
NM_001102402,PCTP,6,5,26284,2170,24114,4822.8,361.6666667,11.1124424
NM_021213,PCTP,6,5,26410,2063,24347,4869.4,343.8333333,11.80174503
NM_018286,TMEM100,2,1,3239,1757,1482,1482,878.5,0.84348321
NM_001099640,TMEM100,4,3,12496,2257,10239,3413,564.25,4.536552946
NM_005450,NOG,1,0,1893,1893,NA,NA,1893,NA
NM_001085430,C17orf67,8,7,41984,2020,39964,5709.142857,252.5,19.78415842
NM_005082,TRIM25,9,8,26141,5753,20388,2548.5,639.2222222,3.543890144
NM_004645,COIL,7,6,22852,2640,20212,3368.666667,377.1428571,7.656060606
NM_021626,SCPEP1,13,12,28663,1958,26705,2225.416667,150.6153846,13.63891726
NM_001282544,CCDC182,1,0,850,850,NA,NA,850,NA
NM_016070,MRPS23,5,4,11148,1497,9651,2412.75,299.4,6.446893788
NM_007146,VEZF1,6,5,16707,4639,12068,2413.6,773.1666667,2.60142272
NM_006924,SRSF1,4,3,6429,5447,982,327.3333333,1361.75,0.180282724
NM_001078166,SRSF1,3,2,6429,5646,783,391.5,1882,0.138682253
NM_080677,DYNLL2,3,2,6840,1525,5315,2657.5,508.3333333,3.485245902
NM_000250,MPO,12,11,11081,3227,7854,714,268.9166667,2.433839479
NM_006151,LPO,13,12,30094,2992,27102,2258.5,230.1538462,9.05815508
NM_012374,OR4D1,1,0,934,934,NA,NA,934,NA
NM_017777,MKS1,18,17,13871,2416,11455,673.8235294,134.2222222,4.741307947
NM_001160102,LPO,11,10,30094,2741,27353,2735.3,249.1818182,9.97920467
NM_001165927,MKS1,18,17,14171,2405,11766,692.1176471,133.6111111,4.892307692
NM_000502,EPX,13,12,12448,2730,9718,809.8333333,210,3.55970696
NM_001004707,OR4D2,1,0,925,925,NA,NA,925,NA
NM_001261835,BZRAP1,32,31,27566,7703,19863,640.7419355,240.71875,2.578605738
NM_003168,SUPT4H1,5,4,7065,1533,5532,1383,306.6,3.608610568
NM_004758,BZRAP1,32,31,27566,7730,19836,639.8709677,241.5625,2.56610608
NM_024418,BZRAP1,31,30,27566,7549,20017,667.2333333,243.516129,2.651609485
NM_001038704,C17orf47,2,1,2787,2129,658,658,1064.5,0.309065289
NM_001198713,Sep-04,12,11,20570,1718,18852,1713.818182,143.1666667,10.97322468
NM_001080439,HSF5,6,5,68232,4113,64119,12823.8,685.5,15.58935084
NM_001256822,Sep-04,12,11,7799,1787,6012,546.5454545,148.9166667,3.364297706
NM_001256782,Sep-04,13,12,20570,1816,18754,1562.833333,139.6923077,10.32709251
NM_080416,Sep-04,12,11,11836,1689,10147,922.4545455,140.75,6.007696862
NM_080415,Sep-04,10,9,11836,1955,9881,1097.888889,195.5,5.054219949
NM_004687,MTMR4,19,18,28360,5848,22512,1250.666667,307.7894737,3.849521204
NM_004574,Sep-04,12,11,9219,1918,7301,663.7272727,159.8333333,3.806569343
NM_002876,RAD51C,2,1,2809,668,2141,2141,334,3.20508982
NM_058216,RAD51C,9,8,41771,1331,40440,5055,147.8888889,30.38317055
NM_001100595,SKA2,3,2,45494,2973,42521,21260.5,991,14.30238816
NM_182620,SKA2,4,3,45494,2976,42518,14172.66667,744,14.28696237
NM_018149,SMG8,4,3,5242,3270,1972,657.3333333,817.5,0.603058104
NM_001165994,GDPD1,9,8,52556,1159,51397,6424.625,128.7777778,44.34598792
NM_001165993,GDPD1,10,9,55504,1794,53710,5967.777778,179.4,29.9386845
NM_182569,GDPD1,10,9,55504,3294,52210,5801.111111,329.4,15.85003036
NM_016077,PTRH2,2,1,10191,800,9391,9391,400,11.73875
NM_004859,CLTC,32,31,77269,8607,68662,2214.903226,268.96875,7.977460207
NM_001288653,CLTC,32,31,77269,8619,68650,2214.516129,269.34375,7.964961132
NM_016125,RNFT1,9,8,12396,2025,10371,1296.375,225,5.121481481
NM_001193610,TUBD1,8,7,33467,2329,31138,4448.285714,291.125,13.36968656
NM_001272043,RPS6KB1,15,14,57381,4333,53048,3789.142857,288.8666667,12.24278791
NM_001272044,RPS6KB1,16,15,57381,5499,51882,3458.8,343.6875,9.434806328
NM_001272060,RPS6KB1,15,14,57381,5369,52012,3715.142857,357.9333333,9.687465077
NM_001193613,TUBD1,6,5,33467,1922,31545,6309,320.3333333,16.41259105
NM_003161,RPS6KB1,15,14,57381,5369,52012,3715.142857,357.9333333,9.687465077
NM_016261,TUBD1,9,8,33467,2501,30966,3870.75,277.8888889,12.38144742
NM_001193612,TUBD1,9,8,33467,2432,31035,3879.375,270.2222222,12.76110197
NM_001193611,TUBD1,7,6,33467,2193,31274,5212.333333,313.2857143,14.26082991
NM_001193609,TUBD1,8,7,33467,2335,31132,4447.428571,291.875,13.33276231
NM_001272042,RPS6KB1,14,13,57381,5299,52082,4006.307692,378.5,9.828646915
NM_022070,HEATR6,20,19,35742,3955,31787,1673,197.75,8.037168142
NM_000717,CA4,8,7,9606,1162,8444,1206.285714,145.25,7.266781411
NM_181707,C17orf64,6,5,8924,966,7958,1591.6,161,8.238095238
NM_005994,TBX2,7,6,9572,3387,6185,1030.833333,483.8571429,1.826099793
NM_203425,C17orf82,1,0,1531,1531,NA,NA,1531,NA
NM_018488,TBX4,8,7,27859,2478,25381,3625.857143,309.75,10.2425343
NM_199290,NACA2,1,0,771,771,NA,NA,771,NA
NM_020748,INTS2,25,24,62651,5906,56745,2364.375,236.24,9.608025737
NM_181725,METTL2A,9,8,26210,2528,23682,2960.25,280.8888889,9.367879747
NM_001144933,EFCAB3,12,11,46262,1705,44557,4050.636364,142.0833333,26.13313783
NM_173503,EFCAB3,10,9,35927,1554,34373,3819.222222,155.4,22.11904762
NM_006039,MRC2,30,29,66202,6022,60180,2075.172414,200.7333333,9.993357688
NM_001915,CYB561,6,5,14059,2990,11069,2213.8,498.3333333,3.702006689
NM_001178057,ACE,13,12,13565,3154,10411,867.5833333,242.6153846,3.300887762
NM_152830,ACE,14,13,13565,3278,10287,791.3076923,234.1428571,3.138194021
NM_000789,ACE,25,24,21321,4994,16327,680.2916667,199.76,3.269323188
NM_001017917,CYB561,6,5,8544,2993,5551,1110.2,498.8333333,1.854660875
NM_001017916,CYB561,6,5,13882,3160,10722,2144.4,526.6666667,3.393037975
NM_016360,TACO1,5,4,7496,1474,6022,1505.5,294.8,4.085481682
NM_005828,DCAF7,8,7,43848,6388,37462,5351.714286,798.5,5.864433312
NM_030576,LIMD2,5,4,4272,3230,1042,260.5,646,0.322600619
NM_020198,CCDC47,13,12,28480,3432,25048,2087.333333,264,7.298368298
NM_001165969,STRADA,11,10,39140,2170,36970,3697,197.2727273,17.03686636
NM_001165970,STRADA,11,10,39140,2125,37015,3701.5,193.1818182,17.41882353
NM_153335,STRADA,9,8,39140,2781,36359,4544.875,309,13.07407407
NM_001003788,STRADA,12,11,39140,2320,36820,3347.272727,193.3333333,15.87068966
NM_001003787,STRADA,13,12,39140,2350,36790,3065.833333,180.7692308,15.65531915
NM_001003786,STRADA,11,10,39140,2237,36903,3690.3,203.3636364,16.4966473
NM_022562,GH1,2,1,1637,378,1259,1259,189,3.330687831
NM_022561,GH1,3,2,1637,540,1097,548.5,180,2.031481481
NM_022559,GH1,5,4,1637,782,855,213.75,156.4,1.093350384
NM_020991,CSH2,5,4,1719,888,831,207.75,177.6,0.935810811
NM_002805,PSMC5,12,11,4619,1372,3247,295.1818182,114.3333333,2.366618076
NM_022644,CSH2,4,3,1719,1140,579,193,285,0.507894737
NM_022581,CSHL1,5,4,1655,773,882,220.5,154.6,1.141009056
NM_022580,CSHL1,4,3,1655,592,1063,354.3333333,148,1.795608108
NM_022579,CSHL1,5,4,1655,842,813,203.25,168.4,0.965558195
NM_022558,GH2,5,4,1732,905,827,206.75,181,0.913812155
NM_022557,GH2,4,3,1732,1161,571,190.3333333,290.25,0.491817399
NM_022556,GH2,5,4,1732,864,868,217,172.8,1.00462963
NM_001199163,PSMC5,12,11,4345,1507,2838,258,125.5833333,1.883211679
NM_022645,CSH2,3,2,1719,601,1118,559,200.3333333,1.860232945
NM_002059,GH2,5,4,1732,909,823,205.75,181.8,0.905390539
NM_001318,CSHL1,4,3,1655,665,990,330,166.25,1.488721805
NM_017647,FTSJ3,21,20,8240,3580,4660,233,170.4761905,1.301675978
NM_022560,GH1,4,3,1637,706,931,310.3333333,176.5,1.318696884
NM_001098426,SMARCD2,13,12,10912,2783,8129,677.4166667,214.0769231,2.920948617
NM_000515,GH1,5,4,1637,827,810,202.5,165.4,0.979443773
NM_001317,CSH1,5,4,1755,923,832,208,184.6,0.901408451
NM_001191029,C17orf72,5,4,5935,3039,2896,724,607.8,0.952945048
NM_001099789,ICAM2,5,4,18041,1141,16900,4225,228.2,14.8115688
NM_000873,ICAM2,4,3,4330,1216,3114,1038,304,2.560855263
NM_001039933,CD79B,6,5,3608,1270,2338,467.6,211.6666667,1.840944882
NM_001191031,C17orf72,5,4,5935,2885,3050,762.5,577,1.057192374
NM_000334,SCN4A,24,23,34366,7829,26537,1153.782609,326.2083333,3.389577213
NM_000626,CD79B,6,5,3608,1267,2341,468.2,211.1666667,1.847671665
NM_021602,CD79B,5,4,3608,954,2654,663.5,190.8,2.78197065
NM_001099788,ICAM2,6,5,18041,1224,16817,3363.4,204,13.73937908
NM_001099787,ICAM2,5,4,18041,1258,16783,4195.75,251.6,13.34101749
NM_001099786,ICAM2,6,5,18041,1341,16700,3340,223.5,12.45339299
NM_001191030,C17orf72,6,5,5935,3092,2843,568.6,515.3333333,0.919469599
NM_001164257,C17orf72,6,5,5935,3113,2822,564.4,518.8333333,0.906521041
NM_001085423,MILR1,5,4,3193,636,2557,639.25,127.2,4.020440252
NM_007215,POLG2,8,7,19284,1602,17682,2526,200.25,11.03745318
NM_000442,PECAM1,2,1,10308,4455,5853,5853,2227.5,1.313804714
NM_004396,DDX5,13,12,8112,3772,4340,361.6666667,290.1538462,1.150583245
NM_004655,AXIN2,11,10,33059,4243,28816,2881.6,385.7272727,6.791421164
NM_000727,CACNG1,4,3,12261,1322,10939,3646.333333,330.5,8.274583964
NM_002816,PSMD12,11,10,26104,1808,24296,2429.6,164.3636364,13.4380531
NM_174871,PSMD12,10,9,26104,1747,24357,2706.333333,174.7,13.94218661
NM_015462,NOL11,18,17,26207,2472,23735,1396.176471,137.3333333,9.601537217
NM_181656,C17orf58,3,2,2552,1569,983,491.5,523,0.626513703
NM_181655,C17orf58,3,2,2552,1426,1126,563,475.3333333,0.789621318
NM_002266,KPNA2,11,10,11124,1991,9133,913.3,181,4.58714214
NM_001174166,SLC16A6,7,6,24240,3962,20278,3379.666667,566,5.118122161
NM_001033572,AMZ2,8,7,9162,1403,7759,1108.428571,175.375,5.530292231
NM_004694,SLC16A6,6,5,24240,3834,20406,4081.2,639,5.322378717
NM_001289056,AMZ2,8,7,9162,1506,7656,1093.714286,188.25,5.083665339
NM_001033570,AMZ2,8,7,9162,1431,7731,1104.428571,178.875,5.402515723
NM_001033569,AMZ2,8,7,9162,1435,7727,1103.857143,179.375,5.38466899
NM_016627,AMZ2,7,6,9162,1987,7175,1195.833333,283.8571429,3.610971314
NM_001033574,AMZ2,6,5,9162,1812,7350,1470,302,4.056291391
NM_001033571,AMZ2,8,7,9162,1407,7755,1107.857143,175.875,5.511727079
NM_001289054,AMZ2,8,7,9162,1415,7747,1106.714286,176.875,5.474911661
NM_001276290,PRKAR1A,10,9,35924,1222,34702,3855.777778,122.2,28.39770867
NM_001276289,PRKAR1A,12,11,21052,4447,16605,1509.545455,370.5833333,3.733977963
NM_212471,PRKAR1A,11,10,21651,4506,17145,1714.5,409.6363636,3.804926764
NM_212472,PRKAR1A,11,10,21052,4344,16708,1670.8,394.9090909,3.846224678
NM_002734,PRKAR1A,11,10,21052,4313,16739,1673.9,392.0909091,3.881057269
NM_007168,ABCA8,38,37,88107,5761,82346,2225.567568,151.6052632,14.29369901
NM_001288986,ABCA8,39,38,88107,5867,82240,2164.210526,150.4358974,14.01738538
NM_001288985,ABCA8,40,39,88107,6044,82063,2104.179487,151.1,13.57759762
NM_018672,ABCA5,38,37,71200,9287,61913,1673.324324,244.3947368,6.666630774
NM_172232,ABCA5,39,38,82749,8216,74533,1961.394737,210.6666667,9.071689387
NM_170741,KCNJ16,4,3,60382,3987,56395,18798.33333,996.75,14.14472034
NM_018658,KCNJ16,5,4,60382,4069,56313,14078.25,813.8,13.83951831
NM_001270422,KCNJ16,6,5,60382,4198,56184,11236.8,699.6666667,13.38351596
NM_000891,KCNJ2,2,1,10509,5388,5121,5121,2694,0.950445434
NM_000346,SOX9,3,2,5401,3937,1464,732,1312.333333,0.371856744
NM_001050,SSTR2,2,1,6904,2966,3938,3938,1483,1.327714093
NM_018714,COG1,14,13,15474,3048,12426,955.8461538,217.7142857,4.076771654
NM_017941,C17orf80,6,5,16336,3660,12676,2535.2,610,3.463387978
NM_001100621,C17orf80,5,4,16336,3551,12785,3196.25,710.2,3.600394255
NM_001129885,CPSF4L,6,5,13433,653,12780,2556,108.8333333,19.5712098
NM_001098832,FAM104A,4,3,25043,2892,22151,7383.666667,723,7.659405256
NM_001289412,FAM104A,4,3,20366,2665,17701,5900.333333,666.25,6.642026266
NM_001289410,FAM104A,2,1,25043,2727,22316,22316,1363.5,8.183351669
NM_001289411,FAM104A,3,2,25043,2746,22297,11148.5,915.3333333,8.119810634
NM_032837,FAM104A,3,2,25043,2828,22215,11107.5,942.6666667,7.855374823
NM_001288771,C17orf80,5,4,13113,2173,10940,2735,434.6,5.034514496
NM_001288770,C17orf80,5,4,16725,3712,13013,3253.25,742.4,3.505657328
NM_001100622,C17orf80,6,5,12724,2121,10603,2120.6,353.5,4.999057049
NM_001278587,LOC100134391,6,5,18705,1146,17559,3511.8,191,15.32198953
NM_001035258,RPL38,5,4,6226,362,5864,1466,72.4,16.19889503
NM_000999,RPL38,5,4,6226,397,5829,1457.25,79.4,14.68261965
NM_023036,DNAI2,14,13,40639,2293,38346,2949.692308,163.7857143,16.72307021
NM_052869,TTYH2,8,7,13654,3263,10391,1484.428571,407.875,3.184492798
NM_001172810,DNAI2,14,13,40639,2254,38385,2952.692308,161,17.02972493
NM_007261,CD300A,7,6,18417,1900,16517,2752.833333,271.4285714,8.693157895
NM_001256841,CD300A,6,5,18417,1560,16857,3371.4,260,10.80576923
NM_018653,GPRC5C,4,3,13734,1824,11910,3970,456,6.529605263
NM_022036,GPRC5C,4,3,15903,2377,13526,4508.666667,594.25,5.690366008
NM_001080466,BTBD17,3,2,5405,1681,3724,1862,560.3333333,2.215348007
NM_181790,GPR142,4,3,5096,1393,3703,1234.333333,348.25,2.658291457
NM_001115152,CD300LD,4,3,12261,648,11613,3871,162,17.9212963
NM_152460,C17orf77,3,2,9293,2528,6765,3382.5,842.6666667,2.676028481
NM_006678,CD300C,4,3,5107,1591,3516,1172,397.75,2.209930861
NM_174892,CD300LB,4,3,10302,2298,8004,2668,574.5,3.483028721
NM_001163990,RAB37,8,7,10120,2549,7571,1081.571429,318.625,2.970184386
NM_001163989,RAB37,9,8,10517,2810,7707,963.375,312.2222222,2.742704626
NM_001006638,RAB37,9,8,10120,2661,7459,932.375,295.6666667,2.803081548
NM_175738,RAB37,9,8,76220,3054,73166,9145.75,339.3333333,23.95743287
NM_001289082,CD300LF,7,6,18694,1863,16831,2805.166667,266.1428571,9.034353194
NM_001289083,CD300LF,8,7,18694,1849,16845,2406.428571,231.125,9.110329908
NM_001289084,CD300LF,7,6,18694,1847,16847,2807.833333,263.8571429,9.121277748
NM_001289085,CD300LF,8,7,18694,1977,16717,2388.142857,247.125,8.455741022
NM_001289086,CD300LF,7,6,18694,1998,16696,2782.666667,285.4285714,8.356356356
NM_001289087,CD300LF,6,5,18694,1778,16916,3383.2,296.3333333,9.514060742
NM_139018,CD300LF,7,6,18694,1802,16892,2815.333333,257.4285714,9.374028857
NM_015654,NAT9,7,6,5786,1882,3904,650.6666667,268.8571429,2.074388948
NM_004110,FDXR,12,11,10539,1913,8626,784.1818182,159.4166667,4.509147935
NM_001278553,GRIN2C,12,11,16797,3249,13548,1231.636364,270.75,4.16989843
NM_001258012,FDXR,12,11,10539,2024,8515,774.0909091,168.6666667,4.20701581
NM_001258013,FDXR,13,12,10539,1989,8550,712.5,153,4.298642534
NM_001258014,FDXR,12,11,10539,1871,8668,788,155.9166667,4.632816676
NM_001258015,FDXR,11,10,10539,1774,8765,876.5,161.2727273,4.940811725
NM_017728,TMEM104,10,9,63302,4759,58543,6504.777778,475.9,12.30153394
NM_024417,FDXR,12,11,10539,1895,8644,785.8181818,157.9166667,4.561477573
NM_000835,GRIN2C,13,12,17847,4283,13564,1130.333333,329.4615385,3.166939061
NM_001258016,FDXR,11,10,6259,1839,4420,442,167.1818182,2.403480152
NM_030630,HID1,19,18,22063,3361,18702,1039,176.8947368,5.564415353
NM_001272005,OTOP3,7,6,14192,2440,11752,1958.666667,348.5714286,4.816393443
NM_173477,USH1G,3,2,7184,3571,3613,1806.5,1190.333333,1.011761411
NM_014603,CDR2L,5,4,18167,3538,14629,3657.25,707.6,4.134821933
NM_001282489,USH1G,3,2,7184,3518,3666,1833,1172.666667,1.042069358
NM_178233,OTOP3,7,6,14192,2374,11818,1969.666667,339.1428571,4.97809604
NM_178160,OTOP2,7,6,9638,2154,7484,1247.333333,307.7142857,3.47446611
NM_024585,ARMC7,3,2,20280,2129,18151,9075.5,709.6666667,8.525598873
NM_015353,KCTD2,6,5,18704,3704,15000,3000,617.3333333,4.049676026
NM_001252377,NT5C,4,3,1572,841,731,243.6666667,210.25,0.869203329
NM_006356,ATP5H,6,5,8121,628,7493,1498.6,104.6666667,11.93152866
NM_014595,NT5C,5,4,1572,962,610,152.5,192.4,0.634095634
NM_001545,ICT1,6,5,8578,885,7693,1538.6,147.5,8.692655367
NM_001271765,SLC16A5,7,6,18435,2024,16411,2735.166667,289.1428571,8.108201581
NM_004695,SLC16A5,7,6,18221,1958,16263,2710.5,279.7142857,8.305924413
NM_001003785,ATP5H,5,4,8121,555,7566,1891.5,111,13.63243243
NM_006937,SUMO2,4,3,15275,1070,14205,4735,267.5,13.27570093
NM_001242501,MIF4GD,5,4,4018,1235,2783,695.75,247,2.253441296
NM_001242500,MIF4GD,6,5,4018,1338,2680,536,223,2.002989537
NM_020679,MIF4GD,7,6,5003,1426,3577,596.1666667,203.7142857,2.508415147
NM_001172704,GGA3,16,15,25752,2954,22798,1519.866667,184.625,7.717670955
NM_001172703,GGA3,17,16,25752,3897,21855,1365.9375,229.2352941,5.608160123
NM_024844,NUP85,19,18,30259,2330,27929,1551.611111,122.6315789,11.98669528
NM_014001,GGA3,16,15,25015,3794,21221,1414.733333,237.125,5.593305219
NM_001005849,SUMO2,3,2,15275,997,14278,7139,332.3333333,14.32096289
NM_001242498,MIF4GD,7,6,5003,1447,3556,592.6666667,206.7142857,2.457498272
NM_015971,MRPS7,5,4,4710,1420,3290,822.5,284,2.316901408
NM_138619,GGA3,17,16,25015,3894,21121,1320.0625,229.0588235,5.423985619
NM_001142643,CASKIN2,19,18,9630,4518,5112,284,237.7894737,1.131474104
NM_020753,CASKIN2,20,19,15325,5036,10289,541.5263158,251.8,2.043089754
NM_014738,KIAA0195,32,31,43871,5496,38375,1237.903226,171.75,6.982350801
NM_207346,TSEN54,11,10,8213,1952,6261,626.1,177.4545455,3.207479508
NM_001162997,SMIM6,2,1,1413,830,583,583,415,0.702409639
NM_001162995,SMIM5,3,2,7974,1551,6423,3211.5,517,4.141199226
NM_000154,GALK1,8,7,7264,1369,5895,842.1428571,171.125,4.30606282
NM_013260,SAP30BP,11,10,40742,2530,38212,3821.2,230,15.10355731
NM_000213,ITGB4,40,39,36385,5959,30426,780.1538462,148.975,5.10589025
NM_005324,H3F3B,4,3,3347,2709,638,212.6666667,677.25,0.235511259
NM_001005619,ITGB4,39,38,33125,5728,27397,720.9736842,146.8717949,4.78299581
NM_001005731,ITGB4,39,38,36385,5748,30637,806.2368421,147.3846154,5.330027836
NM_199242,UNC13D,32,31,17492,4423,13069,421.5806452,138.21875,2.954781822
NM_032478,MRPL38,9,8,6459,1584,4875,609.375,176,3.077651515
NM_012478,WBP2,8,7,9723,1952,7771,1110.142857,244,3.981045082
NM_001256124,TRIM65,5,4,8045,3378,4667,1166.75,675.6,1.381586738
NM_033452,TRIM47,6,5,4413,2269,2144,428.8,378.1666667,0.944909652
NM_173547,TRIM65,6,5,8045,3445,4600,920,574.1666667,1.335268505
NM_001988,EVPL,22,21,20582,6609,13973,665.3809524,300.4090909,2.11423816
NM_007292,ACOX1,14,13,37928,7598,30330,2333.076923,542.7142857,3.991839958
NM_001260503,SRP68,9,8,14883,2054,12829,1603.625,228.2222222,6.245861733
NM_001258,CDK3,8,7,5095,1578,3517,502.4285714,197.25,2.228770596
NM_001185039,ACOX1,14,13,37928,7772,30156,2319.692308,555.1428571,3.880082347
NM_001113324,TEN1,4,3,21371,1001,20370,6790,250.25,20.34965035
NM_004035,ACOX1,14,13,37928,7598,30330,2333.076923,542.7142857,3.991839958
NM_001282314,EXOC7,4,3,2777,775,2002,667.3333333,193.75,2.583225806
NM_001282313,EXOC7,19,18,22580,4853,17727,984.8333333,255.4210526,3.652792087
NM_001145299,EXOC7,20,19,22796,4894,17902,942.2105263,244.7,3.657948508
NM_001145298,EXOC7,19,18,22796,4800,17996,999.7777778,252.6315789,3.749166667
NM_001454,FOXJ1,3,2,4967,2643,2324,1162,881,0.879303821
NM_001013839,EXOC7,19,18,22796,4824,17972,998.4444444,253.8947368,3.725538972
NM_015219,EXOC7,18,17,22796,4730,18066,1062.705882,262.7777778,3.819450317
NM_001145297,EXOC7,20,19,22796,4978,17818,937.7894737,248.9,3.579349136
NM_003857,GALR2,2,1,2742,1359,1383,1383,679.5,1.017660044
NM_180990,ZACN,9,8,3624,1482,2142,267.75,164.6666667,1.44534413
NM_032134,QRICH2,19,18,33633,5378,28255,1569.722222,283.0526316,5.253811826
NM_182565,UBALD2,3,2,6095,1592,4503,2251.5,530.6666667,2.828517588
NM_182965,SPHK1,6,5,3253,2190,1063,212.6,365,0.485388128
NM_001142602,SPHK1,5,4,2654,1871,783,195.75,374.2,0.418492785
NM_001142601,SPHK1,6,5,3253,1827,1426,285.2,304.5,0.780514505
NM_021972,SPHK1,6,5,3253,1869,1384,276.8,311.5,0.740502943
NM_024599,RHBDF2,19,18,30536,3624,26912,1495.111111,190.7368421,7.426048565
NM_001005498,RHBDF2,18,17,17018,3461,13557,797.4705882,192.2777778,3.91707599
NM_134268,CYGB,4,3,10559,2170,8389,2796.333333,542.5,3.865898618
NM_001088,AANAT,4,3,2571,1030,1541,513.6666667,257.5,1.496116505
NM_001077620,PRCD,5,4,5339,1999,3340,835,399.8,1.670835418
NM_001166579,AANAT,7,6,16768,1920,14848,2474.666667,274.2857143,7.733333333
NM_198530,MXRA7,4,3,31407,1843,29564,9854.666667,460.75,16.04123711
NM_001008528,MXRA7,4,3,35249,2508,32741,10913.66667,627,13.0546252
NM_001008529,MXRA7,5,4,31407,1925,29482,7370.5,385,15.31532468
NM_001289107,ST6GALNAC1,10,9,19084,2724,16360,1817.777778,272.4,6.005873715
NM_018414,ST6GALNAC1,9,8,19084,2586,16498,2062.25,287.3333333,6.379737046
NM_003016,SRSF2,2,1,3298,2965,333,333,1482.5,0.112310287
NM_001195427,SRSF2,3,2,3298,1971,1327,663.5,657,0.673262303
NM_001206984,METTL23,5,4,7052,843,6209,1552.25,168.6,7.365361803
NM_001206985,METTL23,4,3,7052,1036,6016,2005.333333,259,5.806949807
NM_001206986,METTL23,4,3,7052,1071,5981,1993.666667,267.75,5.584500467
NM_001206987,METTL23,4,3,7052,1215,5837,1945.666667,303.75,4.804115226
NM_001206983,METTL23,5,4,7052,1177,5875,1468.75,235.4,4.991503823
NM_001080510,METTL23,5,4,7052,1142,5910,1477.5,228.4,5.175131349
NM_024311,MFSD11,14,13,41755,2720,39035,3002.692308,194.2857143,14.35110294
NM_015167,JMJD6,6,5,8358,1828,6530,1306,304.6666667,3.572210066
NM_001242537,MFSD11,12,11,41755,2655,39100,3554.545455,221.25,14.72693032
NM_001242536,MFSD11,12,11,41755,2844,38911,3537.363636,237,13.68178622
NM_001242535,MFSD11,14,13,41755,2813,38942,2995.538462,200.9285714,13.84358336
NM_001242534,MFSD11,14,13,42691,2864,39827,3063.615385,204.5714286,13.90607542
NM_001242533,MFSD11,14,13,41755,3002,38753,2981,214.4285714,12.90906063
NM_001242532,MFSD11,13,12,41755,3117,38638,3219.833333,239.7692308,12.39589349
NM_198955,MGAT5B,16,15,77744,4076,73668,4911.2,254.75,18.07360157
NM_001199172,MGAT5B,17,16,81675,4261,77414,4838.375,250.6470588,18.16803567
NM_144677,MGAT5B,17,16,81675,4255,77420,4838.75,250.2941176,18.19506463
NM_001143998,SEC14L1,17,16,76178,5561,70617,4413.5625,327.1176471,12.69861536
NM_001143999,SEC14L1,17,16,76178,5557,70621,4413.8125,326.8823529,12.7084758
NM_001144001,SEC14L1,15,14,31888,5347,26541,1895.785714,356.4666667,4.963717973
NM_003003,SEC14L1,17,16,76178,5508,70670,4416.875,324,12.83042847
NM_001039573,SEC14L1,18,17,76178,3033,73145,4302.647059,168.5,24.11638642
NM_001113496,Sep-09,10,9,50067,3244,46823,5202.555556,324.4,14.4337238
NM_001113494,Sep-09,11,10,124515,3950,120565,12056.5,359.0909091,30.52278481
NM_001113495,Sep-09,10,9,25355,3649,21706,2411.777778,364.9,5.948479035
NM_001113493,Sep-09,11,10,127408,3997,123411,12341.1,363.3636364,30.87590693
NM_001127198,TMC6,20,19,15864,2911,12953,681.7368421,145.55,4.449673652
NM_007267,TMC6,20,19,19491,2809,16682,878,140.45,5.938768245
NM_152468,TMC8,16,15,12192,4435,7757,517.1333333,277.1875,1.749041714
NM_001204211,TMEM235,5,4,9679,2415,7264,1816,483,3.007867495
NM_001204212,TMEM235,4,3,9679,2276,7403,2467.666667,569,3.252636204
NM_001204210,TMEM235,6,5,9679,2497,7182,1436.4,416.1666667,2.876251502
NM_001012271,BIRC5,5,4,11441,2705,8736,2184,541,3.229574861
NM_001012270,BIRC5,3,2,11441,2516,8925,4462.5,838.6666667,3.547297297
NM_001168,BIRC5,4,3,11441,2635,8806,2935.333333,658.75,3.341935484
NM_001145526,AFMID,11,10,20386,1756,18630,1863,159.6363636,10.60933941
NM_001010982,AFMID,11,10,20386,1741,18645,1864.5,158.2727273,10.70936244
NM_004710,SYNGR2,4,3,4340,1698,2642,880.6666667,424.5,1.555948174
NM_003258,TK1,7,6,13127,1602,11525,1920.833333,228.8571429,7.194132335
NM_003955,SOCS3,2,1,3304,2739,565,565,1369.5,0.206279664
NM_001243540,LOC100653515,3,2,12639,2109,10530,5265,703,4.992887624
NM_001243541,LOC100653515,3,2,12639,2170,10469,5234.5,723.3333333,4.824423963
NM_003255,TIMP2,5,4,72415,3660,68755,17188.75,732,18.78551913
NM_001159772,CANT1,6,5,18103,3485,14618,2923.6,580.8333333,4.194548063
NM_005567,LGALS3BP,6,5,8728,2266,6462,1292.4,377.6666667,2.851721094
NM_198594,C1QTNF1,3,2,25714,2813,22901,11450.5,937.6666667,8.141130466
NM_198593,C1QTNF1,4,3,15491,2799,12692,4230.666667,699.75,4.534476599
NM_030968,C1QTNF1,4,3,25714,2983,22731,7577,745.75,7.620181026
NM_153372,C1QTNF1,4,3,26856,2719,24137,8045.666667,679.75,8.877160721
NM_138793,CANT1,4,3,18103,3539,14564,4854.666667,884.75,4.115286804
NM_001159773,CANT1,5,4,18103,3345,14758,3689.5,669,4.411958146
NM_001042573,ENGASE,14,13,13668,4508,9160,704.6153846,322,2.031943212
NM_178543,ENPP7,6,5,11158,1865,9293,1858.6,310.8333333,4.982841823
NM_020649,CBX8,5,4,2741,1551,1190,297.5,310.2,0.767246937
NM_032647,CBX2,4,3,4356,1081,3275,1091.666667,270.25,3.02960222
NM_005189,CBX2,5,4,9474,4270,5204,1301,854,1.218735363
NM_003655,CBX4,5,4,6260,2654,3606,901.5,530.8,1.358703843
NM_001271845,TBC1D16,8,7,18516,9838,8678,1239.714286,1229.75,0.882089856
NM_001271846,TBC1D16,7,6,7006,1180,5826,971,168.5714286,4.937288136
NM_001271844,TBC1D16,8,7,18516,9799,8717,1245.285714,1224.875,0.889580569
NM_001243342,CCDC40,18,17,54191,3564,50627,2978.058824,198,14.20510662
NM_000152,GAA,20,19,18326,3795,14531,764.7894737,189.75,3.828985507
NM_001079803,GAA,21,20,18326,3611,14715,735.75,171.952381,4.075048463
NM_001079804,GAA,20,19,18326,3530,14796,778.7368421,176.5,4.191501416
NM_017950,CCDC40,20,19,63983,4318,59665,3140.263158,215.9,13.81773969
NM_001166348,SLC26A11,17,16,33110,2870,30240,1890,168.8235294,10.53658537
NM_024110,CARD14,21,20,30825,4190,26635,1331.75,199.5238095,6.356801909
NM_052819,CARD14,10,9,11126,1643,9483,1053.666667,164.3,5.771758977
NM_001257970,CARD14,15,14,24125,2613,21512,1536.571429,174.2,8.23268274
NM_000199,SGSH,8,7,11122,2776,8346,1192.285714,347,3.00648415
NM_001166349,SLC26A11,17,16,33110,2740,30370,1898.125,161.1764706,11.08394161
NM_001166347,SLC26A11,18,17,33110,2941,30169,1774.647059,163.3888889,10.25807548
NM_173626,SLC26A11,18,17,33110,2938,30172,1774.823529,163.2222222,10.26957114
NM_001164638,ENDOV,8,7,15206,1279,13927,1989.571429,159.875,10.88897576
NM_002522,NPTX1,5,4,9773,5442,4331,1082.75,1088.4,0.795847115
NM_173627,ENDOV,10,9,22919,2828,20091,2232.333333,282.8,7.104314003
NM_001164637,ENDOV,9,8,22919,2692,20227,2528.375,299.1111111,7.513744428
NM_024591,CHMP6,8,7,8294,1672,6622,946,209,3.960526316
NM_004920,AATK,13,12,14654,5102,9552,796,392.4615385,1.872206978
NM_001080395,AATK,14,13,48778,5325,43453,3342.538462,380.3571429,8.160187793
NM_138570,SLC38A10,14,13,44470,3119,41351,3180.846154,222.7857143,13.25777493
NM_001086521,C17orf89,3,2,1989,563,1426,713,187.6666667,2.53285968
NM_144679,ENTHD2,12,11,10816,2299,8517,774.2727273,191.5833333,3.704654197
NM_001037984,SLC38A10,16,15,50530,4539,45991,3066.066667,283.6875,10.13240802
NM_001272086,RP11-1055B8.3,4,3,9463,771,8692,2897.333333,192.75,11.27367056
NM_025161,C17orf70,9,8,12520,3662,8858,1107.25,406.8888889,2.418896778
NM_001199954,ACTG1,6,5,2897,2111,786,157.2,351.8333333,0.372335386
NM_001077182,FSCN2,5,4,8741,1747,6994,1748.5,349.4,4.003434459
NM_001614,ACTG1,6,5,2897,1992,905,181,332,0.454317269
NM_012418,FSCN2,5,4,8741,1675,7066,1766.5,335,4.218507463
NM_012140,SLC25A10,11,10,8782,2005,6777,677.7,182.2727273,3.380049875
NM_199287,CCDC137,6,5,7177,2114,5063,1012.6,352.3333333,2.394985809
NM_001039842,OXLD1,2,1,1554,622,932,932,311,1.498392283
NM_031945,TSPAN10,3,2,6432,1616,4816,2408,538.6666667,2.98019802
NM_002602,PDE6G,4,3,6120,1027,5093,1697.666667,256.75,4.959104187
NM_002949,MRPL12,5,4,4158,1020,3138,784.5,204,3.076470588
NM_001270888,SLC25A10,11,10,8782,2032,6750,675,184.7272727,3.321850394
NM_001270953,SLC25A10,11,10,8782,1922,6860,686,174.7272727,3.569198751
NM_001040025,ARL16,5,4,2732,1212,1520,380,242.4,1.254125413
NM_004712,HGS,22,21,18191,2994,15197,723.6666667,136.0909091,5.075818303
NM_000160,GCGR,14,13,9881,2065,7816,601.2307692,147.5,3.784987893
NM_001093767,FAM195B,6,5,10935,990,9945,1989,165,10.04545455
NM_207368,FAM195B,5,4,10935,1290,9645,2411.25,258,7.476744186
NM_000918,P4HB,11,10,17512,2589,14923,1492.3,235.3636364,5.764001545
NM_001288799,FAM195B,4,3,10935,1187,9748,3249.333333,296.75,8.212299916
NM_001288798,FAM195B,7,6,10935,1127,9808,1634.666667,161,8.702750665
NM_001007533,PPP1R27,3,2,1560,802,758,379,267.3333333,0.945137157
NM_006907,PYCR1,7,6,4873,2238,2635,439.1666667,319.7142857,1.177390527
NM_001185078,ARHGDIA,6,5,3687,1780,1907,381.4,296.6666667,1.071348315
NM_005782,ALYREF,6,5,3753,1103,2650,530,183.8333333,2.402538531
NM_001282204,PCYT2,13,12,8340,3365,4975,414.5833333,258.8461538,1.478454681
NM_001185077,ARHGDIA,6,5,3195,2082,1113,222.6,347,0.534582133
NM_001256435,PCYT2,13,12,8578,3521,5057,421.4166667,270.8461538,1.436239705
NM_001256433,PCYT2,12,11,8578,3074,5504,500.3636364,256.1666667,1.790500976
NM_032711,MAFG,3,2,5301,5073,228,114,1691,0.04494382
NM_001282281,PYCR1,8,7,4855,1903,2952,421.7142857,237.875,1.551234892
NM_001282280,PYCR1,8,7,4944,1910,3034,433.4285714,238.75,1.588481675
NM_001282279,PYCR1,7,6,4944,1816,3128,521.3333333,259.4285714,1.72246696
NM_001289420,ANAPC11,5,4,8608,1068,7540,1885,213.6,7.059925094
NM_148896,NPB,2,1,711,619,92,92,309.5,0.148626817
NM_016476,ANAPC11,4,3,8822,952,7870,2623.333333,238,8.266806723
NM_001002249,ANAPC11,4,3,8608,981,7627,2542.333333,245.25,7.774719674
NM_001289418,ANAPC11,3,2,8822,896,7926,3963,298.6666667,8.845982143
NM_001289419,ANAPC11,4,3,8822,968,7854,2618,242,8.113636364
NM_004309,ARHGDIA,6,5,3687,1912,1775,355,318.6666667,0.92834728
NM_002861,PCYT2,13,12,8578,3237,5341,445.0833333,249,1.649984554
NM_002359,MAFG,3,2,9444,5041,4403,2201.5,1680.333333,0.87343781
NM_016538,SIRT7,10,9,6245,1741,4504,500.4444444,174.1,2.587018955
NM_178493,NOTUM,11,10,8676,2228,6448,644.8,202.5454545,2.894075404
NM_001256434,PCYT2,14,13,8578,3290,5288,406.7692308,235,1.607294833
NM_001145113,MYADML2,3,2,7590,2455,5135,2567.5,818.3333333,2.091649695
NM_001184917,PCYT2,14,13,8578,3292,5286,406.6153846,235.1428571,1.605710814
NM_001289414,ANAPC11,4,3,9745,863,8882,2960.666667,215.75,10.29200463
NM_001002244,ANAPC11,4,3,8822,1190,7632,2544,297.5,6.413445378
NM_001002245,ANAPC11,3,2,8822,858,7964,3982,286,9.282051282
NM_001002246,ANAPC11,4,3,8822,922,7900,2633.333333,230.5,8.568329718
NM_001002247,ANAPC11,3,2,8822,866,7956,3978,288.6666667,9.187066975
NM_001002248,ANAPC11,4,3,8822,930,7892,2630.666667,232.5,8.486021505
NM_001289415,ANAPC11,3,2,8822,888,7934,3967,296,8.934684685
NM_001289417,ANAPC11,5,4,8822,1015,7807,1951.75,203,7.691625616
NM_153824,PYCR1,8,7,4873,1896,2977,425.2857143,237,1.570147679
NM_001289416,ANAPC11,3,2,8608,917,7691,3845.5,305.6666667,8.387131952
NM_001282203,PCYT2,13,12,8340,3649,4691,390.9166667,280.6923077,1.285557687
NM_001195218,DCXR,8,7,1818,831,987,141,103.875,1.187725632
NM_144999,LRRC45,17,16,7749,2616,5133,320.8125,153.8823529,1.962155963
NM_144998,STRA13,4,3,4208,746,3462,1154,186.5,4.64075067
NM_002917,RFNG,8,7,3874,1836,2038,291.1428571,229.5,1.110021786
NM_016286,DCXR,8,7,1818,837,981,140.1428571,104.625,1.172043011
NM_001271007,STRA13,4,3,4208,731,3477,1159,182.75,4.756497948
NM_001271006,STRA13,5,4,4208,801,3407,851.75,160.2,4.253433208
NM_022156,DUS1L,14,13,7951,1898,6053,465.6153846,135.5714286,3.18914647
NM_212492,GPS1,13,12,5585,2360,3225,268.75,181.5384615,1.366525424
NM_005052,RAC3,6,5,2550,1066,1484,296.8,177.6666667,1.392120075
NM_004104,FASN,43,42,19894,8501,11393,271.2619048,197.6976744,1.340195271
NM_004127,GPS1,13,12,5585,1877,3708,309,144.3846154,1.975492808
NM_001206950,SLC16A3,5,4,11095,2092,9003,2250.75,418.4,4.303537285
NM_001206952,SLC16A3,5,4,3727,2021,1706,426.5,404.2,0.844136566
NM_001042423,SLC16A3,5,4,7269,2080,5189,1297.25,416,2.494711538
NM_001042422,SLC16A3,5,4,11095,2076,9019,2254.75,415.2,4.344412331
NM_001206951,SLC16A3,5,4,4602,2054,2548,637,410.8,1.240506329
NM_004207,SLC16A3,5,4,10490,2048,8442,2110.5,409.6,4.122070313
NM_006137,CD7,4,3,2736,1287,1449,483,321.75,1.125874126
NM_018949,UTS2R,1,0,1171,1171,NA,NA,1171,NA
NM_003004,SECTM1,5,4,13023,2287,10736,2684,457.4,4.694359423
NM_207459,TEX19,2,1,4531,1938,2593,2593,969,1.337977296
NM_001193655,C17orf62,7,6,7141,2322,4819,803.1666667,331.7142857,2.075366064
NM_001033046,C17orf62,7,6,8246,2158,6088,1014.666667,308.2857143,2.821130677
NM_031968,NARF,12,11,29605,1771,27834,2530.363636,147.5833333,15.71654433
NM_001038618,NARF,11,10,30085,1790,28295,2829.5,162.7272727,15.80726257
NM_012336,NARF,11,10,29605,1632,27973,2797.3,148.3636364,17.14031863
NM_001193657,C17orf62,8,7,8246,2376,5870,838.5714286,297,2.470538721
NM_001193653,C17orf62,8,7,8246,2429,5817,831,303.625,2.39481268
NM_001083608,NARF,10,9,29605,1487,28118,3124.222222,148.7,18.90921318
NM_001100408,C17orf62,6,5,8246,2115,6131,1226.2,352.5,2.898817967
NM_001193654,C17orf62,7,6,8246,2378,5868,978,339.7142857,2.467619849
NM_001100407,C17orf62,8,7,8246,2209,6037,862.4285714,276.125,2.732910819
NM_173620,HEXDC,12,11,24266,2234,22032,2002.909091,186.1666667,9.862130707
NM_019613,WDR45B,10,9,33975,2597,31378,3486.444444,259.7,12.08240277
NM_006822,RAB40B,6,5,41657,1765,39892,7978.4,294.1666667,22.60169972
NM_022158,FN3K,6,5,15623,1439,14184,2836.8,239.8333333,9.856845031
NM_024619,FN3KRP,6,5,11313,1832,9481,1896.2,305.3333333,5.175218341
NM_024702,ZNF750,3,2,10623,3194,7429,3714.5,1064.666667,2.325923607
NM_001004431,METRNL,4,3,15026,1336,13690,4563.333333,334,10.24700599
NM_152721,DOK6,8,7,448040,8904,439136,62733.71429,1113,49.31895777
NM_031446,C18orf21,5,4,6664,1053,5611,1402.75,210.6,5.328584995
NM_001201475,C18orf21,4,3,6664,1131,5533,1844.333333,282.75,4.892130858
NM_001201474,C18orf21,4,3,6664,1064,5600,1866.666667,266,5.263157895
NM_005215,DCC,29,28,1195733,10239,1185494,42339.07143,353.0689655,115.7822053
NM_002845,PTPRM,31,30,839547,5592,833955,27798.5,180.3870968,149.1335837
NM_001105244,PTPRM,33,32,839547,5633,833914,26059.8125,170.6969697,148.0408308
NM_001201476,C18orf21,4,3,6664,861,5803,1934.333333,215.25,6.739837398
NM_019856,MYOM1,37,36,153303,5596,147707,4102.972222,151.2432432,26.39510365
NM_173464,L3MBTL4,20,19,460207,3607,456600,24031.57895,180.35,126.5871916
NM_001242761,DLGAP1,12,11,953125,3611,949514,86319.45455,300.9166667,262.9504292
NM_004746,DLGAP1,13,12,959238,6627,952611,79384.25,509.7692308,143.7469443
NM_003803,MYOM1,38,37,153303,5885,147418,3984.27027,154.8684211,25.0497876
NM_181481,LDLRAD4,6,5,374651,8490,366161,73232.2,1415,43.12850412
NM_001128627,SPIRE1,16,15,210222,5116,205106,13673.73333,319.75,40.09108679
NM_001128626,SPIRE1,17,16,211403,5461,205942,12871.375,321.2352941,37.71140817
NM_181482,LDLRAD4,6,5,434026,8695,425331,85066.2,1449.166667,48.91673376
NM_153000,APCDD1,5,4,34075,2567,31508,7877,513.4,12.2742501
NM_001276249,LDLRAD4,4,3,40992,8142,32850,10950,2035.5,4.034635225
NM_020148,SPIRE1,16,15,211403,5418,205985,13732.33333,338.625,38.01864157
NM_001003674,LDLRAD4,4,3,41292,9152,32140,10713.33333,2288,3.511800699
NM_001003675,LDLRAD4,3,2,41292,9097,32195,16097.5,3032.333333,3.539078817
NM_001142730,KCTD1,5,4,93628,3436,90192,22548,687.2,26.24912689
NM_032933,TMEM241,15,14,141948,3007,138941,9924.357143,200.4666667,46.20585301
NM_198991,KCTD1,6,5,185436,1753,183683,36736.6,292.1666667,104.7820878
NM_018439,IMPACT,11,10,26887,3769,23118,2311.8,342.6363636,6.133722473
NM_001136205,KCTD1,5,4,94527,2172,92355,23088.75,434.4,42.52071823
NM_001142966,GREB1L,33,32,280590,6085,274505,8578.28125,184.3939394,45.11175021
NM_001258222,KCTD1,5,4,202493,1669,200824,50206,333.8,120.3259437
NM_001258221,KCTD1,5,4,94906,1713,93193,23298.25,342.6,54.40338587
NM_001282527,NOL4,11,10,371372,3706,367666,36766.6,336.9090909,99.20831085
NM_001198549,NOL4,7,6,197514,3068,194446,32407.66667,438.2857143,63.37874837
NM_001198548,NOL4,9,8,372453,3660,368793,46099.125,406.6666667,100.7631148
NM_001198547,NOL4,11,10,371372,3857,367515,36751.5,350.6363636,95.28519575
NM_001198546,NOL4,10,9,372453,3775,368678,40964.22222,377.5,97.66304636
NM_003787,NOL4,11,10,372453,3968,368485,36848.5,360.7272727,92.86416331
NM_020776,KIAA1328,10,9,396210,4864,391346,43482.88889,486.4,80.45764803
NM_001142397,CTIF,13,12,324161,5831,318330,26527.5,448.5384615,54.59269422
NM_002747,MAPK4,6,5,171714,4742,166972,33394.4,790.3333333,35.21130325
NM_001256758,RNF165,6,5,126598,4858,121740,24348,809.6666667,25.05969535
NM_001242692,SLC14A2,21,20,470115,3694,466421,23321.05,175.9047619,126.2644829
NM_014772,CTIF,12,11,324161,5750,318411,28946.45455,479.1666667,55.37582609
NM_152470,RNF165,8,7,126598,5284,121314,17330.57143,660.5,22.95874338
NM_015285,WDR7,28,27,378422,7310,371112,13744.88889,261.0714286,50.76771546
NM_052834,WDR7,27,26,378422,7210,371212,14277.38462,267.037037,51.48571429
NM_018181,ZNF532,11,10,123650,6475,117175,11717.5,588.6363636,18.0965251
NM_012327,PIGN,30,29,142833,4828,138005,4758.793103,160.9333333,28.58429992
NM_000633,BCL2,3,2,196036,6495,189541,94770.5,2165,29.182602
NM_176787,PIGN,31,30,142833,4906,137927,4597.566667,158.2580645,28.11394211
NM_001146189,ZNF407,7,6,290096,5857,284239,47373.16667,836.7142857,48.52979341
NM_001146190,ZNF407,4,3,173666,5602,168064,56021.33333,1400.5,30.00071403
NM_017757,ZNF407,8,7,434711,8016,426695,60956.42857,1002,53.23041417
NM_001012716,C18orf56,2,1,8722,846,7876,7876,423,9.309692671
NM_130386,COLEC12,10,9,181376,3144,178232,19803.55556,314.4,56.68956743
NM_005131,THOC1,21,20,53541,2141,51400,2570,101.952381,24.00747314
NM_005433,YES1,12,11,90737,4697,86040,7821.818182,391.4166667,18.31807537
NM_032048,EMILIN2,8,7,67064,4017,63047,9006.714286,502.125,15.69504605
NM_015295,SMCHD1,48,47,149131,8720,140411,2987.468085,181.6666667,16.1021789
NM_001242764,DLGAP1,10,9,378225,5240,372985,41442.77778,524,71.18034351
NM_001242763,DLGAP1,11,10,378739,5325,373414,37341.4,484.0909091,70.12469484
NM_001242762,DLGAP1,10,9,378739,5210,373529,41503.22222,521,71.69462572
NM_001144945,MYL12B,4,3,15567,951,14616,4872,237.75,15.36908517
NM_001242766,DLGAP1,11,10,349330,5298,344032,34403.2,481.6363636,64.93620234
NM_001242765,DLGAP1,9,8,343217,2251,340966,42620.75,250.1111111,151.4731231
NM_001144944,MYL12B,4,3,15673,1029,14644,4881.333333,257.25,14.23129252
NM_033546,MYL12B,4,3,16173,1010,15163,5054.333333,252.5,15.01287129
NM_001003809,DLGAP1,10,9,349330,5267,344063,38229.22222,526.7,65.32428327
NM_001281535,EPB41L3,22,21,236612,3934,232678,11079.90476,178.8181818,59.14539908
NM_001281534,EPB41L3,20,19,151931,4131,147800,7778.947368,206.55,35.77826192
NM_001281533,EPB41L3,21,20,148177,3993,144184,7209.2,190.1428571,36.10919108
NM_012307,EPB41L3,23,22,151931,4800,147131,6687.772727,208.6956522,30.65229167
NM_005559,LAMA1,63,62,176072,9720,166352,2683.096774,154.2857143,17.11440329
NM_001243517,C18orf64,6,5,79239,609,78630,15726,101.5,129.1133005
NM_015210,SOGA2,17,16,115408,6109,109299,6831.1875,359.3529412,17.8914716
NM_015208,ANKRD12,13,12,149234,11325,137909,11492.41667,871.1538462,12.17739514
NM_001204056,ANKRD12,12,11,148424,11353,137071,12461,946.0833333,12.07354884
NM_001083625,ANKRD12,12,11,149234,11255,137979,12543.54545,937.9166667,12.2593514
NM_001042388,PPP4R1,20,19,67818,3994,63824,3359.157895,199.7,15.97996995
NM_006868,RAB31,7,6,154327,4001,150326,25054.33333,571.5714286,37.57210697
NM_005134,PPP4R1,20,19,67818,3943,63875,3361.842105,197.15,16.19959422
NM_022068,PIEZO2,52,51,478519,9765,468754,9191.254902,187.7884615,48.00348182
NM_032525,TUBB6,4,3,18313,1819,16494,5498,454.75,9.067619571
NM_001142339,GNAL,13,12,134214,6045,128169,10680.75,465,21.20248139
NM_182978,GNAL,12,11,196671,6487,190184,17289.45455,540.5833333,29.31771235
NM_001261443,GNAL,13,12,134214,5847,128367,10697.25,449.7692308,21.95433556
NM_031216,SEH1L,9,8,39555,3515,36040,4505,390.5555556,10.25320057
NM_032142,CEP192,45,44,133692,8021,125671,2856.159091,178.2444444,15.66774716
NM_147163,PSMG2,7,6,67003,989,66014,11002.33333,141.2857143,66.74823054
NM_002828,PTPN2,9,8,92035,3427,88608,11076,380.7777778,25.8558506
NM_001013437,SEH1L,9,8,39555,1893,37662,4707.75,210.3333333,19.89540412
NM_001207013,PTPN2,11,10,98859,1783,97076,9707.6,162.0909091,54.44531688
NM_020232,PSMG2,7,6,22754,1131,21623,3603.833333,161.5714286,19.11847922
NM_080422,PTPN2,10,9,98859,1713,97146,10794,171.3,56.71103327
NM_080423,PTPN2,9,8,98859,1610,97249,12156.125,178.8888889,60.40310559
NM_000529,MC2R,2,1,33494,3654,29840,29840,1827,8.166392994
NM_003799,RNMT,12,11,37852,6215,31637,2876.090909,517.9166667,5.090426388
NM_001145029,ANKRD30B,36,35,104500,4653,99847,2852.771429,129.25,21.45862884
NM_005406,ROCK1,33,32,162111,6681,155430,4857.1875,202.4545455,23.26448137
NM_138340,ABHD3,9,8,53910,2073,51837,6479.625,230.3333333,25.00578871
NM_020774,MIB1,21,20,129630,9588,120042,6002.1,456.5714286,12.52002503
NM_052911,ESCO1,12,11,71433,4511,66922,6083.818182,375.9166667,14.83529151
NM_203292,RBBP8,18,17,92612,3243,89369,5257,180.1666667,27.55750848
NM_203291,RBBP8,19,18,92612,3260,89352,4964,171.5789474,27.40858896
NM_002894,RBBP8,19,18,93156,3290,89866,4992.555556,173.1578947,27.31489362
NM_001276342,C18orf8,18,17,28339,1976,26363,1550.764706,109.7777778,13.34159919
NM_198129,LAMA3,75,74,265469,10580,254889,3444.445946,141.0666667,24.0915879
NM_000227,LAMA3,38,37,82047,5655,76392,2064.648649,148.8157895,13.50875332
NM_080597,OSBPL1A,28,27,235824,4230,231594,8577.555556,151.0714286,54.75035461
NM_013326,C18orf8,20,19,28339,2246,26093,1373.315789,112.3,11.6175423
NM_001242508,OSBPL1A,16,15,149461,2962,146499,9766.6,185.125,49.45948683
NM_018030,OSBPL1A,14,13,110187,3329,106858,8219.846154,237.7857143,32.09912887
NM_001127717,LAMA3,74,73,265469,10411,255058,3493.945205,140.6891892,24.4988954
NM_001135993,TTC39C,14,13,121192,5254,115938,8918.307692,375.2857143,22.06661591
NM_001127718,LAMA3,37,36,82047,5486,76561,2126.694444,148.2702703,13.95570543
NM_173505,ANKRD29,10,9,62873,2283,60590,6732.222222,228.3,26.53964082
NM_153211,TTC39C,14,13,142839,4901,137938,10610.61538,350.0714286,28.14486839
NM_015461,ZNF521,8,7,290328,4979,285349,40764.14286,622.375,57.31050412
NM_005640,TAF4B,15,14,165243,4767,160476,11462.57143,317.8,33.66393958
NM_001025097,PSMA8,7,6,59505,1704,57801,9633.5,243.4285714,33.92077465
NM_001025096,PSMA8,7,6,59505,1818,57687,9614.5,259.7142857,31.7310231
NM_144662,PSMA8,7,6,59505,1836,57669,9611.5,262.2857143,31.41013072
NM_031422,CHST9,6,5,269709,2265,267444,53488.8,377.5,118.0768212
NM_001256316,CHST9,5,4,269709,2226,267483,66870.75,445.2,120.1630728
NM_001792,CDH2,16,15,226517,4383,222134,14808.93333,273.9375,50.68081223
NM_001134453,DSG4,15,14,37142,3652,33490,2392.142857,243.4666667,9.170317634
NM_024423,DSC3,17,16,52731,6995,45736,2858.5,411.4705882,6.53838456
NM_001941,DSC3,16,15,52731,6951,45780,3052,434.4375,6.586102719
NM_001943,DSG2,15,14,50789,5668,45121,3222.928571,377.8666667,7.960656316
NM_004775,B4GALT6,9,8,62479,4823,57656,7207,535.8888889,11.95438524
NM_177986,DSG4,16,15,37142,3596,33546,2236.4,224.75,9.328698554
NM_020805,KLHL14,9,8,100342,4270,96072,12009,474.4444444,22.49929742
NM_017831,RNF125,6,5,54711,5894,48817,9763.4,982.3333333,8.282490668
NM_022751,GAREM,6,5,206965,7040,199925,39985,1173.333333,28.3984375
NM_014939,TRAPPC8,29,28,113957,6283,107674,3845.5,216.6551724,17.13735477
NM_001242409,GAREM,6,5,206965,7043,199922,39984.4,1173.833333,28.38591509
NM_030632,ASXL3,12,11,168860,7654,161206,14655.09091,637.8333333,21.0616671
NM_001105528,CCDC178,22,21,502681,3377,499304,23776.38095,153.5,147.8543086
NM_198995,CCDC178,22,21,503321,3332,499989,23809,151.4545455,150.0567227
NM_001198945,DTNA,11,10,375526,3978,371548,37154.8,361.6363636,93.40070387
NM_001198941,DTNA,15,14,158582,4414,154168,11012,294.2666667,34.92705029
NM_001198940,DTNA,21,20,298528,6530,291998,14599.9,310.952381,44.71638591
NM_001198939,DTNA,22,21,298528,6552,291976,13903.61905,297.8181818,44.56288156
NM_001198938,DTNA,20,19,298528,3946,294582,15504.31579,197.3,74.65331982
NM_032979,DTNA,17,16,375526,4563,370963,23185.1875,268.4117647,81.29804953
NM_032978,DTNA,17,16,158584,4589,153995,9624.6875,269.9411765,33.55741992
NM_001392,DTNA,13,12,336040,1746,334294,27857.83333,134.3076923,191.4627721
NM_032975,DTNA,22,21,398556,6544,392012,18667.2381,297.4545455,59.90403423
NM_001391,DTNA,17,16,112840,4384,108456,6778.5,257.8823529,24.73905109
NM_001390,DTNA,22,21,135870,6365,129505,6166.904762,289.3181818,20.34642577
NM_001128175,DTNA,12,11,236012,1732,234280,21298.18182,144.3333333,135.2655889
NM_001143827,MAPRE2,8,7,165226,4329,160897,22985.28571,541.125,37.16724417
NM_001143826,MAPRE2,8,7,166542,4183,162359,23194.14286,522.875,38.81400908
NM_014268,MAPRE2,7,6,102110,4270,97840,16306.66667,610,22.91334895
NM_001256420,MAPRE2,6,5,102110,4141,97969,19593.8,690.1666667,23.6582951
NM_025135,FHOD3,25,24,482365,5014,477351,19889.625,200.56,95.20362984
NM_001281740,FHOD3,29,28,482365,5567,476798,17028.5,191.9655172,85.64720675
NM_001281739,FHOD3,24,23,482365,4962,477403,20756.65217,206.75,96.21180975
NM_017947,MOCOS,15,14,81207,2742,78465,5604.642857,182.8,28.61597374
NM_001025089,CELF4,12,11,322994,3952,319042,29003.81818,329.3333333,80.72925101
NM_001025088,CELF4,13,12,322994,4061,318933,26577.75,312.3846154,78.53558237
NM_001025087,CELF4,13,12,322994,4064,318930,26577.5,312.6153846,78.47687008
NM_020180,CELF4,13,12,322994,4067,318927,26577.25,312.8461538,78.41824441
NM_002647,PIK3C3,25,24,126249,3092,123157,5131.541667,123.68,39.83085382
NM_002930,RIT2,5,4,372476,1107,371369,92842.25,221.4,335.4733514
NM_001272077,RIT2,6,5,372476,1172,371304,74260.8,195.3333333,316.8122867
NM_001130110,SETBP1,4,3,197243,1789,195454,65151.33333,447.25,109.2532141
NM_015559,SETBP1,6,5,387614,9905,377709,75541.8,1650.833333,38.13316507
NM_007163,SLC14A2,20,19,68296,4175,64121,3374.789474,208.75,15.35832335
NM_145055,C18orf25,5,4,92969,5470,87499,21874.75,1094,15.99616088
NM_020964,EPG5,44,43,119733,12742,106991,2488.162791,289.5909091,8.39671951
NM_024430,PSTPIP2,15,14,88750,3039,85711,6122.214286,202.6,28.20368542
NM_001008239,C18orf25,4,3,92969,5286,87683,29227.66667,1321.5,16.58777904
NM_016097,IER3IP1,3,2,21357,1507,19850,9925,502.3333333,13.17186463
NM_144612,LOXHD1,40,39,179781,6894,172887,4433,172.35,25.07789382
NM_173206,PIAS2,13,12,101824,4586,97238,8103.166667,352.7692308,21.20322721
NM_013305,ST8SIA5,7,6,77960,2630,75330,12555,375.7142857,28.64258555
NM_031303,KATNAL2,15,14,101829,2848,98981,7070.071429,189.8666667,34.75456461
NM_004671,PIAS2,14,13,107474,4440,103034,7925.692308,317.1428571,23.20585586
NM_001039360,ZBTB7C,3,2,110043,4174,105869,52934.5,1391.333333,25.3639195
NM_017653,DYM,17,16,416909,2645,414264,25891.5,155.5882353,156.6215501
NM_006111,ACAA2,10,9,30379,1944,28435,3159.444444,194.4,14.62705761
NM_001080467,MYO5B,40,39,372297,9560,362737,9300.948718,239,37.94320084
NM_018696,ELAC1,4,3,20105,2237,17868,5956,559.25,7.987483236
NM_173529,C18orf54,8,7,23263,5059,18204,2600.571429,632.375,3.598339593
NM_001288981,C18orf54,9,8,24120,5534,18586,2323.25,614.8888889,3.358511023
NM_001288982,C18orf54,7,6,21509,4903,16606,2767.666667,700.4285714,3.386905976
NM_001288980,C18orf54,9,8,24120,5702,18418,2302.25,633.5555556,3.230094704
NM_001243232,TCF4,16,15,181666,7804,173862,11590.8,487.75,22.27857509
NM_001243234,TCF4,13,12,99530,7374,92156,7679.666667,567.2307692,12.49742338
NM_001243230,TCF4,19,18,366300,7812,358488,19916,411.1578947,45.88940092
NM_001243227,TCF4,19,18,367485,8185,359300,19961.11111,430.7894737,43.89737324
NM_001243236,TCF4,13,12,80292,7378,72914,6076.166667,567.5384615,9.882624017
NM_001243235,TCF4,13,12,99530,7362,92168,7680.666667,566.3076923,12.51942407
NM_001243233,TCF4,16,15,200163,7733,192430,12828.66667,483.3125,24.88426225
NM_001243231,TCF4,18,17,288440,7772,280668,16509.88235,431.7777778,36.1127123
NM_001243228,TCF4,20,19,367485,8296,359189,18904.68421,414.8,43.29664899
NM_001243226,TCF4,21,20,413628,8107,405521,20276.05,386.047619,50.02109288
NM_001083962,TCF4,20,19,366300,8352,357948,18839.36842,417.6,42.85775862
NM_004163,RAB27B,6,5,67041,7009,60032,12006.4,1168.166667,8.564987873
NM_003199,TCF4,20,19,366300,8340,357960,18840,417,42.92086331
NM_001242804,RP11-35G9.3,3,2,38976,1985,36991,18495.5,661.6666667,18.63526448
NM_005603,ATP8B1,28,27,156670,5965,150705,5581.666667,213.0357143,25.26487846
NM_001144968,NEDD4L,31,30,252209,8409,243800,8126.666667,271.2580645,28.99274587
NM_001144964,NEDD4L,31,30,354316,8467,345849,11528.3,273.1290323,40.84669895
NM_173844,MALT1,16,15,78755,5013,73742,4916.133333,313.3125,14.7101536
NM_001144970,NEDD4L,29,28,206152,8390,197762,7062.928571,289.3103448,23.57115614
NM_001144967,NEDD4L,31,30,357164,8513,348651,11621.7,274.6129032,40.95512745
NM_006785,MALT1,17,16,78755,5047,73708,4606.75,296.8823529,14.6043194
NM_015277,NEDD4L,30,29,357164,8452,348712,12024.55172,281.7333333,41.25792712
NM_001243960,NEDD4L,29,28,357164,8319,348845,12458.75,286.862069,41.93352566
NM_001144971,NEDD4L,31,30,252209,8437,243772,8125.733333,272.1612903,28.89320849
NM_001144965,NEDD4L,31,30,252209,8419,243790,8126.333333,271.5806452,28.9571208
NM_001144966,NEDD4L,30,29,180020,8343,171677,5919.896552,278.1,20.57737025
NM_001144969,NEDD4L,30,29,252209,8348,243861,8409,278.2666667,29.21190704
NM_052947,ALPK2,13,12,147709,7313,140396,11699.66667,562.5384615,19.1981403
NM_005570,LMAN1,13,12,31454,4847,26607,2217.25,372.8461538,5.489374871
NM_133459,CCBE1,11,10,266475,6271,260204,26020.4,570.0909091,41.49322277
NM_173557,RNF152,2,1,78002,1807,76195,76195,903.5,42.16657443
NM_003839,TNFRSF11A,10,9,62425,4603,57822,6424.666667,460.3,12.56180752
NM_001278268,TNFRSF11A,10,9,62425,4561,57864,6429.333333,456.1,12.68669152
NM_001270951,TNFRSF11A,7,6,62425,3649,58776,9796,521.2857143,16.10742669
NM_001270950,TNFRSF11A,8,7,62425,3764,58661,8380.142857,470.5,15.58475027
NM_020854,KIAA1468,29,28,119833,5483,114350,4083.928571,189.0689655,20.85537115
NM_001270949,TNFRSF11A,9,8,62425,3818,58607,7325.875,424.2222222,15.35018334
NM_194449,PHLPP1,17,16,265006,6428,258578,16161.125,378.1176471,40.22682016
NM_004869,VPS4B,11,10,33329,3389,29940,2994,308.0909091,8.834464444
NM_033646,CDH7,12,11,130689,2740,127949,11631.72727,228.3333333,46.69671533
NM_004361,CDH7,12,11,130019,2840,127179,11561.72727,236.6666667,44.78133803
NM_021153,CDH19,12,11,102953,6253,96700,8790.909091,521.0833333,15.464577
NM_001271028,CDH19,10,9,102953,5881,97072,10785.77778,588.1,16.50603639
NM_024781,CCDC102B,8,7,257111,2719,254392,36341.71429,339.875,93.56086797
NM_001093729,CCDC102B,10,9,339937,2827,337110,37456.66667,282.7,119.2465511
NM_173630,RTTN,49,48,201921,7142,194779,4057.895833,145.755102,27.27233268
NM_001201465,NETO1,11,10,125263,2368,122895,12289.5,215.2727273,51.89822635
NM_138966,NETO1,11,10,123821,6320,117501,11750.1,574.5454545,18.59193038
NM_138999,NETO1,5,4,31661,1853,29808,7452,370.6,16.08634647
NM_001190807,CYB5A,4,3,38726,812,37914,12638,203,46.69211823
NM_032649,CNDP1,12,11,50571,2210,48361,4396.454545,184.1666667,21.88280543
NM_148923,CYB5A,5,4,38726,843,37883,9470.75,168.6,44.93831554
NM_001914,CYB5A,6,5,38726,868,37858,7571.6,144.6666667,43.61520737
NM_001037331,SMIM21,3,2,17764,1372,16392,8196,457.3333333,11.94752187
NM_014643,ZNF516,8,7,137511,8634,128879,18411.28571,1079.25,14.92691684
NM_002385,MBP,6,5,38268,2252,36016,7203.2,375.3333333,15.9928952
NM_001025101,MBP,9,8,153987,2782,151205,18900.625,309.1111111,54.3511862
NM_001025100,MBP,4,3,120037,4893,115144,38381.33333,1223.25,23.53239321
NM_001025090,MBP,6,5,38268,2207,36061,7212.2,367.8333333,16.33937472
NM_001025081,MBP,7,6,38268,2286,35982,5997,326.5714286,15.74015748
NM_001025092,MBP,5,4,38268,2173,36095,9023.75,434.6,16.61067648
NM_007345,ZNF236,31,30,146568,8154,138414,4613.8,263.0322581,16.9749816
NM_001480,GALR1,3,2,20090,2788,17302,8651,929.3333333,6.205882353
NM_001278675,NFATC1,8,7,67730,2599,65131,9304.428571,324.875,25.06002309
NM_001278672,NFATC1,9,8,129051,3976,125075,15634.375,441.7777778,31.45749497
NM_001278670,NFATC1,9,8,133553,4350,129203,16150.375,483.3333333,29.70183908
NM_001278669,NFATC1,10,9,133553,5041,128512,14279.11111,504.1,25.49335449
NM_198531,ATP9B,30,29,308887,4387,304500,10500,146.2333333,69.40961933
NM_006162,NFATC1,10,9,133553,4734,128819,14313.22222,473.4,27.21144909
NM_048368,CTDP1,12,11,74711,3602,71109,6464.454545,300.1666667,19.74153248
NM_001278673,NFATC1,9,8,129051,3567,125484,15685.5,396.3333333,35.17914214
NM_001202504,CTDP1,13,12,73082,3393,69689,5807.416667,261,20.53905099
NM_004715,CTDP1,13,12,74711,3766,70945,5912.083333,289.6923077,18.83828996
NM_172389,NFATC1,10,9,129051,4360,124691,13854.55556,436,28.59885321
NM_172387,NFATC1,10,9,129051,4667,124384,13820.44444,466.7,26.65181058
NM_172390,NFATC1,8,7,72232,2973,69259,9894.142857,371.625,23.29599731
NM_172388,NFATC1,9,8,133553,3634,129919,16239.875,403.7777778,35.75096313
NM_032510,PARD6G,3,2,90282,3837,86445,43222.5,1279,22.52931978
NM_001136180,HSBP1L1,4,3,6242,754,5488,1829.333333,188.5,7.278514589
NM_001037334,USP14,15,14,55258,4066,51192,3656.571429,271.0666667,12.5902607
NM_005151,USP14,16,15,55258,4172,51086,3405.733333,260.75,12.24496644
NM_199167,CLUL1,9,8,33595,1873,31722,3965.25,208.1111111,16.93646556
NM_001289036,CLUL1,11,10,53297,2194,51103,5110.3,199.4545455,23.29216044
NM_014410,CLUL1,9,8,53297,1947,51350,6418.75,216.3333333,26.37390858
NM_004066,CETN1,1,0,1157,1157,NA,NA,1157,NA
NM_202758,ENOSF1,15,14,42195,5360,36835,2631.071429,357.3333333,6.872201493
NM_001071,TYMS,7,6,15897,1590,14307,2384.5,227.1428571,8.998113208
NM_017512,ENOSF1,16,15,42340,5404,36936,2462.4,337.75,6.834937084
NM_001126123,ENOSF1,16,15,42340,4204,38136,2542.4,262.75,9.071360609
NM_001117,ADCYAP1,4,3,6978,3263,3715,1238.333333,815.75,1.138522832
NM_001099733,ADCYAP1,5,4,7231,3192,4039,1009.75,638.4,1.265350877
NM_006101,NDC80,17,16,45126,2189,42937,2683.5625,128.7647059,19.61489265
NM_022840,METTL4,9,8,33967,3683,30284,3785.5,409.2222222,8.222644583
NM_014646,LPIN2,20,19,94955,6249,88706,4668.736842,312.45,14.19523124
NM_006471,MYL12A,4,3,8708,1233,7475,2491.666667,308.25,6.062449311
NM_003244,TGIF1,3,2,8238,1608,6630,3315,536,4.123134328
NM_001278684,TGIF1,4,3,8759,1876,6883,2294.333333,469,3.668976546
NM_001278682,TGIF1,3,2,8997,1518,7479,3739.5,506,4.92687747
NM_001278686,TGIF1,4,3,45554,1542,44012,14670.66667,385.5,28.54215305
NM_170695,TGIF1,3,2,7005,2252,4753,2376.5,750.6666667,2.110568384
NM_173211,TGIF1,3,2,4636,1357,3279,1639.5,452.3333333,2.416359617
NM_173209,TGIF1,3,2,8759,1694,7065,3532.5,564.6666667,4.170602125
NM_173210,TGIF1,3,2,7005,1645,5360,2680,548.3333333,3.258358663
NM_173208,TGIF1,4,3,8759,1879,6880,2293.333333,469.75,3.661522086
NM_173207,TGIF1,3,2,10824,1486,9338,4669,495.3333333,6.283983849
NM_174886,TGIF1,4,3,46483,1676,44807,14935.66667,419,26.73448687
NM_001145194,C18orf42,2,1,53585,2304,51281,51281,1152,22.25737847
NM_001143823,ZBTB14,4,3,7178,3687,3491,1163.666667,921.75,0.94684025
NM_003409,ZBTB14,3,2,7178,3656,3522,1761,1218.666667,0.963347921
NM_001243704,ZBTB14,4,3,8036,3346,4690,1563.333333,836.5,1.40167364
NM_001243702,ZBTB14,4,3,6685,3355,3330,1110,838.75,0.992548435
NM_001080209,TMEM200C,1,0,1921,1921,NA,NA,1921,NA
NM_001010000,ARHGAP28,17,16,81282,5548,75734,4733.375,326.3529412,13.65068493
NM_001105581,LRRC30,1,0,907,907,NA,NA,907,NA
NM_001025300,RAB12,6,5,29939,2144,27795,5559,357.3333333,12.96408582
NM_021074,NDUFV2,8,7,31717,938,30779,4397,117.25,32.81343284
NM_020648,TWSG1,5,4,67655,3761,63894,15973.5,752.2,16.98856687
NM_006788,RALBP1,10,9,62578,4364,58214,6468.222222,436.4,13.3395967
NM_194434,VAPA,6,5,46065,6865,39200,7840,1144.166667,5.710123816
NM_032243,TXNDC2,2,1,2435,1928,507,507,964,0.262966805
NM_001098529,TXNDC2,2,1,2435,2131,304,304,1065.5,0.14265603
NM_003574,VAPA,7,6,46065,7001,39064,6510.666667,1000.142857,5.579774318
NM_003826,NAPG,12,11,26895,3727,23168,2106.181818,310.5833333,6.216259726
NM_001282300,SLC35G4,1,0,1056,1056,NA,NA,1056,NA
NM_001261444,GNAL,8,7,28248,5560,22688,3241.142857,695,4.08057554
NM_001242904,MPPE1,8,7,25326,2671,22655,3236.428571,333.875,8.481842007
NM_023075,MPPE1,11,10,25326,2970,22356,2235.6,270,7.527272727
NM_020412,CHMP1B,1,0,3061,3061,NA,NA,3061,NA
NM_014214,IMPA2,8,7,49460,1545,47915,6845,193.125,31.01294498
NM_001277333,ANKRD62,14,13,35902,4747,31155,2396.538462,339.0714286,6.563092479
NM_001279,CIDEA,5,4,23278,1055,22223,5555.75,211,21.06445498
NM_006796,AFG3L2,17,16,48334,3226,45108,2819.25,189.7647059,13.98264104
NM_001142405,SLMO1,7,6,24343,1727,22616,3769.333333,246.7142857,13.0955414
NM_006553,SLMO1,7,6,24343,1724,22619,3769.833333,246.2857143,13.12006961
NM_024899,CEP76,12,11,30152,2959,27193,2472.090909,246.5833333,9.18992903
NM_001271989,CEP76,11,10,30152,2733,27419,2741.9,248.4545455,10.03256495
NM_152352,FAM210A,4,3,63247,4248,58999,19666.33333,1062,13.88865348
NM_001276251,LDLRAD4,3,2,10998,8685,2313,1156.5,2895,0.266321244
NM_001098801,FAM210A,5,4,63247,4389,58858,14714.5,877.8,13.41034404
NM_005913,MC5R,1,0,1320,1320,NA,NA,1320,NA
NM_145287,ZNF519,3,2,32549,6813,25736,12868,2271,3.777484221
NM_001137671,POTEC,11,10,31864,2254,29610,2961,204.9090909,13.13664596
NM_006938,SNRPD1,4,3,17950,1604,16346,5448.666667,401,10.19077307
NM_005257,GATA6,7,6,33089,3777,29312,4885.333333,539.5714286,7.760656606
NM_172241,CTAGE1,1,0,4316,4316,NA,NA,4316,NA
NM_001256438,CABLES1,10,9,125908,4277,121631,13514.55556,427.7,28.4383914
NM_138375,CABLES1,10,9,104647,4298,100349,11149.88889,429.8,23.3478362
NM_001100619,CABLES1,10,9,124709,5015,119694,13299.33333,501.5,23.8671984
NM_003831,RIOK3,13,12,30314,4046,26268,2189,311.2307692,6.492338112
NM_000271,NPC1,25,24,55120,4839,50281,2095.041667,193.56,10.39078322
NM_001243425,TTC39C,2,1,5880,1060,4820,4820,530,4.547169811
NM_012189,CABYR,6,5,22646,2374,20272,4054.4,395.6666667,8.539174389
NM_138643,CABYR,4,3,22646,1192,21454,7151.333333,298,17.99832215
NM_138644,CABYR,6,5,22118,1290,20828,4165.6,215,16.14573643
NM_153770,CABYR,6,5,22646,943,21703,4340.6,157.1666667,23.01484624
NM_153769,CABYR,6,5,22646,1417,21229,4245.8,236.1666667,14.98165138
NM_153768,CABYR,5,4,22646,2319,20327,5081.75,463.8,8.765416128
NM_021624,HRH4,3,2,19330,3671,15659,7829.5,1223.666667,4.265595206
NM_001143828,HRH4,2,1,19330,3406,15924,15924,1703,4.67527892
NM_001160166,HRH4,2,1,19330,3506,15824,15824,1753,4.51340559
NM_005637,SS18,10,9,74396,3353,71043,7893.666667,335.3,21.18789144
NM_001007559,SS18,11,10,74396,3447,70949,7094.9,313.3636364,20.58282565
NM_001650,AQP4,5,4,13710,5207,8503,2125.75,1041.4,1.632994046
NM_004028,AQP4,4,3,10569,5126,5443,1814.333333,1281.5,1.061841592
NM_024422,DSC2,16,15,36448,5215,31233,2082.2,325.9375,5.98906999
NM_004949,DSC2,17,16,36448,5262,31186,1949.125,309.5294118,5.926643862
NM_024421,DSC1,16,15,33607,4226,29381,1958.733333,264.125,6.952437293
NM_004948,DSC1,17,16,33607,4273,29334,1833.375,251.3529412,6.864966066
NM_001942,DSG1,15,14,39343,5461,33882,2420.142857,364.0666667,6.204358176
NM_001944,DSG3,16,15,30935,5567,25368,1691.2,347.9375,4.556852883
NM_000371,TTR,4,3,7258,932,6326,2108.666667,233,6.787553648
NM_001034172,SLC25A52,1,0,1186,1186,NA,NA,1186,NA
NM_001191324,RNF138,7,6,38957,3290,35667,5944.5,470,10.84103343
NM_016271,RNF138,8,7,39708,3578,36130,5161.428571,447.25,10.09782001
NM_198128,RNF138,5,4,38957,3006,35951,8987.75,601.2,11.95974717
NM_005925,MEP1B,15,14,30381,2326,28055,2003.928571,155.0666667,12.06147893
NM_001198942,DTNA,16,15,73563,5928,67635,4509,370.5,11.40941296
NM_001198944,DTNA,14,13,73563,5755,67808,5216,411.0714286,11.78245004
NM_032981,DTNA,8,7,50478,3628,46850,6692.857143,453.5,12.91345094
NM_032980,DTNA,14,13,73508,5688,67820,5216.923077,406.2857143,11.9233474
NM_001198943,DTNA,13,12,73884,5668,68216,5684.666667,436,12.03528582
NM_001166012,ZSCAN30,5,4,39189,4351,34838,8709.5,870.2,8.006894967
NM_032347,ZNF397,6,5,17405,1489,15916,3183.2,248.1666667,10.68905306
NM_001135178,ZNF397,4,3,6161,2648,3513,1171,662,1.326661631
NM_001112734,ZSCAN30,4,3,39189,4146,35043,11681,1036.5,8.452243126
NM_001288711,ZSCAN30,2,1,39189,3441,35748,35748,1720.5,10.38884045
NM_006965,ZNF24,4,3,12250,6315,5935,1978.333333,1578.75,0.939825812
NM_145756,ZNF396,5,4,10642,2793,7849,1962.25,558.6,2.810239885
NM_194281,INO80C,5,4,29666,985,28681,7170.25,197,29.1177665
NM_001098817,INO80C,7,6,29666,1095,28571,4761.833333,156.4285714,26.09223744
NM_020474,GALNT1,11,10,57267,3849,53418,5341.8,349.9090909,13.87840998
NM_018170,RPRD1A,7,6,77583,4274,73309,12218.16667,610.5714286,17.15231633
NM_001242877,ELP2,21,20,44853,2568,42285,2114.25,122.2857143,16.4661215
NM_001242876,ELP2,21,20,44853,2631,42222,2111.1,125.2857143,16.04789054
NM_012319,SLC39A6,10,9,20865,3630,17235,1915,363,4.747933884
NM_018255,ELP2,22,21,44853,2647,42206,2009.809524,120.3181818,15.94484322
NM_001242879,ELP2,19,18,44849,2430,42419,2356.611111,127.8947368,17.4563786
NM_001242878,ELP2,20,19,44853,2435,42418,2232.526316,121.75,17.4201232
NM_001242875,ELP2,23,22,44853,2843,42010,1909.545455,123.6086957,14.77664439
NM_001099406,SLC39A6,8,7,18396,1674,16722,2388.857143,209.25,9.989247312
NM_015476,TPGS2,7,6,35112,4058,31054,5175.666667,579.7142857,7.652538196
NM_001271956,TPGS2,7,6,49193,1277,47916,7986,182.4285714,37.52231793
NM_001271955,TPGS2,5,4,42734,1432,41302,10325.5,286.4,28.84217877
NM_001271954,TPGS2,6,5,31200,1543,29657,5931.4,257.1666667,19.22034997
NM_001271951,TPGS2,7,6,42734,1709,41025,6837.5,244.1428571,24.00526624
NM_001271952,TPGS2,7,6,31200,1613,29587,4931.166667,230.4285714,18.34283943
NM_001271950,TPGS2,6,5,35112,3928,31184,6236.8,654.6666667,7.938900204
NM_001271953,TPGS2,7,6,42428,1306,41122,6853.666667,186.5714286,31.48698315
NM_001271949,TPGS2,7,6,35112,3953,31159,5193.166667,564.7142857,7.882367822
NM_020783,SYT4,4,3,9760,4100,5660,1886.666667,1025,1.380487805
NM_015865,SLC14A1,10,9,28395,3981,24414,2712.666667,398.1,6.132629992
NM_001128588,SLC14A1,11,10,28395,4140,24255,2425.5,376.3636364,5.858695652
NM_001146037,SLC14A1,9,8,25569,4235,21334,2666.75,470.5555556,5.037544274
NM_001146036,SLC14A1,11,10,28395,4069,24326,2432.6,369.9090909,5.978373065
NM_213602,SIGLEC15,6,5,16978,1511,15467,3093.4,251.8333333,10.23626737
NM_138443,HAUS1,9,8,24003,1134,22869,2858.625,126,20.16666667
NM_001257335,ATP5A1,12,11,14211,2270,11941,1085.545455,189.1666667,5.260352423
NM_001257334,ATP5A1,12,11,14211,1868,12343,1122.090909,155.6666667,6.607601713
NM_001001935,ATP5A1,12,11,14211,2007,12204,1109.454545,167.25,6.080717489
NM_004046,ATP5A1,12,11,14211,1934,12277,1116.090909,161.1666667,6.347983454
NM_001001937,ATP5A1,13,12,20091,1958,18133,1511.083333,150.6153846,9.260980592
NM_001145472,LOXHD1,24,23,82337,3989,78348,3406.434783,166.2083333,19.64101279
NM_001173129,LOXHD1,10,9,42116,1850,40266,4474,185,21.76540541
NM_001145473,LOXHD1,9,8,41834,1986,39848,4981,220.6666667,20.06445116
NM_016427,TCEB3B,1,0,3047,3047,NA,NA,3047,NA
NM_001242907,TCEB3CL2,1,0,1878,1878,NA,NA,1878,NA
NM_001242907,TCEB3CL2,1,0,1878,1878,NA,NA,1878,NA
NM_145653,TCEB3C,1,0,1878,1878,NA,NA,1878,NA
NM_145653,TCEB3C,1,0,1878,1878,NA,NA,1878,NA
NM_001100817,TCEB3CL,1,0,1642,1642,NA,NA,1642,NA
NM_001100817,TCEB3CL,1,0,1642,1642,NA,NA,1642,NA
NM_001100817,TCEB3CL,1,0,1642,1642,NA,NA,1642,NA
NM_032124,HDHD2,7,6,43092,2192,40900,6816.666667,313.1428571,18.65875912
NM_001278063,SKOR2,7,6,37096,3055,34041,5673.5,436.4285714,11.14271686
NM_001037802,SKOR2,3,2,18062,894,17168,8584,298,19.20357942
NM_005901,SMAD2,11,10,97506,10439,87067,8706.7,949,8.340549861
NM_001135937,SMAD2,10,9,98053,10456,87597,9733,1045.6,8.377677888
NM_001003652,SMAD2,11,10,98053,10547,87506,8750.6,958.8181818,8.296766853
NM_001190822,SMAD7,4,3,29482,2296,27186,9062,574,11.84059233
NM_005904,SMAD7,4,3,30860,3091,27769,9256.333333,772.75,8.983824005
NM_001190821,SMAD7,4,3,30860,3088,27772,9257.333333,772,8.993523316
NM_001190823,SMAD7,2,1,22956,2387,20569,20569,1193.5,8.617092585
NM_001199355,RPL17-C18orf32,7,6,10408,1948,8460,1410,278.2857143,4.342915811
NM_001035005,C18orf32,3,2,6098,1656,4442,2221,552,2.68236715
NM_001199356,RPL17-C18orf32,7,6,11389,2015,9374,1562.333333,287.8571429,4.652109181
NM_001199343,RPL17,8,7,3985,902,3083,440.4285714,112.75,3.417960089
NM_001199342,RPL17,8,7,3985,919,3066,438,114.875,3.336235038
NM_001199340,RPL17,8,7,4086,820,3266,466.5714286,102.5,3.982926829
NM_001199346,C18orf32,3,2,6098,1492,4606,2303,497.3333333,3.087131367
NM_001199345,RPL17,6,5,4086,679,3407,681.4,113.1666667,5.017673049
NM_001199344,RPL17,7,6,3985,803,3182,530.3333333,114.7142857,3.9626401
NM_001199341,RPL17,7,6,3985,820,3165,527.5,117.1428571,3.859756098
NM_000985,RPL17,7,6,4086,970,3116,519.3333333,138.5714286,3.212371134
NM_001035006,RPL17,7,6,4086,721,3365,560.8333333,103,4.667128988
NM_006033,LIPG,10,9,30853,4151,26702,2966.888889,415.1,6.432666827
NM_015847,MBD1,16,15,12930,3129,9801,653.4,195.5625,3.132310642
NM_015846,MBD1,17,16,12930,3277,9653,603.3125,192.7647059,2.945682026
NM_015845,MBD1,14,13,12930,2995,9935,764.2307692,213.9285714,3.317195326
NM_015844,MBD1,16,15,12930,3108,9822,654.8,194.25,3.16023166
NM_002384,MBD1,15,14,12930,2969,9961,711.5,197.9333333,3.355001684
NM_001204142,MBD1,14,13,12930,3269,9661,743.1538462,233.5,2.955338024
NM_001204141,MBD1,15,14,14894,2862,12032,859.4285714,190.8,4.20405311
NM_001204138,MBD1,17,16,10734,2803,7931,495.6875,164.8823529,2.829468427
NM_001204136,MBD1,16,15,12930,3204,9726,648.4,200.25,3.035580524
NM_001204140,MBD1,16,15,10734,2637,8097,539.8,164.8125,3.070534699
NM_001204139,MBD1,17,16,14894,3086,11808,738,181.5294118,3.826312378
NM_001204137,MBD1,17,16,10734,2806,7928,495.5,165.0588235,2.825374198
NM_001204143,MBD1,14,13,12923,2670,10253,788.6923077,190.7142857,3.840074906
NM_145020,CCDC11,8,7,39304,1832,37472,5353.142857,229,20.45414847
NM_014593,CXXC1,15,14,5981,2969,3012,215.1428571,197.9333333,1.014482991
NM_001101654,CXXC1,15,14,5981,2981,3000,214.2857143,198.7333333,1.0063737
NM_001204151,MBD1,13,12,8550,1681,6869,572.4166667,129.3076923,4.08625818
NM_001039535,SKA1,7,6,19148,2925,16223,2703.833333,417.8571429,5.546324786
NM_145060,SKA1,7,6,19148,2880,16268,2711.333333,411.4285714,5.648611111
NM_031939,MRO,8,7,24946,5266,19680,2811.428571,658.25,3.737181922
NM_001127176,MRO,7,6,24946,5162,19784,3297.333333,737.4285714,3.832623014
NM_001127175,MRO,6,5,24946,5005,19941,3988.2,834.1666667,3.984215784
NM_001127174,MRO,6,5,30266,4894,25372,5074.4,815.6666667,5.184307315
NM_002396,ME2,16,15,70732,4638,66094,4406.266667,289.875,14.25053903
NM_001168335,ME2,14,13,70732,4466,66266,5097.384615,319,14.83788625
NM_005359,SMAD4,12,11,54830,8783,46047,4186.090909,731.9166667,5.24274166
NM_016626,MEX3C,2,1,23133,4144,18989,18989,2072,4.582287645
NM_015832,MBD2,3,2,22110,1357,20753,10376.5,452.3333333,15.29329403
NM_003927,MBD2,7,6,73189,5195,67994,11332.33333,742.1428571,13.08835419
NM_007195,POLI,10,9,28757,6068,22689,2521,606.8,3.73912327
NM_139171,STARD6,6,5,29883,669,29214,5842.8,111.5,43.66816143
NM_173629,DYNAP,3,2,8336,2030,6306,3153,676.6666667,3.106403941
NM_025214,CCDC68,12,11,58001,4144,53857,4896.090909,345.3333333,12.99638031
NM_001143829,CCDC68,12,11,56541,4041,52500,4772.727273,336.75,12.9918337
NM_004786,TXNL1,8,7,35869,1332,34537,4933.857143,166.5,25.92867868
NM_001257964,BOD1L2,1,0,3348,3348,NA,NA,3348,NA
NM_015879,ST8SIA3,4,3,16442,10157,6285,2095,2539.25,0.618785074
NM_004852,ONECUT2,2,1,55615,16124,39491,39491,8062,2.449206152
NM_000140,FECH,11,10,41898,7271,34627,3462.7,661,4.762343557
NM_001012515,FECH,11,10,41898,7289,34609,3460.9,662.6363636,4.748113596
NM_004539,NARS,14,13,21285,2879,18406,1415.846154,205.6428571,6.393192081
NM_001289967,LOC101927322,2,1,1866,1207,659,659,603.5,0.545981773
NM_033280,SEC11C,6,5,18940,787,18153,3630.6,131.1666667,23.0660737
NM_002091,GRP,3,2,10604,850,9754,4877,283.3333333,11.47529412
NM_001012513,GRP,3,2,10604,831,9773,4886.5,277,11.76052948
NM_001012512,GRP,3,2,10604,829,9775,4887.5,276.3333333,11.79131484
NM_013435,RAX,3,2,6360,3200,3160,1580,1066.666667,0.9875
NM_181654,CPLX4,3,2,23247,1967,21280,10640,655.6666667,10.81850534
NM_021127,PMAIP1,2,1,4348,1938,2410,2410,969,1.243550052
NM_005912,MC4R,1,0,1439,1439,NA,NA,1439,NA
NM_031891,CDH20,11,10,64592,2866,61726,6172.6,260.5454545,21.53733426
NM_017742,ZCCHC2,14,13,55162,5557,49605,3815.769231,396.9285714,8.926579089
NM_002035,KDSR,10,9,39537,5208,34329,3814.333333,520.8,6.591589862
NM_000657,BCL2,2,1,1428,1208,220,220,604,0.182119205
NM_002639,SERPINB5,7,6,28176,2640,25536,4256,377.1428571,9.672727273
NM_006919,SERPINB3,8,7,6768,1785,4983,711.8571429,223.125,2.791596639
NM_012397,SERPINB13,8,7,11901,3188,8713,1244.714286,398.5,2.733061481
NM_002974,SERPINB4,8,7,7011,1727,5284,754.8571429,215.875,3.059640996
NM_080474,SERPINB12,7,6,10853,1225,9628,1604.666667,175,7.859591837
NM_001040147,SERPINB7,8,7,52331,1984,50347,7192.428571,248,25.3765121
NM_080475,SERPINB11,8,7,20930,1738,19192,2741.714286,217.25,11.04257768
NM_001261831,SERPINB7,7,6,30003,2200,27803,4633.833333,314.2857143,12.63772727
NM_001261830,SERPINB7,8,7,27601,1959,25642,3663.142857,244.875,13.08933129
NM_003784,SERPINB7,8,7,30003,2252,27751,3964.428571,281.5,12.32282416
NM_001143818,SERPINB2,9,8,16187,2175,14012,1751.5,241.6666667,6.442298851
NM_002575,SERPINB2,8,7,16187,1916,14271,2038.714286,239.5,7.448329854
NM_005024,SERPINB10,7,6,19733,1201,18532,3088.666667,171.5714286,15.4304746
NM_198833,SERPINB8,7,6,19347,3397,15950,2658.333333,485.2857143,4.695319399
NM_002640,SERPINB8,7,6,19347,3380,15967,2661.166667,482.8571429,4.723964497
NM_001031848,SERPINB8,7,6,16626,1275,15351,2558.5,182.1428571,12.04
NM_001276490,SERPINB8,6,5,19347,3201,16146,3229.2,533.5,5.044048735
NM_001123366,HMSD,4,3,11059,629,10430,3476.666667,157.25,16.58187599
NM_032160,DSEL,2,1,10150,9283,867,867,4641.5,0.093396531
NM_019022,TMX3,16,15,41430,4761,36669,2444.6,297.5625,7.701953371
NM_006566,CD226,7,6,94041,2644,91397,15232.83333,377.7142857,34.56770045
NM_004232,SOCS6,2,1,41299,5848,35451,35451,2924,6.062072503
NM_001278515,GTSCR1,3,2,20340,601,19739,9869.5,200.3333333,32.84359401
NM_182511,CBLN2,5,4,7810,2899,4911,1227.75,579.8,1.694032425
NM_152676,FBXO15,10,9,74413,1759,72654,8072.666667,175.9,41.30415009
NM_014177,TIMM21,6,5,10460,1540,8920,1784,256.6666667,5.792207792
NM_001142958,FBXO15,10,9,74514,1731,72783,8087,173.1,42.04679376
NM_001174123,C18orf63,14,13,43314,5079,38235,2941.153846,362.7857143,7.528056704
NM_001168499,CNDP2,9,8,23868,4957,18911,2363.875,550.7777778,3.815009078
NM_018235,CNDP2,12,11,27191,5085,22106,2009.636364,423.75,4.347295969
NM_001044369,FAM69C,4,3,21542,2046,19496,6498.666667,511.5,9.528836755
NM_005786,TSHZ1,2,1,79197,4994,74203,74203,2497,14.85843012
NM_175907,ZADH2,2,1,12005,5497,6508,6508,2748.5,1.183918501
NM_001272093,FLJ44313,3,2,2570,2079,493,246.5,693,0.237133237
NM_171999,SALL3,3,2,18696,5553,13143,6571.5,1851,2.366828741
NM_025078,PQLC1,6,5,49235,2550,46685,9337,425,18.30784314
NM_001146345,PQLC1,5,4,49235,2495,46740,11685,499,18.73346693
NM_001146343,PQLC1,4,3,49235,2277,46958,15652.66667,569.25,20.62274923
NM_012283,KCNG2,2,1,36150,1403,34747,34747,701.5,24.76621525
NM_001171967,RBFA,6,5,16308,5600,10708,2141.6,933.3333333,1.912142857
NM_006701,TXNL4A,3,2,15667,1390,14277,7138.5,463.3333333,10.27122302
NM_024805,RBFA,7,6,16308,5686,10622,1770.333333,812.2857143,1.868097081
NM_014913,ADNP2,4,3,31315,5391,25924,8641.333333,1347.75,4.808755333
NM_133502,ZNF274,8,7,30574,2887,27687,3955.285714,360.875,9.590232075
NM_024074,TMEM38A,6,5,27880,1631,26249,5249.8,271.8333333,16.09380748
NM_001278735,ZNF274,7,6,30574,2805,27769,4628.166667,400.7142857,9.899821747
NM_001278734,ZNF274,8,7,30574,2902,27672,3953.142857,362.75,9.535492764
NM_030973,MED25,18,17,18703,2361,16342,961.2941176,131.1666667,6.921643371
NM_198471,KANK3,11,10,20680,2798,17882,1788.2,254.3636364,6.390993567
NM_001167869,ATP5SL,5,4,8622,1568,7054,1763.5,313.6,4.49872449
NM_001167868,ATP5SL,5,4,8260,1614,6646,1661.5,322.8,4.11771995
NM_001167867,ATP5SL,6,5,8260,1778,6482,1296.4,296.3333333,3.645669291
NM_001167871,ATP5SL,5,4,8622,1650,6972,1743,330,4.225454545
NM_001167870,ATP5SL,4,3,8622,1486,7136,2378.666667,371.5,4.802153432
NM_018035,ATP5SL,6,5,8622,1732,6890,1378,288.6666667,3.978060046
NM_016325,ZNF274,7,6,30574,2790,27784,4630.666667,398.5714286,9.958422939
NM_016324,ZNF274,5,4,30574,2583,27991,6997.75,516.6,10.83662408
NM_033103,RHPN2,15,14,86328,3546,82782,5913,236.4,23.34517766
NM_002068,GNA15,7,6,27577,2139,25438,4239.666667,305.5714286,11.89247312
NM_130855,PTPRS,30,29,135297,6048,129249,4456.862069,201.6,21.37053571
NM_130854,PTPRS,33,32,135297,7266,128031,4000.96875,220.1818182,17.62056152
NM_001039846,IZUMO4,10,9,2717,1025,1692,188,102.5,1.650731707
NM_130853,PTPRS,29,28,135297,6035,129262,4616.5,208.1034483,21.41872411
NM_002850,PTPRS,38,37,135297,7385,127912,3457.081081,194.3421053,17.32051456
NM_019112,ABCA7,47,46,25470,6865,18605,404.4565217,146.0638298,2.710123816
NM_001031735,IZUMO4,9,8,2717,970,1747,218.375,107.7777778,1.801030928
NM_133475,ANKRD24,22,21,41462,4048,37414,1781.619048,184,9.242588933
NM_003331,TYK2,25,24,30046,4273,25773,1073.875,170.92,6.031593728
NM_032497,ZNF559,7,6,20075,3063,17012,2835.333333,437.5714286,5.554031995
NM_001172650,ZNF559-ZNF177,12,11,58393,2562,55831,5075.545455,213.5,21.79195941
NM_007253,CYP4F8,13,12,14420,1918,12502,1041.833333,147.5384615,6.518248175
NM_152601,ZNF709,4,3,23636,4903,18733,6244.333333,1225.75,3.820722007
NM_145045,CCDC151,13,12,14710,2175,12535,1044.583333,167.3076923,5.763218391
NM_001202406,ZNF559,6,5,20075,2999,17076,3415.2,499.8333333,5.693897966
NM_001202425,ZNF559-ZNF177,9,8,57924,2851,55073,6884.125,316.7777778,19.31708173
NM_001202410,ZNF559,7,6,20075,3148,16927,2821.166667,449.7142857,5.377064803
NM_001202407,ZNF559,6,5,20075,3009,17066,3413.2,501.5,5.671651712
NM_001202412,ZNF559,7,6,19621,2863,16758,2793,409,5.853300733
NM_001202411,ZNF559,7,6,20075,3177,16898,2816.333333,453.8571429,5.318854265
NM_001202409,ZNF559,7,6,20075,3300,16775,2795.833333,471.4285714,5.083333333
NM_001202408,ZNF559,6,5,20075,3077,16998,3399.6,512.8333333,5.524211895
NM_004146,NDUFB7,3,2,6001,549,5452,2726,183,9.930783242
NM_001098482,CRTC1,15,14,98720,7007,91713,6550.928571,467.1333333,13.08876837
NM_001256653,ZNF43,4,3,47121,5253,41868,13956,1313.25,7.970302684
NM_001256651,ZNF43,3,2,47121,5125,41996,20998,1708.333333,8.194341463
NM_001256650,ZNF43,6,5,47121,5514,41607,8321.4,919,7.54570185
NM_001256649,ZNF43,7,6,47121,5643,41478,6913,806.1428571,7.350345561
NM_015321,CRTC1,14,13,98720,6958,91762,7058.615385,497,13.18798505
NM_001145404,ZNF506,3,2,29042,3231,25811,12905.5,1077,7.988548437
NM_001099269,ZNF506,4,3,29042,3328,25714,8571.333333,832,7.7265625
NM_001256648,ZNF43,7,6,47121,5778,41343,6890.5,825.4285714,7.155244029
NM_001042474,ZNF565,5,4,33026,2173,30853,7713.25,434.6,14.1983433
NM_018028,SAMD4B,16,15,42431,4506,37925,2528.333333,281.625,8.416555704
NM_001039672,YIF1B,8,7,12408,2794,9614,1373.428571,349.25,3.440944882
NM_001039673,YIF1B,8,7,12408,2785,9623,1374.714286,348.125,3.45529623
NM_001039671,YIF1B,8,7,12247,2776,9471,1353,347,3.411743516
NM_001145463,YIF1B,9,8,12408,2863,9545,1193.125,318.1111111,3.333915473
NM_033557,YIF1B,7,6,6311,2912,3399,566.5,416,1.167239011
NM_152477,ZNF565,5,4,32615,2028,30587,7646.75,405.6,15.08234714
NM_014164,FXYD5,9,8,15165,904,14261,1782.625,100.4444444,15.77544248
NM_001164605,FXYD5,9,8,14945,907,14038,1754.75,100.7777778,15.47739802
NM_001145462,YIF1B,8,7,12247,2746,9501,1357.285714,343.25,3.459941733
NM_001145461,YIF1B,8,7,12247,2770,9477,1353.857143,346.25,3.421299639
NM_144779,FXYD5,9,8,15118,917,14201,1775.125,101.8888889,15.48636859
NM_144685,HIPK4,4,3,10918,2456,8462,2820.666667,614,3.445439739
NM_016457,PRKD2,18,17,42813,3619,39194,2305.529412,201.0555556,10.83006355
NM_001079882,PRKD2,17,16,40006,2940,37066,2316.625,172.9411765,12.60748299
NM_001079881,PRKD2,19,18,42813,3205,39608,2200.444444,168.6842105,12.35819033
NM_001079880,PRKD2,19,18,42813,3341,39472,2192.888889,175.8421053,11.81442682
NM_014601,EHD2,6,5,29792,3590,26202,5240.4,598.3333333,7.298607242
NM_001193269,EML2,22,21,34329,2815,31514,1500.666667,127.9545455,11.19502664
NM_001193268,EML2,22,21,36119,2911,33208,1581.333333,132.3181818,11.40776366
NM_174945,ZNF575,4,3,2946,1715,1231,410.3333333,428.75,0.717784257
NM_012155,EML2,19,18,30019,2273,27746,1541.444444,119.6315789,12.20677519
NM_001145971,RDH13,7,6,18895,1938,16957,2826.166667,276.8571429,8.749742002
NM_001012729,DUXA,6,5,15764,3352,12412,2482.4,558.6666667,3.702863962
NM_138412,RDH13,8,7,25224,2031,23193,3313.285714,253.875,11.41949778
NM_001256080,KLK2,4,3,7136,2679,4457,1485.666667,669.75,1.663680478
NM_005551,KLK2,5,4,7136,2840,4296,1074,568,1.512676056
NM_001002836,ZNF787,3,2,33919,1931,31988,15994,643.6666667,16.5655101
NM_001002231,KLK2,5,4,7136,2877,4259,1064.75,575.4,1.480361488
NM_032551,KISS1R,5,4,3675,1630,2045,511.25,326,1.254601227
NM_194460,RNF126,9,8,15709,1659,14050,1756.25,184.3333333,8.468957203
NM_020695,REXO1,16,15,33209,4597,28612,1907.466667,287.3125,6.224059169
NM_001319,CSNK1G2,12,11,40177,2916,37261,3387.363636,243,12.77812071
NM_032482,DOT1L,28,27,68431,7464,60967,2258.037037,266.5714286,8.168140407
NM_052847,GNG7,5,4,191530,4251,187279,46819.75,850.2,44.05528111
NM_003260,TLE2,20,19,31531,2725,28806,1516.105263,136.25,10.57100917
NM_001144762,TLE2,18,17,31978,2300,29678,1745.764706,127.7777778,12.90347826
NM_001144761,TLE2,20,19,49999,2511,47488,2499.368421,125.55,18.91198726
NM_015898,ZBTB7A,3,2,21602,4444,17158,8579,1481.333333,3.860936094
NM_002378,MATK,14,13,23845,2093,21752,1673.230769,149.5,10.3927377
NM_001172673,CELF5,12,11,72373,5019,67354,6123.090909,418.25,13.41980474
NM_012398,PIP5K1C,18,17,70300,5100,65200,3835.294118,283.3333333,12.78431373
NM_205843,NFIC,11,10,109656,8079,101577,10157.7,734.4545455,12.57296695
NM_001245004,NFIC,10,9,102652,7901,94751,10527.88889,790.1,11.99227946
NM_001245002,NFIC,11,10,102652,8056,94596,9459.6,732.3636364,11.74230387
NM_001245005,NFIC,10,9,109656,7924,101732,11303.55556,792.4,12.83846542
NM_021938,CELF5,13,12,72374,1866,70508,5875.666667,143.5384615,37.78563773
NM_001195733,PIP5K1C,17,16,70300,5015,65285,4080.3125,295,13.01794616
NM_005597,NFIC,9,8,102652,7814,94838,11854.75,868.2222222,12.13693371
NM_025241,UBXN6,11,10,12790,1926,10864,1086.4,175.0909091,5.640706127
NM_015015,KDM4B,23,22,184486,5626,178860,8130,244.6086957,31.79168148
NM_017720,STAP2,13,12,14809,1550,13259,1104.916667,119.2307692,8.554193548
NM_001013841,STAP2,13,12,14809,1412,13397,1116.416667,108.6153846,9.48796034
NM_139159,DPP9,22,21,48613,4291,44322,2110.571429,195.0454545,10.32906082
NM_001164194,PLIN3,8,7,29436,2312,27124,3874.857143,289,11.73183391
NM_001164189,PLIN3,8,7,29436,2345,27091,3870.142857,293.125,11.55266525
NM_005817,PLIN3,8,7,29436,2348,27088,3869.714286,293.5,11.53662692
NM_001201340,SAFB,20,19,45445,2925,42520,2237.894737,146.25,14.53675214
NM_134433,RFX2,17,16,117491,4054,113437,7089.8125,238.4705882,27.98149975
NM_152784,CATSPERD,22,21,58056,2535,55521,2643.857143,115.2272727,21.90177515
NM_002967,SAFB,21,20,45445,3127,42318,2115.9,148.9047619,13.53309882
NM_030924,ACSBG2,15,14,57472,2795,54677,3905.5,186.3333333,19.56243292
NM_001289180,ACSBG2,15,14,57472,2514,54958,3925.571429,167.6,21.86077963
NM_001289178,ACSBG2,15,14,57472,2750,54722,3908.714286,183.3333333,19.89890909
NM_001289179,ACSBG2,15,14,57472,2711,54761,3911.5,180.7333333,20.19955736
NM_001289177,ACSBG2,15,14,57472,2804,54668,3904.857143,186.9333333,19.49643367
NM_001193375,NDUFA11,4,3,12739,2637,10102,3367.333333,659.25,3.830868411
NM_001201339,SAFB,21,20,45445,3130,42315,2115.75,149.047619,13.51916933
NM_001201338,SAFB,21,20,45445,3133,42312,2115.6,149.1904762,13.50526652
NM_000635,RFX2,18,17,117491,4130,113361,6668.294118,229.4444444,27.44818402
NM_175614,NDUFA11,4,3,9345,807,8538,2846,201.75,10.57992565
NM_001044387,ZNF557,8,7,18509,5997,12512,1787.428571,749.625,2.086376522
NM_024341,ZNF557,8,7,18509,6009,12500,1785.714286,751.125,2.080213014
NM_000208,INSR,22,21,181747,9081,172666,8222.190476,412.7727273,19.01398524
NM_001079817,INSR,21,20,181747,9044,172703,8635.15,430.6666667,19.09586466
NM_005428,VAV1,27,26,84700,2964,81736,3143.692308,109.7777778,27.57624831
NM_000064,C3,41,40,42818,5142,37676,941.9,125.4146341,7.327110074
NM_001044388,ZNF557,8,7,18509,5988,12521,1788.714286,748.5,2.091015364
NM_001258207,VAV1,26,25,84700,2867,81833,3273.32,110.2692308,28.54307639
NM_001258206,VAV1,26,25,84700,2897,81803,3272.12,111.4230769,28.23714187
NM_003685,KHSRP,20,19,11705,3270,8435,443.9473684,163.5,2.579510703
NM_006351,TIMM44,13,12,17107,2013,15094,1257.833333,154.8461538,7.498261302
NM_006702,PNPLA6,35,34,27617,4507,23110,679.7058824,128.7714286,5.127579321
NM_001201359,CCL25,6,5,9903,1005,8898,1779.6,167.5,8.853731343
NM_005624,CCL25,6,5,9903,1008,8895,1779,168,8.824404762
NM_015318,ARHGEF18,21,20,77374,5241,72133,3606.65,249.5714286,13.76321313
NM_001166114,PNPLA6,32,31,26066,4421,21645,698.2258065,138.15625,4.895951142
NM_001166113,PNPLA6,35,34,27019,4495,22524,662.4705882,128.4285714,5.010901001
NM_001166112,PNPLA6,34,33,27527,4542,22985,696.5151515,133.5882353,5.060546015
NM_001166111,PNPLA6,34,33,27064,4607,22457,680.5151515,135.5,4.874538745
NM_024690,MUC16,84,83,132500,43900,88600,1067.46988,522.6190476,2.018223235
NM_031203,HNRNPM,17,16,44201,2437,41764,2610.25,143.3529412,17.1374641
NM_001282352,ADAMTS10,13,12,11958,2473,9485,790.4166667,190.2307692,3.835422564
NM_005968,HNRNPM,16,15,44201,2553,41648,2776.533333,159.5625,16.31335684
NM_030957,ADAMTS10,26,25,30498,4297,26201,1048.04,165.2692308,6.097509891
NM_015719,COL5A3,67,66,50912,6241,44671,676.8333333,93.14925373,7.157667041
NM_001040664,PPAN-P2RY11,13,12,9167,3220,5947,495.5833333,247.6923077,1.84689441
NM_002566,P2RY11,2,1,3869,1978,1891,1891,989,0.956016178
NM_001198690,PPAN-P2RY11,13,12,9167,3282,5885,490.4166667,252.4615385,1.793113955
NM_020428,SLC44A2,22,21,19066,3456,15610,743.3333333,157.0909091,4.516782407
NM_001005361,DNM2,21,20,113859,3687,110172,5508.6,175.5714286,29.88120423
NM_001005360,DNM2,21,20,113859,3687,110172,5508.6,175.5714286,29.88120423
NM_199141,CARM1,16,15,51197,2984,48213,3214.2,186.5,16.15717158
NM_003072,SMARCA4,35,34,101362,5729,95633,2812.735294,163.6857143,16.69279106
NM_001128849,SMARCA4,36,35,101152,5616,95536,2729.6,156,17.01139601
NM_001005362,DNM2,20,19,113859,3674,110185,5799.210526,183.7,29.9904736
NM_001128848,SMARCA4,33,32,78132,5341,72791,2274.71875,161.8484848,13.62872121
NM_001145056,SLC44A2,22,21,42116,3397,38719,1843.761905,154.4090909,11.39799823
NM_001128846,SMARCA4,33,32,78132,5350,72782,2274.4375,162.1212121,13.60411215
NM_001128847,SMARCA4,33,32,78132,5344,72788,2274.625,161.9393939,13.62050898
NM_001128845,SMARCA4,33,32,78132,5353,72779,2274.34375,162.2121212,13.59592752
NM_001128844,SMARCA4,36,35,101362,5806,95556,2730.171429,161.2777778,16.45814674
NM_001190716,DNM2,21,20,113859,3684,110175,5508.75,175.4285714,29.90635179
NM_004945,DNM2,20,19,113859,3674,110185,5799.210526,183.7,29.9904736
NM_032377,ELOF1,4,3,6195,1023,5172,1724,255.75,5.055718475
NM_152357,ZNF440,4,3,20911,4185,16726,5575.333333,1046.25,3.996654719
NM_001271848,ZNF700,4,3,25707,2905,22802,7600.666667,726.25,7.849225473
NM_144566,ZNF700,4,3,25707,2896,22811,7603.666667,724,7.876726519
NM_014975,MAST1,26,25,36509,4949,31560,1262.4,190.3461538,6.377045868
NM_024038,C19orf43,3,2,4077,913,3164,1582,304.3333333,3.465498357
NM_023035,CACNA1A,47,46,300020,8688,291332,6333.304348,184.8510638,33.53268877
NM_001127222,CACNA1A,47,46,300020,8675,291345,6333.586957,184.5744681,33.58443804
NM_001174080,CACNA1A,47,46,300020,8674,291346,6333.608696,184.5531915,33.58842518
NM_002501,NFIX,10,9,103028,5586,97442,10826.88889,558.6,17.44396706
NM_020714,ZNF490,5,4,34705,6103,28602,7150.5,1220.6,4.6865476
NM_000068,CACNA1A,47,46,300020,8683,291337,6333.413043,184.7446809,33.552574
NM_052876,NACC1,6,5,22861,4506,18355,3671,751,4.073457612
NM_001127221,CACNA1A,47,46,300020,8673,291347,6333.630435,184.5319149,33.59241324
NM_017721,CC2D1A,29,28,24739,3669,21070,752.5,126.5172414,5.742709185
NM_002741,PKN1,22,21,38515,3102,35413,1686.333333,141,11.41618311
NM_014921,LPHN1,23,22,58450,7865,50585,2299.318182,341.9565217,6.43165925
NM_001008701,LPHN1,24,23,58450,7881,50569,2198.652174,328.375,6.416571501
NM_004843,IL27RA,14,13,21167,2673,18494,1422.615385,190.9285714,6.918817808
NM_001272088,SLC1A6,6,5,18424,1860,16564,3312.8,310,8.905376344
NM_001272087,SLC1A6,8,7,18424,3034,15390,2198.571429,379.25,5.072511536
NM_005858,AKAP8,14,13,26282,3557,22725,1748.076923,254.0714286,6.388810796
NM_032433,ZNF333,12,11,30904,3779,27125,2465.909091,314.9166667,7.177824821
NM_005071,SLC1A6,9,8,22887,1874,21013,2626.625,208.2222222,11.21291355
NM_021235,EPS15L1,23,22,110436,2877,107559,4889.045455,125.0869565,37.38581856
NM_001258374,EPS15L1,24,23,116770,3285,113485,4934.130435,136.875,34.54642314
NM_001258375,EPS15L1,22,21,110436,2743,107693,5128.238095,124.6818182,39.26102807
NM_001258376,EPS15L1,16,15,71383,3564,67819,4521.266667,222.75,19.02890011
NM_006387,CHERP,17,16,24565,4112,20453,1278.3125,241.8823529,4.973978599
NM_032855,HSH2D,9,8,24541,2371,22172,2771.5,263.4444444,9.351328553
NM_001082,CYP4F2,13,12,20052,2373,17679,1473.25,182.5384615,7.450063211
NM_001007525,NWD1,19,18,97989,7664,90325,5018.055556,403.3684211,11.78562109
NM_001130065,MYO9B,40,39,137515,7663,129852,3329.538462,191.575,16.94532168
NM_024050,DDA1,5,4,13771,4082,9689,2422.25,816.4,2.373591377
NM_001011699,HAUS8,11,10,25774,1464,24310,2431,133.0909091,16.60519126
NM_004145,MYO9B,40,39,137515,7651,129864,3329.846154,191.275,16.97346752
NM_015692,CPAMD8,42,41,133865,6030,127835,3117.926829,143.5714286,21.19983416
NM_033417,HAUS8,11,10,25774,1467,24307,2430.7,133.3636364,16.56918882
NM_000215,JAK3,24,23,23250,5458,17792,773.5652174,227.4166667,3.259802125
NM_015016,MAST3,27,26,53898,5920,47978,1845.307692,219.2592593,8.104391892
NM_006532,ELL,12,11,79466,4039,75427,6857,336.5833333,18.67467195
NM_000923,PDE4C,16,15,40241,5362,34879,2325.266667,335.125,6.504848937
NM_002248,KCNN1,11,10,47821,2668,45153,4515.3,242.5454545,16.92391304
NM_005919,MEF2BNB-MEF2B,10,9,47026,1962,45064,5007.111111,196.2,22.96839959
NM_014884,SUGP2,11,10,42685,3668,39017,3901.7,333.4545455,10.63713195
NM_198207,CERS1,6,5,18237,2109,16128,3225.6,351.5,7.647226174
NM_001017392,SUGP2,11,10,41205,4779,36426,3642.6,434.4545455,7.622096673
NM_001492,GDF1,8,7,27594,2566,25028,3575.428571,320.75,9.75370226
NM_021267,CERS1,8,7,27594,2566,25028,3575.428571,320.75,9.75370226
NM_017660,GATAD2A,12,11,123101,5684,117417,10674.27273,473.6666667,20.65745954
NM_001145785,MEF2B,9,8,24724,1460,23264,2908,162.2222222,15.93424658
NM_172231,SUGP1,14,13,44001,2103,41898,3222.923077,150.2142857,19.92296719
NM_145297,ZNF626,4,3,16895,1126,15769,5256.333333,281.5,14.0044405
NM_001076675,ZNF626,4,3,41659,6092,35567,11855.66667,1523,5.838312541
NM_001172671,ZNF430,5,4,39428,3921,35507,8876.75,784.2,9.055598062
NM_133473,ZNF431,5,4,43967,3851,40116,10029,770.2,10.41703454
NM_025189,ZNF430,5,4,39428,3924,35504,8876,784.8,9.047910296
NM_021269,ZNF708,4,3,38251,4007,34244,11414.66667,1001.75,8.546044422
NM_007153,ZNF208,4,3,44850,9092,35758,11919.33333,2273,3.932908051
NM_001080409,ZNF99,4,3,31990,7885,24105,8035,1971.25,3.057070387
NM_138330,ZNF675,4,3,34311,2213,32098,10699.33333,553.25,14.50429282
NM_001278663,ZNF254,3,2,96564,4030,92534,46267,1343.333333,22.96129032
NM_001278661,ZNF254,5,4,96564,4255,92309,23077.25,851,21.69424207
NM_001278677,ZNF254,6,5,96564,4328,92236,18447.2,721.3333333,21.31146026
NM_014717,ZNF536,5,4,185639,4940,180699,45174.75,988,36.57874494
NM_032816,CEP89,19,18,92967,2624,90343,5019.055556,138.1052632,34.42949695
NM_032139,ANKRD27,29,28,78197,4482,73715,2632.678571,154.5517241,16.44689871
NM_001172774,DPY19L3,19,18,80146,6021,74125,4118.055556,316.8947368,12.31107789
NM_207325,DPY19L3,19,18,79779,6047,73732,4096.222222,318.2631579,12.19315363
NM_022467,CHST8,4,3,88982,2483,86499,28833,620.75,34.83648812
NM_000285,PEPD,15,14,134946,2025,132921,9494.357143,135,65.64
NM_001166057,PEPD,13,12,134946,1831,133115,11092.91667,140.8461538,72.70070999
NM_001166056,PEPD,13,12,134946,1900,133046,11087.16667,146.1538462,70.02421053
NM_001127896,CHST8,4,3,151543,2141,149402,49800.66667,535.25,69.78141056
NM_001127895,CHST8,5,4,151555,2231,149324,37331,446.2,66.93142089
NM_000175,GPI,18,17,37288,4212,33076,1945.647059,234,7.852801519
NM_001184722,GPI,18,17,37675,4275,33400,1964.705882,237.5,7.812865497
NM_001007248,ZNF599,4,3,15157,3119,12038,4012.666667,779.75,3.859570375
NM_001289789,GPI,19,18,37675,4360,33315,1850.833333,229.4736842,7.641055046
NM_001289790,GPI,17,16,37288,4127,33161,2072.5625,242.7647059,8.03513448
NM_000704,ATP4A,22,21,13467,3581,9886,470.7619048,162.7727273,2.760681374
NM_001083961,WDR62,32,31,50231,4777,45454,1466.258065,149.28125,9.515176889
NM_173636,WDR62,32,31,50231,4762,45469,1466.741935,148.8125,9.548299034
NM_001204838,ZNF568,10,9,81605,2769,78836,8759.555556,276.9,28.47092813
NM_001242476,ZNF345,4,3,27926,3038,24888,8296,759.5,8.192231731
NM_001242475,ZNF345,3,2,27926,2942,24984,12492,980.6666667,8.492182189
NM_001242474,ZNF345,4,3,28701,3108,25593,8531,777,8.234555985
NM_001242472,ZNF345,3,2,28701,2962,25739,12869.5,987.3333333,8.689736664
NM_003419,ZNF345,3,2,29219,3129,26090,13045,1043,8.338127197
NM_001204839,ZNF568,9,8,81605,2507,79098,9887.25,278.5555556,31.5508576
NM_032838,ZNF566,5,4,44318,5202,39116,9779,1040.4,7.519415609
NM_001145345,ZNF566,5,4,44444,5267,39177,9794.25,1053.4,7.438200114
NM_001145344,ZNF566,5,4,44444,5255,39189,9797.25,1051,7.457469077
NM_001145343,ZNF566,5,4,44444,5258,39186,9796.5,1051.6,7.452643591
NM_020917,ZFP14,5,4,44752,7498,37254,9313.5,1499.6,4.96852494
NM_001145650,ZNF529,5,4,61663,5172,56491,14122.75,1034.4,10.92246713
NM_001145649,ZNF529,6,5,61663,5233,56430,11286,872.1666667,10.78348939
NM_144689,ZNF420,5,4,51271,2978,48293,12073.25,595.6,16.21658831
NM_032453,ZNF527,5,4,21909,5131,16778,4194.5,1026.2,3.269927889
NM_014898,ZFP30,6,5,22926,4617,18309,3661.8,769.5,3.965562053
NM_001013659,ZNF793,8,7,36400,7129,29271,4181.571429,891.125,4.105905457
NM_015073,SIPA1L3,22,21,301142,8005,293137,13958.90476,363.8636364,36.61923798
NM_024907,FBXO17,6,5,34414,2295,32119,6423.8,382.5,13.99520697
NM_001042723,RYR1,105,104,153866,15481,138385,1330.625,147.4380952,8.939022027
NM_001398,ECH1,10,9,16437,1273,15164,1684.888889,127.3,11.91201885
NM_000540,RYR1,106,105,153866,15497,138369,1317.8,146.1981132,8.928760405
NM_004924,ACTN4,21,20,82906,3975,78931,3946.55,189.2857143,19.85685535
NM_001004318,PAPL,13,12,27185,2974,24211,2017.583333,228.7692308,8.140887693
NM_001243027,AKT2,14,13,55080,5277,49803,3831,376.9285714,9.437748721
NM_003890,FCGBP,36,35,86572,16426,70146,2004.171429,456.2777778,4.270424936
NM_001626,AKT2,14,13,55080,5314,49766,3828.153846,379.5714286,9.365073391
NM_001243028,AKT2,13,12,55080,5183,49897,4158.083333,398.6923077,9.627049971
NM_001001563,TIMM50,11,10,10478,2583,7895,789.5,234.8181818,3.056523422
NM_144732,HNRNPUL1,15,14,45422,3729,41693,2978.071429,248.6,11.18074551
NM_007040,HNRNPUL1,15,14,43693,4216,39477,2819.785714,281.0666667,9.363614801
NM_016154,RAB4B,8,7,18727,1197,17530,2504.285714,149.625,14.6449457
NM_020971,SPTBN4,36,35,109241,8723,100518,2871.942857,242.3055556,11.52332913
NM_133444,ZNF526,3,2,7863,3957,3906,1953,1319,0.987111448
NM_002698,POU2F2,14,13,46365,6910,39455,3035,493.5714286,5.70984081
NM_001247994,POU2F2,14,13,46365,6774,39591,3045.461538,483.8571429,5.844552702
NM_001207026,POU2F2,13,12,40647,1716,38931,3244.25,132,22.68706294
NM_001207025,POU2F2,14,13,46365,6958,39407,3031.307692,497,5.663552745
NM_001410,MEGF8,41,40,53162,11007,42155,1053.875,268.4634146,3.829835559
NM_001271938,MEGF8,42,41,53162,11209,41953,1023.243902,266.8809524,3.742795968
NM_001288773,CEACAM21,8,7,37313,1700,35613,5087.571429,212.5,20.94882353
NM_031451,TEX101,9,8,30006,1592,28414,3551.75,176.8888889,17.84798995
NM_002785,PSG11,6,5,18824,1547,17277,3455.4,257.8333333,11.16806723
NM_203287,PSG11,5,4,18824,1248,17576,4394,249.6,14.08333333
NM_001113410,PSG11,5,4,18824,1180,17644,4411,236,14.95254237
NM_003425,ZNF45,10,9,22637,3913,18724,2080.444444,391.3,4.78507539
NM_001031749,LYPD5,5,4,6536,2506,4030,1007.5,501.2,1.608140463
NM_001005377,PLAUR,6,5,21777,1424,20353,4070.6,237.3333333,14.29283708
NM_001005376,PLAUR,7,6,24253,1441,22812,3802,205.8571429,15.83067314
NM_013361,ZNF223,5,4,15980,2419,13561,3390.25,483.8,5.606035552
NM_002659,PLAUR,7,6,21777,1560,20217,3369.5,222.8571429,12.95961538
NM_182573,LYPD5,5,4,24731,2478,22253,5563.25,495.6,8.980225989
NM_001288763,LYPD5,4,3,4104,2555,1549,516.3333333,638.75,0.606262231
NM_002856,PVRL2,6,5,32807,2157,30650,6130,359.5,14.2095503
NM_019121,PPP1R37,13,12,54114,2965,51149,4262.416667,228.0769231,17.25092749
NM_001042724,PVRL2,9,8,43094,2865,40229,5028.625,318.3333333,14.04153578
NM_001282176,CLPTM1,14,13,38764,2518,36246,2788.153846,179.8571429,14.39475774
NM_001282175,CLPTM1,14,13,38356,2494,35862,2758.615385,178.1428571,14.37931034
NM_001294,CLPTM1,14,13,38125,2645,35480,2729.230769,188.9285714,13.41398866
NM_001012643,MYPOP,3,2,12583,1890,10693,5346.5,630,5.657671958
NM_001205281,PPP5D1,4,3,120414,1245,119169,39723,311.25,95.71807229
NM_001135113,IGFL2,4,3,13063,616,12447,4149,154,20.20616883
NM_175875,SIX5,3,2,4456,3334,1122,561,1111.333333,0.336532693
NM_001002915,IGFL2,5,4,13524,905,12619,3154.75,181,13.94364641
NM_001145713,SAE1,7,6,79815,2326,77489,12914.83333,332.2857143,33.31427343
NM_015168,ZC3H4,15,14,49564,6131,43433,3102.357143,408.7333333,7.084162453
NM_018485,C5AR2,2,1,5012,1398,3614,3614,699,2.585121602
NM_001271749,C5AR2,2,1,9870,1436,8434,8434,718,5.873259053
NM_001145714,SAE1,8,7,79815,2397,77418,11059.71429,299.625,32.29787234
NM_015063,SLC8A2,10,9,44030,5121,38909,4323.222222,512.1,7.597930092
NM_005500,SAE1,9,8,79815,2543,77272,9659,282.5555556,30.38615808
NM_004491,ARHGAP35,6,5,86402,8894,77508,15501.6,1482.333333,8.714639083
NM_006801,KDELR1,5,4,8985,1562,7423,1855.75,312.4,4.752240717
NM_001184902,CARD8,13,12,47862,5515,42347,3528.916667,424.2307692,7.678513146
NM_001184904,CARD8,4,3,17687,630,17057,5685.666667,157.5,27.07460317
NM_000234,LIG1,28,27,55160,3412,51748,1916.592593,121.8571429,15.16647128
NM_001289063,LIG1,27,26,55160,3318,51842,1993.923077,122.8888889,15.62447257
NM_001289064,LIG1,26,25,55160,3206,51954,2078.16,123.3076923,16.20524017
NM_015953,NOSIP,10,9,25106,1377,23729,2636.555556,137.7,17.23238925
NM_001136052,CPT1C,20,19,22625,2841,19784,1041.263158,142.05,6.96374516
NM_001195227,TRPM4,24,23,54084,3685,50399,2191.26087,153.5416667,13.67679783
NM_001199753,CPT1C,20,19,22625,2874,19751,1039.526316,143.7,6.87230341
NM_014037,SLC6A16,12,11,35584,2945,32639,2967.181818,245.4166667,11.08285229
NM_017636,TRPM4,25,24,54084,4121,49963,2081.791667,164.84,12.12399903
NM_001270960,NOSIP,9,8,25106,1257,23849,2981.125,139.6666667,18.97295147
NM_020309,SLC17A7,12,11,12155,2988,9167,833.3636364,249,3.06793842
NM_006184,NUCB1,13,12,23235,2592,20643,1720.25,199.3846154,7.96412037
NM_152359,CPT1C,19,18,22625,2804,19821,1101.166667,147.5789474,7.068830243
NM_001199752,CPT1C,20,19,22625,2938,19687,1036.157895,146.9,6.700816882
NM_001077186,MYH14,42,41,106918,6855,100063,2440.560976,163.2142857,14.59708242
NM_024729,MYH14,41,40,106918,6830,100088,2502.2,166.5853659,14.65417277
NM_001135163,SIGLEC11,10,9,12181,2887,9294,1032.666667,288.7,3.219258746
NM_001145809,MYH14,43,42,106918,6955,99963,2380.071429,161.744186,14.37282531
NM_052884,SIGLEC11,11,10,12181,3176,9005,900.5,288.7272727,2.835327456
NM_012315,KLK9,5,4,7123,1443,5680,1420,288.6,3.936243936
NM_001161499,ZNF611,6,5,32243,4523,27720,5544,753.8333333,6.128675658
NM_001161501,ZNF611,5,4,32233,4385,27848,6962,877,6.350741163
NM_030972,ZNF611,7,6,27071,4566,22505,3750.833333,652.2857143,4.928821726
NM_001172655,ZNF701,5,4,16512,5543,10969,2742.25,1108.6,1.978892297
NM_018260,ZNF701,4,3,16903,5248,11655,3885,1312,2.220846037
NM_001277120,ZNF468,5,4,19119,4036,15083,3770.75,807.2,3.737115956
NM_001161500,ZNF611,5,4,32243,4422,27821,6955.25,884.4,6.29149706
NM_144684,ZNF480,5,4,28750,4746,24004,6001,949.2,5.057732828
NM_001008801,ZNF468,4,3,19119,3917,15202,5067.333333,979.25,3.881031402
NM_002739,PRKCG,18,17,25436,3146,22290,1311.176471,174.7777778,7.08518754
NM_182609,ZNF677,5,4,19475,3498,15977,3994.25,699.6,4.567467124
NM_001278426,LILRB4,12,11,7541,3914,3627,329.7272727,326.1666667,0.92667348
NM_001278428,LILRB4,12,11,7541,3914,3627,329.7272727,326.1666667,0.92667348
NM_001278427,LILRB4,12,11,7541,3911,3630,330,325.9166667,0.928151368
NM_001278429,LILRB4,11,10,7541,3880,3661,366.1,352.7272727,0.943556701
NM_206828,NLRP7,10,9,23998,3260,20738,2304.222222,326,6.361349693
NM_001127255,NLRP7,11,10,23998,3432,20566,2056.6,312,5.992424242
NM_014516,CNOT3,18,17,18012,2905,15107,888.6470588,161.3888889,5.200344234
NM_139176,NLRP7,11,10,23998,3348,20650,2065,304.3636364,6.16786141
NM_001258383,LOC100287534,9,8,21474,1824,19650,2456.25,202.6666667,10.77302632
NM_024710,ISOC2,6,5,8705,1175,7530,1506,195.8333333,6.408510638
NM_001161440,PTPRH,18,17,28261,3412,24849,1461.705882,189.5555556,7.282825322
NM_176820,NLRP9,9,8,29972,3493,26479,3309.875,388.1111111,7.580589751
NM_001282011,TMEM150B,8,7,12541,990,11551,1650.142857,123.75,11.66767677
NM_134444,NLRP4,10,9,45278,3684,41594,4621.555556,368.4,11.29044517
NM_001136201,ISOC2,6,5,8705,1127,7578,1515.6,187.8333333,6.72404614
NM_002842,PTPRH,20,19,28261,3948,24313,1279.631579,197.4,6.158308004
NM_001085488,TMEM150B,8,7,12541,941,11600,1657.142857,117.625,12.32731137
NM_001136202,ISOC2,5,4,8705,916,7789,1947.25,183.2,8.503275109
NM_176811,NLRP8,10,9,40799,3944,36855,4095,394.4,9.344574037
NM_001277090,ZNF550,6,5,18029,4315,13714,2742.8,719.1666667,3.178215527
NM_001277093,ZNF550,5,4,18029,2006,16023,4005.75,401.2,7.987537388
NM_005773,ZNF256,3,2,6878,2213,4665,2332.5,737.6666667,2.107998192
NM_138347,ZNF551,3,2,7834,3724,4110,2055,1241.333333,1.103651987
NM_006635,ZNF460,3,2,13585,3852,9733,4866.5,1284,2.526739356
NM_001277092,ZNF550,5,4,18029,3381,14648,3662,676.2,4.332446022
NM_001277091,ZNF550,6,5,18029,3729,14300,2860,621.5,3.83480826
NM_001270938,ZNF551,3,2,7834,3602,4232,2116,1200.666667,1.174902832
NM_014347,ZNF324,4,3,6535,3235,3300,1100,808.75,1.020092736
NM_181846,ZSCAN22,3,2,15329,4646,10683,5341.5,1548.666667,2.299397331
NM_001005240,OR4F17,1,0,919,919,NA,NA,919,NA
NM_199202,THEG,7,6,13958,1261,12697,2116.166667,180.1428571,10.06899286
NM_016585,THEG,8,7,13958,1334,12624,1803.428571,166.75,9.463268366
NM_017550,MIER2,14,13,39218,2776,36442,2803.230769,198.2857143,13.12752161
NM_003712,PPAP2C,6,5,10397,1320,9077,1815.4,220,6.876515152
NM_177526,PPAP2C,6,5,10397,1279,9118,1823.6,213.1666667,7.129007037
NM_177543,PPAP2C,6,5,10131,1387,8744,1748.8,231.1666667,6.304253785
NM_130762,MADCAM1,4,3,8855,1280,7575,2525,320,5.91796875
NM_130760,MADCAM1,5,4,8855,1542,7313,1828.25,308.4,4.742542153
NM_001136263,C2CD4C,2,1,3729,3126,603,603,1563,0.192898273
NM_012435,SHC2,13,12,44415,2507,41908,3492.333333,192.8461538,16.7163941
NM_033513,TPGS1,2,1,12159,1116,11043,11043,558,9.89516129
NM_182577,ODF3L2,4,3,11639,1608,10031,3343.666667,402,6.23818408
NM_005317,GZMM,5,4,5888,946,4942,1235.5,189.2,5.22410148
NM_198591,BSG,7,6,12218,1645,10573,1762.166667,235,6.427355623
NM_198589,BSG,8,7,11041,1748,9293,1327.571429,218.5,5.316361556
NM_020637,FGF22,3,2,3680,516,3164,1582,172,6.131782946
NM_005035,POLRMT,21,20,16347,3821,12526,626.3,181.952381,3.278199424
NM_001258351,GZMM,5,4,5888,942,4946,1236.5,188.4,5.250530786
NM_001194,HCN2,8,7,27268,3416,23852,3407.428571,427,6.982435597
NM_198590,BSG,8,7,12218,1803,10415,1487.857143,225.375,5.776483638
NM_001728,BSG,9,8,11041,2097,8944,1118,233,4.265140677
NM_004359,CDC34,5,4,10356,1450,8906,2226.5,290,6.142068966
NM_005860,FSTL3,5,4,7005,2516,4489,1122.25,503.2,1.78418124
NM_214710,PRSS57,5,4,9917,1058,8859,2214.75,211.6,8.373345936
NM_001040134,PALM,8,7,39379,2750,36629,5232.714286,343.75,13.31963636
NM_173481,MISP,5,4,13174,2856,10318,2579.5,571.2,3.612745098
NM_002579,PALM,9,8,39379,2883,36496,4562,320.3333333,12.65903573
NM_024888,LPPR3,7,6,9466,2394,7072,1178.666667,342,2.954051796
NM_031991,PTBP1,14,13,14937,3217,11720,901.5384615,229.7857143,3.643145788
NM_031990,PTBP1,15,14,14937,3275,11662,833,218.3333333,3.560916031
NM_002819,PTBP1,15,14,14937,3296,11641,831.5,219.7333333,3.531856796
NM_005481,MED16,16,15,25258,2940,22318,1487.866667,183.75,7.591156463
NM_001928,CFD,5,4,3947,1164,2783,695.75,232.8,2.390893471
NM_002777,PRTN3,5,4,7192,1006,6186,1546.5,201.2,6.149105368
NM_001700,AZU1,5,4,4188,917,3271,817.75,183.4,3.567066521
NM_001972,ELANE,5,4,3957,929,3028,757,185.8,3.25941873
NM_138774,R3HDM4,8,7,16724,1817,14907,2129.571429,227.125,8.204182719
NM_001270366,LPPR3,8,7,9466,2311,7155,1022.142857,288.875,3.096062311
NM_201277,CNN2,6,5,12768,2347,10421,2084.2,391.1666667,4.440136344
NM_024100,WDR18,10,9,10243,1561,8682,964.6666667,156.1,5.561819347
NM_005224,ARID3A,9,8,46768,2819,43949,5493.625,313.2222222,15.59028024
NM_033420,TMEM259,10,9,11493,2618,8875,986.1111111,261.8,3.389992361
NM_138690,GRIN3B,9,8,9288,3263,6025,753.125,362.5555556,1.846460313
NM_001033026,TMEM259,11,10,11493,2719,8774,877.4,247.1818182,3.226921662
NM_004368,CNN2,7,6,12768,2465,10303,1717.166667,352.1428571,4.179716024
NM_001282335,HMHA1,22,21,16612,4975,11637,554.1428571,226.1363636,2.339095477
NM_001282334,HMHA1,13,12,11199,5287,5912,492.6666667,406.6923077,1.118214488
NM_012292,HMHA1,23,22,20667,5499,15168,689.4545455,239.0869565,2.758319694
NM_002695,POLR2E,8,7,8815,2874,5941,848.7142857,359.25,2.067153793
NM_014963,SBNO2,32,31,66651,4957,61694,1990.129032,154.90625,12.44583417
NM_001258328,HMHA1,23,22,21910,5410,16500,750,235.2173913,3.049907579
NM_001100122,SBNO2,29,28,24642,4622,20020,715,159.3793103,4.331458243
NM_001039847,GPX4,7,6,2865,958,1907,317.8333333,136.8571429,1.990605428
NM_002085,GPX4,7,6,2865,936,1929,321.5,133.7142857,2.060897436
NM_001039848,GPX4,7,6,2141,1014,1127,187.8333333,144.8571429,1.111439842
NM_000455,STK11,10,9,22638,3286,19352,2150.222222,328.6,5.889227024
NM_017914,C19orf24,3,2,3725,898,2827,1413.5,299.3333333,3.148106904
NM_001405,EFNA2,4,3,15278,2146,13132,4377.333333,536.5,6.119291705
NM_001687,ATP5D,4,3,3077,1000,2077,692.3333333,250,2.077
NM_001280,CIRBP,7,6,3906,1404,2502,417,200.5714286,1.782051282
NM_152769,C19orf26,9,8,8045,2573,5472,684,285.8888889,2.12670035
NM_001001975,ATP5D,5,4,3077,705,2372,593,141,3.364539007
NM_177401,MIDN,8,7,10592,3801,6791,970.1428571,475.125,1.786635096
NM_000156,GAMT,6,5,4546,1144,3402,680.4,190.6666667,2.973776224
NM_024407,NDUFS7,8,7,11707,794,10913,1559,99.25,13.74433249
NM_032853,MUM1,14,13,23456,4115,19341,1487.769231,293.9285714,4.700121507
NM_001018,RPS15,4,3,2131,535,1596,532,133.75,2.98317757
NM_018959,DAZAP1,12,11,28120,2216,25904,2354.909091,184.6666667,11.68953069
NM_138924,GAMT,5,4,3761,1774,1987,496.75,354.8,1.120067644
NM_170711,DAZAP1,13,12,28120,2306,25814,2151.166667,177.3846154,11.1942758
NM_005883,APC2,15,14,23097,10166,12931,923.6428571,677.7333333,1.271985048
NM_213604,ADAMTSL5,12,11,8173,2869,5304,482.1818182,239.0833333,1.84872778
NM_001174118,MEX3D,3,2,13391,2666,10725,5362.5,888.6666667,4.02288072
NM_152482,C19orf25,3,2,6030,2260,3770,1885,753.3333333,1.668141593
NM_138393,REEP6,5,4,6761,1378,5383,1345.75,275.6,3.906386067
NM_203304,MEX3D,2,1,13391,2852,10539,10539,1426,3.695301543
NM_001243079,PLK5,14,13,11384,1947,9437,725.9230769,139.0714286,4.846944016
NM_017573,PCSK4,15,14,9024,2718,6306,450.4285714,181.2,2.3200883
NM_001136139,TCF3,19,18,40999,4097,36902,2050.111111,215.6315789,9.00707835
NM_001281454,MBD3,7,6,16092,2410,13682,2280.333333,344.2857143,5.677178423
NM_001281453,MBD3,7,6,16092,2506,13586,2264.333333,358,5.421388667
NM_006830,UQCR11,3,2,8331,1338,6993,3496.5,446,5.226457399
NM_003200,TCF3,19,18,43041,4470,38571,2142.833333,235.2631579,8.62885906
NM_001080488,ONECUT3,2,1,21784,1487,20297,20297,743.5,13.64963013
NM_001178002,ATP8B3,29,28,30164,5033,25131,897.5357143,173.5517241,4.993244586
NM_138813,ATP8B3,29,28,30203,5124,25079,895.6785714,176.6896552,4.894418423
NM_031213,ABHD17A,6,5,8545,1722,6823,1364.6,287,3.962253194
NM_001130111,ABHD17A,5,4,8545,1568,6977,1744.25,313.6,4.449617347
NM_031918,KLF16,2,1,11168,2889,8279,8279,1444.5,2.865697473
NM_138422,ADAT3,2,1,8077,1628,6449,6449,814,3.961302211
NM_079834,SCAMP4,7,6,20641,2533,18108,3018,361.8571429,7.148835373
NM_199054,MKNK2,14,13,13775,3799,9976,767.3846154,271.3571429,2.625954198
NM_017797,BTBD2,9,8,30257,2627,27630,3453.75,291.8888889,10.5177008
NM_130807,MOB3A,5,4,25236,3336,21900,5475,667.2,6.564748201
NM_017572,MKNK2,14,13,13775,1772,12003,923.3076923,126.5714286,6.773702032
NM_001261826,AP3D1,32,31,50571,5088,45483,1467.193548,159,8.939268868
NM_003938,AP3D1,30,29,50571,4900,45671,1574.862069,163.3333333,9.320612245
NM_016199,LSM7,4,3,7096,524,6572,2190.666667,131,12.54198473
NM_198532,C19orf35,4,3,7552,2574,4978,1659.333333,643.5,1.933954934
NM_007165,SF3A2,9,8,11864,1659,10205,1275.625,184.3333333,6.151295961
NM_152988,SPPL2B,15,14,26473,3766,22707,1621.928571,251.0666667,6.029474243
NM_018049,PLEKHJ1,6,5,3175,1221,1954,390.8,203.5,1.6003276
NM_001101391,LINGO3,2,1,18384,2132,16252,16252,1066,7.622889306
NM_001077238,SPPL2B,15,14,26473,3829,22644,1617.428571,255.2666667,5.913815618
NM_144616,JSRP1,7,6,4174,1152,3022,503.6666667,164.5714286,2.623263889
NM_000479,AMH,5,4,2961,2023,938,234.5,404.6,0.46366782
NM_004152,OAZ1,5,4,3969,1151,2818,704.5,230.2,2.448305821
NM_182973,TMPRSS9,17,16,36304,3197,33107,2069.1875,188.0588235,10.35564592
NM_012458,TIMM13,3,2,2294,1998,296,148,666,0.148148148
NM_015675,GADD45B,4,3,2136,1379,757,252.3333333,344.75,0.548948513
NM_032737,LMNB2,12,11,28805,4656,24149,2195.363636,388,5.186640893
NM_145173,DIRAS1,2,1,6827,3400,3427,3427,1700,1.007941176
NM_144564,SLC39A3,3,2,7553,1428,6125,3062.5,476,4.289215686
NM_213568,SLC39A3,2,1,5552,2988,2564,2564,1494,0.858099063
NM_024967,ZNF556,4,3,11170,1636,9534,3178,409,5.827628362
NM_003021,SGTA,12,11,28644,2327,26317,2392.454545,193.9166667,11.30941126
NM_001172775,ZNF555,4,3,19041,8548,10493,3497.666667,2137,1.227538606
NM_152791,ZNF555,4,3,19041,8551,10490,3496.666667,2137.75,1.226757104
NM_003249,THOP1,13,12,28095,2563,25532,2127.666667,197.1538462,9.961763558
NM_001102651,ZNF554,5,4,16863,3703,13160,3290,740.6,3.553875236
NM_021217,ZNF77,4,3,11755,2044,9711,3237,511,4.750978474
NM_173480,ZNF57,4,3,17580,2007,15573,5191,501.75,7.759342302
NM_001143986,TLE6,17,16,17648,2025,15623,976.4375,119.1176471,7.715061728
NM_024760,TLE6,16,15,17648,1946,15702,1046.8,121.625,8.068859198
NM_198969,AES,7,6,10058,1750,8308,1384.666667,250,4.747428571
NM_198970,AES,7,6,9465,1680,7785,1297.5,240,4.633928571
NM_002067,GNA11,7,6,29594,4152,25442,4240.333333,593.1428571,6.127649326
NM_001130,AES,7,6,9465,1683,7782,1297,240.4285714,4.623885918
NM_020170,NCLN,15,14,23700,3748,19952,1425.142857,249.8666667,5.323372465
NM_003775,S1PR4,1,0,1596,1596,NA,NA,1596,NA
NM_016263,FZR1,14,13,30462,3629,26833,2064.076923,259.2142857,7.394047947
NM_031304,DOHH,5,4,9804,1748,8056,2014,349.6,4.608695652
NM_001136198,FZR1,13,12,13803,3459,10344,862,266.0769231,2.99045967
NM_001136197,FZR1,11,10,13803,3181,10622,1062.2,289.1818182,3.339201509
NM_001136503,C19orf77,4,3,6137,912,5225,1741.666667,228,5.729166667
NM_001145165,DOHH,5,4,10121,2037,8084,2021,407.4,3.968581247
NM_001135580,C19orf71,4,3,4875,675,4200,1400,168.75,6.222222222
NM_006339,HMG20B,10,9,6140,1594,4546,505.1111111,159.4,2.851944793
NM_201636,TBXA2R,4,3,12329,1945,10384,3461.333333,486.25,5.338817481
NM_021231,CACTIN,11,10,16172,2687,13485,1348.5,244.2727273,5.018608113
NM_001287529,MFSD12,10,9,13387,2118,11269,1252.111111,211.8,5.320585458
NM_133261,GIPC3,6,5,7972,4323,3649,729.8,720.5,0.844089752
NM_001060,TBXA2R,3,2,12329,2604,9725,4862.5,868,3.734639017
NM_001080543,CACTIN,10,9,16188,3634,12554,1394.888889,363.4,3.454595487
NM_174983,MFSD12,10,9,13387,2145,11242,1249.111111,214.5,5.241025641
NM_172251,MRPL54,3,2,4900,626,4274,2137,208.6666667,6.827476038
NM_001267560,TJP3,21,20,42478,3144,39334,1966.7,149.7142857,12.51081425
NM_001267561,TJP3,21,20,29116,3131,25985,1299.25,149.0952381,8.29926541
NM_032753,RAX2,3,2,3132,2156,976,488,718.6666667,0.452690167
NM_139355,MATK,14,13,8450,2152,6298,484.4615385,153.7142857,2.926579926
NM_139354,MATK,13,12,8450,1928,6522,543.5,148.3076923,3.382780083
NM_004886,APBA3,11,10,10904,2169,8735,873.5,197.1818182,4.027201475
NM_033064,ATCAY,13,12,47464,5049,42415,3534.583333,388.3846154,8.400673401
NM_001145640,ZFR2,2,1,17218,869,16349,16349,434.5,18.81357883
NM_015174,ZFR2,19,18,65007,4776,60231,3346.166667,251.3684211,12.6111809
NM_001961,EEF2,15,14,9409,3173,6236,445.4285714,211.5333333,1.965332493
NM_170678,NMRK2,8,7,9315,1134,8181,1168.714286,141.75,7.214285714
NM_001348,DAPK3,8,7,11376,2113,9263,1323.285714,264.125,4.383814482
NM_015897,PIAS4,11,10,30320,1748,28572,2857.2,158.9090909,16.34553776
NM_001289117,NMRK2,8,7,9315,1149,8166,1166.571429,143.625,7.107049608
NM_001271997,CREB3L3,9,8,19455,2520,16935,2116.875,280,6.720238095
NM_001271996,CREB3L3,10,9,19455,2622,16833,1870.333333,262.2,6.419908467
NM_001271995,CREB3L3,10,9,19455,2625,16830,1870,262.5,6.411428571
NM_001193285,SIRT6,7,6,8492,1562,6930,1155,223.1428571,4.436619718
NM_032607,CREB3L3,10,9,19455,2628,16827,1869.666667,262.8,6.402968037
NM_016539,SIRT6,8,7,8492,1644,6848,978.2857143,205.5,4.165450122
NM_030662,MAP2K2,11,10,33808,1744,32064,3206.4,158.5454545,18.3853211
NM_024333,FSD1,13,12,19254,1860,17394,1449.5,143.0769231,9.351612903
NM_001169126,TMIGD2,5,4,10205,1259,8946,2236.5,251.8,7.105639396
NM_005755,EBI3,5,4,7986,1142,6844,1711,228.4,5.992994746
NM_018074,CCDC94,8,7,21976,1405,20571,2938.714286,175.625,14.64128114
NM_020209,SHD,6,5,12124,2582,9542,1908.4,430.3333333,3.695584818
NM_144615,TMIGD2,5,4,10205,1271,8934,2233.5,254.2,7.029110936
NM_001159846,MPND,11,10,16561,1518,15043,1504.3,138,9.909749671
NM_001199944,SH3GL1,10,9,40053,2208,37845,4205,220.8,17.13994565
NM_032868,MPND,12,11,16561,1579,14982,1362,131.5833333,9.488283724
NM_001171091,UBXN6,11,10,10294,1824,8470,847,165.8181818,4.643640351
NM_001199943,SH3GL1,9,8,40203,2405,37798,4724.75,267.2222222,15.71642412
NM_003025,SH3GL1,10,9,40203,2550,37653,4183.666667,255,14.76588235
NM_005483,CHAF1A,15,14,40736,3358,37378,2669.857143,223.8666667,11.13103038
NM_001013706,PLIN5,8,7,12666,2449,10217,1459.571429,306.125,4.171906901
NM_001080400,PLIN4,6,5,15526,6359,9167,1833.4,1059.833333,1.441578865
NM_032631,HDGFRP2,17,16,29969,2323,27646,1727.875,136.6470588,11.9009901
NM_032108,SEMA6B,17,16,17173,3959,13214,825.875,232.8823529,3.337711543
NM_052972,LRG1,2,1,2811,1782,1029,1029,891,0.577441077
NM_001001520,HDGFRP2,17,16,29969,2326,27643,1727.6875,136.8235294,11.88435082
NM_001242901,AC005594.3,3,2,6668,3074,3594,1797,1024.666667,1.169160703
NM_152362,TNFAIP8L1,2,1,16055,3819,12236,12236,1909.5,3.2039801
NM_019107,C19orf10,6,5,12860,1057,11803,2360.6,176.1666667,11.16650899
NM_001167942,TNFAIP8L1,2,1,15553,3847,11706,11706,1923.5,3.042890564
NM_018708,FEM1A,1,0,3845,3845,NA,NA,3845,NA
NM_182919,TICAM1,2,1,15820,2724,13096,13096,1362,4.80763583
NM_013282,UHRF1,16,15,51601,4080,47521,3168.066667,255,11.64730392
NM_001048201,UHRF1,17,16,52657,3917,48740,3046.25,230.4117647,12.44319632
NM_001080523,ARRDC5,3,2,12432,1641,10791,5395.5,547,6.575868373
NM_181710,ZNRF4,1,0,1443,1443,NA,NA,1443,NA
NM_014649,SAFB2,21,20,35930,3339,32591,1629.55,159,9.760706798
NM_198708,HSD11B1L,7,6,7760,1855,5905,984.1666667,265,3.18328841
NM_198707,HSD11B1L,7,6,7760,1904,5856,976,272,3.075630252
NM_198706,HSD11B1L,8,7,7760,1968,5792,827.4285714,246,2.943089431
NM_198705,HSD11B1L,6,5,7760,1723,6037,1207.4,287.1666667,3.50377249
NM_198704,HSD11B1L,6,5,7760,1628,6132,1226.4,271.3333333,3.766584767
NM_015414,RPL36,3,2,1334,540,794,397,180,1.47037037
NM_198533,HSD11B1L,8,7,7760,1805,5955,850.7142857,225.625,3.299168975
NM_033643,RPL36,4,3,1408,437,971,323.6666667,109.25,2.221967963
NM_205767,C19orf70,4,3,2480,904,1576,525.3333333,226,1.743362832
NM_001267868,HSD11B1L,9,8,7760,2107,5653,706.625,234.1111111,2.682961557
NM_001267871,HSD11B1L,6,5,7760,1560,6200,1240,260,3.974358974
NM_001267870,HSD11B1L,5,4,7760,1630,6130,1532.5,326,3.760736196
NM_001267869,HSD11B1L,6,5,7760,1791,5969,1193.8,298.5,3.332774986
NM_001276480,LONP1,18,17,28620,2901,25719,1512.882353,161.1666667,8.865563599
NM_001276479,LONP1,19,18,28333,2938,25395,1410.833333,154.6315789,8.643635126
NM_004793,LONP1,18,17,28426,3222,25204,1482.588235,179,7.822470515
NM_001161619,DUS3L,12,11,6098,1397,4701,427.3636364,116.4166667,3.365068003
NM_004558,NRTN,2,1,4519,1106,3413,3413,553,3.085895118
NM_001097641,FUT3,2,1,8588,2051,6537,6537,1025.5,3.187225744
NM_001134316,PRR22,3,2,1807,1395,412,206,465,0.295340502
NM_000149,FUT3,3,2,8588,2593,5995,2997.5,864.3333333,2.31199383
NM_000150,FUT6,3,2,9107,3140,5967,2983.5,1046.666667,1.900318471
NM_001040701,FUT6,2,1,9107,3011,6096,6096,1505.5,2.024576553
NM_002034,FUT5,2,1,4716,1990,2726,2726,995,1.369849246
NM_001097640,FUT3,3,2,8588,2191,6397,3198.5,730.3333333,2.919671383
NM_001097639,FUT3,3,2,8588,2245,6343,3171.5,748.3333333,2.825389755
NM_020175,DUS3L,13,12,6098,2124,3974,331.1666667,163.3846154,1.870998117
NM_007322,RANBP3,17,16,62170,3417,58753,3672.0625,201,17.19432251
NM_007320,RANBP3,16,15,62170,3212,58958,3930.533333,200.75,18.35554172
NM_080590,CAPS,5,4,2031,1533,498,124.5,306.6,0.324853229
NM_001017921,VMAC,2,1,5413,1672,3741,3741,836,2.237440191
NM_004058,CAPS,5,4,2031,1614,417,104.25,322.8,0.258364312
NM_003624,RANBP3,17,16,62170,3402,58768,3673,200.1176471,17.27454439
NM_005934,MLLT1,12,11,69569,4517,65052,5913.818182,376.4166667,14.40159398
NM_133492,ACER1,6,5,27132,1094,26038,5207.6,182.3333333,23.80073126
NM_032306,ALKBH7,4,3,2819,1335,1484,494.6666667,333.75,1.111610487
NM_006012,CLPP,6,5,7454,1157,6297,1259.4,192.8333333,5.442523768
NM_004158,PSPN,2,1,557,473,84,84,236.5,0.177589852
NM_002096,GTF2F1,13,12,13713,2564,11149,929.0833333,197.2307692,4.348283931
NM_024898,DENND1C,23,22,14582,2818,11764,534.7272727,122.5217391,4.174591909
NM_024103,SLC25A23,10,9,19708,3470,16238,1804.222222,347,4.679538905
NM_001289131,TUBB4A,4,3,8267,2480,5787,1929,620,2.333467742
NM_001289130,TUBB4A,4,3,8267,2513,5754,1918,628.25,2.289693593
NM_001289129,TUBB4A,5,4,8531,2405,6126,1531.5,481,2.547193347
NM_006087,TUBB4A,4,3,8267,2556,5711,1903.666667,639,2.234350548
NM_139161,CRB3,4,3,2972,1110,1862,620.6666667,277.5,1.677477477
NM_003811,TNFSF9,3,2,4931,1668,3263,1631.5,556,1.956235012
NM_174881,CRB3,5,4,2972,770,2202,550.5,154,2.85974026
NM_173637,SLC25A41,7,6,7744,1558,6186,1031,222.5714286,3.970474968
NM_001289127,TUBB4A,5,4,8531,2457,6074,1518.5,491.4,2.472120472
NM_001289123,TUBB4A,5,4,8531,2475,6056,1514,495,2.446868687
NM_003807,TNFSF14,5,4,7453,2899,4554,1138.5,579.8,1.570886513
NM_172014,TNFSF14,5,4,7453,2791,4662,1165.5,558.2,1.670369043
NM_001252,CD70,3,2,5315,916,4399,2199.5,305.3333333,4.802401747
NM_001080452,GPR108,18,17,7710,2094,5616,330.3529412,116.3333333,2.681948424
NM_005490,SH2D3A,10,9,15352,2366,12986,1442.888889,236.6,5.488588335
NM_001288962,TRIP10,15,14,11846,2216,9630,687.8571429,147.7333333,4.34566787
NM_001288963,TRIP10,14,13,11846,2076,9770,751.5384615,148.2857143,4.706165703
NM_004240,TRIP10,14,13,11846,2047,9799,753.7692308,146.2142857,4.787005374
NM_001256255,EMR1,18,17,52906,2632,50274,2957.294118,146.2222222,19.10106383
NM_001256254,EMR1,18,17,52906,2740,50166,2950.941176,152.2222222,18.30875912
NM_001256253,EMR1,20,19,52906,2970,49936,2628.210526,148.5,16.81346801
NM_001256252,EMR1,20,19,52906,3108,49798,2620.947368,155.4,16.02252252
NM_001974,EMR1,21,20,52906,3166,49740,2487,150.7619048,15.71067593
NM_001164425,MBD3L3,2,1,2431,775,1656,1656,387.5,2.136774194
NM_144614,MBD3L2,2,1,2397,776,1621,1621,388,2.088917526
NM_001136507,MBD3L5,2,1,2430,775,1655,1655,387.5,2.135483871
NM_001164419,MBD3L4,2,1,2431,775,1656,1656,387.5,2.136774194
NM_001130955,ARHGEF18,20,19,32799,5761,27038,1423.052632,288.05,4.693282416
NM_198534,C19orf45,9,8,10893,1688,9205,1150.625,187.5555556,5.453199052
NM_018083,ZNF358,2,1,4909,1955,2954,2954,977.5,1.510997442
NM_080662,PEX11G,5,4,12170,1091,11079,2769.75,218.2,10.15490376
NM_020533,MCOLN1,14,13,11401,2112,9289,714.5384615,150.8571429,4.398200758
NM_001270539,PEX11G,5,4,12170,908,11262,2815.5,181.6,12.4030837
NM_001127396,STXBP2,19,18,10775,1905,8870,492.7777778,100.2631579,4.656167979
NM_001080429,CAMSAP3,19,18,22410,4204,18206,1011.444444,221.2631579,4.330637488
NM_001171155,PET100,4,3,1841,343,1498,499.3333333,85.75,4.367346939
NM_006949,STXBP2,19,18,10775,1914,8861,492.2777778,100.7368421,4.629571578
NM_001271830,PCP2,4,3,1399,498,901,300.3333333,124.5,1.809236948
NM_020902,CAMSAP3,17,16,22410,4121,18289,1143.0625,242.4117647,4.438000485
NM_020196,XAB2,19,18,10030,2674,7356,408.6666667,140.7368421,2.750934929
NM_001272034,STXBP2,19,18,10775,1947,8828,490.4444444,102.4736842,4.53415511
NM_174895,PCP2,4,3,2135,780,1355,451.6666667,195,1.737179487
NM_001042461,TRAPPC5,2,1,2043,829,1214,1214,414.5,1.464414958
NM_002002,FCER2,11,10,13391,1626,11765,1176.5,147.8181818,7.235547355
NM_001220500,FCER2,11,10,13391,1630,11761,1176.1,148.1818182,7.215337423
NM_021155,CD209,7,6,7585,4333,3252,542,619,0.750519271
NM_001144899,CD209,7,6,7585,3850,3735,622.5,550,0.97012987
NM_001144908,CLEC4M,6,5,6458,1552,4906,981.2,258.6666667,3.161082474
NM_001144907,CLEC4M,6,5,6458,1740,4718,943.6,290,2.711494253
NM_001144897,CD209,7,6,7585,4315,3270,545,616.4285714,0.757821553
NM_001144906,CLEC4M,6,5,6458,1533,4925,985,255.5,3.212654925
NM_001144896,CD209,6,5,7585,4260,3325,665,710,0.780516432
NM_001144895,CD209,7,6,7585,4057,3528,588,579.5714286,0.869608085
NM_001144894,CD209,5,4,7585,4199,3386,846.5,839.8,0.806382472
NM_001144893,CD209,5,4,7585,3923,3662,915.5,784.6,0.933469284
NM_001042462,TRAPPC5,2,1,2043,681,1362,1362,340.5,2
NM_198492,CLEC4G,9,8,3216,1369,1847,230.875,152.1111111,1.349159971
NM_001193374,RETN,4,3,1370,473,897,299,118.25,1.89640592
NM_001244856,CLEC4G,9,8,3216,1333,1883,235.375,148.1111111,1.412603151
NM_001207019,FCER2,10,9,10724,1493,9231,1025.666667,149.3,6.182853315
NM_020415,RETN,4,3,1370,482,888,296,120.5,1.842323651
NM_001144911,CLEC4M,5,4,6458,1743,4715,1178.75,348.6,2.705106139
NM_001144909,CLEC4M,8,7,6458,1805,4653,664.7142857,225.625,2.577839335
NM_001144910,CLEC4M,8,7,6458,1874,4584,654.8571429,234.25,2.446104589
NM_014257,CLEC4M,7,6,6458,1942,4516,752.6666667,277.4285714,2.325437693
NM_001144905,CLEC4M,8,7,6458,1871,4587,655.2857143,233.875,2.451630144
NM_001144904,CLEC4M,7,6,6458,1789,4669,778.1666667,255.5714286,2.609837898
NM_174918,C19orf59,7,6,2778,1315,1463,243.8333333,187.8571429,1.112547529
NM_174894,TRAPPC5,2,1,2043,852,1191,1191,426,1.397887324
NM_003083,SNAPC2,5,4,2944,1555,1389,347.25,311,0.893247588
NM_145185,MAP2K7,11,10,10600,3383,7217,721.7,307.5454545,2.133313627
NM_001159944,EVI5L,19,18,18478,3754,14724,818,197.5789474,3.922216303
NM_001268284,LRRC8E,4,3,13520,3749,9771,3257,937.25,2.606295012
NM_001268285,LRRC8E,2,1,13520,3461,10059,10059,1730.5,2.906385438
NM_206833,CTXN1,2,1,1672,1265,407,407,632.5,0.32173913
NM_025061,LRRC8E,3,2,13520,3605,9915,4957.5,1201.666667,2.750346741
NM_001190467,FLJ22184,6,5,5723,4523,1200,240,753.8333333,0.265310635
NM_145245,EVI5L,19,18,34703,3832,30871,1715.055556,201.6842105,8.056106472
NM_001195259,TGFBR3L,6,5,2950,1262,1688,337.6,210.3333333,1.337559429
NM_001419,ELAVL1,6,5,47074,6064,41010,8202,1010.666667,6.762862797
NM_032447,FBN3,63,62,82100,9030,73070,1178.548387,143.3333333,8.091915836
NM_024552,CERS4,12,11,53089,1828,51261,4660.090909,152.3333333,28.04212254
NM_001165895,CD320,4,3,6231,1129,5102,1700.666667,282.25,4.519043401
NM_001031,RPS28,4,3,898,386,512,170.6666667,96.5,1.32642487
NM_016579,CD320,5,4,6231,1256,4975,1243.75,251.2,3.960987261
NM_005001,NDUFA7,4,3,10098,589,9509,3169.666667,147.25,16.14431239
NM_016496,Mar-02,6,5,25714,1657,24057,4811.4,276.1666667,14.51840676
NM_001039667,ANGPTL4,6,5,10250,1797,8453,1690.6,299.5,4.703951029
NM_001005416,Mar-02,4,3,25714,1174,24540,8180,293.5,20.90289608
NM_001005415,Mar-02,5,4,25714,1385,24329,6082.25,277,17.56606498
NM_139314,ANGPTL4,7,6,10250,1912,8338,1389.666667,273.1428571,4.360878661
NM_004218,RAB11B,5,4,14114,1633,12481,3120.25,326.6,7.642988365
NM_032152,PRAM1,10,9,12600,2219,10381,1153.444444,221.9,4.678233438
NM_032370,ZNF414,6,5,2834,1203,1631,326.2,200.5,1.355777224
NM_001146175,ZNF414,8,7,3588,1412,2176,310.8571429,176.5,1.541076487
NM_012335,MYO1F,28,27,56659,4201,52458,1942.888889,150.0357143,12.4870269
NM_178525,ACTL9,1,0,1435,1435,NA,NA,1435,NA
NM_001004699,OR2Z1,1,0,1057,1057,NA,NA,1057,NA
NM_145208,MBD3L1,1,0,749,749,NA,NA,749,NA
NM_144693,ZNF558,6,5,13185,3020,10165,2033,503.3333333,3.36589404
NM_001190791,ZNF317,6,5,23037,3985,19052,3810.4,664.1666667,4.780928482
NM_020933,ZNF317,7,6,23037,4082,18955,3159.166667,583.1428571,4.64355708
NM_175883,OR7D2,1,0,3225,3225,NA,NA,3225,NA
NM_001005193,OR7G2,1,0,1039,1039,NA,NA,1039,NA
NM_001005192,OR7G1,1,0,937,937,NA,NA,937,NA
NM_001004456,OR1M1,1,0,943,943,NA,NA,943,NA
NM_001001958,OR7G3,1,0,940,940,NA,NA,940,NA
NM_198535,ZNF699,5,4,9811,2099,7712,1928,419.8,3.674130538
NM_001079935,OR7E24,1,0,1021,1021,NA,NA,1021,NA
NM_001005191,OR7D4,1,0,1023,1023,NA,NA,1023,NA
NM_006631,ZNF266,11,10,23154,3801,19353,1935.3,345.5454545,5.091554854
NM_003451,ZNF177,9,8,19599,2271,17328,2166,252.3333333,7.63011889
NM_001172651,ZNF177,6,5,6303,2453,3850,770,408.8333333,1.569506726
NM_001271314,ZNF266,11,10,23154,3750,19404,1940.4,340.9090909,5.1744
NM_001008727,ZNF121,4,3,18919,1733,17186,5728.666667,433.25,9.916907098
NM_024106,ZNF426,8,7,10624,2312,8312,1187.428571,289,3.595155709
NM_152476,ZNF560,10,9,32250,2812,29438,3270.888889,281.2,10.46870555
NM_017656,ZNF562,4,3,26440,5572,20868,6956,1393,3.745154343
NM_001242812,C19orf82,4,3,13382,1838,11544,3848,459.5,6.280739935
NM_001130031,ZNF562,6,5,26440,5790,20650,4130,965,3.566493955
NM_001199814,ZNF812,6,5,10681,2017,8664,1732.8,336.1666667,4.295488349
NM_152289,ZNF561,6,5,13916,4546,9370,1874,757.6666667,2.061152662
NM_001130032,ZNF562,6,5,26440,5737,20703,4140.6,956.1666667,3.608680495
NM_001048241,UBL5,5,4,2243,456,1787,446.75,91.2,3.918859649
NM_024292,UBL5,5,4,2231,524,1707,426.75,104.8,3.257633588
NM_017703,FBXL12,3,2,8790,1855,6935,3467.5,618.3333333,3.738544474
NM_001077624,ZNF846,6,5,11261,2139,9122,1824.4,356.5,4.264609631
NM_006221,PIN1,4,3,14484,1124,13360,4453.333333,281,11.886121
NM_058164,OLFM2,6,5,82678,1867,80811,16162.2,311.1666667,43.28387788
NM_018381,C19orf66,8,7,7124,2132,4992,713.1428571,266.5,2.341463415
NM_031917,ANGPTL6,6,5,10414,1863,8551,1710.2,310.5,4.589908749
NM_015725,RDH8,6,5,9031,1720,7311,1462.2,286.6666667,4.250581395
NM_020230,PPAN,12,11,5078,1740,3338,303.4545455,145,1.918390805
NM_001379,DNMT1,40,39,61735,5392,56343,1444.692308,134.8,10.44936944
NM_003755,EIF3G,11,10,4911,1138,3773,377.3,103.4545455,3.315465729
NM_001130823,DNMT1,41,40,61735,5441,56294,1407.35,132.7073171,10.34625988
NM_004230,S1PR2,2,1,9841,3586,6255,6255,1793,1.744283324
NM_001031734,FDX1L,5,4,5802,847,4955,1238.75,169.4,5.850059032
NM_002162,ICAM3,7,6,5895,1787,4108,684.6666667,255.2857143,2.298824846
NM_015956,MRPL4,9,8,8083,1467,6616,827,163,4.509884117
NM_133452,RAVER1,13,12,17427,3605,13822,1151.833333,277.3076923,3.834119279
NM_022377,ICAM4,2,1,1619,1491,128,128,745.5,0.085848424
NM_001039132,ICAM4,3,2,1619,1268,351,175.5,422.6666667,0.27681388
NM_146388,MRPL4,8,7,8098,2412,5686,812.2857143,301.5,2.357379768
NM_000201,ICAM1,7,6,15776,3253,12523,2087.166667,464.7142857,3.849677221
NM_146387,MRPL4,10,9,8083,1332,6751,750.1111111,133.2,5.068318318
NM_003259,ICAM5,11,10,6801,3013,3788,378.8,273.9090909,1.257218719
NM_001544,ICAM4,3,2,1619,1345,274,137,448.3333333,0.203717472
NM_001103167,ZGLP1,4,3,4756,1984,2772,924,496,1.397177419
NM_007065,CDC37,8,7,12464,1679,10785,1540.714286,209.875,6.423466349
NM_012289,KEAP1,6,5,16687,2569,14118,2823.6,428.1666667,5.49552355
NM_001243121,PDE4A,17,16,52860,4706,48154,3009.625,276.8235294,10.23246919
NM_001111308,PDE4A,15,14,38788,4608,34180,2441.428571,307.2,7.417534722
NM_001111307,PDE4A,15,14,48976,4794,44182,3155.857143,319.6,9.216103463
NM_006202,PDE4A,10,9,16676,4271,12405,1378.333333,427.1,2.904472021
NM_203500,KEAP1,6,5,17260,2598,14662,2932.4,433,5.643571978
NM_001111309,PDE4A,15,14,37198,4503,32695,2335.357143,300.2,7.260715079
NM_005498,AP1M2,12,11,14646,1763,12883,1171.181818,146.9166667,7.307430516
NM_030760,S1PR5,2,1,4710,2343,2367,2367,1171.5,1.010243278
NM_023008,KRI1,19,18,12943,3024,9919,551.0555556,159.1578947,3.280092593
NM_001281504,ATG4D,10,9,9531,2062,7469,829.8888889,206.2,3.622211445
NM_032885,ATG4D,10,9,9531,1988,7543,838.1111111,198.8,3.794265594
NM_001800,CDKN2D,2,1,2495,1401,1094,1094,700.5,0.780870807
NM_079421,CDKN2D,3,2,2519,1148,1371,685.5,382.6666667,1.194250871
NM_001166215,S1PR5,2,1,5252,2459,2793,2793,1229.5,1.135827572
NM_031209,QTRT1,10,9,11933,1344,10589,1176.555556,134.4,7.878720238
NM_012218,ILF3,20,19,38160,6129,32031,1685.842105,306.45,5.226138032
NM_001137673,ILF3,18,17,31508,3758,27750,1632.352941,208.7777778,7.38424694
NM_017620,ILF3,20,19,38160,6141,32019,1685.210526,307.05,5.213971666
NM_004516,ILF3,18,17,31508,3746,27762,1633.058824,208.1111111,7.411105179
NM_153464,ILF3,18,17,31508,3303,28205,1659.117647,183.5,8.539206782
NM_001136482,C19orf38,7,6,21256,1096,20160,3360,156.5714286,18.39416058
NM_006858,TMED1,4,3,4242,1732,2510,836.6666667,433,1.449191686
NM_138358,C19orf52,2,1,1494,1398,96,96,699,0.068669528
NM_024029,YIPF2,10,9,5915,1514,4401,489,151.4,2.906869221
NM_000527,LDLR,18,17,44469,5301,39168,2304,294.5,7.388794567
NM_001195798,LDLR,18,17,44469,5295,39174,2304.352941,294.1666667,7.398300283
NM_001195803,LDLR,16,15,44469,4765,39704,2646.933333,297.8125,8.332423924
NM_001195799,LDLR,17,16,44469,5177,39292,2455.75,304.5294118,7.589723778
NM_001195800,LDLR,16,15,44469,4795,39674,2644.933333,299.6875,8.274035454
NM_182513,SPC24,5,4,8655,659,7996,1999,131.8,12.13353566
NM_015493,KANK2,11,10,30325,4961,25364,2536.4,451,5.112678895
NM_018687,C19orf80,4,3,2326,876,1450,483.3333333,219,1.655251142
NM_020812,DOCK6,48,47,63201,6448,56753,1207.510638,134.3333333,8.801643921
NM_001136191,KANK2,13,12,33302,5221,28081,2340.083333,401.6153846,5.378471557
NM_001161616,RGL3,19,18,25288,2580,22708,1261.555556,135.7894737,8.801550388
NM_001145416,TMEM205,4,3,3531,801,2730,910,200.25,3.4082397
NM_198536,TMEM205,3,2,3531,1298,2233,1116.5,432.6666667,1.720338983
NM_000121,EPOR,8,7,7139,2449,4690,670,306.125,1.915067374
NM_012466,TSPAN16,7,6,30859,1056,29803,4967.166667,150.8571429,28.22253788
NM_022737,LPPR2,10,9,10314,2737,7577,841.8888889,273.7,2.768359518
NM_033408,TMEM205,4,3,3531,920,2611,870.3333333,230,2.838043478
NM_001282509,TSPAN16,7,6,19832,1032,18800,3133.333333,147.4285714,18.21705426
NM_001080503,CCDC159,11,10,8441,1074,7367,736.7,97.63636364,6.859404097
NM_001170635,LPPR2,10,9,10314,2678,7636,848.4444444,267.8,2.851381628
NM_001035223,RGL3,19,18,25288,2562,22726,1262.555556,134.8421053,8.870413739
NM_001282510,TSPAN16,6,5,19832,956,18876,3775.2,159.3333333,19.74476987
NM_004283,RAB3D,5,4,17624,4278,13346,3336.5,855.6,3.119682094
NM_175871,SWSAP1,2,1,2246,1664,582,582,832,0.349759615
NM_001001329,PRKCSH,18,17,15706,2461,13245,779.1176471,136.7222222,5.381958553
NM_001289102,PRKCSH,17,16,15223,2311,12912,807,135.9411765,5.587191692
NM_002743,PRKCSH,18,17,15318,2082,13236,778.5882353,115.6666667,6.357348703
NM_001243204,ECSIT,8,7,22951,1595,21356,3050.857143,199.375,13.38934169
NM_032281,ELAVL3,7,6,29662,4668,24994,4165.666667,666.8571429,5.354327335
NM_001142465,ECSIT,6,5,23258,1062,22196,4439.2,177,20.90018832
NM_001142464,ECSIT,7,6,23258,1556,21702,3617,222.2857143,13.94730077
NM_016581,ECSIT,8,7,23258,1706,21552,3078.857143,213.25,12.63305979
NM_001299,CNN1,7,6,11561,1593,9968,1661.333333,227.5714286,6.25737602
NM_001420,ELAVL3,7,6,29662,4689,24973,4162.166667,669.8571429,5.325869055
NM_138783,ZNF653,9,8,22498,2249,20249,2531.125,249.8888889,9.003557137
NM_001289103,PRKCSH,18,17,15706,2495,13211,777.1176471,138.6111111,5.29498998
NM_001289104,PRKCSH,18,17,15706,2491,13215,777.3529412,138.3888889,5.305098354
NM_001111036,ACP5,6,5,4328,1564,2764,552.8,260.6666667,1.767263427
NM_001111035,ACP5,7,6,4328,1638,2690,448.3333333,234,1.642246642
NM_001111034,ACP5,6,5,4119,1614,2505,501,269,1.55204461
NM_145295,ZNF627,4,3,21741,2868,18873,6291,717,6.580543933
NM_001611,ACP5,5,4,3080,1479,1601,400.25,295.8,1.082488168
NM_001080493,ZNF823,4,3,17682,2399,15283,5094.333333,599.75,6.370571071
NM_152356,ZNF491,3,2,9917,2826,7091,3545.5,942,2.509200283
NM_152355,ZNF441,4,3,17080,4452,12628,4209.333333,1113,2.836477987
NM_152262,ZNF439,3,2,3464,2553,911,455.5,851,0.356835096
NM_021915,ZNF69,5,4,26697,1664,25033,6258.25,332.8,15.04387019
NM_001080411,ZNF433,4,3,20995,2325,18670,6223.333333,581.25,8.030107527
NM_001012753,ZNF763,4,3,15331,2627,12704,4234.666667,656.75,4.835934526
NM_001136501,ZNF844,4,3,13082,2838,10244,3414.666667,709.5,3.609584214
NM_001080404,ZNF878,4,3,9164,1766,7398,2466,441.5,4.189127973
NM_021143,ZNF20,4,3,9056,3062,5994,1998,765.5,1.957544089
NM_003437,ZNF136,4,3,26194,3022,23172,7724,755.5,7.667769689
NM_145233,ZNF625,4,3,11839,1699,10140,3380,424.75,5.968216598
NM_001203250,ZNF20,4,3,9056,3053,6003,2001,763.25,1.966262692
NM_001164276,ZNF44,5,4,23091,2799,20292,5073,559.8,7.249732047
NM_016264,ZNF44,4,3,23091,2654,20437,6812.333333,663.5,7.700452148
NM_145276,ZNF563,4,3,16232,2777,13455,4485,694.25,4.845156644
NM_005815,ZNF443,4,3,11408,2668,8740,2913.333333,667,3.275862069
NM_030824,ZNF442,6,5,16292,2831,13461,2692.2,471.8333333,4.754856941
NM_001080821,ZNF799,4,3,11262,2592,8670,2890,648,3.344907407
NM_144976,ZNF564,4,3,26174,2952,23222,7740.666667,738,7.866531165
NM_016145,WDR83OS,4,3,1586,865,721,240.3333333,216.25,0.833526012
NM_001173498,MAN2B1,24,23,20271,3245,17026,740.2608696,135.2083333,5.246841294
NM_001099737,WDR83,11,10,9030,1464,7566,756.6,133.0909091,5.168032787
NM_000528,MAN2B1,24,23,20271,3248,17023,740.1304348,135.3333333,5.241071429
NM_032332,WDR83,9,8,6131,1205,4926,615.75,133.8888889,4.087966805
NM_032301,FBXW9,10,9,7727,1747,5980,664.4444444,174.7,3.423010876
NM_013433,TNPO2,25,24,23099,4930,18169,757.0416667,197.2,3.685395538
NM_013406,DHPS,8,7,6172,1219,4953,707.5714286,152.375,4.06316653
NM_001206974,DHPS,9,8,5496,1212,4284,535.5,134.6666667,3.534653465
NM_001930,DHPS,9,8,6172,1361,4811,601.375,151.2222222,3.534900808
NM_001136196,TNPO2,25,24,23456,4974,18482,770.0833333,198.96,3.715721753
NM_001136195,TNPO2,26,25,24804,5118,19686,787.44,196.8461538,3.846424385
NM_153358,ZNF791,4,3,18946,2499,16447,5482.333333,624.75,6.581432573
NM_005809,PRDX2,6,5,5092,1044,4048,809.6,174,3.877394636
NM_001270445,RTBDN,6,5,5200,989,4211,842.2,164.8333333,4.257836198
NM_001270440,RTBDN,7,6,9953,2085,7868,1311.333333,297.8571429,3.773621103
NM_031429,RTBDN,7,6,9953,1352,8601,1433.5,193.1428571,6.361686391
NM_013312,HOOK2,23,22,12619,2633,9986,453.9090909,114.4782609,3.792631979
NM_017682,BEST2,9,8,5866,1919,3947,493.375,213.2222222,2.056800417
NM_002229,JUNB,1,0,1817,1817,NA,NA,1817,NA
NM_001100176,HOOK2,22,21,12619,2626,9993,475.8571429,119.3636364,3.805407464
NM_001270442,RTBDN,6,5,9101,1019,8082,1616.4,169.8333333,7.931305201
NM_001270443,RTBDN,6,5,5200,1007,4193,838.6,167.8333333,4.163853029
NM_001270444,RTBDN,6,5,5200,995,4205,841,165.8333333,4.226130653
NM_001270441,RTBDN,6,5,9101,1031,8070,1614,171.8333333,7.827352085
NM_001080997,RTBDN,6,5,4941,1078,3863,772.6,179.6666667,3.583487941
NM_006397,RNASEH2A,8,7,7036,1150,5886,840.8571429,143.75,5.11826087
NM_004317,ASNA1,7,6,10833,1287,9546,1591,183.8571429,7.417249417
NM_004343,CALR,9,8,5892,1920,3972,496.5,213.3333333,2.06875
NM_000159,GCDH,12,11,8872,1895,6977,634.2727273,157.9166667,3.681794195
NM_052850,GADD45GIP1,2,1,3100,765,2335,2335,382.5,3.052287582
NM_001270363,RAD23A,8,7,7831,1664,6167,881,208,3.706129808
NM_001270362,RAD23A,9,8,7831,1827,6004,750.5,203,3.286261631
NM_006563,KLF1,3,2,2782,1617,1165,582.5,539,0.720470006
NM_152654,DAND5,2,1,5137,1734,3403,3403,867,1.962514418
NM_013976,GCDH,12,11,8872,1663,7209,655.3636364,138.5833333,4.334936861
NM_001375,DNASE2,6,5,6312,2014,4298,859.6,335.6666667,2.134061569
NM_001105578,SYCE2,6,5,20194,939,19255,3851,156.5,20.50585729
NM_005053,RAD23A,9,8,7831,1830,6001,750.125,203.3333333,3.279234973
NM_004461,FARSA,13,12,11276,1866,9410,784.1666667,143.5384615,5.042872454
NM_001271043,NFIX,11,10,74217,5744,68473,6847.3,522.1818182,11.92078691
NM_001271044,NFIX,10,9,74827,5555,69272,7696.888889,555.5,12.47020702
NM_017722,TRMT1,16,15,11751,2281,9470,631.3333333,142.5625,4.151687856
NM_001142554,TRMT1,15,14,11751,2193,9558,682.7142857,146.2,4.358413133
NM_001136035,TRMT1,17,16,11851,2161,9690,605.625,127.1176471,4.484035169
NM_005583,LYL1,4,3,4134,1792,2342,780.6666667,448,1.306919643
NM_001271610,STX10,7,6,6318,1400,4918,819.6666667,200,3.512857143
NM_001271609,STX10,8,7,6318,1307,5011,715.8571429,163.375,3.833970926
NM_001271611,STX10,7,6,6318,1163,5155,859.1666667,166.1428571,4.43250215
NM_004907,IER2,2,1,4438,2048,2390,2390,1024,1.166992188
NM_003765,STX10,8,7,6318,1311,5007,715.2857143,163.875,3.819221968
NM_032285,MRI1,6,5,9761,3042,6719,1343.8,507,2.208744247
NM_030818,CCDC130,10,9,15355,1642,13713,1523.666667,164.2,8.351400731
NM_014047,C19orf53,3,2,4331,912,3419,1709.5,304,3.748903509
NM_001031727,MRI1,6,5,9761,3183,6578,1315.6,530.5,2.066603833
NM_024323,C19orf57,8,7,23743,2428,21315,3045,303.5,8.778830313
NM_023072,ZSWIM4,13,12,36772,4352,32420,2701.666667,334.7692308,7.449448529
NM_001098622,NANOS3,2,1,3510,835,2675,2675,417.5,3.203592814
NM_024825,PODNL1,8,7,7291,3339,3952,564.5714286,417.375,1.183587901
NM_001146255,PODNL1,6,5,22206,3046,19160,3832,507.6666667,6.290216678
NM_080864,RLN3,2,1,2768,454,2314,2314,227,5.0969163
NM_138353,DCAF15,13,12,8939,2271,6668,555.6666667,174.6923077,2.936151475
NM_002918,RFX1,21,20,44794,4398,40396,2019.8,209.4285714,9.185084129
NM_001146254,PODNL1,8,7,22206,3315,18891,2698.714286,414.375,5.698642534
NM_001277378,C19orf67,6,5,4165,1453,2712,542.4,242.1666667,1.866483138
NM_138352,SAMD1,5,4,2005,1304,701,175.25,260.8,0.537576687
NM_002730,PRKACA,10,9,26054,2683,23371,2596.777778,268.3,8.710771524
NM_018154,ASF1B,4,3,17121,1735,15386,5128.666667,433.75,8.868011527
NM_001145028,PALM3,6,5,5794,2266,3528,705.6,377.6666667,1.556928508
NM_207518,PRKACA,10,9,22487,2484,20003,2222.555556,248.4,8.05273752
NM_005804,DDX39A,11,10,10587,1551,9036,903.6,141,5.825918762
NM_001025160,CD97,19,18,27583,3364,24219,1345.5,177.0526316,7.199464923
NM_001784,CD97,18,17,27583,3231,24352,1432.470588,179.5,7.536985453
NM_078481,CD97,20,19,27583,3512,24071,1266.894737,175.6,6.853929385
NM_202469,GIPC1,7,6,18392,1579,16813,2802.166667,225.5714286,10.6478784
NM_202470,GIPC1,7,6,18392,1809,16583,2763.833333,258.4285714,9.166943062
NM_213560,PKN1,22,21,31595,2969,28626,1363.142857,134.9545455,9.641630179
NM_202468,GIPC1,8,7,18392,1898,16494,2356.285714,237.25,8.690200211
NM_000955,PTGER1,3,2,2898,1424,1474,737,474.6666667,1.03511236
NM_138501,TECR,13,12,36415,1179,35236,2936.333333,90.69230769,29.88634436
NM_202494,GIPC1,6,5,18392,1490,16902,3380.4,248.3333333,11.34362416
NM_006145,DNAJB1,3,2,3621,2236,1385,692.5,745.3333333,0.61940966
NM_005716,GIPC1,9,8,18392,1955,16437,2054.625,217.2222222,8.407672634
NM_001204118,CLEC17A,14,13,28062,2176,25886,1991.230769,155.4285714,11.89613971
NM_032571,EMR3,16,15,55803,2439,53364,3557.6,152.4375,21.87945879
NM_001289159,EMR3,13,12,55803,2058,53745,4478.75,158.3076923,26.11516035
NM_001289158,EMR3,15,14,55803,2282,53521,3822.928571,152.1333333,23.45354952
NM_207390,CLEC17A,13,12,28062,2065,25997,2166.416667,158.8461538,12.58934625
NM_198944,OR7C1,1,0,964,964,NA,NA,964,NA
NM_013447,EMR2,21,20,45846,6488,39358,1967.9,308.952381,6.066276202
NM_017506,OR7A5,1,0,2139,2139,NA,NA,2139,NA
NM_001271052,EMR2,19,18,44232,6027,38205,2122.5,317.2105263,6.338974614
NM_030901,OR7A17,1,0,931,931,NA,NA,931,NA
NM_012377,OR7C2,1,0,961,961,NA,NA,961,NA
NM_001005190,OR7A10,1,0,931,931,NA,NA,931,NA
NM_001004713,OR1I1,1,0,1069,1069,NA,NA,1069,NA
NM_012114,CASP14,7,6,8814,3151,5663,943.8333333,450.1428571,1.797207236
NM_173482,CCDC105,7,6,12546,1758,10788,1798,251.1428571,6.136518771
NM_006844,ILVBL,16,15,10827,2347,8480,565.3333333,146.6875,3.613123136
NM_033025,SYDE1,8,7,7577,3262,4315,616.4285714,407.75,1.322808093
NM_000435,NOTCH3,33,32,41350,8104,33246,1038.9375,245.5757576,4.102418559
NM_024794,EPHX3,7,6,5503,1817,3686,614.3333333,259.5714286,2.028618602
NM_014299,BRD4,12,11,33417,4647,28770,2615.454545,387.25,6.191091026
NM_058243,BRD4,20,19,42963,5218,37745,1986.578947,260.9,7.233614412
NM_001142886,EPHX3,8,7,6127,1779,4348,621.1428571,222.375,2.444069702
NM_021241,WIZ,8,7,28446,4176,24270,3467.142857,522,5.811781609
NM_052890,PGLYRP2,5,4,10860,1886,8974,2243.5,377.2,4.758218452
NM_014371,AKAP8L,14,13,38976,2128,36848,2834.461538,152,17.31578947
NM_022904,RASAL3,18,17,12946,3308,9638,566.9411765,183.7777778,2.913542926
NM_173483,CYP4F22,14,13,43794,2623,41171,3167,187.3571429,15.69614945
NM_013939,OR10H2,1,0,1030,1030,NA,NA,1030,NA
NM_013938,OR10H3,1,0,952,952,NA,NA,952,NA
NM_023944,CYP4F12,13,12,24158,1796,22362,1863.5,138.1538462,12.45100223
NM_001199208,CYP4F3,13,12,19865,3001,16864,1405.333333,230.8461538,5.61946018
NM_001199209,CYP4F3,13,12,19865,2985,16880,1406.666667,229.6153846,5.654941374
NM_000896,CYP4F3,13,12,19865,3001,16864,1405.333333,230.8461538,5.61946018
NM_013940,OR10H1,1,0,1121,1121,NA,NA,1121,NA
NM_001004466,OR10H5,1,0,949,949,NA,NA,949,NA
NM_021187,CYP4F11,12,11,22498,3407,19091,1735.545455,283.9166667,5.603463458
NM_001128932,CYP4F11,13,12,22498,2986,19512,1626,229.6923077,6.534494307
NM_001004465,OR10H4,1,0,952,952,NA,NA,952,NA
NM_003290,TPM4,8,7,26680,2653,24027,3432.428571,331.625,9.056539766
NM_001145160,TPM4,9,8,35498,2639,32859,4107.375,293.2222222,12.45130731
NM_005370,RAB8A,8,7,21957,2185,19772,2824.571429,273.125,9.048970252
NM_054113,CIB3,6,5,12109,667,11442,2288.4,111.1666667,17.15442279
NM_014077,FAM32A,4,3,6624,1453,5171,1723.666667,363.25,3.558843772
NM_001130524,AP1M1,13,12,37493,2404,35089,2924.083333,184.9230769,14.59608985
NM_032493,AP1M1,12,11,37493,2367,35126,3193.272727,197.25,14.83988171
NM_016270,KLF2,3,2,2690,1652,1038,519,550.6666667,0.628329298
NM_001288834,C19orf44,8,7,22143,2533,19610,2801.428571,316.625,7.741808133
NM_032207,C19orf44,9,8,25060,3455,21605,2700.625,383.8888889,6.253256151
NM_145046,CALR3,9,8,17137,1301,15836,1979.5,144.5555556,12.17217525
NM_024881,SLC35E1,6,5,22547,5099,17448,3489.6,849.8333333,3.421847421
NM_024104,SMIM7,5,4,14011,1378,12633,3158.25,275.6,9.167634253
NM_004831,MED26,3,2,53299,3187,50112,25056,1062.333333,15.72387826
NM_015260,SIN3B,20,19,50957,5158,45799,2410.473684,257.9,8.879216751
NM_003950,F2RL3,2,1,3006,2733,273,273,1366.5,0.099890231
NM_001278445,ANKLE1,9,8,6003,3144,2859,357.375,349.3333333,0.909351145
NM_024527,ABHD8,5,4,11344,2095,9249,2312.25,419,4.414797136
NM_023937,MRPL34,2,1,1177,970,207,207,485,0.213402062
NM_031941,USHBP1,13,12,14697,2423,12274,1022.833333,186.3846154,5.065621131
NM_152363,ANKLE1,9,8,6003,3227,2776,347,358.5555556,0.860241711
NM_018467,USE1,8,7,4485,864,3621,517.2857143,108,4.190972222
NM_001278444,ANKLE1,8,7,6003,3009,2994,427.7142857,376.125,0.995014955
NM_024578,OCEL1,6,5,2975,1097,1878,375.6,182.8333333,1.711941659
NM_001278443,ANKLE1,9,8,6003,3116,2887,360.875,346.2222222,0.926508344
NM_005234,NR2F6,4,3,13459,1808,11651,3883.666667,452,6.444137168
NM_001288756,BABAM1,9,8,11979,1458,10521,1315.125,162,7.216049383
NM_001033549,BABAM1,9,8,11979,1507,10472,1309,167.4444444,6.948905109
NM_001288757,BABAM1,6,5,11979,1279,10700,2140,213.1666667,8.365910868
NM_014173,BABAM1,9,8,11979,1469,10510,1313.75,163.2222222,7.154526889
NM_001190844,TMEM221,3,2,13060,1933,11127,5563.5,644.3333333,5.7563373
NM_001195422,GTPBP3,9,8,7751,2604,5147,643.375,289.3333333,1.976574501
NM_133644,GTPBP3,8,7,5216,2706,2510,358.5714286,338.25,0.927568367
NM_001128855,GTPBP3,9,8,5216,2548,2668,333.5,283.1111111,1.047095761
NM_020959,ANO8,18,17,11608,4170,7438,437.5294118,231.6666667,1.783693046
NM_032620,GTPBP3,9,8,5216,2611,2605,325.625,290.1111111,0.99770203
NM_031310,PLVAP,6,5,25875,2282,23593,4718.6,380.3333333,10.33873795
NM_138401,MVB12A,9,8,5230,1202,4028,503.5,133.5555556,3.351081531
NM_004335,BST2,5,4,2711,1024,1687,421.75,204.8,1.647460938
NM_024656,COLGALT1,12,11,27456,3605,23851,2168.272727,300.4166667,6.616088766
NM_138454,NXNL1,2,1,5493,910,4583,4583,455,5.036263736
NM_012088,PGLS,5,4,9667,1039,8628,2157,207.8,8.304138595
NM_001098524,FAM129C,16,15,28727,2238,26489,1765.933333,139.875,11.8360143
NM_198580,SLC27A1,12,11,35679,3559,32120,2920,296.5833333,9.025007024
NM_173544,FAM129C,16,15,30540,2524,28016,1867.733333,157.75,11.09984152
NM_001080421,UNC13A,42,41,86873,9880,76993,1877.878049,235.2380952,7.792813765
NM_001161359,FCHO1,27,26,37093,3078,34015,1308.269231,114,11.05100715
NM_001161358,FCHO1,28,27,40852,3149,37703,1396.407407,112.4642857,11.9730073
NM_001161357,FCHO1,29,28,40852,3254,37598,1342.785714,112.2068966,11.55439459
NM_001265587,INSL3,3,2,5063,903,4160,2080,301,4.606866002
NM_005543,INSL3,2,1,5063,807,4256,4256,403.5,5.273853779
NM_014256,B3GNT3,3,2,18468,2723,15745,7872.5,907.6666667,5.782225487
NM_015122,FCHO1,29,28,37093,3244,33849,1208.892857,111.862069,10.43434032
NM_018174,MAP1S,7,6,15023,3283,11740,1956.666667,469,3.575997563
NM_000980,RPL18A,5,4,3448,676,2772,693,135.2,4.100591716
NM_001136203,CCDC124,5,4,10972,992,9980,2495,198.4,10.06048387
NM_138442,CCDC124,5,4,8891,1054,7837,1959.25,210.8,7.435483871
NM_000453,SLC5A5,15,14,23203,3591,19612,1400.857143,239.4,5.461431356
NM_005535,IL12RB1,17,16,27328,2117,25211,1575.6875,124.5294118,11.90883325
NM_001286826,ARRDC2,8,7,5936,2508,3428,489.7142857,313.5,1.366826156
NM_153701,IL12RB1,10,9,16327,1867,14460,1606.666667,186.7,7.745045528
NM_001025604,ARRDC2,8,7,12972,2536,10436,1490.857143,317,4.115141956
NM_015683,ARRDC2,8,7,5936,2511,3425,489.2857143,313.875,1.363998407
NM_001098818,PDE4C,15,14,18516,5086,13430,959.2857143,339.0666667,2.64058199
NM_001098819,PDE4C,15,14,16534,5139,11395,813.9285714,342.6,2.217357463
NM_006332,IFI30,7,6,4346,1035,3311,551.8333333,147.8571429,3.199033816
NM_002866,RAB3A,5,4,7265,1506,5759,1439.75,301.2,3.824037185
NM_032683,MPV17L2,5,4,3512,1363,2149,537.25,272.6,1.576669112
NM_005027,PIK3R2,16,15,17357,3982,13375,891.6666667,248.875,3.358864892
NM_025249,KIAA1683,4,3,17415,3847,13568,4522.666667,961.75,3.526904081
NM_001145305,KIAA1683,4,3,17415,3886,13529,4509.666667,971.5,3.481471951
NM_001145304,KIAA1683,4,3,17415,4408,13007,4335.666667,1102,2.950771325
NM_012321,LSM4,5,4,16963,1830,15133,3783.25,366,8.269398907
NM_017712,PGPEP1,5,4,29357,7089,22268,5567,1417.8,3.141204683
NM_001252129,LSM4,4,3,16963,1787,15176,5058.666667,446.75,8.492445439
NM_001286968,JUND,1,0,1964,1964,NA,NA,1964,NA
NM_005354,JUND,1,0,1964,1964,NA,NA,1964,NA
NM_145256,LRRC25,2,1,6463,2405,4058,4058,1202.5,1.687318087
NM_032627,SSBP4,18,17,15228,1805,13423,789.5882353,100.2777778,7.436565097
NM_001009998,SSBP4,17,16,15228,1738,13490,843.125,102.2352941,7.761795167
NM_001253389,ISYNA1,8,7,2923,2132,791,113,266.5,0.371013133
NM_001170938,ISYNA1,10,9,3915,2268,1647,183,226.8,0.726190476
NM_004864,GDF15,2,1,3020,1202,1818,1818,601,1.512479201
NM_016368,ISYNA1,11,10,3915,2431,1484,148.4,221,0.610448375
NM_012181,FKBP8,9,8,11817,1775,10042,1255.25,197.2222222,5.657464789
NM_001171949,KXD1,5,4,11627,1501,10126,2531.5,300.2,6.746169221
NM_001171948,KXD1,6,5,11627,1598,10029,2005.8,266.3333333,6.275969962
NM_003333,UBA52,5,4,5658,2794,2864,716,558.8,1.025053686
NM_012109,TMEM59L,8,7,8169,1627,6542,934.5714286,203.375,4.020897357
NM_001033930,UBA52,5,4,5658,2816,2842,710.5,563.2,1.009232955
NM_024069,KXD1,5,4,11627,1466,10161,2540.25,293.2,6.931105048
NM_001100419,C19orf60,5,4,3654,819,2835,708.75,163.8,3.461538462
NM_001100418,C19orf60,5,4,3654,885,2769,692.25,177,3.128813559
NM_004750,CRLF1,9,8,13627,1813,11814,1476.75,201.4444444,6.516271373
NM_018316,KLHL26,3,2,33466,3125,30341,15170.5,1041.666667,9.70912
NM_002911,UPF1,24,23,36297,5369,30928,1344.695652,223.7083333,5.760476811
NM_000095,COMP,19,18,8533,2471,6062,336.7777778,130.0526316,2.45325779
NM_199444,COPE,9,8,19878,987,18891,2361.375,109.6666667,19.13981763
NM_199442,COPE,9,8,19878,990,18888,2361,110,19.07878788
NM_001145722,HOMER3,10,9,11105,1859,9246,1027.333333,185.9,4.973641743
NM_007263,COPE,10,9,19878,1144,18734,2081.555556,114.4,16.37587413
NM_019070,DDX49,13,12,8960,1849,7111,592.5833333,142.2307692,3.845862628
NM_001145724,HOMER3,8,7,9850,1295,8555,1222.142857,161.875,6.606177606
NM_001145721,HOMER3,10,9,11153,1428,9725,1080.555556,142.8,6.81022409
NM_004838,HOMER3,10,9,12033,1587,10446,1160.666667,158.7,6.582230624
NM_001199196,ARMC6,9,8,24602,2497,22105,2763.125,277.4444444,8.852623148
NM_033415,ARMC6,8,7,24602,2388,22214,3173.428571,298.5,9.302345059
NM_017814,TMEM161A,12,11,18887,1839,17048,1549.818182,153.25,9.270255574
NM_178526,SLC25A42,8,7,49040,3277,45763,6537.571429,409.625,13.96490693
NM_001256766,TMEM161A,10,9,18887,1528,17359,1928.777778,152.8,11.36060209
NM_001278728,RFXANK,8,7,9105,1215,7890,1127.142857,151.875,6.49382716
NM_001278727,RFXANK,9,8,9672,1381,8291,1036.375,153.4444444,6.003620565
NM_134440,RFXANK,9,8,9672,1378,8294,1036.75,153.1111111,6.018867925
NM_003721,RFXANK,10,9,9672,1448,8224,913.7777778,144.8,5.679558011
NM_001145784,MEF2BNB,6,5,15689,1439,14250,2850,239.8333333,9.902710215
NM_001145783,MEF2BNB,4,3,10717,1501,9216,3072,375.25,6.139906729
NM_023002,HAPLN4,5,4,7146,3443,3703,925.75,688.6,1.075515539
NM_004386,NCAN,15,14,40281,6421,33860,2418.571429,428.0666667,5.273321912
NM_176880,NR2C2AP,5,4,2016,1304,712,178,260.8,0.54601227
NM_001001524,TM6SF2,10,9,8902,1493,7409,823.2222222,149.3,4.962491628
NM_015329,MAU2,19,18,37935,4872,33063,1836.833333,256.4210526,6.786330049
NM_032037,TSSK6,1,0,1443,1443,NA,NA,1443,NA
NM_001190328,YJEFN3,6,5,8725,888,7837,1567.4,148,8.82545045
NM_015965,NDUFA13,5,4,11996,547,11449,2862.25,109.4,20.93053016
NM_198537,YJEFN3,7,6,8725,1039,7686,1281,148.4285714,7.397497594
NM_153221,CILP2,8,7,8396,4207,4189,598.4285714,525.875,0.995721417
NM_025245,PBX4,8,7,57211,1738,55473,7924.714286,217.25,31.91772152
NM_020410,ATP13A1,26,25,18495,3890,14605,584.2,149.6153846,3.754498715
NM_016573,GMIP,21,20,14196,3562,10634,531.7,169.6190476,2.98540146
NM_033204,ZNF101,4,3,11477,1454,10023,3341,363.5,6.893397524
NM_004720,LPAR2,3,2,4575,1797,2778,1389,599,1.54590985
NM_001288999,GMIP,20,19,14196,3483,10713,563.8421053,174.15,3.075796727
NM_001288998,GMIP,20,19,14196,3474,10722,564.3157895,173.7,3.086355786
NM_021030,ZNF14,4,3,22642,2967,19675,6558.333333,741.75,6.631277385
NM_031218,ZNF93,4,3,34662,2798,31864,10621.33333,699.5,11.38813438
NM_021047,ZNF253,4,3,27581,2333,25248,8416,583.25,10.82211745
NM_033196,ZNF682,4,3,35052,3211,31841,10613.66667,802.75,9.916225475
NM_001077349,ZNF682,4,3,34839,3168,31671,10557,792,9.997159091
NM_007138,ZNF90,4,3,43176,3757,39419,13139.66667,939.25,10.49214799
NM_052852,ZNF486,4,3,33278,3901,29377,9792.333333,975.25,7.530633171
NM_001159293,ZNF737,4,3,27830,8395,19435,6478.333333,2098.75,2.315068493
NM_003429,ZNF85,4,3,27446,2335,25111,8370.333333,583.75,10.75417559
NM_001256173,ZNF85,3,2,27446,2207,25239,12619.5,735.6666667,11.43588582
NM_001256171,ZNF85,5,4,27446,2426,25020,6255,485.2,10.31327288
NM_001256172,ZNF85,4,3,20726,1558,19168,6389.333333,389.5,12.3029525
NM_182515,ZNF714,5,4,42932,8796,34136,8534,1759.2,3.880854934
NM_001076678,ZNF493,4,3,30377,4958,25419,8473,1239.5,5.126865672
NM_145326,ZNF493,4,3,11682,1706,9976,3325.333333,426.5,5.847596717
NM_175910,ZNF493,2,1,30377,4733,25644,25644,2366.5,5.418128037
NM_001001415,ZNF429,4,3,32644,2365,30279,10093,591.25,12.80295983
NM_001256654,ZNF43,3,2,31261,5134,26127,13063.5,1711.333333,5.089014414
NM_003423,ZNF43,4,3,31261,5262,25999,8666.333333,1315.5,4.940896997
NM_173531,ZNF100,5,4,43589,4475,39114,9778.5,895,8.740558659
NM_033468,ZNF257,4,3,38639,3524,35115,11705,881,9.964528944
NM_001001411,ZNF676,3,2,17852,2937,14915,7457.5,979,5.078311202
NM_001242680,ZNF729,4,3,30728,3839,26889,8963,959.75,7.004167752
NM_001098626,ZNF98,4,3,31251,2264,28987,9662.333333,566,12.80344523
NM_020855,ZNF492,4,3,33348,4249,29099,9699.666667,1062.25,6.848434926
NM_001267716,ZNF728,4,3,28327,2636,25691,8563.666667,659,9.746206373
NM_001277403,ZNF730,4,3,30239,2371,27868,9289.333333,592.75,11.75369043
NM_003430,ZNF91,4,3,37773,5400,32373,10791,1350,5.995
NM_138286,ZNF681,4,3,19698,6501,13197,4399,1625.25,2.029995385
NM_001244038,ZNF726,4,3,19087,1968,17119,5706.333333,492,8.698678862
NM_001278678,ZNF254,2,1,42809,3894,38915,38915,1947,9.993579866
NM_001278665,ZNF254,4,3,20194,542,19652,6550.666667,135.5,36.25830258
NM_001278664,ZNF254,3,2,42809,3991,38818,19409,1330.333333,9.726384365
NM_001278662,ZNF254,5,4,42809,4235,38574,9643.5,847,9.108382527
NM_203282,ZNF254,4,3,42809,4119,38690,12896.66667,1029.75,9.393056567
NM_006003,UQCRFS1,2,1,5971,1226,4745,4745,613,3.870309951
NM_001146339,VSTM2B,5,4,37737,1248,36489,9122.25,249.6,29.23798077
NM_006627,POP4,7,6,10994,2601,8393,1398.833333,371.5714286,3.226835832
NM_001282931,C19orf12,4,3,16661,4808,11853,3951,1202,2.465266223
NM_001282930,C19orf12,2,1,16661,4515,12146,12146,2257.5,2.690143965
NM_024310,PLEKHF1,2,1,10058,1741,8317,8317,870.5,4.777139575
NM_031448,C19orf12,3,2,16661,4686,11975,5987.5,1562,2.555484422
NM_001031726,C19orf12,3,2,16172,4415,11757,5878.5,1471.666667,2.662967157
NM_001256047,C19orf12,3,2,16905,4492,12413,6206.5,1497.333333,2.763357079
NM_001256046,C19orf12,4,3,16661,4632,12029,4009.666667,1158,2.59693437
NM_001282929,C19orf12,2,1,16172,4244,11928,11928,2122,2.810556079
NM_001238,CCNE1,12,11,12316,1959,10357,941.5454545,163.25,5.286881062
NM_001252641,URI1,11,10,92970,2507,90463,9046.3,227.9090909,36.08416434
NM_003796,URI1,11,10,74375,3471,70904,7090.4,315.5454545,20.42754249
NM_020856,TSHZ3,2,1,74341,4915,69426,69426,2457.5,14.12533062
NM_001278578,THEG5,3,2,5363,1364,3999,1999.5,454.6666667,2.931818182
NM_001278576,THEG5,4,3,5363,1496,3867,1289,374,2.584893048
NM_001205273,THEG5,2,1,1271,960,311,311,480,0.323958333
NM_001278577,THEG5,4,3,5363,1507,3856,1285.333333,376.75,2.558725946
NM_001278575,THEG5,3,2,5363,1371,3992,1996,457,2.911743253
NM_001136156,ZNF507,7,6,42061,7725,34336,5722.666667,1103.571429,4.444789644
NM_014910,ZNF507,6,5,42061,7630,34431,6886.2,1271.666667,4.512581913
NM_004708,PDCD5,6,5,6266,610,5656,1131.2,101.6666667,9.272131148
NM_207391,RGS9BP,1,0,2895,2895,NA,NA,2895,NA
NM_001110822,TDRD12,13,12,71037,1630,69407,5783.916667,125.3846154,42.5809816
NM_001105570,NUDT19,3,2,21837,2970,18867,9433.5,990,6.352525253
NM_001126335,SLC7A9,13,12,39266,1701,37565,3130.416667,130.8461538,22.0840682
NM_014270,SLC7A9,13,12,39266,1787,37479,3123.25,137.4615385,20.97313934
NM_001243036,SLC7A9,13,12,39266,1796,37470,3122.5,138.1538462,20.86302895
NM_152266,C19orf40,5,4,4814,1143,3671,917.75,228.6,3.211723535
NM_173479,WDR88,11,10,43707,1733,41974,4197.4,157.5454545,24.22042701
NM_018025,GPATCH1,20,19,49534,3382,46152,2429.052632,169.1,13.6463631
NM_019849,SLC7A10,11,10,17188,1957,15231,1523.1,177.9090909,7.782830864
NM_004364,CEBPA,1,0,2632,2632,NA,NA,2632,NA
NM_002333,LRP3,7,6,14176,3705,10471,1745.166667,529.2857143,2.826180837
NM_001285829,CEBPA,1,0,2632,2632,NA,NA,2632,NA
NM_001287424,CEBPA,1,0,2632,2632,NA,NA,2632,NA
NM_001287435,CEBPA,1,0,2632,2632,NA,NA,2632,NA
NM_001806,CEBPG,2,1,9019,3772,5247,5247,1886,1.391039236
NM_001252296,CEBPG,2,1,8164,3635,4529,4529,1817.5,1.245942228
NM_001129995,KCTD15,7,6,18917,3937,14980,2496.666667,562.4285714,3.80492761
NM_024076,KCTD15,7,6,18917,4939,13978,2329.666667,705.5714286,2.830127556
NM_001129994,KCTD15,7,6,18917,3940,14977,2496.166667,562.8571429,3.801269036
NM_015578,LSM14A,10,9,57070,3725,53345,5927.222222,372.5,14.32080537
NM_001114093,LSM14A,11,10,57070,3783,53287,5328.7,343.9090909,14.08591065
NM_014686,KIAA0355,14,13,101017,6697,94320,7255.384615,478.3571429,14.08391817
NM_032346,PDCD2L,7,6,21771,1164,20607,3434.5,166.2857143,17.70360825
NM_001080436,WTIP,8,7,19207,2212,16995,2427.857143,276.5,7.683092224
NM_005499,UBA2,17,16,41532,2682,38850,2428.125,157.7647059,14.48545861
NM_001025591,SCGB2B2,3,2,1146,430,716,358,143.3333333,1.665116279
NM_001289183,ZNF302,5,4,8760,2591,6169,1542.25,518.2,2.380934002
NM_001289187,ZNF302,5,4,8760,2898,5862,1465.5,579.6,2.022774327
NM_001289186,ZNF302,5,4,8760,2549,6211,1552.75,509.8,2.43664182
NM_001029997,ZNF181,4,3,8296,2955,5341,1780.333333,738.75,1.807445008
NM_001289184,ZNF302,5,4,8760,2654,6106,1526.5,530.8,2.300678222
NM_001145665,ZNF181,4,3,8296,2952,5344,1781.333333,738,1.810298103
NM_001289181,ZNF302,6,5,8760,2784,5976,1195.2,464,2.146551724
NM_001012320,ZNF302,5,4,8760,2628,6132,1533,525.6,2.333333333
NM_001289182,ZNF302,5,4,8760,2901,5859,1464.75,580.2,2.019648397
NM_001289189,ZNF302,5,4,8760,2914,5846,1461.5,582.8,2.006177076
NM_001289185,ZNF302,5,4,8760,2631,6129,1532.25,526.2,2.329532497
NM_001289188,ZNF302,5,4,8760,2920,5840,1460,584,2
NM_001289190,ZNF302,5,4,8760,2851,5909,1477.25,570.2,2.072606103
NM_001289191,ZNF302,5,4,8760,2888,5872,1468,577.6,2.033240997
NM_001289192,ZNF302,5,4,8760,2911,5849,1462.25,582.2,2.009275163
NM_018443,ZNF302,5,4,8760,2651,6109,1527.25,530.2,2.304413429
NM_018675,ZNF302,5,4,8760,3158,5602,1400.5,631.6,1.773907536
NM_020895,GRAMD1A,20,19,26129,2660,23469,1235.210526,133,8.822932331
NM_194325,ZNF30,5,4,18271,2589,15682,3920.5,517.8,6.057164929
NM_001099438,ZNF30,5,4,18271,2658,15613,3903.25,531.6,5.873965388
NM_001136199,GRAMD1A,18,17,26129,2625,23504,1382.588235,145.8333333,8.953904762
NM_175872,ZNF792,4,3,7697,3892,3805,1268.333333,973,0.977646454
NM_001099437,ZNF30,5,4,18271,2592,15679,3919.75,518.4,6.048996914
NM_001136007,FXYD3,11,10,8498,1590,6908,690.8,144.5454545,4.344654088
NM_199037,SCN1B,3,2,3584,1115,2469,1234.5,371.6666667,2.214349776
NM_002151,HPN,14,13,26069,1799,24270,1866.923077,128.5,13.49082824
NM_001278717,FXYD1,8,7,4064,699,3365,480.7142857,87.375,4.814020029
NM_021902,FXYD1,8,7,4268,565,3703,529,70.625,6.553982301
NM_005971,FXYD3,9,8,8498,1382,7116,889.5,153.5555556,5.149059334
NM_022006,FXYD7,6,5,11053,719,10334,2066.8,119.8333333,14.37273992
NM_021910,FXYD3,9,8,8498,1544,6954,869.25,171.5555556,4.50388601
NM_001278718,FXYD1,8,7,3423,593,2830,404.2857143,74.125,4.772344013
NM_001037,SCN1B,6,5,9763,1454,8309,1661.8,242.3333333,5.714580468
NM_001136012,FXYD3,8,7,8498,1459,7039,1005.571429,182.375,4.824537354
NM_001136011,FXYD3,10,9,8498,1467,7031,781.2222222,146.7,4.792774369
NM_001136009,FXYD3,6,5,5839,849,4990,998,141.5,5.877502945
NM_001136010,FXYD3,5,4,5839,764,5075,1268.75,152.8,6.642670157
NM_001136008,FXYD3,6,5,7377,784,6593,1318.6,130.6666667,8.409438776
NM_139284,LGI4,9,8,10763,2897,7866,983.25,321.8888889,2.715222644
NM_005031,FXYD1,8,7,3598,589,3009,429.8571429,73.625,5.108658744
NM_182983,HPN,13,12,26069,2378,23691,1974.25,182.9230769,9.962573591
NM_015925,LSR,9,8,19310,2230,17080,2135,247.7777778,7.659192825
NM_207291,USF2,9,8,10824,1517,9307,1163.375,168.5555556,6.135135135
NM_021175,HAMP,3,2,2637,429,2208,1104,143,5.146853147
NM_001260490,LSR,7,6,19310,1961,17349,2891.5,280.1428571,8.847016828
NM_001260489,LSR,9,8,19310,2227,17083,2135.375,247.4444444,7.670857656
NM_205835,LSR,8,7,19310,2082,17228,2461.142857,260.25,8.274735831
NM_205834,LSR,10,9,19310,2288,17022,1891.333333,228.8,7.439685315
NM_152481,FAM187B,2,1,3926,1181,2745,2745,590.5,2.324301439
NM_003367,USF2,10,9,10824,1719,9105,1011.666667,171.9,5.296684119
NM_002361,MAG,11,10,21722,2442,19280,1928,222,7.895167895
NM_001278417,CD22,13,12,18193,3129,15064,1255.333333,240.6923077,4.814317673
NM_001185099,CD22,13,12,18194,3041,15153,1262.75,233.9230769,4.982900362
NM_001185101,CD22,12,11,18194,2773,15421,1401.909091,231.0833333,5.561125135
NM_001199216,MAG,11,10,21722,2429,19293,1929.3,220.8181818,7.942774804
NM_001771,CD22,14,13,18194,3306,14888,1145.230769,236.1428571,4.503327284
NM_080600,MAG,12,11,21722,2488,19234,1748.545455,207.3333333,7.730707395
NM_001185100,CD22,13,12,18194,3186,15008,1250.666667,245.0769231,4.710608914
NM_005304,FFAR3,2,1,1903,1674,229,229,837,0.136798088
NM_005303,FFAR1,1,0,924,924,NA,NA,924,NA
NM_001035516,DMKN,6,5,4696,609,4087,817.4,101.5,6.711001642
NM_001190347,DMKN,17,16,16443,1872,14571,910.6875,110.1176471,7.783653846
NM_032635,TMEM147,7,6,1929,902,1027,171.1666667,128.8571429,1.138580931
NM_001126058,DMKN,10,9,10356,1471,8885,987.2222222,147.1,6.04010877
NM_001126057,DMKN,11,10,10356,1508,8848,884.8,137.0909091,5.867374005
NM_001126056,DMKN,18,17,16443,1921,14522,854.2352941,106.7222222,7.559604373
NM_033317,DMKN,16,15,16443,1952,14491,966.0666667,122,7.423668033
NM_001242597,TMEM147,6,5,1929,972,957,191.4,162,0.984567901
NM_001244847,KRTDAP,5,4,3209,456,2753,688.25,91.2,6.037280702
NM_001242598,TMEM147,5,4,1929,678,1251,312.75,135.6,1.845132743
NM_014364,GAPDHS,11,10,11909,1503,10406,1040.6,136.6363636,6.923486361
NM_001190348,DMKN,13,12,10356,1624,8732,727.6666667,124.9230769,5.376847291
NM_001190349,DMKN,9,8,10356,1419,8937,1117.125,157.6666667,6.298097252
NM_001166035,SBSN,4,3,4986,727,4259,1419.666667,181.75,5.858321871
NM_001166034,SBSN,4,3,4986,1990,2996,998.6666667,497.5,1.505527638
NM_207392,KRTDAP,6,5,3209,499,2710,542,83.16666667,5.430861723
NM_001126059,DMKN,12,11,13274,966,12308,1118.909091,80.5,12.74120083
NM_198538,SBSN,5,4,4986,962,4024,1006,192.4,4.182952183
NM_005306,FFAR2,1,0,2054,2054,NA,NA,2054,NA
NM_007000,UPK1A,8,7,11971,1278,10693,1527.571429,159.75,8.366979656
NM_001281443,UPK1A,9,8,11971,1377,10594,1324.25,153,7.693536674
NM_014209,ETV2,7,6,3128,1494,1634,272.3333333,213.4285714,1.093708166
NM_001863,COX6B1,4,3,10563,594,9969,3323,148.5,16.78282828
NM_015302,HAUS5,19,18,12607,4328,8279,459.9444444,227.7894737,1.912892791
NM_024321,RBM42,10,9,8609,1660,6949,772.1111111,166,4.186144578
NM_024660,IGFLR1,5,4,3202,1201,2001,500.25,240.2,1.666111574
NM_021232,PRODH2,11,10,13311,1688,11623,1162.3,153.4545455,6.885663507
NM_001281532,PSENEN,4,3,1580,800,780,260,200,0.975
NM_001172630,ARHGAP33,21,20,13309,4240,9069,453.45,201.9047619,2.138915094
NM_144987,U2AF1L4,6,5,2917,737,2180,436,122.8333333,2.957937585
NM_172341,PSENEN,4,3,1580,838,742,247.3333333,209.5,0.885441527
NM_014383,ZBTB32,6,5,4112,1966,2146,429.2,327.6666667,1.09155646
NM_001039887,C19orf55,12,11,11035,2158,8879,807.1818182,179.8333333,4.114457831
NM_144617,HSPB6,3,2,2465,1463,1002,501,487.6666667,0.684894053
NM_014727,KMT2B,37,36,20860,8506,12354,343.1666667,229.8918919,1.452386551
NM_019104,LIN37,9,8,6160,1159,5001,625.125,128.7777778,4.314926661
NM_001040425,U2AF1L4,6,5,2917,795,2122,424.4,132.5,2.66918239
NM_052948,ARHGAP33,21,20,13309,3939,9370,468.5,187.5714286,2.378776339
NM_032123,KIRREL2,16,15,10240,2740,7500,500,171.25,2.737226277
NM_001173515,TYROBP,4,3,3910,559,3351,1117,139.75,5.994633274
NM_001173514,TYROBP,4,3,3910,562,3348,1116,140.5,5.957295374
NM_001024807,APLP1,17,16,11300,2467,8833,552.0625,145.1176471,3.5804621
NM_024509,LRFN3,3,2,8077,2518,5559,2779.5,839.3333333,2.207704527
NM_199179,KIRREL2,15,14,10240,2589,7651,546.5,172.6,2.955195056
NM_199180,KIRREL2,15,14,10240,3008,7232,516.5714286,200.5333333,2.404255319
NM_014266,HCST,4,3,1793,511,1282,427.3333333,127.75,2.508806262
NM_198125,TYROBP,5,4,3910,593,3317,829.25,118.6,5.593591906
NM_003332,TYROBP,5,4,3910,596,3314,828.5,119.2,5.560402685
NM_139239,NFKBID,12,11,12411,1846,10565,960.4545455,153.8333333,5.723185265
NM_005166,APLP1,17,16,11300,2464,8836,552.25,144.9411765,3.586038961
NM_004646,NPHS1,29,28,26623,5053,21570,770.3571429,174.2413793,4.268751237
NM_001007469,HCST,4,3,1793,508,1285,428.3333333,127,2.529527559
NM_198867,ALKBH6,7,6,5120,945,4175,695.8333333,135,4.417989418
NM_001042631,SDHAF1,1,0,1132,1132,NA,NA,1132,NA
NM_032878,ALKBH6,7,6,5121,984,4137,689.5,140.5714286,4.204268293
NM_001199570,CLIP3,13,12,18013,3469,14544,1212,266.8461538,4.192562698
NM_152658,THAP8,4,3,19779,1829,17950,5983.333333,457.25,9.814106069
NM_015526,CLIP3,14,13,18237,3386,14851,1142.384615,241.8571429,4.386001181
NM_001039876,SYNE4,8,7,5672,1549,4123,589,193.625,2.661717237
NM_006233,POLR2I,6,5,1597,878,719,143.8,146.3333333,0.818906606
NM_001864,COX7A1,4,3,1949,766,1183,394.3333333,191.5,1.544386423
NM_001749,CAPNS1,11,10,10339,1489,8850,885,135.3636364,5.9435863
NM_001281,TBCB,6,5,10963,1481,9482,1896.4,246.8333333,6.40243079
NM_001270948,OVOL3,3,2,2510,698,1812,906,232.6666667,2.595988539
NM_001003962,CAPNS1,11,10,10339,1486,8853,885.3,135.0909091,5.957604307
NM_007145,ZNF146,4,3,24173,3860,20313,6771,965,5.262435233
NM_001099639,ZNF146,3,2,24173,3744,20429,10214.5,1248,5.456463675
NM_001099638,ZNF146,3,2,24173,3785,20388,10194,1261.666667,5.38652576
NM_133466,ZFP82,5,4,26691,2621,24070,6017.5,524.2,9.183517741
NM_001012756,ZNF260,4,3,17661,5478,12183,4061,1369.5,2.223986857
NM_001166038,ZNF260,3,2,17661,5344,12317,6158.5,1781.333333,2.304827844
NM_001166037,ZNF260,3,2,17661,5363,12298,6149,1787.666667,2.293119523
NM_001166036,ZNF260,4,3,17661,5472,12189,4063,1368,2.22752193
NM_020951,ZNF529,5,4,29682,5150,24532,6133,1030,4.763495146
NM_032825,ZNF382,5,4,23294,2832,20462,5115.5,566.4,7.225282486
NM_001256838,ZNF382,5,4,23294,2807,20487,5121.75,561.4,7.298539366
NM_152603,ZNF567,4,3,31925,2692,29233,9744.333333,673,10.85921248
NM_153257,ZNF461,6,5,29458,3198,26260,5252,533,8.211382114
NM_001242802,ZNF790,5,4,19707,2456,17251,4312.75,491.2,7.024022801
NM_001242801,ZNF790,5,4,31947,2366,29581,7395.25,473.2,12.50253593
NM_001242800,ZNF790,5,4,32467,2188,30279,7569.75,437.6,13.83866545
NM_001267779,ZNF850,4,3,29338,7629,21709,7236.333333,1907.25,2.845589199
NM_001193552,ZNF850,5,4,29338,7726,21612,5403,1545.2,2.797307792
NM_206894,ZNF790,5,4,20064,2148,17916,4479,429.6,8.340782123
NM_198539,ZNF568,7,6,36416,4115,32301,5383.5,587.8571429,7.849574727
NM_001204837,ZNF568,5,4,36416,3793,32623,8155.75,758.6,8.600843659
NM_001204836,ZNF568,6,5,36416,3853,32563,6512.6,642.1666667,8.451336621
NM_001204835,ZNF568,7,6,36416,4112,32304,5384,587.4285714,7.856031128
NM_001171979,ZNF829,6,5,27899,4983,22916,4583.2,830.5,4.598836043
NM_001037232,ZNF829,6,5,28169,5038,23131,4626.2,839.6666667,4.591306074
NM_199126,ZNF585A,6,5,25000,6768,18232,3646.4,1128,2.693853428
NM_152655,ZNF585A,6,5,25305,6828,18477,3695.4,1138,2.706063269
NM_152279,ZNF585B,5,4,28972,6215,22757,5689.25,1243,3.661625101
NM_152604,ZNF383,5,4,17210,1699,15511,3877.75,339.8,9.129487934
NM_001288800,ZNF585A,5,4,25305,6725,18580,4645,1345,2.762825279
NM_181786,HKR1,6,5,29779,2935,26844,5368.8,489.1666667,9.146166951
NM_144694,ZNF570,5,4,16262,2252,14010,3502.5,450.4,6.221136767
NM_152484,ZNF569,6,5,56281,4064,52217,10443.4,677.3333333,12.84867126
NM_152606,ZNF540,5,4,62808,3270,59538,14884.5,654,18.20733945
NM_001172225,ZNF540,5,4,19350,3241,16109,4027.25,648.2,4.970379512
NM_001172226,ZNF540,4,3,19350,3144,16206,5402,786,5.154580153
NM_016536,ZNF571,4,3,30520,2280,28240,9413.333333,570,12.38596491
NM_032689,ZNF607,5,4,23429,4369,19060,4765,873.8,4.36255436
NM_001172690,ZNF573,5,4,41029,2262,38767,9691.75,452.4,17.13837312
NM_001172692,ZNF573,4,3,41029,2128,38901,12967,532,18.28054511
NM_001172691,ZNF573,5,4,41029,2256,38773,9693.25,451.2,17.18661348
NM_001172677,ZNF607,5,4,22827,4018,18809,4702.25,803.6,4.681184669
NM_001172689,ZNF573,6,5,41029,2454,38575,7715,409,15.7192339
NM_152605,ZNF781,4,3,24568,3146,21422,7140.666667,786.5,6.809281627
NM_152360,ZNF573,8,7,41029,2524,38505,5500.714286,315.5,15.25554675
NM_031951,WDR87,6,5,21847,8953,12894,2578.8,1492.166667,1.440187647
NM_001243947,PPP1R14A,3,2,5356,699,4657,2328.5,233,6.662374821
NM_021102,SPINT2,7,6,28158,1809,26349,4391.5,258.4285714,14.5655058
NM_033256,PPP1R14A,4,3,5356,781,4575,1525,195.25,5.85787452
NM_033520,C19orf33,4,3,844,465,379,126.3333333,116.25,0.815053763
NM_001135156,DPF1,12,11,18670,2315,16355,1486.818182,192.9166667,7.064794816
NM_001135155,DPF1,12,11,13243,2338,10905,991.3636364,194.8333333,4.664242943
NM_001166103,SPINT2,6,5,28158,1637,26521,5304.2,272.8333333,16.2009774
NM_004647,DPF1,11,10,13243,2235,11008,1100.8,203.1818182,4.925279642
NM_001146205,RASGRP4,17,16,17249,3133,14116,882.25,184.2941176,4.505585701
NM_001146207,RASGRP4,15,14,17249,2942,14307,1021.928571,196.1333333,4.863018355
NM_001146206,RASGRP4,14,13,17249,2665,14584,1121.846154,190.3571429,5.472420263
NM_001146204,RASGRP4,17,16,17249,3028,14221,888.8125,178.1176471,4.696499339
NM_001146203,RASGRP4,16,15,17249,2958,14291,952.7333333,184.875,4.831304936
NM_001146202,RASGRP4,17,16,17249,3193,14056,878.5,187.8235294,4.402129659
NM_001042522,SPRED3,5,4,9685,5079,4606,1151.5,1015.8,0.906871431
NM_021185,CATSPERG,29,28,35148,3753,31395,1121.25,129.4137931,8.365307754
NM_152657,GGN,4,3,3678,2158,1520,506.6666667,539.5,0.704355885
NM_002812,PSMD8,7,6,9276,1546,7730,1288.333333,220.8571429,5
NM_004823,KCNK6,3,2,9167,2658,6509,3254.5,886,2.44883371
NM_170604,RASGRP4,17,16,17249,3235,14014,875.875,190.2941176,4.331993818
NM_174905,FAM98C,8,7,5955,1283,4672,667.4285714,160.375,3.641465316
NM_013234,EIF3K,8,7,17875,887,16988,2426.857143,110.875,19.15219842
NM_001042600,MAP4K1,31,30,30397,2745,27652,921.7333333,88.5483871,10.07358834
NM_007181,MAP4K1,32,31,30397,2844,27553,888.8064516,88.875,9.688115331
NM_002307,LGALS7,4,3,2551,498,2053,684.3333333,124.5,4.12248996
NM_001042507,LGALS7B,4,3,2546,493,2053,684.3333333,123.25,4.164300203
NM_006149,LGALS4,10,9,11431,1289,10142,1126.888889,128.9,7.868114818
NM_144691,CAPN12,21,20,14284,3150,11134,556.7,150,3.534603175
NM_021107,MRPS12,2,1,2067,1079,988,988,539.5,0.915662651
NM_030593,SIRT2,15,14,21309,2079,19230,1373.571429,138.6,9.24963925
NM_198445,RINL,12,11,10449,3056,7393,672.0909091,254.6666667,2.419175393
NM_033362,MRPS12,3,2,2313,1049,1264,632,349.6666667,1.204957102
NM_001005335,HNRNPL,13,12,15953,1894,14059,1171.583333,145.6923077,7.422914467
NM_012237,SIRT2,16,15,21270,2088,19182,1278.8,130.5,9.186781609
NM_001195833,RINL,12,11,10449,3072,7377,670.6363636,256,2.401367188
NM_148169,FBXO17,6,5,11288,2182,9106,1821.2,363.6666667,4.173235564
NM_002503,NFKBIB,6,5,8966,1242,7724,1544.8,207,6.21900161
NM_001243212,CCER2,5,4,3180,1062,2118,529.5,212.4,1.994350282
NM_001243116,NFKBIB,6,5,9196,1000,8196,1639.2,166.6666667,8.196
NM_001533,HNRNPL,13,12,13591,2128,11463,955.25,163.6923077,5.38674812
NM_017827,SARS2,16,15,15634,2075,13559,903.9333333,129.6875,6.534457831
NM_033363,MRPS12,3,2,2067,976,1091,545.5,325.3333333,1.117827869
NM_001193286,SIRT2,13,12,21309,1925,19384,1615.333333,148.0769231,10.06961039
NM_001145901,SARS2,17,16,15634,2082,13552,847,122.4705882,6.509125841
NM_178820,FBXO27,6,5,8537,2328,6209,1241.8,388,2.66709622
NM_001001414,NCCRP1,6,5,4920,1979,2941,588.2,329.8333333,1.486104093
NM_001014835,PAK4,9,8,53628,2388,51240,6405,265.3333333,21.45728643
NM_001014832,PAK4,9,8,53628,2774,50854,6356.75,308.2222222,18.33237203
NM_001014831,PAK4,11,10,53628,3075,50553,5055.3,279.5454545,16.44
NM_001014834,PAK4,8,7,53628,2314,51314,7330.571429,289.25,22.17545376
NM_001080468,SYCN,2,1,1346,484,862,862,242,1.780991736
NM_005884,PAK4,10,9,53628,2848,50780,5642.222222,284.8,17.83005618
NM_001276254,IFNL4,6,5,2544,1641,903,180.6,273.5,0.550274223
NM_020862,LRFN1,2,1,8521,3134,5387,5387,1567,1.718889598
NM_172138,IFNL2,6,5,1577,740,837,167.4,123.3333333,1.131081081
NM_172139,IFNL3,5,4,1341,600,741,185.25,120,1.235
NM_004877,GMFG,7,6,7729,664,7065,1177.5,94.85714286,10.64006024
NM_172140,IFNL1,5,4,2349,861,1488,372,172.2,1.728222997
NM_017592,MED29,4,3,9242,3571,5671,1890.333333,892.75,1.588070568
NM_003169,SUPT5H,29,28,31022,3805,27217,972.0357143,131.2068966,7.152956636
NM_019088,PAF1,14,13,5567,2302,3265,251.1538462,164.4285714,1.418331885
NM_003407,ZFP36,2,1,2567,1754,813,813,877,0.463511973
NM_001256826,PAF1,13,12,5567,2087,3480,290,160.5384615,1.667465261
NM_001130825,SUPT5H,29,28,31124,3729,27395,978.3928571,128.5862069,7.346473585
NM_022835,PLEKHG2,19,18,15307,7626,7681,426.7222222,401.3684211,1.007212169
NM_001020,RPS16,5,4,2773,595,2178,544.5,119,3.660504202
NM_001130824,SUPT5H,30,29,31124,3667,27457,946.7931034,122.2333333,7.487592037
NM_001111020,SUPT5H,30,29,31124,3742,27382,944.2068966,124.7333333,7.317477285
NM_013268,LGALS13,4,3,4947,599,4348,1449.333333,149.75,7.258764608
NM_153232,EID2,1,0,1393,1393,NA,NA,1393,NA
NM_016941,DLL3,8,7,9566,2391,7175,1025,298.875,3.00083647
NM_152361,EID2B,1,0,1866,1866,NA,NA,1866,NA
NM_182704,SELV,6,5,5575,1710,3865,773,285,2.260233918
NM_203486,DLL3,9,8,9566,2055,7511,938.875,228.3333333,3.654987835
NM_001190441,LGALS16,4,3,4731,604,4127,1375.666667,151,6.832781457
NM_203471,LGALS14,5,4,5144,1088,4056,1014,217.6,3.727941176
NM_001828,CLC,4,3,6778,637,6141,2047,159.25,9.640502355
NM_020129,LGALS14,4,3,5144,782,4362,1454,195.5,5.578005115
NM_006484,DYRK1B,12,11,8853,2463,6390,580.9090909,205.25,2.594397077
NM_006483,DYRK1B,11,10,8853,2426,6427,642.7,220.5454545,2.649216818
NM_001436,FBL,9,8,11963,1174,10789,1348.625,130.4444444,9.189948893
NM_001143832,LEUTX,3,2,9543,675,8868,4434,225,13.13777778
NM_004714,DYRK1B,11,10,8853,2546,6307,630.7,231.4545455,2.477219167
NM_006503,PSMC4,11,10,10761,1925,8836,883.6,175,4.59012987
NM_153001,PSMC4,11,10,10761,1832,8929,892.9,166.5454545,4.873908297
NM_001010880,ZNF780A,6,5,17913,3681,14232,2846.4,613.5,3.866340668
NM_001142578,ZNF780A,6,5,17948,3604,14344,2868.8,600.6666667,3.980022198
NM_001142577,ZNF780A,6,5,17948,3607,14341,2868.2,601.1666667,3.975880233
NM_001005851,ZNF780B,5,4,27950,8669,19281,4820.25,1733.8,2.224131964
NM_178544,ZNF546,7,6,20573,4600,15973,2662.166667,657.1428571,3.472391304
NM_001142579,ZNF780A,9,8,21788,4259,17529,2191.125,473.2222222,4.115754872
NM_024877,CNTD2,5,4,4484,1822,2662,665.5,364.4,1.461031833
NM_002446,MAP3K10,10,9,23833,3446,20387,2265.222222,344.6,5.916134649
NM_152479,TTC9B,3,2,2343,846,1497,748.5,282,1.769503546
NM_012268,PLD3,13,12,30060,2418,27642,2303.5,186,11.43176179
NM_001031696,PLD3,13,12,30060,2194,27866,2322.166667,168.7692308,12.70100273
NM_001256441,C19orf47,9,8,27351,2108,25243,3155.375,234.2222222,11.97485769
NM_001256440,C19orf47,9,8,27469,2113,25356,3169.5,234.7777778,12
NM_013376,SERTAD1,2,1,3525,1206,2319,2319,603,1.922885572
NM_013368,SERTAD3,2,1,1759,1520,239,239,760,0.157236842
NM_181882,PRX,7,6,19602,4864,14738,2456.333333,694.8571429,3.030016447
NM_203344,SERTAD3,2,1,3536,1409,2127,2127,704.5,1.509581263
NM_000713,BLVRB,5,4,18036,861,17175,4293.75,172.2,19.94773519
NM_020956,PRX,6,5,19602,5512,14090,2818,918.6666667,2.556240929
NM_001042544,LTBP4,33,32,32586,5177,27409,856.53125,156.8787879,5.294378984
NM_025213,SPTBN4,10,9,30265,2429,27836,3092.888889,242.9,11.45986002
NM_003573,LTBP4,33,32,36655,5066,31589,987.15625,153.5151515,6.235491512
NM_138392,SHKBP1,18,17,14550,2383,12167,715.7058824,132.3888889,5.105749056
NM_001042545,LTBP4,30,29,28450,4990,23460,808.9655172,166.3333333,4.701402806
NM_024876,ADCK4,15,14,25358,2458,22900,1635.714286,163.8666667,9.316517494
NM_025194,ITPKC,7,6,23759,3392,20367,3394.5,484.5714286,6.00442217
NM_198476,C19orf54,6,5,9069,2759,6310,1262,459.8333333,2.287060529
NM_006533,MIA,4,3,2118,639,1479,493,159.75,2.314553991
NM_001142555,ADCK4,14,13,23579,2089,21490,1653.076923,149.2142857,10.28721876
NM_001202553,MIA,5,4,2318,515,1803,450.75,103,3.500970874
NM_004756,NUMBL,10,9,24746,3569,21177,2353,356.9,5.933594844
NM_004596,SNRPA,6,5,14540,1635,12905,2581,272.5,7.892966361
NM_030589,CYP2A7,8,7,7315,2136,5179,739.8571429,267,2.424625468
NM_080732,EGLN2,6,5,9300,2161,7139,1427.8,360.1666667,3.303563165
NM_000764,CYP2A7,9,8,7315,2290,5025,628.125,254.4444444,2.194323144
NM_000762,CYP2A6,9,8,6911,1773,5138,642.25,197,2.897913142
NM_053046,EGLN2,6,5,9014,2251,6763,1352.6,375.1666667,3.00444247
NM_000767,CYP2B6,9,8,27099,3061,24038,3004.75,340.1111111,7.852989219
NM_000766,CYP2A13,9,8,7746,1769,5977,747.125,196.5555556,3.378745054
NM_000774,CYP2F1,10,9,13930,1836,12094,1343.777778,183.6,6.587145969
NM_021913,AXL,20,19,42570,4762,37808,1989.894737,238.1,7.93952121
NM_030622,CYP2S1,9,8,14331,2630,11701,1462.625,292.2222222,4.44904943
NM_001699,AXL,19,18,42570,4734,37836,2102,249.1578947,7.992395437
NM_001278599,AXL,17,16,35014,4137,30877,1929.8125,243.3529412,7.463620981
NM_001164783,BCKDHA,9,8,27218,1780,25438,3179.75,197.7777778,14.29101124
NM_030578,B9D2,4,3,9758,1035,8723,2907.666667,258.75,8.428019324
NM_198540,B3GNT8,3,2,3373,1877,1496,748,625.6666667,0.797016516
NM_001042595,TMEM91,4,3,6820,975,5845,1948.333333,243.75,5.994871795
NM_052848,CCDC97,5,4,14696,3327,11369,2842.25,665.4,3.417192666
NM_000660,TGFB1,7,6,23404,2590,20814,3469,370,8.036293436
NM_001098822,TMEM91,4,3,7551,935,6616,2205.333333,233.75,7.075935829
NM_001098825,TMEM91,4,3,20118,743,19375,6458.333333,185.75,26.07671602
NM_001098824,TMEM91,4,3,7551,912,6639,2213,228,7.279605263
NM_001098823,TMEM91,4,3,7551,924,6627,2209,231,7.172077922
NM_001098821,TMEM91,4,3,7551,1083,6468,2156,270.75,5.972299169
NM_020158,EXOSC5,6,5,10982,999,9983,1996.6,166.5,9.992992993
NM_000709,BCKDHA,9,8,27218,1783,25435,3179.375,198.1111111,14.26528323
NM_001130514,C19orf69,2,1,1609,948,661,661,474,0.697257384
NM_001817,CEACAM4,7,6,8100,1212,6888,1148,173.1428571,5.683168317
NM_006890,CEACAM7,5,4,14863,2294,12569,3142.25,458.8,5.47907585
NM_001098506,CEACAM21,7,6,10668,1366,9302,1550.333333,195.1428571,6.80966325
NM_033543,CEACAM21,7,6,10668,1363,9305,1550.833333,194.7142857,6.826852531
NM_002483,CEACAM6,6,5,16717,2637,14080,2816,439.5,5.339400834
NM_001277163,CEACAM3,6,5,15071,1064,14007,2801.4,177.3333333,13.16447368
NM_001815,CEACAM3,7,6,15071,1170,13901,2316.833333,167.1428571,11.88119658
NM_004363,CEACAM5,10,9,21909,3610,18299,2033.222222,361,5.068975069
NM_001040283,DMRTC2,9,8,7313,1829,5484,685.5,203.2222222,2.998359759
NM_199002,ARHGEF1,29,28,23160,3267,19893,710.4642857,112.6551724,6.089072544
NM_173506,LYPD4,5,4,7360,1797,5563,1390.75,359.4,3.095715081
NM_006423,RABAC1,5,4,2697,812,1885,471.25,162.4,2.321428571
NM_004706,ARHGEF1,29,28,24339,3242,21097,753.4642857,111.7931034,6.507402838
NM_198977,ARHGEF1,28,27,24339,3142,21197,785.0740741,112.2142857,6.746339911
NM_001783,CD79A,5,4,4251,1263,2988,747,252.6,2.365795724
NM_021601,CD79A,5,4,4251,1149,3102,775.5,229.8,2.699738903
NM_001022,RPS19,6,5,11498,855,10643,2128.6,142.5,12.44795322
NM_002088,GRIK5,19,18,67491,3552,63939,3552.166667,186.9473684,18.00084459
NM_001256213,ATP1A3,23,22,26887,3489,23398,1063.545455,151.6956522,6.706219547
NM_022752,ZNF574,2,1,5432,3133,2299,2299,1566.5,0.733801468
NM_001256214,ATP1A3,23,22,27696,3659,24037,1092.590909,159.0869565,6.569281224
NM_152296,ATP1A3,23,22,27696,3620,24076,1094.363636,157.3913043,6.650828729
NM_133328,DEDD2,5,4,19201,2030,17171,4292.75,406,8.45862069
NM_001270615,DEDD2,5,4,19201,2015,17186,4296.5,403,8.529032258
NM_001270614,DEDD2,5,4,21561,1948,19613,4903.25,389.6,10.06827515
NM_006494,ERF,4,3,7594,2709,4885,1628.333333,677.25,1.803248431
NM_199285,PRR19,3,2,8691,1533,7158,3579,511,4.66927593
NM_019884,GSK3A,11,10,12400,2190,10210,1021,199.0909091,4.662100457
NM_001145940,PAFAH1B3,6,5,5769,865,4904,980.8,144.1666667,5.669364162
NM_001145939,PAFAH1B3,6,5,5746,1104,4642,928.4,184,4.204710145
NM_002573,PAFAH1B3,5,4,5613,1081,4532,1133,216.2,4.192414431
NM_015125,CIC,20,19,11134,5493,5641,296.8947368,274.65,1.026943382
NM_173633,TMEM145,15,14,11739,1794,9945,710.3571429,119.6,5.543478261
NM_032488,CNFN,4,3,3275,532,2743,914.3333333,133,5.156015038
NM_198477,CXCL17,4,3,14443,857,13586,4528.666667,214.25,15.8529755
NM_005357,LIPE,10,9,25921,3823,22098,2455.333333,382.3,5.780277269
NM_001712,CEACAM1,9,8,21205,3528,17677,2209.625,392,5.010487528
NM_001024912,CEACAM1,8,7,21205,3474,17731,2533,434.25,5.103914796
NM_001205344,CEACAM1,8,7,21205,3469,17736,2533.714286,433.625,5.112712597
NM_001816,CEACAM8,6,5,14689,2309,12380,2476,384.8333333,5.361628411
NM_001184816,CEACAM1,7,6,21205,3185,18020,3003.333333,455,5.657770801
NM_001184815,CEACAM1,9,8,21205,3333,17872,2234,370.3333333,5.362136214
NM_001184813,CEACAM1,8,7,21205,3239,17966,2566.571429,404.875,5.546773696
NM_021016,PSG3,7,6,18876,1915,16961,2826.833333,273.5714286,8.85691906
NM_001184826,PSG1,6,5,13260,1991,11269,2253.8,331.8333333,5.659969864
NM_001184825,PSG1,6,5,13260,2077,11183,2236.6,346.1666667,5.384207992
NM_006905,PSG1,5,4,12515,2281,10234,2558.5,456.2,4.486628672
NM_001130168,PSG8,5,4,12994,1670,11324,2831,334,6.780838323
NM_001130167,PSG8,6,5,12994,2037,10957,2191.4,339.5,5.378988709
NM_182707,PSG8,5,4,11448,1446,10002,2500.5,289.2,6.917012448
NM_001031850,PSG6,6,5,15844,1743,14101,2820.2,290.5,8.090074584
NM_002783,PSG7,6,5,13048,2044,11004,2200.8,340.6666667,5.383561644
NM_002782,PSG6,6,5,14310,1484,12826,2565.2,247.3333333,8.642857143
NM_001206650,PSG7,5,4,13048,1677,11371,2842.75,335.4,6.780560525
NM_031246,PSG2,6,5,18533,1618,16915,3383,269.6666667,10.45426452
NM_002781,PSG5,6,5,18795,1646,17149,3429.8,274.3333333,10.41859052
NM_001130014,PSG5,6,5,18795,1578,17217,3443.4,263,10.91064639
NM_001276495,PSG4,5,4,13074,1894,11180,2795,378.8,5.902851109
NM_002784,PSG9,6,5,16249,1712,14537,2907.4,285.3333333,8.491238318
NM_002780,PSG4,6,5,13074,2174,10900,2180,362.3333333,5.013799448
NM_213633,PSG4,5,4,13074,1894,11180,2795,378.8,5.902851109
NM_020406,CD177,9,8,9657,2373,7284,910.5,263.6666667,3.069532238
NM_198850,PHLDB3,16,15,29732,2505,27227,1815.133333,156.5625,10.86906188
NM_001130011,TEX101,6,5,3734,1169,2565,513,194.8333333,2.194183062
NM_014400,LYPD3,5,4,4887,1711,3176,794,342.2,1.85622443
NM_014297,ETHE1,7,6,20527,970,19557,3259.5,138.5714286,20.16185567
NM_001193621,PINLYP,6,5,5306,921,4385,877,153.5,4.761129207
NM_001193622,PINLYP,4,3,1562,579,983,327.6666667,144.75,1.69775475
NM_001145347,ZNF576,3,2,3851,1866,1985,992.5,622,1.063772776
NM_006297,XRCC1,17,16,32268,2119,30149,1884.3125,124.6470588,14.22793771
NM_024327,ZNF576,3,2,4045,1902,2143,1071.5,634,1.126708728
NM_145296,CADM4,9,8,17471,2185,15286,1910.75,242.7777778,6.995881007
NM_001145641,SRRM5,1,0,2399,2399,NA,NA,2399,NA
NM_182498,ZNF428,3,2,12640,1398,11242,5621,466,8.04148784
NM_001007561,IRGQ,3,2,11770,9690,2080,1040,3230,0.214654283
NM_002250,KCNN4,9,8,14726,2249,12477,1559.625,249.8888889,5.547799022
NM_019612,IRGC,2,1,3957,1608,2349,2349,804,1.460820896
NM_019108,SMG9,14,13,23843,2367,21476,1652,169.0714286,9.073088297
NM_181845,ZNF283,7,6,21579,2572,19007,3167.833333,367.4285714,7.389968896
NM_001033719,ZNF404,2,1,7775,1844,5931,5931,922,3.21637744
NM_003445,ZNF155,5,4,14157,2711,11446,2861.5,542.2,4.222058281
NM_001129996,ZNF222,4,3,7770,1654,6116,2038.666667,413.5,3.697702539
NM_198089,ZNF155,5,4,14157,2634,11523,2880.75,526.8,4.374715262
NM_001260488,ZNF155,6,5,14157,2724,11433,2286.6,454,4.197136564
NM_001260486,ZNF155,5,4,14157,2737,11420,2855,547.4,4.172451589
NM_006300,ZNF230,5,4,10997,4137,6860,1715,827.4,1.65820643
NM_013359,ZNF221,6,5,16357,2432,13925,2785,405.3333333,5.725740132
NM_013360,ZNF222,4,3,7770,1622,6148,2049.333333,405.5,3.790382244
NM_001260487,ZNF155,5,4,14157,2620,11537,2884.25,524,4.403435115
NM_001146220,ZNF226,7,6,10369,892,9477,1579.5,127.4285714,10.62443946
NM_015919,ZNF226,6,5,10335,831,9504,1900.8,138.5,11.4368231
NM_006630,ZNF234,6,5,18754,4606,14148,2829.6,767.6666667,3.07164568
NM_001144824,ZNF234,6,5,18754,4488,14266,2853.2,748,3.178698752
NM_001037813,ZNF284,5,4,15328,2213,13115,3278.75,442.6,5.926344329
NM_013398,ZNF224,6,5,13999,2489,11510,2302,414.8333333,4.624347127
NM_013362,ZNF225,5,4,19709,2736,16973,4243.25,547.2,6.203581871
NM_001032374,ZNF226,6,5,10335,1000,9335,1867,166.6666667,9.335
NM_001032373,ZNF226,6,5,12591,2573,10018,2003.6,428.8333333,3.893509522
NM_001032372,ZNF226,6,5,12523,2609,9914,1982.8,434.8333333,3.799923342
NM_181756,ZNF233,5,4,15405,2798,12607,3151.75,559.6,4.50571837
NM_001207005,ZNF233,5,4,15439,2768,12671,3167.75,553.6,4.57767341
NM_004234,ZNF235,5,4,18679,3195,15484,3871,639,4.846322379
NM_001289166,ZNF227,6,5,24742,3062,21680,4336,510.3333333,7.080339647
NM_001289167,ZNF227,6,5,24742,3018,21724,4344.8,503,7.198144467
NM_001289168,ZNF227,5,4,24742,2996,21746,5436.5,599.2,7.258344459
NM_001289169,ZNF227,5,4,24742,2999,21743,5435.75,599.8,7.250083361
NM_001289170,ZNF227,4,3,24742,2911,21831,7277,727.75,7.499484713
NM_001289171,ZNF227,4,3,24742,2914,21828,7276,728.5,7.490734386
NM_001289172,ZNF227,4,3,24742,2972,21770,7256.666667,743,7.325033647
NM_001289173,ZNF227,5,4,24742,2995,21747,5436.75,599,7.261101836
NM_182490,ZNF227,6,5,24742,3059,21683,4336.6,509.8333333,7.088264139
NM_152354,ZNF285,4,3,15971,2690,13281,4427,672.5,4.937174721
NM_001278510,ZNF229,6,5,22342,4841,17501,3500.2,806.8333333,3.615162157
NM_014518,ZNF229,6,5,22241,4970,17271,3454.2,828.3333333,3.475050302
NM_013380,ZNF112,4,3,30152,3690,26462,8820.666667,922.5,7.171273713
NM_001083335,ZNF112,5,4,30152,3740,26412,6603,748,7.062032086
NM_001278509,ZNF180,5,4,25931,4268,21663,5415.75,853.6,5.075679475
NM_001278508,ZNF180,4,3,25931,4264,21667,7222.333333,1066,5.081378987
NM_013256,ZNF180,5,4,25931,4340,21591,5397.75,868,4.974884793
NM_001102597,CEACAM20,13,12,23339,1822,21519,1793.25,140.1538462,11.81064764
NM_001102599,CEACAM20,12,11,23339,1542,21799,1981.727273,128.5,14.13683528
NM_001102598,CEACAM20,11,10,23339,1505,21836,2183.6,136.8181818,14.5089701
NM_001288762,ZNF180,4,3,25932,4218,21714,7238,1054.5,5.147937411
NM_001288761,ZNF180,4,3,25932,4141,21791,7263.666667,1035.25,5.262255494
NM_001288759,ZNF180,5,4,25932,4346,21586,5396.5,869.2,4.966866084
NM_001288760,ZNF180,7,6,25932,4516,21416,3569.333333,645.1428571,4.742249779
NM_001102600,CEACAM20,12,11,23339,1785,21556,1959.636364,148.75,12.07619048
NM_001135770,PVR,6,5,15266,1649,13617,2723.4,274.8333333,8.257731959
NM_020219,CEACAM19,8,7,12905,2256,10649,1521.285714,282,4.720301418
NM_006505,PVR,8,7,22332,5911,16421,2345.857143,738.875,2.778040941
NM_001039213,CEACAM16,7,6,11567,1699,9868,1644.666667,242.7142857,5.808122425
NM_001205280,IGSF23,5,4,23143,994,22149,5537.25,198.8,22.28269618
NM_001135769,PVR,7,6,22332,5751,16581,2763.5,821.5714286,2.883150756
NM_001135768,PVR,8,7,22332,5776,16556,2365.142857,722,2.86634349
NM_001127893,CEACAM19,8,7,12905,2253,10652,1521.714286,281.625,4.727918331
NM_005581,BCAM,15,14,12364,2468,9896,706.8571429,164.5333333,4.009724473
NM_012116,CBLC,11,10,22779,1602,21177,2117.7,145.6363636,13.21910112
NM_005178,BCL3,9,8,11325,1873,9452,1181.5,208.1111111,5.046449546
NM_001130852,CBLC,10,9,22779,1463,21316,2368.444444,146.3,14.57006152
NM_001013257,BCAM,14,13,12364,3445,8919,686.0769231,246.0714286,2.588969521
NM_001128917,TOMM40,9,8,12471,1811,10660,1332.5,201.2222222,5.88625069
NM_001128916,TOMM40,10,9,12471,1720,10751,1194.555556,172,6.250581395
NM_000041,APOE,4,3,3613,1184,2429,809.6666667,296,2.05152027
NM_000483,APOC2,4,3,3585,733,2852,950.6666667,183.25,3.890859482
NM_001646,APOC4,3,2,3260,618,2642,1321,206,4.275080906
NM_001645,APOC1,4,3,4687,465,4222,1407.333333,116.25,9.079569892
NM_006114,TOMM40,10,9,12471,1717,10754,1194.888889,171.7,6.263249854
NM_024707,GEMIN7,3,2,12254,1650,10604,5302,550,6.426666667
NM_007056,CLASRP,21,20,31918,2255,29663,1483.15,107.3809524,13.15432373
NM_006509,RELB,11,10,36751,2286,34465,3446.5,207.8181818,15.07655293
NM_145288,ZNF296,3,2,4932,1589,3343,1671.5,529.6666667,2.103838892
NM_001278439,CLASRP,20,19,31918,2068,29850,1571.052632,103.4,14.43423598
NM_001007270,GEMIN7,3,2,12266,1564,10702,5351,521.3333333,6.842710997
NM_001007269,GEMIN7,2,1,12254,1526,10728,10728,763,7.030144168
NM_198478,NKPD1,4,3,10402,4691,5711,1903.666667,1172.75,1.217437647
NM_138568,EXOC3L2,10,9,21592,1729,19863,2207,172.9,11.48814344
NM_024108,TRAPPC6A,6,5,15317,817,14500,2900,136.1666667,17.74785802
NM_001270893,TRAPPC6A,5,4,15317,706,14611,3652.75,141.2,20.69546742
NM_001270892,TRAPPC6A,5,4,15317,748,14569,3642.25,149.6,19.47727273
NM_001270891,TRAPPC6A,6,5,15317,775,14542,2908.4,129.1666667,18.76387097
NM_212550,BLOC1S3,2,1,3057,2602,455,455,1301,0.174865488
NM_001130867,ERCC2,12,11,11824,1747,10077,916.0909091,145.5833333,5.768174013
NM_031417,MARK4,18,17,54027,5261,48766,2868.588235,292.2777778,9.26934043
NM_001199867,MARK4,17,16,54027,5180,48847,3052.9375,304.7058824,9.42992278
NM_000400,ERCC2,23,22,19198,2591,16607,754.8636364,112.6521739,6.409494404
NM_001824,CKM,8,7,16566,1666,14900,2128.571429,208.25,8.943577431
NM_177417,KLC3,13,12,10782,1806,8976,748,138.9230769,4.970099668
NM_001983,ERCC1,10,9,16588,3392,13196,1466.222222,339.2,3.890330189
NM_006663,PPP1R13L,13,12,25422,3133,22289,1857.416667,241,7.114267475
NM_202001,ERCC1,8,7,10130,1282,8848,1264,160.25,6.901716069
NM_001080401,PPM1N,5,4,4035,1719,2316,579,343.8,1.347294939
NM_001166049,ERCC1,9,8,16588,3319,13269,1658.625,368.7777778,3.997890931
NM_005619,RTN2,11,10,11769,2299,9470,947,209,4.119182253
NM_012099,CD3EAP,3,2,4559,3289,1270,635,1096.333333,0.386135604
NM_001142502,PPP1R13L,13,12,26717,3135,23582,1965.166667,241.1538462,7.522169059
NM_001114171,FOSB,3,2,7186,3671,3515,1757.5,1223.666667,0.957504767
NM_006732,FOSB,4,3,7186,3780,3406,1135.333333,945,0.901058201
NM_206900,RTN2,10,9,11769,2079,9690,1076.666667,207.9,4.660894661
NM_206901,RTN2,7,6,7959,1118,6841,1140.166667,159.7142857,6.118962433
NM_025136,OPA3,2,1,38585,7875,30710,30710,3937.5,3.89968254
NM_001017989,OPA3,2,1,57099,1934,55165,55165,967,28.5237849
NM_003370,VASP,13,12,19554,2303,17251,1437.583333,177.1538462,7.490664351
NM_005282,GPR4,2,1,12445,3049,9396,9396,1524.5,3.08166612
NM_000164,GIPR,14,13,14217,2038,12179,936.8461538,145.5714286,5.97595682
NM_001242348,C19orf83,3,2,1189,927,262,131,309,0.282632147
NM_017659,QPCTL,7,6,11509,2318,9191,1531.833333,331.1428571,3.965056083
NM_001080469,FBXO46,2,1,20266,2992,17274,17274,1496,5.773395722
NM_001163377,QPCTL,6,5,11509,2035,9474,1894.8,339.1666667,4.655528256
NM_004597,SNRPD2,3,2,4733,756,3977,1988.5,252,5.260582011
NM_177542,SNRPD2,4,3,4733,872,3861,1287,218,4.427752294
NM_030785,RSPH6A,6,5,19639,2490,17149,3429.8,415,6.887148594
NM_001081563,DMPK,14,13,10896,3257,7639,587.6153846,232.6428571,2.345409886
NM_001081562,DMPK,15,14,12850,2870,9980,712.8571429,191.3333333,3.477351916
NM_001081560,DMPK,15,14,12850,2874,9976,712.5714286,191.6,3.47112039
NM_004409,DMPK,15,14,12850,2889,9961,711.5,192.6,3.44790585
NM_015649,IRF2BP1,1,0,2512,2512,NA,NA,2512,NA
NM_004819,SYMPK,27,26,47850,4215,43635,1678.269231,156.1111111,10.35231317
NM_004943,DMWD,5,4,9798,3313,6485,1621.25,662.6,1.957440386
NM_004497,FOXA3,2,1,9539,1991,7548,7548,995.5,3.791059769
NM_001288766,DMPK,13,12,12850,2735,10115,842.9166667,210.3846154,3.698354662
NM_001288765,DMPK,13,12,9912,2523,7389,615.75,194.0769231,2.928656361
NM_001288764,DMPK,16,15,12850,2949,9901,660.0666667,184.3125,3.357409291
NM_001029861,NANOS2,1,0,1565,1565,NA,NA,1565,NA
NM_002516,NOVA2,4,3,33888,1881,32007,10669,470.25,17.01594896
NM_001267723,CCDC61,14,13,23157,1837,21320,1640,131.2142857,11.60587915
NM_005091,PGLYRP1,3,2,4146,955,3191,1595.5,318.3333333,3.341361257
NM_207393,IGFL3,4,3,4605,666,3939,1313,166.5,5.914414414
NM_001002923,IGFL4,4,3,1270,577,693,231,144.25,1.201039861
NM_198541,IGFL1,4,3,1493,773,720,240,193.25,0.931435964
NM_032040,CCDC8,1,0,3335,3335,NA,NA,3335,NA
NM_006247,PPP5C,13,12,43983,2245,41738,3478.166667,172.6923077,18.59153675
NM_001204284,PPP5C,12,11,43983,2178,41805,3800.454545,181.5,19.19421488
NM_152796,HIF3A,12,11,40166,1773,38393,3490.272727,147.75,21.65425832
NM_022462,HIF3A,14,13,45059,5802,39257,3019.769231,414.4285714,6.766115133
NM_152795,HIF3A,15,14,46389,5867,40522,2894.428571,391.1333333,6.906766661
NM_152794,HIF3A,15,14,39836,5899,33937,2424.071429,393.2666667,5.753008985
NM_018215,PNMAL1,3,2,5074,3699,1375,687.5,1233,0.371722087
NM_020709,PNMAL2,1,0,4723,4723,NA,NA,4723,NA
NM_001103149,PNMAL1,3,2,5074,3494,1580,790,1164.666667,0.452203778
NM_145056,DACT3,4,3,13528,2838,10690,3563.333333,709.5,3.766737139
NM_000960,PTGIR,3,2,4631,2089,2542,1271,696.3333333,1.216850168
NM_033258,GNG8,2,1,608,215,393,393,107.5,1.827906977
NM_005184,CALM3,6,5,9529,2265,7264,1452.8,377.5,3.207064018
NM_005628,SLC1A5,8,7,13704,2881,10823,1546.142857,360.125,3.756681708
NM_001039877,STRN4,18,17,26954,3228,23726,1395.647059,179.3333333,7.350061958
NM_024301,FKRP,4,3,12531,3426,9105,3035,856.5,2.657618214
NM_013403,STRN4,18,17,26954,3207,23747,1396.882353,178.1666667,7.404739632
NM_001145144,SLC1A5,8,7,12407,1745,10662,1523.142857,218.125,6.110028653
NM_001145145,SLC1A5,7,6,9996,1934,8062,1343.666667,276.2857143,4.168562565
NM_001039885,FKRP,4,3,12531,3478,9053,3017.666667,869.5,2.60293272
NM_004069,AP2S1,5,4,12782,895,11887,2971.75,179,13.28156425
NM_021575,AP2S1,4,3,12782,780,12002,4000.666667,195,15.38717949
NM_017854,TMEM160,3,2,2717,658,2059,1029.5,219.3333333,3.129179331
NM_002517,NPAS1,11,10,24876,2054,22822,2282.2,186.7272727,11.11100292
NM_001127240,BBC3,4,3,11946,1833,10113,3371,458.25,5.517184943
NM_001127242,BBC3,2,1,11946,1351,10595,10595,675.5,7.842339008
NM_001127241,BBC3,3,2,11946,1543,10403,5201.5,514.3333333,6.74206092
NM_014417,BBC3,4,3,10374,1847,8527,2842.333333,461.75,4.61667569
NM_178511,PRR24,1,0,840,840,NA,NA,840,NA
NM_001736,C5AR1,2,1,12225,2343,9882,9882,1171.5,4.217669654
NM_015603,CCDC9,12,11,15481,2090,13391,1217.363636,174.1666667,6.407177033
NM_020160,MEIS3,13,12,16412,2179,14233,1186.083333,167.6153846,6.531895365
NM_014681,DHX34,17,16,33425,4389,29036,1814.75,258.1764706,6.615629984
NM_001271750,C5AR2,2,1,1530,1359,171,171,679.5,0.125827815
NM_001009813,MEIS3,13,12,16412,1990,14422,1201.833333,153.0769231,7.247236181
NM_001277075,ZNF541,15,14,35173,4595,30578,2184.142857,306.3333333,6.654624592
NM_007059,KPTN,12,11,9123,1700,7423,674.8181818,141.6666667,4.366470588
NM_003827,NAPA,11,10,27626,1871,25755,2575.5,170.0909091,13.76536611
NM_015711,GLTSCR1,15,14,95083,5754,89329,6380.642857,383.6,15.52467848
NM_198479,TPRX1,2,1,2363,1841,522,522,920.5,0.283541554
NM_015710,GLTSCR2,13,12,11532,1535,9997,833.0833333,118.0769231,6.512703583
NM_003009,SEPW1,6,5,6103,886,5217,1043.4,147.6666667,5.888261851
NM_000554,CRX,4,3,21489,4470,17019,5673,1117.5,3.80738255
NM_001128326,BSPH1,6,5,24126,660,23466,4693.2,110,35.55454545
NM_003167,SULT2A1,6,5,15933,1993,13940,2788,332.1666667,6.994480682
NM_001159323,PLA2G4C,17,16,63011,2584,60427,3776.6875,152,23.38506192
NM_019855,CABP5,6,5,14673,1834,12839,2567.8,305.6666667,7.000545256
NM_001159322,PLA2G4C,17,16,63011,2510,60501,3781.3125,147.6470588,24.10398406
NM_022142,ELSPBP1,7,6,30504,1066,29438,4906.333333,152.2857143,27.61538462
NM_003706,PLA2G4C,17,16,63011,2541,60470,3779.375,149.4705882,23.79771743
NM_001184901,CARD8,11,10,41763,5239,36524,3652.4,476.2727273,6.971559458
NM_001184900,CARD8,11,10,32979,5292,27687,2768.7,481.0909091,5.23185941
NM_001184903,CARD8,11,10,41763,5247,36516,3651.6,477,6.959405374
NM_014959,CARD8,12,11,41763,5351,36412,3310.181818,445.9166667,6.8047094
NM_199341,C19orf68,4,3,26930,3592,23338,7779.333333,898,6.497216036
NM_012451,SYNGR4,5,4,11985,1020,10965,2741.25,204,10.75
NM_001425,EMP3,5,4,5183,834,4349,1087.25,166.8,5.214628297
NM_018273,TMEM143,8,7,31572,2257,29315,4187.857143,282.125,12.98848028
NM_144577,CCDC114,14,13,23625,3234,20391,1568.538462,231,6.305194805
NM_153608,ZNF114,5,4,16211,2211,14000,3500,442.2,6.331976481
NM_031485,GRWD1,7,6,8136,2463,5673,945.5,351.8571429,2.303288672
NM_013348,KCNJ14,3,2,10405,2854,7551,3775.5,951.3333333,2.645760336
NM_004228,CYTH2,12,11,13108,4616,8492,772,384.6666667,1.839688042
NM_001080434,LMTK3,16,15,27920,4988,22932,1528.8,311.75,4.597433841
NM_000836,GRIN2D,13,12,50058,5106,44952,3746,392.7692308,8.803760282
NM_017457,CYTH2,12,11,13108,4619,8489,771.7272727,384.9166667,1.837843689
NM_001204159,SPHK2,7,6,10875,2875,8000,1333.333333,410.7142857,2.782608696
NM_001204160,SPHK2,6,5,5456,2690,2766,553.2,448.3333333,1.028252788
NM_001204158,SPHK2,7,6,11117,2794,8323,1387.166667,399.1428571,2.978883321
NM_133498,SPACA4,1,0,973,973,NA,NA,973,NA
NM_017708,FAM83E,5,4,12839,2016,10823,2705.75,403.2,5.368551587
NM_001243876,SPHK2,6,5,11117,2498,8619,1723.8,416.3333333,3.450360288
NM_001352,DBP,4,3,6824,1647,5177,1725.666667,411.75,3.143290832
NM_001217,CA11,9,8,8181,1662,6519,814.875,184.6666667,3.922382671
NM_000979,RPL18,7,6,4093,894,3199,533.1666667,127.7142857,3.578299776
NM_001270490,RPL18,6,5,4093,806,3287,657.4,134.3333333,4.078163772
NM_020126,SPHK2,7,6,11117,2971,8146,1357.666667,424.4285714,2.741837765
NM_004605,SULT2B1,6,5,23693,1259,22434,4486.8,209.8333333,17.81890389
NM_177973,SULT2B1,7,6,47257,1207,46050,7675,172.4285714,38.15244408
NM_182574,MAMSTR,8,7,3961,1831,2130,304.2857143,228.875,1.163298744
NM_001130915,MAMSTR,10,9,6723,1589,5134,570.4444444,158.9,3.23096287
NM_000148,FUT1,4,3,7381,4250,3131,1043.666667,1062.5,0.736705882
NM_000511,FUT2,2,1,9965,3101,6864,6864,1550.5,2.213479523
NM_145807,NTN5,7,6,11602,1843,9759,1626.5,263.2857143,5.295170917
NM_017805,RASIP1,12,11,20130,3314,16816,1528.727273,276.1666667,5.074230537
NM_001097638,FUT2,2,1,9965,3091,6874,6874,1545.5,2.223875768
NM_019113,FGF21,3,2,2240,888,1352,676,296,1.522522523
NM_182575,IZUMO1,10,9,6023,1631,4392,488,163.1,2.692826487
NM_001164773,BCAT2,9,8,16003,1332,14671,1833.875,148,11.01426426
NM_001161354,PLEKHA4,17,16,31532,2804,28728,1795.5,164.9411765,10.24536377
NM_001284325,BCAT2,12,11,16003,2092,13911,1264.636364,174.3333333,6.649617591
NM_020904,PLEKHA4,20,19,31532,3103,28429,1496.263158,155.15,9.161778924
NM_003323,TULP2,13,12,17776,1773,16003,1333.583333,136.3846154,9.025944726
NM_016246,HSD17B14,9,8,23662,1246,22416,2802,138.4444444,17.99036918
NM_001190,BCAT2,11,10,16003,1610,14393,1439.3,146.3636364,8.939751553
NM_014330,PPP1R15A,3,2,3672,2386,1286,643,795.3333333,0.538977368
NM_002103,GYS1,16,15,25230,3634,21596,1439.733333,227.125,5.942762796
NM_006666,RUVBL2,15,14,22028,1503,20525,1466.071429,100.2,13.65602129
NM_033378,CGB2,3,2,1367,735,632,316,245,0.859863946
NM_001161587,GYS1,15,14,25230,3441,21789,1556.357143,229.4,6.332170881
NM_000146,FTL,4,3,1572,875,697,232.3333333,218.75,0.796571429
NM_000894,LHB,3,2,1112,526,586,293,175.3333333,1.114068441
NM_000737,CGB,3,2,1508,922,586,293,307.3333333,0.635574837
NM_033377,CGB1,3,2,1367,735,632,316,245,0.859863946
NM_014475,DHDH,7,6,11289,1088,10201,1700.166667,155.4285714,9.375919118
NM_138764,BAX,6,5,6940,777,6163,1232.6,129.5,7.931788932
NM_138763,BAX,5,4,6940,668,6272,1568,133.6,9.389221557
NM_138761,BAX,6,5,6940,816,6124,1224.8,136,7.504901961
NM_004324,BAX,5,4,6404,896,5508,1377,179.2,6.147321429
NM_002152,HRC,6,5,4227,2390,1837,367.4,398.3333333,0.768619247
NM_003660,PPFIA3,30,29,31643,4772,26871,926.5862069,159.0666667,5.630972339
NM_033043,CGB5,3,2,1468,883,585,292.5,294.3333333,0.662514156
NM_031886,KCNA7,2,1,5525,4374,1151,1151,2187,0.263145862
NM_006179,NTF4,2,1,2729,1001,1728,1728,500.5,1.726273726
NM_018111,C19orf73,1,0,745,745,NA,NA,745,NA
NM_033183,CGB8,3,2,1475,890,585,292.5,296.6666667,0.657303371
NM_033142,CGB7,3,2,1468,883,585,292.5,294.3333333,0.662514156
NM_022165,LIN7B,6,5,4101,761,3340,668,126.8333333,4.388961892
NM_003089,SNRNP70,10,9,23407,1933,21474,2386,193.3,11.10915675
NM_001195256,GFY,3,2,2389,1560,829,414.5,520,0.531410256
NM_003598,TEAD2,12,11,21861,2173,19688,1789.818182,181.0833333,9.06028532
NM_001256658,TEAD2,12,11,21863,2228,19635,1785,185.6666667,8.812836625
NM_001197302,DKKL1,5,4,11388,997,10391,2597.75,199.4,10.4222668
NM_001256662,TEAD2,12,11,21863,1958,19905,1809.545455,163.1666667,10.1659857
NM_001256661,TEAD2,13,12,20901,2203,18698,1558.166667,169.4615385,8.487517022
NM_001256660,TEAD2,13,12,21863,2228,19635,1636.25,171.3846154,8.812836625
NM_001197301,DKKL1,4,3,11333,942,10391,3463.666667,235.5,11.03078556
NM_014419,DKKL1,5,4,11333,1036,10297,2574.25,207.2,9.939189189
NM_001256659,TEAD2,12,11,21863,2184,19679,1789,182,9.010531136
NM_001774,CD37,8,7,5186,1251,3935,562.1428571,156.375,3.145483613
NM_144688,CCDC155,20,19,29783,2403,27380,1441.052632,120.15,11.39409072
NM_001040031,CD37,8,7,5186,1217,3969,567,152.125,3.261298274
NM_178449,PTH2,2,1,1029,461,568,568,230.5,1.232104121
NM_012423,RPL13A,8,7,4755,1188,3567,509.5714286,148.5,3.002525253
NM_001278638,FLT3LG,9,8,12024,1082,10942,1367.75,120.2222222,10.11275416
NM_001278637,FLT3LG,9,8,12024,1093,10931,1366.375,121.4444444,10.00091491
NM_001204503,FLT3LG,8,7,11672,1084,10588,1512.571429,135.5,9.767527675
NM_001204502,FLT3LG,9,8,12024,1116,10908,1363.5,124,9.774193548
NM_001136019,FCGRT,7,6,14151,1900,12251,2041.833333,271.4285714,6.447894737
NM_001270491,RPL13A,7,6,4755,1111,3644,607.3333333,158.7142857,3.279927993
NM_004107,FCGRT,6,5,13251,1635,11616,2323.2,272.5,7.104587156
NM_001015,RPS11,5,4,3349,651,2698,674.5,130.2,4.144393241
NM_001459,FLT3LG,9,8,12024,1065,10959,1369.875,118.3333333,10.29014085
NM_020650,RCN3,7,6,16017,1861,14156,2359.333333,265.8571429,7.606663084
NM_017916,PIH1D1,9,8,5567,1255,4312,539,139.4444444,3.435856574
NM_001145396,ALDH16A1,16,15,17834,2969,14865,991,185.5625,5.006736275
NM_153329,ALDH16A1,17,16,17834,3123,14711,919.4375,183.7058824,4.710534742
NM_020719,PRR12,14,13,34786,6957,27829,2140.692308,496.9285714,4.00014374
NM_001101340,ADM5,2,1,2307,2114,193,193,1057,0.091296121
NM_198318,PRMT1,10,9,11300,1406,9894,1099.333333,140.6,7.036984353
NM_001040668,BCL2L12,7,6,8776,1859,6917,1152.833333,265.5714286,3.720817644
NM_021228,SCAF1,11,10,16526,4324,12202,1220.2,393.0909091,2.821924144
NM_006270,RRAS,6,5,4850,989,3861,772.2,164.8333333,3.903943377
NM_138639,BCL2L12,7,6,8776,1862,6914,1152.333333,266,3.7132116
NM_001536,PRMT1,11,10,11300,1461,9839,983.9,132.8181818,6.734428474
NM_001207042,PRMT1,8,7,11300,1200,10100,1442.857143,150,8.416666667
NM_001571,IRF3,8,7,6308,1624,4684,669.1428571,203,2.884236453
NM_000951,PRRG2,7,6,9680,1400,8280,1380,200,5.914285714
NM_001282521,BCL2L12,4,3,8776,1407,7369,2456.333333,351.75,5.237384506
NM_001282520,BCL2L12,5,4,8776,1495,7281,1820.25,299,4.870234114
NM_001282519,BCL2L12,6,5,8776,1637,7139,1427.8,272.8333333,4.361026268
NM_001282517,BCL2L12,5,4,8776,1444,7332,1833,288.8,5.077562327
NM_001282516,BCL2L12,6,5,8776,1588,7188,1437.6,264.6666667,4.526448363
NM_001197125,IRF3,7,6,6308,1450,4858,809.6666667,207.1428571,3.350344828
NM_001197123,IRF3,8,7,6308,1682,4626,660.8571429,210.25,2.750297265
NM_001197122,IRF3,8,7,6308,1640,4668,666.8571429,205,2.846341463
NM_001197126,IRF3,6,5,6308,1277,5031,1006.2,212.8333333,3.939702428
NM_001197128,IRF3,5,4,6308,895,5413,1353.25,179,6.048044693
NM_001197127,IRF3,6,5,6308,1068,5240,1048,178,4.906367041
NM_001197124,IRF3,7,6,6308,1242,5066,844.3333333,177.4285714,4.078904992
NM_025129,FUZ,11,10,6445,1756,4689,468.9,159.6363636,2.670273349
NM_130787,AP2A1,23,22,40191,3456,36735,1669.772727,150.2608696,10.62934028
NM_001171937,FUZ,10,9,6445,1647,4798,533.1111111,164.7,2.913175471
NM_014203,AP2A1,24,23,40191,3523,36668,1594.26087,146.7916667,10.40817485
NM_021733,TSKS,11,10,23506,1823,21683,2168.3,165.7272727,11.89413055
NM_032375,AKT1S1,5,4,8356,2452,5904,1476,490.4,2.407830343
NM_017432,PTOV1,12,11,9585,1896,7689,699,158,4.055379747
NM_001278160,AKT1S1,5,4,9325,1854,7471,1867.75,370.8,4.029665588
NM_001278159,AKT1S1,5,4,7218,2043,5175,1293.75,408.6,2.533039648
NM_001193357,NUP62,2,1,22717,3186,19531,19531,1593,6.130257376
NM_001168222,TBC1D17,16,15,11327,2289,9038,602.5333333,143.0625,3.948449104
NM_007254,PNKP,17,16,6364,1738,4626,289.125,102.2352941,2.661680092
NM_153718,NUP62,2,1,22706,3266,19440,19440,1633,5.95223515
NM_012068,ATF5,4,3,5236,2279,2957,985.6666667,569.75,1.297498903
NM_012346,NUP62,2,1,22691,3227,19464,19464,1613.5,6.031608305
NM_016553,NUP62,3,2,22906,3589,19317,9658.5,1196.333333,5.382279186
NM_024682,TBC1D17,17,16,11327,2389,8938,558.625,140.5294118,3.741314357
NM_001193646,ATF5,3,2,4795,2073,2722,1361,691,1.313072841
NM_001098633,AKT1S1,5,4,8356,1818,6538,1634.5,363.6,3.596259626
NM_001098632,AKT1S1,5,4,8356,2030,6326,1581.5,406,3.116256158
NM_001258018,IL4I1,10,9,39885,2415,37470,4163.333333,241.5,15.51552795
NM_001258017,IL4I1,10,9,39885,2333,37552,4172.444444,233.3,16.09601372
NM_172374,IL4I1,10,9,39885,2357,37528,4169.777778,235.7,15.92193466
NM_153719,NUP62,3,2,22706,3422,19284,9642,1140.666667,5.635300994
NM_152899,IL4I1,8,7,7235,1803,5432,776,225.375,3.012756517
NM_001025778,VRK3,14,13,49083,1964,47119,3624.538462,140.2857143,23.9913442
NM_016440,VRK3,15,14,49083,2115,46968,3354.857143,141,22.2070922
NM_015428,ZNF473,5,4,22821,4695,18126,4531.5,939,3.860702875
NM_001006656,ZNF473,5,4,22821,4573,18248,4562,914.6,3.990378307
NM_152358,IZUMO2,7,6,10735,821,9914,1652.333333,117.2857143,12.07551766
NM_004977,KCNC3,5,4,13871,3181,10690,2672.5,636.2,3.360578434
NM_003121,SPIB,6,5,12116,3536,8580,1716,589.3333333,2.426470588
NM_001256647,NR1H2,9,8,6607,1808,4799,599.875,200.8888889,2.654314159
NM_001256849,POLD1,27,26,33697,3494,30203,1161.653846,129.4074074,8.644247281
NM_007121,NR1H2,10,9,6607,2100,4507,500.7777778,210,2.146190476
NM_138411,FAM71E1,5,4,9960,1230,8730,2182.5,246,7.097560976
NM_002691,POLD1,27,26,33697,3491,30206,1161.769231,129.2962963,8.65253509
NM_001243999,SPIB,6,5,12116,3532,8584,1716.8,588.6666667,2.430351076
NM_001243998,SPIB,5,4,12116,3320,8796,2199,664,2.64939759
NM_001244000,SPIB,6,5,12116,3501,8615,1723,583.5,2.460725507
NM_004851,NAPSA,9,8,7199,1401,5798,724.75,155.6666667,4.13847252
NM_004533,MYBPC2,28,27,33425,3626,29799,1103.666667,129.5,8.218146718
NM_175063,EMC10,8,7,7051,2219,4832,690.2857143,277.375,2.177557458
NM_206538,EMC10,7,6,7051,2131,4920,820,304.4285714,2.308775223
NM_001114598,ASPDH,7,6,2287,1051,1236,206,150.1428571,1.176022835
NM_001024656,ASPDH,5,4,3092,853,2239,559.75,170.6,2.624853458
NM_138334,JOSD2,5,4,5164,850,4314,1078.5,170,5.075294118
NM_001080457,LRRC4B,3,2,51154,2960,48194,24097,986.6666667,16.28175676
NM_001270639,JOSD2,5,4,5360,1004,4356,1089,200.8,4.338645418
NM_001270686,JOSD2,5,4,5164,847,4317,1079.25,169.4,5.096812279
NM_001270641,JOSD2,4,3,5360,877,4483,1494.333333,219.25,5.111744584
NM_001270640,JOSD2,5,4,5360,1001,4359,1089.75,200.2,4.354645355
NM_001160329,SYT3,11,10,17860,2491,15369,1536.9,226.4545455,6.169811321
NM_001160328,SYT3,11,10,17860,2855,15005,1500.5,259.5454545,5.255691769
NM_016148,SHANK1,23,22,55113,6666,48447,2202.136364,289.826087,7.267776778
NM_001195076,C19orf81,5,4,9867,770,9097,2274.25,154,11.81428571
NM_002975,CLEC11A,4,3,2378,1411,967,322.3333333,352.75,0.685329554
NM_032298,SYT3,9,8,16070,2924,13146,1643.25,324.8888889,4.495896033
NM_001030047,KLK3,5,4,5851,1911,3940,985,382.2,2.061747776
NM_001277081,KLK15,5,4,6236,1311,4925,1231.25,262.2,3.756674294
NM_001030048,KLK3,5,4,5851,1340,4511,1127.75,268,3.36641791
NM_001506,GPR32,1,0,1270,1270,NA,NA,1270,NA
NM_033068,ACPT,11,10,4811,1358,3453,345.3,123.4545455,2.542709867
NM_017509,KLK15,5,4,6236,1314,4922,1230.5,262.8,3.745814307
NM_002257,KLK1,5,4,4643,881,3762,940.5,176.2,4.27014756
NM_001648,KLK3,5,4,5851,1469,4382,1095.5,293.8,2.98298162
NM_001277082,KLK15,4,3,6236,1173,5063,1687.666667,293.25,4.316283035
NM_199250,C19orf48,4,3,7013,1508,5505,1835,377,3.650530504
NM_199249,C19orf48,5,4,7015,1672,5343,1335.75,334.4,3.195574163
NM_001207053,KLK7,5,4,7587,1965,5622,1405.5,393,2.861068702
NM_001281431,KLK8,5,4,5696,858,4838,1209.5,171.6,5.638694639
NM_001012964,KLK6,6,5,10161,1532,8629,1725.8,255.3333333,5.632506527
NM_007196,KLK8,6,5,5696,1019,4677,935.4,169.8333333,4.589793916
NM_012427,KLK5,6,5,9787,1569,8218,1643.6,261.5,5.237731039
NM_001012965,KLK6,5,4,10162,1484,8678,2169.5,296.8,5.847708895
NM_001243126,KLK7,5,4,7587,1948,5639,1409.75,389.6,2.89476386
NM_002774,KLK6,7,6,11044,1518,9526,1587.666667,216.8571429,6.275362319
NM_001077492,KLK5,6,5,9787,1366,8421,1684.2,227.6666667,6.164714495
NM_001077491,KLK5,7,6,9787,1435,8352,1392,205,5.820209059
NM_144507,KLK8,3,2,5696,459,5237,2618.5,153,11.40958606
NM_144506,KLK8,4,3,5696,594,5102,1700.666667,148.5,8.589225589
NM_144505,KLK8,6,5,5696,1154,4542,908.4,192.3333333,3.935875217
NM_139277,KLK7,6,5,7338,1927,5411,1082.2,321.1666667,2.807991697
NM_004917,KLK4,5,4,4388,1352,3036,759,270.4,2.24556213
NM_005046,KLK7,6,5,7587,2097,5490,1098,349.5,2.618025751
NM_015596,KLK13,5,4,8906,1263,7643,1910.75,252.6,6.051464766
NM_006853,KLK11,6,5,5805,1199,4606,921.2,199.8333333,3.841534612
NM_019598,KLK12,7,6,5802,952,4850,808.3333333,136,5.094537815
NM_001167605,KLK11,6,5,5805,1274,4531,906.2,212.3333333,3.556514914
NM_145888,KLK10,6,5,6956,2974,3982,796.4,495.6666667,1.338937458
NM_145895,KLK12,5,4,5802,819,4983,1245.75,163.8,6.084249084
NM_145894,KLK12,6,5,5802,1080,4722,944.4,180,4.372222222
NM_145232,CTU1,3,2,10786,2110,8676,4338,703.3333333,4.111848341
NM_014441,SIGLEC9,7,6,5432,1725,3707,617.8333333,246.4285714,2.148985507
NM_002776,KLK10,6,5,7284,3112,4172,834.4,518.6666667,1.340616967
NM_022046,KLK14,7,6,6350,1140,5210,868.3333333,162.8571429,4.570175439
NM_001198558,SIGLEC9,7,6,11385,1607,9778,1629.666667,229.5714286,6.084629745
NM_001136032,KLK11,6,5,4387,1187,3200,640,197.8333333,2.695871946
NM_144947,KLK11,6,5,5400,1281,4119,823.8,213.5,3.215456674
NM_001077500,KLK10,6,5,7433,3013,4420,884,502.1666667,1.466976435
NM_001177608,CD33,7,6,10888,1115,9773,1628.833333,159.2857143,8.765022422
NM_001082618,CD33,6,5,14941,1091,13850,2770,181.8333333,12.69477544
NM_173635,SIGLECL1,6,5,11620,1712,9908,1981.6,285.3333333,5.787383178
NM_014385,SIGLEC7,7,6,11227,1761,9466,1577.666667,251.5714286,5.375354912
NM_016543,SIGLEC7,6,5,11227,1481,9746,1949.2,246.8333333,6.580688724
NM_001772,CD33,7,6,14941,1473,13468,2244.666667,210.4285714,9.143245078
NM_001277201,SIGLEC7,2,1,11227,968,10259,10259,484,10.5981405
NM_001161748,LIM2,5,4,8049,863,7186,1796.5,172.6,8.326767092
NM_001163922,VSIG10L,10,9,10585,3684,6901,766.7777778,368.4,1.873235613
NM_001101372,IGLON5,8,7,19002,3108,15894,2270.571429,388.5,5.113899614
NM_030657,LIM2,5,4,8049,989,7060,1765,197.8,7.138523761
NM_001193623,C19orf84,2,1,2287,1320,967,967,660,0.732575758
NM_152353,CLDND2,4,3,1907,978,929,309.6666667,244.5,0.949897751
NM_001014763,ETFB,5,4,9689,1306,8383,2095.75,261.2,6.418836141
NM_001985,ETFB,6,5,21265,922,20343,4068.6,153.6666667,22.06399132
NM_005601,NKG7,4,3,1088,830,258,86,207.5,0.310843373
NM_001177548,SIGLEC6,7,6,12328,2080,10248,1708,297.1428571,4.926923077
NM_001177549,SIGLEC6,6,5,12328,1919,10409,2081.8,319.8333333,5.42417926
NM_001177547,SIGLEC6,7,6,12328,1973,10355,1725.833333,281.8571429,5.248352762
NM_198846,SIGLEC6,6,5,12328,1952,10376,2075.2,325.3333333,5.31557377
NM_198845,SIGLEC6,7,6,12328,2081,10247,1707.833333,297.2857143,4.924074964
NM_033130,SIGLEC10,11,10,7784,3405,4379,437.9,309.5454545,1.286049927
NM_001171161,SIGLEC10,9,8,7784,2674,5110,638.75,297.1111111,1.910994764
NM_001171159,SIGLEC10,10,9,7784,2945,4839,537.6666667,294.5,1.643123939
NM_001171158,SIGLEC10,10,9,7784,2975,4809,534.3333333,297.5,1.616470588
NM_001171157,SIGLEC10,10,9,7784,3119,4665,518.3333333,311.9,1.49567169
NM_001171156,SIGLEC10,11,10,7784,3231,4553,455.3,293.7272727,1.40916125
NM_053003,SIGLEC12,8,7,10564,2266,8298,1185.428571,283.25,3.6619594
NM_014442,SIGLEC8,7,6,7459,2956,4503,750.5,422.2857143,1.523342355
NM_001245,SIGLEC6,8,7,12328,2130,10198,1456.857143,266.25,4.787793427
NM_001256795,LOC100129083,3,2,1521,732,789,394.5,244,1.077868852
NM_033329,SIGLEC12,7,6,9168,1875,7293,1215.5,267.8571429,3.8896
NM_001278392,CEACAM18,6,5,11964,1131,10833,2166.6,188.5,9.578249337
NM_007147,ZNF175,5,4,18462,3790,14672,3668,758,3.871240106
NM_001098612,SIGLEC14,7,6,4328,2120,2208,368,302.8571429,1.041509434
NM_003830,SIGLEC5,9,8,18973,2532,16441,2055.125,281.3333333,6.49328594
NM_001523,HAS1,5,4,10858,2092,8766,2191.5,418.4,4.190248566
NM_001462,FPR2,2,1,7139,2013,5126,5126,1006.5,2.546448087
NM_002029,FPR1,2,1,6126,1319,4807,4807,659.5,3.644427597
NM_001193306,FPR1,3,2,6129,1374,4755,2377.5,458,3.46069869
NM_001005738,FPR2,2,1,9328,1915,7413,7413,957.5,3.871018277
NM_001135590,ZNF577,7,6,16640,2937,13703,2283.833333,419.5714286,4.665645216
NM_023074,ZNF649,5,4,15819,3232,12587,3146.75,646.4,3.894492574
NM_032679,ZNF577,7,6,16680,3090,13590,2265,441.4285714,4.398058252
NM_002030,FPR3,2,1,30925,2519,28406,28406,1259.5,11.2766971
NM_025040,ZNF614,5,4,15105,4681,10424,2606,936.2,2.226874599
NM_024840,ZNF613,6,5,18325,2237,16088,3217.6,372.8333333,7.191774698
NM_021632,ZNF350,5,4,22488,2346,20142,5035.5,469.2,8.585677749
NM_198480,ZNF615,6,5,16898,4065,12833,2566.6,677.5,3.156949569
NM_001199324,ZNF615,7,6,16898,4099,12799,2133.166667,585.5714286,3.122468895
NM_014650,ZNF432,5,4,15398,2578,12820,3205,515.6,4.972847168
NM_001031721,ZNF613,6,5,18325,2345,15980,3196,390.8333333,6.814498934
NM_178523,ZNF616,4,3,25540,3051,22489,7496.333333,762.75,7.371025893
NM_001136499,ZNF841,7,6,31301,3883,27418,4569.666667,554.7142857,7.061035282
NM_001102657,ZNF836,5,4,16773,3338,13435,3358.75,667.6,4.024865189
NM_001010851,ZNF766,4,3,23154,2979,20175,6725,744.75,6.772406848
NM_014225,PPP2R1A,15,14,36625,2524,34101,2435.785714,168.2666667,13.51069731
NM_001161426,ZNF610,6,5,30880,2157,28723,5744.6,359.5,13.31617988
NM_001145434,ZNF880,4,3,15878,2266,13612,4537.333333,566.5,6.0070609
NM_032423,ZNF528,7,6,20538,3985,16553,2758.833333,569.2857143,4.153826851
NM_001161427,ZNF610,5,4,30880,2140,28740,7185,428,13.42990654
NM_001161425,ZNF610,6,5,30880,2270,28610,5722,378.3333333,12.60352423
NM_001143939,ZNF534,4,3,8034,2090,5944,1981.333333,522.5,2.844019139
NM_173530,ZNF610,6,5,21696,2126,19570,3914,354.3333333,9.205079962
NM_001143938,ZNF534,4,3,8034,2051,5983,1994.333333,512.75,2.917113603
NM_001039886,ZNF808,5,4,28396,3316,25080,6270,663.2,7.563329312
NM_001099694,ZNF578,6,5,63304,6747,56557,11311.4,1124.5,8.382540388
NM_018300,ZNF83,3,2,26028,2604,23424,11712,868,8.995391705
NM_001277952,ZNF83,5,4,26028,2851,23177,5794.25,570.2,8.129428271
NM_001277951,ZNF83,3,2,26028,2655,23373,11686.5,885,8.803389831
NM_001277949,ZNF83,5,4,78218,2913,75305,18826.25,582.6,25.85135599
NM_001277948,ZNF83,5,4,78218,2874,75344,18836,574.8,26.21572721
NM_001277947,ZNF83,6,5,78218,2947,75271,15054.2,491.1666667,25.5415677
NM_001277946,ZNF83,4,3,78218,2785,75433,25144.33333,696.25,27.08545781
NM_001277945,ZNF83,6,5,78218,3002,75216,15043.2,500.3333333,25.05529647
NM_001105552,ZNF83,4,3,26028,2732,23296,7765.333333,683,8.527086384
NM_001105551,ZNF83,5,4,26028,2857,23171,5792.75,571.4,8.110255513
NM_001105549,ZNF83,6,5,26028,2948,23080,4616,491.3333333,7.829036635
NM_001105550,ZNF83,5,4,26028,2831,23197,5799.25,566.2,8.193924408
NM_006969,ZNF28,4,3,24263,4598,19665,6555,1149.5,4.276859504
NM_198457,ZNF600,3,2,21288,2550,18738,9369,850,7.348235294
NM_001031665,ZNF816,5,4,13534,2752,10782,2695.5,550.4,3.917877907
NM_207333,ZNF320,4,3,15176,6149,9027,3009,1537.25,1.468043584
NM_001202473,ZNF816-ZNF321P,4,3,35778,2684,33094,11031.33333,671,12.33010432
NM_001202457,ZNF816,4,3,13534,2600,10934,3644.666667,650,4.205384615
NM_001202456,ZNF816,4,3,13534,2610,10924,3641.333333,652.5,4.185440613
NM_001102603,ZNF160,7,6,36822,4343,32479,5413.166667,620.4285714,7.478471103
NM_198893,ZNF160,7,6,36822,4311,32511,5418.5,615.8571429,7.541405706
NM_001191055,ERVV-2,2,1,6391,2484,3907,3907,1242,1.572866345
NM_152473,ERVV-1,1,0,2491,2491,NA,NA,2491,NA
NM_033288,ZNF160,6,5,36822,4225,32597,6519.4,704.1666667,7.715266272
NM_024733,ZNF665,4,3,30069,3295,26774,8924.666667,823.75,8.125644917
NM_032584,ZNF347,5,4,20367,4236,16131,4032.75,847.2,3.808073654
NM_001172675,ZNF347,5,4,20367,4239,16128,4032,847.8,3.804670913
NM_001172674,ZNF347,5,4,20358,4559,15799,3949.75,911.8,3.46545295
NM_001136038,ZNF415,4,3,25041,2534,22507,7502.333333,633.5,8.882004736
NM_018355,ZNF415,4,3,25043,2302,22741,7580.333333,575.5,9.878801043
NM_001164309,ZNF415,4,3,25041,2407,22634,7544.666667,601.75,9.40340673
NM_033341,BIRC8,1,0,2023,2023,NA,NA,2023,NA
NM_138374,ZNF845,4,3,21122,4315,16807,5602.333333,1078.75,3.895017381
NM_173857,VN1R4,1,0,907,907,NA,NA,907,NA
NM_173856,VN1R2,1,0,1312,1312,NA,NA,1312,NA
NM_001008401,ZNF761,7,6,26290,4219,22073,3678.833333,602.7142857,5.231808485
NM_001040185,ZNF765,4,3,16867,4581,12286,4095.333333,1145.25,2.681947173
NM_001004301,ZNF813,4,3,26559,4192,22367,7455.666667,1048,5.335639313
NM_001289951,ZNF761,6,5,26290,3999,22293,4458.6,666.5,5.574643661
NM_001289952,ZNF761,6,5,13263,4067,9198,1839.6,677.8333333,2.2616179
NM_001289953,ZNF761,5,4,4130,803,3329,832.25,160.6,4.145703611
NM_001079906,ZNF331,6,5,42192,4137,38055,7611,689.5,9.198694706
NM_001079907,ZNF331,6,5,24964,4157,20807,4161.4,692.8333333,5.005292278
NM_001253799,ZNF331,6,5,41985,4125,37860,7572,687.5,9.178181818
NM_001253798,ZNF331,7,6,41985,4156,37829,6304.833333,593.7142857,9.10226179
NM_001253801,ZNF331,5,4,25626,3900,21726,5431.5,780,5.570769231
NM_001253800,ZNF331,6,5,41483,4084,37399,7479.8,680.6666667,9.157443683
NM_018555,ZNF331,7,6,59348,5150,54198,9033,735.7142857,10.5238835
NM_001012728,DPRX,3,2,4955,651,4304,2152,217,6.611367127
NM_001277129,NLRP12,9,8,30804,3701,27103,3387.875,411.2222222,7.323155904
NM_001277126,NLRP12,10,9,30804,3876,26928,2992,387.6,6.947368421
NM_001020821,MYADM,3,2,7031,3189,3842,1921,1063,1.204766384
NM_001020820,MYADM,3,2,10080,3057,7023,3511.5,1019,2.297350343
NM_001020819,MYADM,3,2,8554,3121,5433,2716.5,1040.333333,1.740788209
NM_138373,MYADM,3,2,8554,3057,5497,2748.5,1019,1.798168139
NM_144687,NLRP12,10,9,30804,3873,26931,2992.333333,387.3,6.9535244
NM_001020818,MYADM,2,1,6910,3222,3688,3688,1611,1.144630664
NM_031897,CACNG6,2,1,20380,1639,18741,18741,819.5,11.43441123
NM_031896,CACNG7,5,4,30980,2350,28630,7157.5,470,12.18297872
NM_031895,CACNG8,4,3,27181,8755,18426,6142,2188.75,2.104625928
NM_145815,CACNG6,3,2,20380,1715,18665,9332.5,571.6666667,10.88338192
NM_145814,CACNG6,4,3,20380,1854,18526,6175.333333,463.5,9.992448759
NM_001135686,TARM1,5,4,11435,902,10533,2633.25,180.4,11.67738359
NM_133169,OSCAR,6,5,8063,1543,6520,1304,257.1666667,4.225534673
NM_133168,OSCAR,5,4,8063,1509,6554,1638.5,301.8,4.343273691
NM_130771,OSCAR,7,6,8063,1556,6507,1084.5,222.2857143,4.181876607
NM_001282350,OSCAR,4,3,8063,2022,6041,2013.666667,505.5,2.987636004
NM_001282349,OSCAR,5,4,8063,2056,6007,1501.75,411.2,2.921692607
NM_198481,VSTM1,9,8,23129,1031,22098,2762.25,114.5555556,21.43355965
NM_015629,PRPF31,14,13,16362,2197,14165,1089.615385,156.9285714,6.447428311
NM_013342,TFPT,6,5,8737,1211,7526,1505.2,201.8333333,6.214698596
NM_001288791,VSTM1,9,8,23129,822,22307,2788.375,91.33333333,27.13746959
NM_206818,OSCAR,6,5,8063,2069,5994,1198.8,344.8333333,2.897051716
NM_004542,NDUFA3,4,3,4123,358,3765,1255,89.5,10.51675978
NM_001288792,VSTM1,8,7,23129,937,22192,3170.285714,117.125,23.68409819
NM_001288793,VSTM1,6,5,23129,668,22461,4492.2,111.3333333,33.6242515
NM_006840,LILRB5,13,12,6899,2277,4622,385.1666667,175.1538462,2.029863856
NM_001282333,TSEN34,6,5,4277,1921,2356,471.2,320.1666667,1.22644456
NM_001282332,TSEN34,5,4,3814,2426,1388,347,485.2,0.572135202
NM_001278406,LILRB2,8,7,3004,1423,1581,225.8571429,177.875,1.111033029
NM_001278403,LILRB2,14,13,7065,2798,4267,328.2307692,199.8571429,1.52501787
NM_001278404,LILRB2,13,12,7360,2787,4573,381.0833333,214.3846154,1.640832436
NM_024316,LENG1,4,3,4069,892,3177,1059,223,3.561659193
NM_001146083,MBOAT7,7,6,16629,2479,14150,2358.333333,354.1428571,5.707946753
NM_001146056,MBOAT7,6,5,16629,2399,14230,2846,399.8333333,5.931638183
NM_024075,TSEN34,5,4,4277,2302,1975,493.75,460.4,0.857949609
NM_001080978,LILRB2,14,13,7360,2936,4424,340.3076923,209.7142857,1.506811989
NM_001077446,TSEN34,4,3,3331,2265,1066,355.3333333,566.25,0.470640177
NM_001145303,TMC4,15,14,13113,2496,10617,758.3571429,166.4,4.253605769
NM_024318,LILRA6,8,7,3783,1455,2328,332.5714286,181.875,1.6
NM_024298,MBOAT7,8,7,16629,2607,14022,2003.142857,325.875,5.378596087
NM_005874,LILRB2,14,13,7360,2939,4421,340.0769231,209.9285714,1.504253147
NM_001013,RPS9,5,4,6791,718,6073,1518.25,143.6,8.45821727
NM_001278405,LILRB2,12,11,6719,2636,4083,371.1818182,219.6666667,1.548937785
NM_001146082,MBOAT7,7,6,11743,2076,9667,1611.166667,296.5714286,4.65655106
NM_001081443,LILRB5,12,11,6899,1979,4920,447.2727273,164.9166667,2.486104093
NM_001081442,LILRB5,13,12,6899,2280,4619,384.9166667,175.3846154,2.025877193
NM_144686,TMC4,15,14,13113,2478,10635,759.6428571,165.2,4.291767554
NM_001081450,LILRB3,13,12,26566,2838,23728,1977.333333,218.3076923,8.360817477
NM_006864,LILRB3,13,12,26566,2835,23731,1977.583333,218.0769231,8.370723104
NM_012276,LILRA4,8,7,5731,1716,4015,573.5714286,214.5,2.33974359
NM_006865,LILRA3,7,6,4412,1610,2802,467,230,1.740372671
NM_021250,LILRA5,7,6,6058,1372,4686,781,196,3.415451895
NM_001172654,LILRA3,7,6,4368,1374,2994,499,196.2857143,2.179039301
NM_181986,LILRA5,4,3,1976,1049,927,309,262.25,0.883698761
NM_181879,LILRA5,5,4,1976,1086,890,222.5,217.2,0.819521179
NM_181985,LILRA5,6,5,6058,1335,4723,944.6,222.5,3.537827715
NM_001289023,LAIR1,9,8,11489,2772,8717,1089.625,308,3.144660895
NM_001289025,LAIR1,10,9,11489,2824,8665,962.7777778,282.4,3.068342776
NM_002287,LAIR1,10,9,11489,2827,8662,962.4444444,282.7,3.064025469
NM_021706,LAIR1,9,8,11489,2775,8714,1089.25,308.3333333,3.14018018
NM_001289026,LAIR1,10,9,16928,2772,14156,1572.888889,277.2,5.106782107
NM_001289027,LAIR1,9,8,16928,2738,14190,1773.75,304.2222222,5.182615047
NM_020659,TTYH1,14,13,21296,1918,19378,1490.615385,137,10.10323253
NM_002288,LAIR2,5,4,7889,707,7182,1795.5,141.4,10.15841584
NM_001201461,TTYH1,14,13,21296,1921,19375,1490.384615,137.2142857,10.08589276
NM_021270,LAIR2,4,3,7889,655,7234,2411.333333,163.75,11.04427481
NM_001005367,TTYH1,13,12,21296,1871,19425,1618.75,143.9230769,10.38214858
NM_198988,LENG9,1,0,1917,1917,NA,NA,1917,NA
NM_145057,CDC42EP5,3,2,8230,894,7336,3668,298,8.205816555
NM_052925,LENG8,16,15,13133,3986,9147,609.8,249.125,2.294781736
NM_006669,LILRB1,16,15,20622,3229,17393,1159.533333,201.8125,5.386497368
NM_006866,LILRA2,7,6,13772,1711,12061,2010.166667,244.4285714,7.049094097
NM_001278430,LILRB4,6,5,2389,1005,1384,276.8,167.5,1.377114428
NM_001278399,LILRB1,9,8,3668,1699,1969,246.125,188.7777778,1.15891701
NM_001278398,LILRB1,14,13,7038,2759,4279,329.1538462,197.0714286,1.550924248
NM_001278319,LILRA1,7,6,5525,1801,3724,620.6666667,257.2857143,2.067740144
NM_001278318,LILRA1,8,7,8807,2696,6111,873,337,2.266691395
NM_001130917,LILRA2,8,7,13772,1763,12009,1715.571429,220.375,6.811684628
NM_001081639,LILRB1,15,14,7144,2917,4227,301.9285714,194.4666667,1.449091532
NM_001081638,LILRB1,15,14,7144,2917,4227,301.9285714,194.4666667,1.449091532
NM_001081637,LILRB1,15,14,7038,2814,4224,301.7142857,187.6,1.501066098
NM_006863,LILRA1,10,9,8807,3298,5509,612.1111111,329.8,1.670406307
NM_015868,KIR2DL3,8,7,14532,1604,12928,1846.857143,200.5,8.059850374
NM_153443,KIR3DL3,8,7,12021,1699,10322,1474.571429,212.375,6.075338434
NM_014218,KIR2DL1,8,7,14515,1606,12909,1844.142857,200.75,8.037982565
NM_002000,FCAR,5,4,16292,1676,14616,3654,335.2,8.720763723
NM_001242867,KIR3DL2,8,7,16774,1842,14932,2133.142857,230.25,8.10640608
NM_001242357,NCR1,5,4,6933,822,6111,1527.75,164.4,7.434306569
NM_001242356,NCR1,6,5,6933,874,6059,1211.8,145.6666667,6.932494279
NM_001080770,KIR2DL4,7,6,10907,1482,9425,1570.833333,211.7142857,6.359649123
NM_001281972,KIR2DS4,7,6,15895,1564,14331,2388.5,223.4285714,9.163043478
NM_001281971,KIR2DS4,8,7,15895,1616,14279,2039.857143,202,8.836014851
NM_133279,FCAR,4,3,14892,1628,13264,4421.333333,407,8.147420147
NM_133278,FCAR,4,3,16292,1573,14719,4906.333333,393.25,9.357279085
NM_133274,FCAR,4,3,16292,1565,14727,4909,391.25,9.410223642
NM_133273,FCAR,3,2,16292,1350,14942,7471,450,11.06814815
NM_133272,FCAR,4,3,16292,1639,14653,4884.333333,409.75,8.940207444
NM_133271,FCAR,4,3,16292,1387,14905,4968.333333,346.75,10.74621485
NM_133269,FCAR,5,4,16292,1610,14682,3670.5,322,9.119254658
NM_006737,KIR3DL2,9,8,16774,1894,14880,1860,210.4444444,7.856388596
NM_013289,KIR3DL1,9,8,14342,1910,12432,1554,212.2222222,6.508900524
NM_012314,KIR2DS4,8,7,15895,1616,14279,2039.857143,202,8.836014851
NM_002255,KIR2DL4,8,7,10907,1587,9320,1331.428571,198.375,5.872715816
NM_133277,FCAR,3,2,16292,1347,14945,7472.5,449,11.09502598
NM_001145458,NCR1,6,5,6933,1108,5825,1165,184.6666667,5.257220217
NM_001145457,NCR1,7,6,6933,1157,5776,962.6666667,165.2857143,4.992221262
NM_001080772,KIR2DL4,8,7,10907,1587,9320,1331.428571,198.375,5.872715816
NM_004829,NCR1,7,6,6933,1160,5773,962.1666667,165.7142857,4.976724138
NM_001174083,NLRP2,14,13,34801,3520,31281,2406.230769,251.4285714,8.886647727
NM_001174082,NLRP2,12,11,34801,3521,31280,2843.636364,293.4166667,8.883839818
NM_001174081,NLRP2,13,12,35860,3557,32303,2691.916667,273.6153846,9.081529379
NM_001083899,GP6,8,7,24559,2274,22285,3183.571429,284.25,9.799912049
NM_016363,GP6,8,7,24559,2270,22289,3184.142857,283.75,9.818942731
NM_017852,NLRP2,13,12,34801,3588,31213,2601.083333,276,8.699275362
NM_001256017,GP6,7,6,24559,2215,22344,3724,316.4285714,10.08758465
NM_003283,TNNT1,14,13,16447,1062,15385,1183.461538,75.85714286,14.48681733
NM_003180,SYT5,9,8,7253,1834,5419,677.375,203.7777778,2.95474373
NM_001126132,TNNT1,14,13,16447,1014,15433,1187.153846,72.42857143,15.2199211
NM_000363,TNNI3,7,6,5966,848,5118,853,121.1428571,6.035377358
NM_133180,EPS8L1,20,19,12072,2605,9467,498.2631579,130.25,3.634165067
NM_001256716,DNAAF3,12,11,8063,2330,5733,521.1818182,194.1666667,2.460515021
NM_001256715,DNAAF3,12,11,8063,2243,5820,529.0909091,186.9166667,2.594739189
NM_001256714,DNAAF3,12,11,8063,2314,5749,522.6363636,192.8333333,2.484442524
NM_017729,EPS8L1,15,14,7533,2217,5316,379.7142857,147.8,2.397834912
NM_178837,DNAAF3,12,11,8063,2254,5809,528.0909091,187.8333333,2.577196096
NM_001271618,PPP1R12C,22,21,26689,2981,23708,1128.952381,135.5,7.953035894
NM_017607,PPP1R12C,22,21,26689,2987,23702,1128.666667,135.7727273,7.935051892
NM_001126133,TNNT1,13,12,16447,980,15467,1288.916667,75.38461538,15.78265306
NM_012267,HSPBP1,8,7,18162,1916,16246,2320.857143,239.5,8.479123173
NM_001130106,HSPBP1,9,8,18162,1808,16354,2044.25,200.8888889,9.045353982
NM_014931,PPP6R1,24,23,28893,3661,25232,1097.043478,152.5416667,6.892105982
NM_032430,BRSK1,19,18,28371,3100,25271,1403.944444,163.1578947,8.151935484
NM_173804,TMEM86B,3,2,2632,1754,878,439,584.6666667,0.500570125
NM_032701,SUV420H2,9,8,8270,2318,5952,744,257.5555556,2.567730802
NM_001145176,SHISA7,4,3,14127,6039,8088,2696,1509.75,1.339294585
NM_001136137,RPL28,4,3,1789,686,1103,367.6666667,171.5,1.60787172
NM_001136136,RPL28,3,2,1110,597,513,256.5,199,0.859296482
NM_001136134,RPL28,4,3,6153,4405,1748,582.6666667,1101.25,0.396821793
NM_014501,UBE2S,4,3,6677,1195,5482,1827.333333,298.75,4.587447699
NM_000991,RPL28,5,4,6153,4212,1941,485.25,842.4,0.460826211
NM_001267718,IL11,4,3,6083,2209,3874,1291.333333,552.25,1.753734722
NM_001136135,RPL28,5,4,6153,901,5252,1313,180.2,5.829078801
NM_139172,TMEM190,5,4,1410,598,812,203,119.6,1.357859532
NM_144613,COX6B2,5,4,5114,1668,3446,861.5,333.6,2.065947242
NM_001190764,TMEM238,2,1,5017,664,4353,4353,332,6.555722892
NM_000641,IL11,5,4,6083,2383,3700,925,476.6,1.552664708
NM_001145402,FAM71E2,11,10,8346,3194,5152,515.2,290.3636364,1.613024421
NM_001101401,SBK2,4,3,7337,1066,6271,2090.333333,266.5,5.882739212
NM_033113,ZNF628,3,2,8157,3850,4307,2153.5,1283.333333,1.118701299
NM_001144950,SSC5D,14,13,30598,4924,25674,1974.923077,351.7142857,5.214053615
NM_001199824,SBK3,4,3,4888,1273,3615,1205,318.25,2.839748625
NM_152600,ZNF579,2,1,3322,2170,1152,1152,1085,0.530875576
NM_020378,NAT14,3,2,2380,1353,1027,513.5,451,0.759053954
NM_001195267,SSC5D,13,12,15823,3094,12729,1060.75,238,4.114091791
NM_016535,ZNF581,2,1,2005,1228,777,777,614,0.632736156
NM_203374,ZNF784,2,1,3836,1998,1838,1838,999,0.91991992
NM_007279,U2AF2,12,11,20668,3143,17525,1593.181818,261.9166667,5.575882914
NM_001130072,EPN1,11,10,20574,2495,18079,1807.9,226.8181818,7.246092184
NM_001130071,EPN1,11,10,19144,2958,16186,1618.6,268.9090909,5.4719405
NM_032836,FIZ1,3,2,8158,2663,5495,2747.5,887.6666667,2.063462261
NM_001163423,ZNF580,2,1,1375,1028,347,347,514,0.337548638
NM_153219,ZNF524,2,1,2776,1111,1665,1665,555.5,1.498649865
NM_013333,EPN1,10,9,20574,2416,18158,2017.555556,241.6,7.515728477
NM_013301,CCDC106,6,5,5574,1998,3576,715.2,333,1.78978979
NM_016202,ZNF580,1,0,1420,1420,NA,NA,1420,NA
NM_001195605,ZNF865,1,0,4950,4950,NA,NA,4950,NA
NM_001012478,U2AF2,12,11,20668,3131,17537,1594.272727,260.9166667,5.601085915
NM_207115,ZNF580,2,1,2446,1134,1312,1312,567,1.15696649
NM_145007,NLRP11,12,11,51367,4053,47314,4301.272727,337.75,11.67382186
NM_001277397,RFPL4AL1,2,1,1376,866,510,510,433,0.58891455
NM_001145014,RFPL4A,3,2,4036,911,3125,1562.5,303.6666667,3.430296378
NM_176810,NLRP13,11,10,36393,3168,33225,3322.5,288,10.48768939
NM_153447,NLRP5,15,14,62084,3898,58186,4156.142857,259.8666667,14.92714212
NM_001080456,ZSCAN5B,4,3,3365,1630,1735,578.3333333,407.5,1.064417178
NM_033106,GALP,6,5,9757,944,8813,1762.6,157.3333333,9.335805085
NM_001145546,GALP,5,4,9757,894,8863,2215.75,178.8,9.913870246
NM_024303,ZSCAN5A,5,4,6982,1927,5055,1263.75,385.4,2.623248573
NM_001253792,ZNF444,5,4,19729,2066,17663,4415.75,413.2,8.549370765
NM_018337,ZNF444,5,4,19729,2069,17660,4415,413.8,8.535524408
NM_022103,ZNF667,5,4,38079,3865,34214,8553.5,773,8.852263907
NM_152478,ZNF583,5,4,20708,2595,18113,4528.25,519,6.979961464
NM_001159861,ZNF583,5,4,20684,2548,18136,4534,509.6,7.117739403
NM_001159860,ZNF583,5,4,21019,2543,18476,4619,508.6,7.265434526
NM_144690,ZNF582,5,4,10243,2302,7941,1985.25,460.4,3.449609036
NM_021216,ZNF71,3,2,28882,3130,25752,12876,1043.333333,8.227476038
NM_020828,ZFP28,8,7,17855,4095,13760,1965.714286,511.875,3.36019536
NM_020813,ZNF471,5,4,21059,4971,16088,4022,994.2,3.236370952
NM_001001668,ZNF470,6,5,15374,7147,8227,1645.4,1191.166667,1.151112355
NM_001193628,SMIM17,4,3,14089,2546,11543,3847.666667,636.5,4.533778476
NM_001005850,ZNF835,2,1,9105,2776,6329,6329,1388,2.279899135
NM_001146327,ZIM2,12,11,66176,2272,63904,5809.454545,189.3333333,28.12676056
NM_001146326,ZIM2,12,11,66176,2185,63991,5817.363636,182.0833333,29.28649886
NM_015363,ZIM2,11,10,66176,2108,64068,6406.8,191.6363636,30.39278937
NM_001146187,PEG3,9,8,30651,8384,22267,2783.375,931.5555556,2.655892176
NM_001146186,PEG3,7,6,14931,8723,6208,1034.666667,1246.142857,0.711681761
NM_001146185,PEG3,9,8,30651,8378,22273,2784.125,930.8888889,2.658510384
NM_001146184,PEG3,9,8,30651,8692,21959,2744.875,965.7777778,2.526346065
NM_006210,PEG3,10,9,30651,8769,21882,2431.333333,876.9,2.495381457
NM_052882,ZIM3,5,4,11108,2632,8476,2119,526.4,3.220364742
NM_020903,USP29,4,3,11786,3610,8176,2725.333333,902.5,2.264819945
NM_001023563,ZNF805,4,3,22055,10130,11925,3975,2532.5,1.177196446
NM_003417,ZNF264,4,3,31348,12167,19181,6393.666667,3041.75,1.576477357
NM_003160,AURKC,7,6,4541,1121,3420,570,160.1428571,3.050847458
NM_001015879,AURKC,7,6,4541,1116,3425,570.8333333,159.4285714,3.068996416
NM_001145078,ZNF805,3,2,22055,10002,12053,6026.5,3334,1.205058988
NM_001015878,AURKC,7,6,4490,1257,3233,538.8333333,179.5714286,2.571996818
NM_020657,ZNF304,3,2,8622,4419,4203,2101.5,1473,0.951120163
NM_213598,ZNF543,4,3,10281,3675,6606,2202,918.75,1.79755102
NM_001172773,ZNF548,4,3,12703,4554,8149,2716.333333,1138.5,1.789415898
NM_006959,ZNF17,3,2,10780,2681,8099,4049.5,893.6666667,3.020887728
NM_152909,ZNF548,3,2,12703,4517,8186,4093,1505.666667,1.812264778
NM_173631,ZNF547,4,3,16036,2778,13258,4419.333333,694.5,4.7724982
NM_001098494,ZNF419,4,3,6971,2271,4700,1566.666667,567.75,2.069572875
NM_001098493,ZNF419,4,3,6971,2328,4643,1547.666667,582,1.994415808
NM_001098492,ZNF419,4,3,6971,2331,4640,1546.666667,582.75,1.990561991
NM_001098491,ZNF419,5,4,6971,2371,4600,1150,474.2,1.940109658
NM_198542,ZNF773,4,3,8203,2191,6012,2004,547.75,2.743952533
NM_001024596,ZNF772,5,4,7986,5424,2562,640.5,1084.8,0.472345133
NM_001023561,ZNF749,3,2,10500,2932,7568,3784,977.3333333,2.581173261
NM_001199295,ZNF549,4,3,13553,4125,9428,3142.666667,1031.25,2.285575758
NM_153263,ZNF549,3,2,13553,4085,9468,4734,1361.666667,2.317747858
NM_020633,VN1R1,1,0,1567,1567,NA,NA,1567,NA
NM_001144068,ZNF772,4,3,7986,5300,2686,895.3333333,1325,0.506792453
NM_001098496,ZNF419,3,2,6971,2228,4743,2371.5,742.6666667,2.128815081
NM_001098495,ZNF419,3,2,6971,2231,4740,2370,743.6666667,2.124607799
NM_024691,ZNF419,5,4,6971,2368,4603,1150.75,473.6,1.943834459
NM_003435,ZNF134,3,2,7808,2251,5557,2778.5,750.3333333,2.468680586
NM_198855,ZNF211,3,2,9614,2476,7138,3569,825.3333333,2.882875606
NM_001010879,ZIK1,4,3,8132,2680,5452,1817.333333,670,2.034328358
NM_020880,ZNF530,3,2,8386,2967,5419,2709.5,989,1.826423997
NM_001265600,ZNF211,3,2,9614,2286,7328,3664,762,3.2055993
NM_001265599,ZNF211,5,4,9614,2483,7131,1782.75,496.6,2.871929118
NM_006385,ZNF211,4,3,9614,2516,7098,2366,629,2.821144674
NM_017879,ZNF416,4,3,7311,2513,4798,1599.333333,628.25,1.909271787
NM_001265598,ZNF211,4,3,9614,2633,6981,2327,658.25,2.651348272
NM_001265597,ZNF211,5,4,9614,2673,6941,1735.25,534.6,2.596707819
NM_152677,ZSCAN4,5,4,10219,2251,7968,1992,450.2,3.539760107
NM_024762,ZNF552,3,2,7833,2355,5478,2739,785,2.32611465
NM_024833,ZNF671,4,3,7878,2438,5440,1813.333333,609.5,2.231337162
NM_017652,ZNF586,3,2,10966,2223,8743,4371.5,741,3.932973459
NM_001204814,ZNF586,4,3,10966,2274,8692,2897.333333,568.5,3.82233949
NM_001085384,ZNF154,3,2,8771,2750,6021,3010.5,916.6666667,2.189454545
NM_001077426,ZNF586,2,1,10966,2095,8871,8871,1047.5,4.234367542
NM_173632,ZNF776,3,2,11365,5295,6070,3035,1765,1.146364495
NM_001204818,ZNF587B,4,3,15946,3344,12602,4200.666667,836,3.76854067
NM_001204817,ZNF587,3,2,15312,6937,8375,4187.5,2312.333333,1.207294219
NM_032828,ZNF587,3,2,15312,6940,8372,4186,2313.333333,1.206340058
NM_133460,ZNF418,6,5,13490,3700,9790,1958,616.6666667,2.645945946
NM_152475,ZNF417,3,2,10838,4706,6132,3066,1568.666667,1.303017425
NM_001144989,ZNF814,3,2,19697,6286,13411,6705.5,2095.333333,2.133471206
NM_001289401,ZNF135,5,4,10505,3369,7136,1784,673.8,2.118135945
NM_001289402,ZNF135,5,4,10505,3732,6773,1693.25,746.4,1.814844587
NM_025027,ZNF606,7,6,26275,4232,22043,3673.833333,604.5714286,5.208648393
NM_007134,ZNF135,4,3,10505,3337,7168,2389.333333,834.25,2.148037159
NM_152474,C19orf18,6,5,16099,921,15178,3035.6,153.5,16.47991314
NM_003436,ZNF135,5,4,10505,3400,7105,1776.25,680,2.089705882
NM_001164529,ZNF135,4,3,10505,2942,7563,2521,735.5,2.570700204
NM_001164527,ZNF135,3,2,4699,693,4006,2003,231,5.780663781
NM_001164530,ZNF135,5,4,10505,2462,8043,2010.75,492.4,3.266856214
NM_182572,ZSCAN1,6,5,20567,2060,18507,3701.4,343.3333333,8.983980583
NM_024620,ZNF329,4,3,24455,3417,21038,7012.666667,854.25,6.156862745
NM_001145544,ZSCAN18,6,5,14523,2225,12298,2459.6,370.8333333,5.527191011
NM_001145543,ZSCAN18,7,6,14523,2692,11831,1971.833333,384.5714286,4.3948737
NM_023926,ZSCAN18,7,6,14523,2936,11587,1931.166667,419.4285714,3.946525886
NM_001145542,ZSCAN18,7,6,34586,2581,32005,5334.166667,368.7142857,12.40023247
NM_021089,ZNF8,4,3,16938,2214,14724,4908,553.5,6.650406504
NM_014480,ZNF544,7,6,34940,3517,31423,5237.166667,502.4285714,8.934603355
NM_001195135,LOC646862,1,0,991,991,NA,NA,991,NA
NM_130786,A1BG,8,7,6695,1774,4921,703,221.75,2.773957159
NM_003433,ZNF132,3,2,7410,3034,4376,2188,1011.333333,1.442320369
NM_198458,ZNF497,3,2,8493,3565,4928,2464,1188.333333,1.382328191
NM_138466,ZNF837,3,2,13401,1934,11467,5733.5,644.6666667,5.929162358
NM_001009,RPS5,6,5,7537,747,6790,1358,124.5,9.089692102
NM_001207009,ZNF497,2,1,8493,3467,5026,5026,1733.5,1.449668301
NM_207395,ZNF324B,4,3,6230,2999,3231,1077,749.75,1.07735912
NM_173548,ZNF584,4,3,9631,2263,7368,2456,565.75,3.25585506
NM_003422,MZF1,6,5,11660,2609,9051,1810.2,434.8333333,3.469145266
NM_032792,ZBTB45,3,2,6026,2355,3671,1835.5,785,1.55881104
NM_198426,CHMP2A,6,5,3439,921,2518,503.6,153.5,2.733984799
NM_014453,CHMP2A,6,5,3560,919,2641,528.2,153.1666667,2.873775843
NM_012254,SLC27A5,10,9,13734,2375,11359,1262.111111,237.5,4.782736842
NM_198055,MZF1,6,5,11660,2927,8733,1746.6,487.8333333,2.983600957
NM_017908,ZNF446,7,6,4804,1981,2823,470.5,283,1.42503786
NM_001267033,MZF1,6,5,11660,2683,8977,1795.4,447.1666667,3.345881476
NM_005762,TRIM28,17,16,6248,2976,3272,204.5,175.0588235,1.099462366
NM_003969,UBE2M,6,5,3266,1530,1736,347.2,255,1.134640523
NM_182734,PLCB1,33,32,752637,7240,745397,23293.65625,219.3939394,102.9553867
NM_015192,PLCB1,32,31,752637,7121,745516,24048.90323,222.53125,104.6925994
NM_020884,MYH7B,45,44,46538,6563,39975,908.5227273,145.8444444,6.090964498
NM_006045,ATP9A,28,27,171596,7608,163988,6073.62963,271.7142857,21.55467928
NM_080836,STK35,4,3,46672,6415,40257,13419,1603.75,6.275448168
NM_001282533,LZTS3,6,5,10977,4107,6870,1374,684.5,1.672753835
NM_182797,PLCB4,36,35,263427,5468,257959,7370.257143,151.8888889,47.17611558
NM_001009608,SLX4IP,8,7,188078,1415,186663,26666.14286,176.875,131.9173145
NM_080676,MACROD2,17,16,2057697,4879,2052818,128301.125,287,420.7456446
NM_000933,PLCB4,36,35,173017,5442,167575,4787.857143,151.1666667,30.79290702
NM_001033087,MACROD2,14,13,856339,4438,851901,65530.84615,317,191.9560613
NM_001172646,PLCB4,38,37,411763,5659,406104,10975.78378,148.9210526,71.76250221
NM_001242581,RIN2,12,11,115940,4519,111421,10129.18182,376.5833333,24.65611861
NM_018993,RIN2,11,10,112895,4258,108637,10863.7,387.0909091,25.51362142
NM_033118,MYLK2,13,12,15324,2806,12518,1043.166667,215.8461538,4.461154669
NM_007050,PTPRT,31,30,1117167,12668,1104499,36816.63333,408.6451613,87.18811178
NM_133170,PTPRT,32,31,1117167,12726,1104441,35627.12903,397.6875,86.78618576
NM_001207076,CNBD2,11,10,62095,1780,60315,6031.5,161.8181818,33.88483146
NM_021215,RPRD1B,7,6,58820,3879,54941,9156.833333,554.1428571,14.16370199
NM_183404,RBL1,21,20,92428,3257,89171,4458.55,155.0952381,27.3782622
NM_002895,RBL1,22,21,99650,5708,93942,4473.428571,259.4545455,16.45795375
NM_080834,CNBD2,12,11,62095,1939,60156,5468.727273,161.5833333,31.0242393
NM_015035,ZHX3,4,3,121652,9995,111657,37219,2498.75,11.17128564
NM_175914,HNF4A,10,9,77046,4553,72493,8054.777778,455.3,15.92202943
NM_001030004,HNF4A,8,7,68837,1457,67380,9625.714286,182.125,46.24571036
NM_001030003,HNF4A,10,9,77046,4523,72523,8058.111111,452.3,16.03426929
NM_001174088,NCOA3,23,22,155022,7992,147030,6683.181818,347.4782609,18.39714715
NM_006534,NCOA3,23,22,155022,8007,147015,6682.5,348.1304348,18.36080929
NM_001174087,NCOA3,23,22,155022,8016,147006,6682.090909,348.5217391,18.33907186
NM_001287184,HNF4A,9,8,68837,1680,67157,8394.625,186.6666667,39.97440476
NM_181659,NCOA3,23,22,155022,8019,147003,6681.954545,348.6521739,18.33183689
NM_001287182,HNF4A,11,10,77046,4746,72300,7230,431.4545455,15.23388116
NM_001287183,HNF4A,11,10,77046,4776,72270,7227,434.1818182,15.13190955
NM_001278649,OSBPL2,13,12,57730,3844,53886,4490.5,295.6923077,14.0182102
NM_014835,OSBPL2,14,13,57730,3988,53742,4134,284.8571429,13.47592778
NM_144498,OSBPL2,14,13,57730,4024,53706,4131.230769,287.4285714,13.34642147
NM_006462,RBCK1,11,10,22903,2628,20275,2027.5,238.9090909,7.71499239
NM_031229,RBCK1,12,11,22903,2774,20129,1829.909091,231.1666667,7.25630858
NM_177560,CSNK2A1,12,11,61146,2521,58625,5329.545455,210.0833333,23.25466085
NM_177559,CSNK2A1,14,13,61146,2850,58296,4484.307692,203.5714286,20.45473684
NM_033129,SCRT2,2,1,14585,3579,11006,11006,1789.5,3.075160659
NM_080571,C20orf96,11,10,19917,1619,18298,1829.8,147.1818182,11.3020383
NM_001895,CSNK2A1,13,12,61146,2732,58414,4867.833333,210.1538462,21.38140556
NM_153269,C20orf96,11,10,19917,1615,18302,1830.2,146.8181818,11.33250774
NM_024411,PDYN,4,3,15531,2790,12741,4247,697.5,4.566666667
NM_016143,NSFL1C,9,8,25532,3577,21955,2744.375,397.4444444,6.137824993
NM_001206736,NSFL1C,9,8,25532,3583,21949,2743.625,398.1111111,6.125872174
NM_001190899,PDYN,3,2,15531,2729,12802,6401,909.6666667,4.691095639
NM_001190892,PDYN,3,2,14052,2577,11475,5737.5,859,4.452852154
NM_006065,SIRPB1,6,5,55662,2419,53243,10648.6,403.1666667,22.01033485
NM_001083910,SIRPB1,4,3,55662,1766,53896,17965.33333,441.5,30.5186863
NM_018839,NSFL1C,8,7,25532,3483,22049,3149.857143,435.375,6.330462245
NM_001190898,PDYN,4,3,15531,2787,12744,4248,696.75,4.572658773
NM_001190900,PDYN,4,3,14994,2477,12517,4172.333333,619.25,5.05329027
NM_002836,PTPRA,28,27,174476,3648,170828,6326.962963,130.2857143,46.82785088
NM_080841,PTPRA,23,22,115464,3159,112305,5104.772727,137.3478261,35.55080722
NM_080840,PTPRA,23,22,165175,3334,161841,7356.409091,144.9565217,48.54259148
NM_080751,TMC2,20,19,105179,3189,101990,5367.894737,159.45,31.98181248
NM_001282495,ZNF343,7,6,42704,3562,39142,6523.666667,508.8571429,10.98877035
NM_001134338,RNF24,7,6,84149,3304,80845,13474.16667,472,24.46882567
NM_001134337,RNF24,6,5,84149,3234,80915,16183,539,25.02009895
NM_001009984,C20orf194,37,36,158363,6946,151417,4206.027778,187.7297297,21.79916499
NM_023068,SIGLEC1,21,20,20160,6741,13419,670.95,321,1.990654206
NM_007219,RNF24,6,5,83987,3364,80623,16124.6,560.6666667,23.96640904
NM_001207047,ATRN,25,24,144887,3609,141278,5886.583333,144.36,39.14602383
NM_139322,ATRN,25,24,144887,3992,140895,5870.625,159.68,35.29433868
NM_139321,ATRN,29,28,180106,8684,171422,6122.214286,299.4482759,19.73998158
NM_203327,SLC23A2,17,16,157939,6979,150960,9435,410.5294118,21.6306061
NM_003818,CDS2,13,12,71128,9336,61792,5149.333333,718.1538462,6.618680377
NM_005116,SLC23A2,17,16,149145,6961,142184,8886.5,409.4705882,20.42580089
NM_152611,LRRN4,5,4,13536,2960,10576,2644,592,3.572972973
NM_001819,CHGB,5,4,14033,2655,11378,2844.5,531,4.285499058
NM_152504,C20orf196,3,2,113518,1158,112360,56180,386,97.02936097
NM_021156,TMX4,8,7,38679,2373,36306,5186.571429,296.625,15.29962073
NM_017545,HAO1,8,7,57464,1754,55710,7958.571429,219.25,31.76168757
NM_003081,SNAP25,8,7,88591,2062,86529,12361.28571,257.75,41.96362755
NM_130811,SNAP25,8,7,88591,2062,86529,12361.28571,257.75,41.96362755
NM_020341,PAK7,11,10,301652,4788,296864,29686.4,435.2727273,62.00167084
NM_177990,PAK7,10,9,301652,4681,296971,32996.77778,468.1,63.44178594
NM_018327,SPTLC3,12,11,157786,3857,153929,13993.54545,321.4166667,39.90899663
NM_017714,TASP1,14,13,249549,2365,247184,19014.15385,168.9285714,104.5175476
NM_080826,ISM1,6,5,78881,2598,76283,15256.6,433,29.36220169
NM_001276380,ESF1,14,13,70612,3219,67393,5184.076923,229.9285714,20.93600497
NM_016649,ESF1,14,13,70565,3230,67335,5179.615385,230.7142857,20.84674923
NM_001271539,SEL1L2,18,17,141223,1918,139305,8194.411765,106.5555556,72.63034411
NM_024704,KIF16B,26,25,301332,5288,296044,11841.76,203.3846154,55.98411498
NM_001199866,KIF16B,23,22,206593,4664,201929,9178.590909,202.7826087,43.29524014
NM_001199865,KIF16B,25,24,301332,5134,296198,12341.58333,205.36,57.69341644
NM_001011546,DSTN,5,4,38055,1751,36304,9076,350.2,20.73329526
NM_006870,DSTN,4,3,38055,1618,36437,12145.66667,404.5,22.5197775
NM_001201528,PCSK2,13,12,258472,4686,253786,21148.83333,360.4615385,54.158344
NM_178477,BANF2,4,3,35926,612,35314,11771.33333,153,57.70261438
NM_001014977,BANF2,3,2,35926,448,35478,17739,149.3333333,79.19196429
NM_001159495,BANF2,3,2,42199,372,41827,20913.5,124,112.438172
NM_001201529,PCSK2,11,10,257627,4684,252943,25294.3,425.8181818,54.00149445
NM_002594,PCSK2,12,11,257627,4790,252837,22985.18182,399.1666667,52.78434238
NM_080820,DTD1,6,5,176006,1373,174633,34926.6,228.8333333,127.190823
NM_052865,MGME1,5,4,22002,2132,19870,4967.5,426.4,9.31988743
NM_020689,SLC24A3,17,16,510253,3906,506347,31646.6875,229.7647059,129.6331285
NM_015585,C20orf26,27,26,308190,4147,304043,11693.96154,153.5925926,73.31637328
NM_020343,RALGAPA2,40,39,322996,9466,313530,8039.230769,236.65,33.12169871
NM_001167816,C20orf26,13,12,115689,1959,113730,9477.5,150.6923077,58.05513017
NM_012255,XRN2,30,29,86523,3465,83058,2864.068966,115.5,23.97056277
NM_024893,SYNDIG1,4,3,197420,2527,194893,64964.33333,631.75,77.12425801
NM_001252677,ACSS1,12,11,51954,2450,49504,4500.363636,204.1666667,20.20571429
NM_032501,ACSS1,14,13,51954,3696,48258,3712.153846,264,13.05681818
NM_001252675,ACSS1,14,13,51954,3690,48264,3712.615385,263.5714286,13.0796748
NM_025176,NINL,24,23,132817,4996,127821,5557.434783,208.1666667,25.58466773
NM_015600,ABHD12,13,12,96241,1737,94504,7875.333333,133.6153846,54.4064479
NM_021067,GINS1,7,6,40870,3296,37574,6262.333333,470.8571429,11.39987864
NM_001042472,ABHD12,13,12,90786,2136,88650,7387.5,164.3076923,41.50280899
NM_030789,HM13,12,11,55159,1636,53523,4865.727273,136.3333333,32.71577017
NM_138578,BCL2L1,3,2,58397,2562,55835,27917.5,854,21.79352069
NM_178581,HM13,13,12,55159,1784,53375,4447.916667,137.2307692,29.91872197
NM_001191,BCL2L1,3,2,58397,2373,56024,28012,791,23.60893384
NM_178580,HM13,13,12,55159,1840,53319,4443.25,141.5384615,28.97771739
NM_030815,PDRG1,5,4,7127,1378,5749,1437.25,275.6,4.171988389
NM_002110,HCK,13,12,49668,2166,47502,3958.5,166.6153846,21.93074792
NM_001172132,HCK,14,13,49668,2233,47435,3648.846154,159.5,21.24272279
NM_001172131,HCK,13,12,49668,2163,47505,3958.75,166.3846154,21.96255201
NM_001172130,HCK,13,12,49668,2163,47505,3958.75,166.3846154,21.96255201
NM_001172129,HCK,13,12,49668,2166,47502,3958.5,166.6153846,21.93074792
NM_053041,COMMD7,9,8,41323,1920,39403,4925.375,213.3333333,20.52239583
NM_172236,POFUT1,5,4,10032,1512,8520,2130,302.4,5.634920635
NM_015352,POFUT1,7,6,30773,5226,25547,4257.833333,746.5714286,4.888442403
NM_001256798,C20orf112,11,10,142015,6774,135241,13524.1,615.8181818,19.96471804
NM_080616,C20orf112,8,7,40525,6110,34415,4916.428571,763.75,5.632569558
NM_001099339,COMMD7,9,8,41323,1917,39406,4925.75,213,20.5560772
NM_001172133,HCK,14,13,49668,2231,47437,3649,159.3571429,21.26266248
NM_032819,ZNF341,15,14,60511,3573,56938,4067,238.2,15.93562832
NM_001282933,ZNF341,15,14,60511,3594,56917,4065.5,239.6,15.83667223
NM_016408,CDK5RAP1,14,13,42732,2144,40588,3122.153846,153.1428571,18.93097015
NM_001032999,CBFA2T2,11,10,159911,7330,152581,15258.1,666.3636364,20.8159618
NM_016082,CDK5RAP1,14,13,42732,1996,40736,3133.538462,142.5714286,20.40881764
NM_080675,SUN5,13,12,20660,1265,19395,1616.25,97.30769231,15.33201581
NM_001278169,CDK5RAP1,14,13,42732,1912,40820,3140,136.5714286,21.34937238
NM_001278167,CDK5RAP1,14,13,42732,2141,40591,3122.384615,152.9285714,18.95889771
NM_001278168,CDK5RAP1,13,12,42732,1912,40820,3401.666667,147.0769231,21.34937238
NM_001282935,ZNF341,14,13,60511,3396,57115,4393.461538,242.5714286,16.81831567
NM_007367,RALY,9,8,89535,4734,84801,10600.125,526,17.91318124
NM_021202,TP53INP2,5,4,9091,4129,4962,1240.5,825.8,1.201743764
NM_031483,ITCH,25,24,148159,6426,141733,5905.541667,257.04,22.05617803
NM_001257137,ITCH,26,25,148159,6550,141609,5664.36,251.9230769,21.61969466
NM_001257138,ITCH,24,23,148159,6283,141876,6168.521739,261.7916667,22.58093268
NM_080476,PIGU,12,11,116745,1844,114901,10445.54545,153.6666667,62.31073753
NM_016732,RALY,10,9,89535,4783,84752,9416.888889,478.3,17.71942296
NM_001161766,AHCY,10,9,31539,2381,29158,3239.777778,238.1,12.24611508
NM_199487,UQCC1,9,8,109578,2379,107199,13399.875,264.3333333,45.06052963
NM_007186,CEP250,35,34,56582,8359,48223,1418.323529,238.8285714,5.768991506
NM_001184977,UQCC1,8,7,109578,2252,107326,15332.28571,281.5,47.65808171
NM_006690,MMP24,9,8,50267,4342,45925,5740.625,482.4444444,10.57692308
NM_016436,PHF20,18,17,178367,5907,172460,10144.70588,328.1666667,29.19586931
NM_018244,UQCC1,10,9,109578,2458,107120,11902.22222,245.8,43.58014646
NM_024918,DSN1,11,10,21962,2365,19597,1959.7,215,8.286257928
NM_001258330,EPB41L1,21,20,140091,5766,134325,6716.25,274.5714286,23.29604579
NM_015474,SAMHD1,16,15,60021,3205,56816,3787.733333,200.3125,17.72730109
NM_014902,DLGAP4,12,11,161598,4895,156703,14245.72727,407.9166667,32.01287028
NM_001042486,DLGAP4,7,6,67200,3016,64184,10697.33333,430.8571429,21.28116711
NM_080628,TLDC2,7,6,18064,2048,16016,2669.333333,292.5714286,7.8203125
NM_032214,SLA2,8,7,33697,2562,31135,4447.857143,320.25,12.15261514
NM_001145318,DSN1,10,9,22038,2210,19828,2203.111111,221,8.971945701
NM_001145317,DSN1,10,9,22038,1938,20100,2233.333333,193.8,10.37151703
NM_001145315,DSN1,11,10,22038,2260,19778,1977.8,205.4545455,8.751327434
NM_001258331,EPB41L1,20,19,141297,5992,135305,7121.315789,299.6,22.58094126
NM_001258329,EPB41L1,23,22,140091,6350,133741,6079.136364,276.0869565,21.0615748
NM_001145316,DSN1,11,10,21962,2452,19510,1951,222.9090909,7.956769984
NM_177996,EPB41L1,20,19,140091,5987,134104,7058.105263,299.35,22.39919826
NM_175077,SLA2,8,7,33697,2512,31185,4455,314,12.41441083
NM_183006,DLGAP4,7,6,66900,3805,63095,10515.83333,543.5714286,16.58212878
NM_001281495,CTNNBL1,17,16,178176,2094,176082,11005.125,123.1764706,84.08882521
NM_213632,MROH8,12,11,50769,2012,48757,4432.454545,167.6666667,24.23310139
NM_213631,MROH8,13,12,50769,2118,48651,4054.25,162.9230769,22.97025496
NM_152503,MROH8,24,23,78364,3478,74886,3255.913043,144.9166667,21.53133985
NM_030877,CTNNBL1,16,15,178176,1992,176184,11745.6,124.5,88.44578313
NM_080607,VSTM2L,4,3,42250,1965,40285,13428.33333,491.25,20.50127226
NM_021931,DHX35,22,21,77387,3344,74043,3525.857143,152,22.14204545
NM_015568,PPP1R16B,11,10,117321,6262,111059,11105.9,569.2727273,17.73538805
NM_001190809,DHX35,21,20,77387,3250,74137,3706.85,154.7619048,22.81138462
NM_001172735,PPP1R16B,10,9,117321,6135,111186,12354,613.5,18.12322738
NM_001725,BPI,15,14,33355,1860,31495,2249.642857,124,16.9327957
NM_080552,SLC32A1,2,1,4912,2576,2336,2336,1288,0.906832298
NM_003286,TOP1,21,20,95666,3754,91912,4595.6,178.7619048,24.48375067
NM_032221,CHD6,37,36,216392,10853,205539,5709.416667,293.3243243,18.9384502
NM_022896,LPIN3,20,19,19664,4383,15281,804.2631579,219.15,3.486424823
NM_001278610,MYBL2,13,12,49479,2718,46761,3896.75,209.0769231,17.20419426
NM_001199264,SGK2,13,12,20520,1929,18591,1549.25,148.3846154,9.637636081
NM_032883,TOX2,10,9,153474,2552,150922,16769.11111,255.2,59.13871473
NM_002466,MYBL2,14,13,49479,2791,46688,3591.384615,199.3571429,16.72805446
NM_016276,SGK2,12,11,19538,2132,17406,1582.363636,177.6666667,8.164165103
NM_001098796,TOX2,9,8,153474,2426,151048,18881,269.5555556,62.26215993
NM_001098797,TOX2,9,8,154764,2498,152266,19033.25,277.5555556,60.95516413
NM_001098798,TOX2,8,7,123720,2420,121300,17328.57143,302.5,50.12396694
NM_170693,SGK2,13,12,26640,1922,24718,2059.833333,147.8461538,12.86056191
NM_001261839,TTPAL,5,4,18720,6115,12605,3151.25,1223,2.061324612
NM_182970,RIMS4,6,5,58536,5213,53323,10664.6,868.8333333,10.22885095
NM_000022,ADA,12,11,32215,1544,30671,2788.272727,128.6666667,19.86463731
NM_001039199,TTPAL,5,4,18720,6217,12503,3125.75,1243.4,2.011098601
NM_006282,STK4,11,10,113475,6341,107134,10713.4,576.4545455,16.89544236
NM_024331,TTPAL,6,5,18720,6242,12478,2495.6,1040.333333,1.99903877
NM_003404,YWHAB,7,6,22937,3230,19707,3284.5,461.4285714,6.10123839
NM_001205317,RIMS4,6,5,58536,5216,53320,10664,869.3333333,10.22239264
NM_139323,YWHAB,6,5,22937,3134,19803,3960.6,522.3333333,6.318761966
NM_020967,NCOA5,8,7,28956,3215,25741,3677.285714,401.875,8.006531882
NM_022104,PCIF1,17,16,13347,2714,10633,664.5625,159.6470588,3.917833456
NM_020398,EPPIN,4,3,6802,1993,4809,1603,498.25,2.412945309
NM_021248,CDH22,12,11,134767,3915,130852,11895.63636,326.25,33.42324393
NM_052951,DNTTIP1,13,12,19492,1303,18189,1515.75,100.2307692,13.95932464
NM_001198986,EPPIN-WFDC6,5,4,11148,1867,9281,2320.25,373.4,4.971076593
NM_183048,ZMYND8,22,21,147776,5196,142580,6789.52381,236.1818182,27.44033872
NM_001281784,ZMYND8,21,20,147776,5192,142584,7129.2,247.2380952,27.46224961
NM_001281780,ZMYND8,23,22,147776,5403,142373,6471.5,234.9130435,26.35073108
NM_001281781,ZMYND8,21,20,147776,5054,142722,7136.1,240.6666667,28.23941433
NM_183047,ZMYND8,23,22,147776,5356,142420,6473.636364,232.8695652,26.59073936
NM_012408,ZMYND8,22,21,147776,5271,142505,6785.952381,239.5909091,27.03566686
NM_001281782,ZMYND8,22,21,147776,5199,142577,6789.380952,236.3181818,27.42392768
NM_001281783,ZMYND8,22,21,147776,5409,142367,6779.380952,245.8636364,26.32039194
NM_001193340,SLC13A3,13,12,126664,3992,122672,10222.66667,307.0769231,30.72945892
NM_001193339,SLC13A3,12,11,93640,3910,89730,8157.272727,325.8333333,22.9488491
NM_030777,SLC2A10,5,4,26708,4240,22468,5617,848,5.299056604
NM_001281775,ZMYND8,23,22,147776,5494,142282,6467.363636,238.8695652,25.89770659
NM_001281776,ZMYND8,22,21,147776,5112,142664,6793.52381,232.3636364,27.90766823
NM_001011554,SLC13A3,14,13,126664,4098,122566,9428.153846,292.7142857,29.90873597
NM_001193342,SLC13A3,13,12,93640,3888,89752,7479.333333,299.0769231,23.08436214
NM_172110,EYA2,14,13,294231,2479,291752,22442.46154,177.0714286,117.6893909
NM_001281777,ZMYND8,23,22,147776,5281,142495,6477.045455,229.6086957,26.98257906
NM_001281778,ZMYND8,22,21,147776,5334,142442,6782.952381,242.4545455,26.70453693
NM_001281779,ZMYND8,24,23,147776,5488,142288,6186.434783,228.6666667,25.9271137
NM_001281773,ZMYND8,24,23,147776,5566,142210,6183.043478,231.9166667,25.54976644
NM_001281774,ZMYND8,24,23,147776,5428,142348,6189.043478,226.1666667,26.2247605
NM_022829,SLC13A3,13,12,93640,4061,89579,7464.916667,312.3846154,22.05836001
NM_001281771,ZMYND8,21,20,147776,4952,142824,7141.2,235.8095238,28.84168013
NM_001281772,ZMYND8,24,23,147776,5535,142241,6184.391304,230.625,25.69846432
NM_005244,EYA2,16,15,294231,2718,291513,19434.2,169.875,107.2527594
NM_198596,SULF2,21,20,129212,4250,124962,6248.1,202.3809524,29.40282353
NM_001161841,SULF2,21,20,129212,4259,124953,6247.65,202.8095238,29.33857713
NM_018837,SULF2,21,20,128660,3920,124740,6237,186.6666667,31.82142857
NM_020820,PREX1,40,39,203629,6673,196956,5050.153846,166.825,29.51536041
NM_001316,CSE1L,25,24,50716,3652,47064,1961,146.08,12.8871851
NM_006420,ARFGEF2,39,38,114957,9043,105914,2787.210526,231.8717949,11.71226363
NM_017895,DDX27,21,20,24784,2716,22068,1103.4,129.3333333,8.125184094
NM_001256135,CSE1L,24,23,50716,3483,47233,2053.608696,145.125,13.56101062
NM_001162505,TMEM189,6,5,30063,2292,27771,5554.2,382,12.11649215
NM_015266,SLC9A8,16,15,79531,6278,73253,4883.533333,392.375,11.66820644
NM_002827,PTPN1,10,9,74444,3573,70871,7874.555556,357.3,19.83515253
NM_001278655,RP11-290F20.3,4,3,12311,2014,10297,3432.333333,503.5,5.112711023
NM_199203,TMEM189-UBE2V1,8,7,72676,2926,69750,9964.285714,365.75,23.8380041
NM_001260491,SLC9A8,16,15,79531,6326,73205,4880.333333,395.375,11.57208347
NM_199129,TMEM189,6,5,30063,2301,27762,5552.4,383.5,12.06518905
NM_001278618,PTPN1,9,8,74444,3481,70963,8870.375,386.7777778,20.38580868
NM_001258295,NFATC2,10,9,175878,6855,169023,18780.33333,685.5,24.65689278
NM_012340,NFATC2,11,10,155766,7536,148230,14823,685.0909091,19.66958599
NM_001282531,ADNP,6,5,42074,6231,35843,7168.6,1038.5,5.752367196
NM_015339,ADNP,5,4,42074,6146,35928,8982,1229.2,5.845753336
NM_001136021,NFATC2,11,10,175878,7458,168420,16842,678,22.58246179
NM_001258297,NFATC2,10,9,155766,6933,148833,16537,693.3,21.46733016
NM_001258296,NFATC2,11,10,155766,7022,148744,14874.4,638.3636364,21.18256907
NM_001258294,NFATC2,11,10,175878,6944,168934,16893.4,631.2727273,24.328053
NM_001258292,NFATC2,10,9,175878,7369,168509,18723.22222,736.9,22.86728186
NM_173091,NFATC2,10,9,155766,7447,148319,16479.88889,744.7,19.91661072
NM_181442,ADNP,4,3,42074,5970,36104,12034.66667,1492.5,6.047571189
NM_001010974,BCAS4,4,3,82285,1150,81135,27045,287.5,70.55217391
NM_017843,BCAS4,6,5,82285,1384,80901,16180.2,230.6666667,58.45447977
NM_198799,BCAS4,5,4,82285,1286,80999,20249.75,257.2,62.98522551
NM_199427,ZFP64,9,8,107976,2842,105134,13141.75,315.7777778,36.9929627
NM_001193421,TSHZ2,3,2,310049,11657,298392,149196,3885.666667,25.59766664
NM_173485,TSHZ2,3,2,522925,12190,510735,255367.5,4063.333333,41.8978671
NM_018431,DOK5,8,7,175446,1841,173605,24800.71429,230.125,94.29929386
NM_016407,RTFDC1,9,8,50303,1664,48639,6079.875,184.8888889,29.23016827
NM_001283035,RTFDC1,10,9,50303,1755,48548,5394.222222,175.5,27.66267806
NM_001283036,RTFDC1,9,8,50303,1661,48642,6080.25,184.5555556,29.28476821
NM_001283037,RTFDC1,8,7,50303,1608,48695,6956.428571,201,30.2829602
NM_199171,PMEPA1,4,3,63146,4633,58513,19504.33333,1158.25,12.62961364
NM_199170,PMEPA1,4,3,62224,4568,57656,19218.66667,1142,12.62171629
NM_199169,PMEPA1,4,3,62224,4575,57649,19216.33333,1143.75,12.60087432
NM_183425,RBM38,3,2,17934,2336,15598,7799,778.6666667,6.677226027
NM_001269045,CTCFL,10,9,18912,2925,15987,1776.333333,292.5,5.465641026
NM_001269052,CTCFL,4,3,6370,1984,4386,1462,496,2.210685484
NM_001269043,CTCFL,12,11,29164,2511,26653,2423,209.25,10.61449622
NM_001269044,CTCFL,10,9,25315,3369,21946,2438.444444,336.9,6.514099139
NM_001719,BMP7,7,6,97900,4038,93862,15643.66667,576.8571429,23.24467558
NM_017495,RBM38,4,3,17934,2392,15542,5180.666667,598,6.497491639
NM_001255976,PMEPA1,4,3,42234,4651,37583,12527.66667,1162.75,8.080627822
NM_001269051,CTCFL,5,4,7155,1513,5642,1410.5,302.6,3.729015202
NM_001269050,CTCFL,9,8,18367,2271,16096,2012,252.3333333,7.087626596
NM_001269048,CTCFL,6,5,18127,2961,15166,3033.2,493.5,5.121918271
NM_001269046,CTCFL,10,9,28486,3870,24616,2735.111111,387,6.360723514
NM_001269040,CTCFL,11,10,28486,3575,24911,2491.1,325,6.968111888
NM_001269042,CTCFL,11,10,28486,3572,24914,2491.4,324.7272727,6.974804031
NM_001269041,CTCFL,10,9,27701,4046,23655,2628.333333,404.6,5.846515077
NM_080618,CTCFL,12,11,28486,3676,24810,2255.454545,306.3333333,6.749183896
NM_020182,PMEPA1,4,3,61585,4922,56663,18887.66667,1230.5,11.51219017
NM_001269054,CTCFL,9,8,25575,2052,23523,2940.375,228,11.46345029
NM_001269047,CTCFL,10,9,18912,2976,15936,1770.666667,297.6,5.35483871
NM_001269049,CTCFL,10,9,25575,2264,23311,2590.111111,226.4,10.29637809
NM_001269055,CTCFL,8,7,18367,2143,16224,2317.714286,267.875,7.570695287
NM_020673,RAB22A,7,6,57794,8658,49136,8189.333333,1236.857143,5.675213675
NM_001204873,NPEPL1,13,12,26715,2091,24624,2052,160.8461538,11.77618364
NM_001204872,NPEPL1,13,12,26715,2141,24574,2047.833333,164.6923077,11.47781411
NM_024663,NPEPL1,12,11,23040,2197,20843,1894.818182,183.0833333,9.487027765
NM_001195677,VAPB,3,2,61983,7579,54404,27202,2526.333333,7.178255707
NM_004738,VAPB,6,5,61983,7944,54039,10807.8,1324,6.802492447
NM_001281507,PHACTR3,13,12,219104,2364,216740,18061.66667,181.8461538,91.68358714
NM_001199506,PHACTR3,13,12,171052,2260,168792,14066,173.8461538,74.68672566
NM_001199505,PHACTR3,13,12,270204,2265,267939,22328.25,174.2307692,118.2953642
NM_178457,ZNF831,5,4,68094,9408,58686,14671.5,1881.6,6.237882653
NM_080672,PHACTR3,13,12,243166,2742,240424,20035.33333,210.9230769,87.68198395
NM_014258,SYCP2,44,43,68593,5524,63069,1466.72093,125.5454545,11.41727009
NM_183246,PHACTR3,12,11,126503,2174,124329,11302.63636,181.1666667,57.18905244
NM_183244,PHACTR3,13,12,126503,2385,124118,10343.16667,183.4615385,52.04109015
NM_001252338,CDH4,15,14,441198,6341,434857,31061.21429,422.7333333,68.57861536
NM_003185,TAF4,15,14,91014,4643,86371,6169.357143,309.5333333,18.60241223
NM_001794,CDH4,16,15,688193,6527,681666,45444.4,407.9375,104.4378734
NM_001252339,CDH4,15,14,340858,6498,334360,23882.85714,433.2,51.45583256
NM_006602,TCFL5,6,5,20650,2462,18188,3637.6,410.3333333,7.387489846
NM_002531,NTSR1,4,3,53936,4136,49800,16600,1034,12.04061896
NM_025224,ZBTB46,5,4,61837,5238,56599,14149.75,1047.6,10.8054601
NM_003288,TPD52L2,7,6,26319,2366,23953,3992.166667,338,10.1238377
NM_001958,EEF1A2,8,7,11305,2015,9290,1327.142857,251.875,4.610421836
NM_012469,PRPF6,21,20,52024,3122,48902,2445.1,148.6666667,15.66367713
NM_001243892,TPD52L2,6,5,26319,2236,24083,4816.6,372.6666667,10.77057245
NM_199361,TPD52L2,8,7,26319,2376,23943,3420.428571,297,10.0770202
NM_199360,TPD52L2,9,8,26319,2437,23882,2985.25,270.7777778,9.799753796
NM_199359,TPD52L2,6,5,26319,2305,24014,4802.8,384.1666667,10.41822126
NM_199363,TPD52L2,7,6,26319,2348,23971,3995.166667,335.4285714,10.20911414
NM_199362,TPD52L2,8,7,26319,2409,23910,3415.714286,301.125,9.925280199
NM_001243895,TPD52L2,6,5,26319,2316,24003,4800.6,386,10.36398964
NM_001243894,TPD52L2,5,4,26319,2202,24117,6029.25,440.4,10.95231608
NM_001243891,TPD52L2,7,6,26319,2291,24028,4004.666667,327.2857143,10.48799651
NM_030931,DEFB126,2,1,3200,473,2727,2727,236.5,5.765327696
NM_153325,DEFB125,2,1,8947,711,8236,8236,355.5,11.58368495
NM_139074,DEFB127,2,1,1695,516,1179,1179,258,2.284883721
NM_001037732,DEFB128,2,1,1739,284,1455,1455,142,5.123239437
NM_080831,DEFB129,2,1,2630,700,1930,1930,350,2.757142857
NM_207469,DEFB132,2,1,3361,2122,1239,1239,1061,0.583883129
NM_024958,NRSN2,4,3,8144,2390,5754,1918,597.5,2.407531381
NM_033089,ZCCHC3,1,0,2761,2761,NA,NA,2761,NA
NM_021158,TRIB3,4,3,16897,2456,14441,4813.666667,614,5.879885993
NM_006943,SOX12,1,0,4659,4659,NA,NA,4659,NA
NM_144628,TBC1D20,8,7,27065,4464,22601,3228.714286,558,5.062948029
NM_080725,SRXN1,2,1,6748,2691,4057,4057,1345.5,1.507617986
NM_004609,TCF15,2,1,6275,1229,5046,5046,614.5,4.105777055
NM_033409,SLC52A3,5,4,8506,2700,5806,1451.5,540,2.15037037
NM_015985,ANGPT4,9,8,43665,1930,41735,5216.875,214.4444444,21.62435233
NM_001042353,FAM110A,2,1,12584,1829,10755,10755,914.5,5.880262438
NM_001289147,FAM110A,2,1,5006,1616,3390,3390,808,2.097772277
NM_001289146,FAM110A,2,1,12584,1826,10758,10758,913,5.891566265
NM_001289145,FAM110A,3,2,12584,1939,10645,5322.5,646.3333333,5.48994327
NM_207121,FAM110A,2,1,10213,1621,8592,8592,810.5,5.300431832
NM_031424,FAM110A,1,0,1673,1673,NA,NA,1673,NA
NM_001040007,RSPO4,4,3,43813,2527,41286,13762,631.75,16.33795014
NM_001029871,RSPO4,5,4,43813,2714,41099,10274.75,542.8,15.14333088
NM_006814,PSMF1,7,6,49188,3702,45486,7581,528.8571429,12.28687196
NM_018354,TMEM74B,2,1,3904,1722,2182,2182,861,1.267131243
NM_178578,PSMF1,8,7,54522,3694,50828,7261.142857,461.75,13.75961018
NM_001136566,RAD21L1,14,13,28383,1822,26561,2043.153846,130.1428571,14.57793633
NM_001199784,SDCBP2,9,8,15960,1477,14483,1810.375,164.1111111,9.805687204
NM_015685,SDCBP2,5,4,3764,1364,2400,600,272.8,1.759530792
NM_080489,SDCBP2,9,8,19326,1588,17738,2217.25,176.4444444,11.17002519
NM_014723,SNPH,6,5,43013,5000,38013,7602.6,833.3333333,7.6026
NM_001009612,C20orf202,2,1,4822,1606,3216,3216,803,2.00249066
NM_001199786,FKBP1A,4,3,24197,1524,22673,7557.666667,381,14.87729659
NM_000801,FKBP1A,5,4,24197,1638,22559,5639.75,327.6,13.77228327
NM_054014,FKBP1A,4,3,21462,905,20557,6852.333333,226.25,22.71491713
NM_178460,SIRPD,4,3,23448,816,22632,7544,204,27.73529412
NM_001134836,SIRPB2,5,4,16999,2544,14455,3613.75,508.8,5.681996855
NM_001122962,SIRPB2,5,4,16999,2838,14161,3540.25,567.6,4.989781536
NM_018556,SIRPG,6,5,28629,1722,26907,5381.4,287,15.62543554
NM_001039508,SIRPG,5,4,28629,1388,27241,6810.25,277.6,19.62608069
NM_080816,SIRPG,4,3,28629,1069,27560,9186.666667,267.25,25.78110384
NM_001135844,SIRPB1,6,5,22705,2247,20458,4091.6,374.5,9.10458389
NM_001040023,SIRPA,8,7,44716,4117,40599,5799.857143,514.625,9.861306777
NM_001040022,SIRPA,9,8,45729,4210,41519,5189.875,467.7777778,9.861995249
NM_080792,SIRPA,9,8,45117,3877,41240,5155,430.7777778,10.63709053
NM_001287682,LOC388780,2,1,6225,837,5388,5388,418.5,6.437275986
NM_003245,TGM3,13,12,45114,2690,42424,3535.333333,206.9230769,15.77100372
NM_001282497,ZNF343,7,6,27314,3759,23555,3925.833333,537,6.266294227
NM_001282496,ZNF343,6,5,27314,3593,23721,4744.2,598.8333333,6.602003896
NM_198994,TGM6,13,12,51847,2305,49542,4128.5,177.3076923,21.49327549
NM_024325,ZNF343,6,5,27314,3635,23679,4735.8,605.8333333,6.514167813
NM_003091,SNRPB,7,6,9220,1160,8060,1343.333333,165.7142857,6.948275862
NM_198216,SNRPB,7,6,9220,1014,8206,1367.666667,144.8571429,8.09270217
NM_001254734,TGM6,12,11,51847,2170,49677,4516.090909,180.8333333,22.89262673
NM_001282499,ZNF343,6,5,17292,1041,16251,3250.2,173.5,15.61095101
NM_001282498,ZNF343,4,3,27314,3307,24007,8002.333333,826.75,7.259449652
NM_006392,NOP56,12,11,5863,2025,3838,348.9090909,168.75,1.895308642
NM_001110514,EBF4,18,17,67232,2929,64303,3782.529412,162.7222222,21.95390918
NM_001258384,IDH3B,12,11,5206,1412,3794,344.9090909,117.6666667,2.686968839
NM_174855,IDH3B,12,11,5826,1242,4584,416.7272727,103.5,3.690821256
NM_006899,IDH3B,12,11,5826,1557,4269,388.0909091,129.75,2.741811175
NM_001184699,CPXM1,14,13,6579,2192,4387,337.4615385,156.5714286,2.001368613
NM_080739,C20orf141,2,1,821,729,92,92,364.5,0.126200274
NM_022575,VPS16,24,23,26037,2780,23257,1011.173913,115.8333333,8.365827338
NM_019609,CPXM1,14,13,6579,2414,4165,320.3846154,172.4285714,1.725352113
NM_001256538,C20orf141,3,2,845,620,225,112.5,206.6666667,0.362903226
NM_022760,PCED1A,8,7,5389,2033,3356,479.4285714,254.125,1.65076242
NM_080413,VPS16,20,19,26037,2344,23693,1247,117.2,10.10793515
NM_001271168,PCED1A,8,7,5930,1766,4164,594.8571429,220.75,2.357870895
NM_001167670,TMEM239,2,1,830,703,127,127,351.5,0.180654339
NM_199415,UBOX5,4,3,52339,4187,48152,16050.66667,1046.75,11.50035825
NM_021826,FASTKD5,2,1,13369,2865,10504,10504,1432.5,3.666317627
NM_030811,MRPS26,4,3,2223,1043,1180,393.3333333,260.75,1.13135187
NM_178332,GNRH2,4,3,2125,403,1722,574,100.75,4.272952854
NM_178331,GNRH2,4,3,2125,406,1719,573,101.5,4.233990148
NM_001501,GNRH2,4,3,2125,427,1698,566,106.75,3.976580796
NM_001267584,UBOX5,5,4,52339,4345,47994,11998.5,869,11.04579977
NM_000490,AVP,3,2,2170,622,1548,774,207.3333333,2.488745981
NM_000915,OXT,3,2,899,516,383,191.5,172,0.742248062
NM_014948,UBOX5,5,4,52339,4350,47989,11997.25,870,11.03195402
NM_032034,SLC4A11,19,18,10312,3113,7199,399.9444444,163.8421053,2.312560231
NM_001174090,SLC4A11,20,19,10774,3272,7502,394.8421053,163.6,2.292787286
NM_001174089,SLC4A11,20,19,11826,3122,8704,458.1052632,156.1,2.787956438
NM_023935,DDRGK1,9,8,14285,1263,13022,1627.75,140.3333333,10.31037213
NM_181493,ITPA,8,7,14384,1014,13370,1910,126.75,13.18540434
NM_001267623,ITPA,6,5,14512,1068,13444,2688.8,178,12.58801498
NM_033453,ITPA,8,7,14512,1193,13319,1902.714286,149.125,11.1642917
NM_001282447,ADAM33,22,21,14160,3578,10582,503.9047619,162.6363636,2.957518167
NM_025220,ADAM33,22,21,14160,3581,10579,503.7619048,162.7727273,2.954202737
NM_022139,GFRA4,6,5,4109,1433,2676,535.2,238.8333333,1.867411026
NM_145762,GFRA4,5,4,4109,1522,2587,646.75,304.4,1.699737188
NM_153202,ADAM33,21,20,14160,3502,10658,532.9,166.7619048,3.043403769
NM_021872,CDC25B,15,14,10384,3588,6796,485.4285714,239.2,1.894091416
NM_001039140,C20orf27,6,5,14308,1394,12914,2582.8,232.3333333,9.263988522
NM_001287522,CDC25B,15,14,10384,2736,7648,546.2857143,182.4,2.795321637
NM_001287524,CDC25B,12,11,6061,2638,3423,311.1818182,219.8333333,1.29757392
NM_001287520,CDC25B,16,15,10384,2860,7524,501.6,178.75,2.630769231
NM_001287516,CDC25B,16,15,19351,3087,16264,1084.266667,192.9375,5.268545513
NM_001258430,C20orf27,6,5,14308,1773,12535,2507,295.5,7.069937958
NM_001810,CENPB,1,0,2841,2841,NA,NA,2841,NA
NM_021873,CDC25B,16,15,10384,3712,6672,444.8,232,1.797413793
NM_015417,SPEF1,7,6,3953,1594,2359,393.1666667,227.7142857,1.479924718
NM_001287518,CDC25B,15,14,19351,3005,16346,1167.571429,200.3333333,5.439600666
NM_001197327,HSPA12B,13,12,20443,3158,17285,1440.416667,242.9230769,5.473400887
NM_052970,HSPA12B,13,12,20443,3161,17282,1440.166667,243.1538462,5.467257197
NM_001258429,C20orf27,6,5,14308,1319,12989,2597.8,219.8333333,9.847611827
NM_001287519,CDC25B,16,15,10384,2818,7566,504.4,176.125,2.684882896
NM_004358,CDC25B,16,15,10384,3670,6714,447.6,229.375,1.829427793
NM_001287517,CDC25B,16,15,19351,3045,16306,1087.066667,190.3125,5.35500821
NM_020746,MAVS,7,6,29326,11778,17548,2924.666667,1682.571429,1.489896417
NM_001204447,AP5S1,3,2,4785,1811,2974,1487,603.6666667,1.642186637
NM_001204446,AP5S1,3,2,4785,1963,2822,1411,654.3333333,1.437595517
NM_024960,PANK2,7,6,35018,1719,33299,5549.833333,245.5714286,19.37114602
NM_153640,PANK2,7,6,34041,1770,32271,5378.5,252.8571429,18.23220339
NM_153638,PANK2,7,6,34762,2287,32475,5412.5,326.7142857,14.1998251
NM_001206491,MAVS,6,5,29326,11602,17724,3544.8,1933.666667,1.527667644
NM_018347,AP5S1,3,2,4785,1867,2918,1459,622.3333333,1.56293519
NM_001270691,SMOX,8,7,38970,2331,36639,5234.142857,291.375,15.71814672
NM_175841,SMOX,4,3,38970,1142,37828,12609.33333,285.5,33.12434326
NM_175840,SMOX,8,7,38970,2082,36888,5269.714286,260.25,17.71757925
NM_175842,SMOX,9,8,38970,2173,36797,4599.625,241.4444444,16.93373217
NM_175839,SMOX,7,6,38970,2240,36730,6121.666667,320,16.39732143
NM_000678,ADRA1D,2,1,28383,2668,25715,25715,1334,9.638305847
NM_001080123,PRNP,2,1,15079,2606,12473,12473,1303,4.786262471
NM_001271561,PRNP,2,1,15439,2742,12697,12697,1371,4.630561634
NM_183079,PRNP,2,1,15439,2738,12701,12701,1369,4.638787436
NM_012409,PRND,2,1,6610,4040,2570,2570,2020,0.636138614
NM_000311,PRNP,2,1,15439,2742,12697,12697,1371,4.630561634
NM_001080122,PRNP,2,1,15439,2733,12706,12706,1366.5,4.649103549
NM_001080121,PRNP,2,1,15439,2737,12702,12702,1368.5,4.640847643
NM_014737,RASSF2,12,11,43623,5438,38185,3471.363636,453.1666667,7.021883045
NM_170774,RASSF2,11,10,35102,5296,29806,2980.6,481.4545455,5.628021148
NM_001009925,TMEM230,4,3,13251,1462,11789,3929.666667,365.5,8.063611491
NM_001009923,TMEM230,5,4,13251,1569,11682,2920.5,313.8,7.445506692
NM_001009924,TMEM230,5,4,13251,1787,11464,2866,357.4,6.415221041
NM_014145,TMEM230,4,3,13251,1693,11558,3852.666667,423.25,6.826934436
NM_002592,PCNA,7,6,11671,1362,10309,1718.166667,194.5714286,7.569016153
NM_182649,PCNA,6,5,5050,1325,3725,745,220.8333333,2.811320755
NM_144773,PROKR2,2,1,12331,1157,11174,11174,578.5,9.657735523
NM_019593,GPCPD1,20,19,66594,5479,61115,3216.578947,273.95,11.15440774
NM_182802,MCM8,19,18,44556,3740,40816,2267.555556,196.8421053,10.91336898
NM_001127458,CRLS1,7,6,32801,3659,29142,4857,522.7142857,7.964471167
NM_001281522,MCM8,18,17,44556,3592,40964,2409.647059,199.5555556,11.40423163
NM_001281521,MCM8,19,18,44556,3854,40702,2261.222222,202.8421053,10.56097561
NM_001281520,MCM8,19,18,44556,3788,40768,2264.888889,199.3684211,10.7624076
NM_032485,MCM8,19,18,44556,3734,40822,2267.888889,196.5263158,10.93251205
NM_001281467,TRMT6,10,9,12727,2249,10478,1164.222222,224.9,4.658959538
NM_019095,CRLS1,7,6,33960,3960,30000,5000,565.7142857,7.575757576
NM_015939,TRMT6,11,10,12727,2360,10367,1036.7,214.5454545,4.39279661
NM_017671,FERMT1,15,14,48701,5166,43535,3109.642857,344.4,8.427216415
NM_001200,BMP2,3,2,12167,3153,9014,4507,1051,2.858864573
NM_012261,LAMP5,6,5,16168,2048,14120,2824,341.3333333,6.89453125
NM_001199897,LAMP5,5,4,16168,1915,14253,3563.25,383,7.442819843
NM_198798,ANKEF1,10,9,21712,3769,17943,1993.666667,376.9,4.760679225
NM_022096,ANKEF1,11,10,21712,3834,17878,1787.8,348.5454545,4.663015128
NM_018848,MKKS,6,5,27147,3076,24071,4814.2,512.6666667,7.825422627
NM_170784,MKKS,6,5,29461,2966,26495,5299,494.3333333,8.932906271
NM_000214,JAG1,26,25,36364,6013,30351,1214.04,231.2692308,5.047563612
NM_014962,BTBD3,4,3,8732,4913,3819,1273,1228.25,0.777325463
NM_001282552,BTBD3,4,3,35874,4585,31289,10429.66667,1146.25,6.824209378
NM_001282551,BTBD3,5,4,8732,4592,4140,1035,918.4,0.901567944
NM_001282550,BTBD3,5,4,34104,4496,29608,7402,899.2,6.585409253
NM_001282554,BTBD3,4,3,8732,4500,4232,1410.666667,1125,0.940444444
NM_181443,BTBD3,5,4,35874,4677,31197,7799.25,935.4,6.670301475
NM_001039375,NDUFAF5,10,9,33397,2218,31179,3464.333333,221.8,14.05725879
NM_024120,NDUFAF5,11,10,33397,2303,31094,3109.4,209.3636364,13.50151976
NM_198391,FLRT3,3,2,13676,4027,9649,4824.5,1342.333333,2.396076484
NM_013281,FLRT3,2,1,13676,3832,9844,9844,1916,2.568893528
NM_198220,SNRPB2,7,6,11810,1588,10222,1703.666667,226.8571429,6.437027708
NM_003092,SNRPB2,7,6,11810,1688,10122,1687,241.1428571,5.996445498
NM_020157,OTOR,4,3,3813,1486,2327,775.6666667,371.5,1.565948856
NM_001161705,BFSP1,8,7,65057,2071,62986,8998,258.875,30.4133269
NM_001278608,BFSP1,10,9,75317,2194,73123,8124.777778,219.4,33.32862352
NM_001278607,BFSP1,8,7,65057,2067,62990,8998.571429,258.375,30.47411708
NM_001278606,BFSP1,9,8,65057,2207,62850,7856.25,245.2222222,28.47757136
NM_001195,BFSP1,8,7,37466,2215,35251,5035.857143,276.875,15.91467269
NM_001042576,RRBP1,26,25,68607,3818,64789,2591.56,146.8461538,16.96935568
NM_004587,RRBP1,25,24,68607,3740,64867,2702.791667,149.6,17.34411765
NM_001282454,SNX5,13,12,27396,2230,25166,2097.166667,171.5384615,11.28520179
NM_152227,SNX5,14,13,27396,2314,25082,1929.384615,165.2857143,10.83923941
NM_014426,SNX5,13,12,27199,2358,24841,2070.083333,181.3846154,10.53477523
NM_021220,OVOL2,4,3,33727,1559,32168,10722.66667,389.75,20.63373958
NM_001164811,PET117,2,1,5315,1160,4155,4155,580,3.581896552
NM_020536,CSRP2BP,10,9,46165,3724,42441,4715.666667,372.4,11.39661654
NM_003434,ZNF133,7,6,28715,2902,25813,4302.166667,414.5714286,8.894900069
NM_001083330,ZNF133,4,3,28715,2487,26228,8742.666667,621.75,10.5460394
NM_001283006,ZNF133,3,2,28715,2328,26387,13193.5,776,11.33462199
NM_001283000,ZNF133,5,4,28715,2667,26048,6512,533.4,9.766779153
NM_001283002,ZNF133,5,4,28715,2556,26159,6539.75,511.2,10.23435055
NM_001283001,ZNF133,5,4,28715,2654,26061,6515.25,530.8,9.819517709
NM_001283008,ZNF133,4,3,28715,2517,26198,8732.666667,629.25,10.40842273
NM_001283007,ZNF133,3,2,28715,2346,26369,13184.5,782,11.23998295
NM_001283005,ZNF133,2,1,28715,2249,26466,26466,1124.5,11.76789684
NM_001283004,ZNF133,5,4,28715,2616,26099,6524.75,523.2,9.976681957
NM_001283003,ZNF133,5,4,28715,2629,26086,6521.5,525.8,9.922403956
NM_001282999,ZNF133,4,3,28715,2490,26225,8741.666667,622.5,10.53212851
NM_001282998,ZNF133,4,3,28715,2477,26238,8746,619.25,10.5926524
NM_001282997,ZNF133,5,4,28715,2649,26066,6516.5,529.8,9.8399396
NM_001282996,ZNF133,6,5,28715,2599,26116,5223.2,433.1666667,10.04848018
NM_001282995,ZNF133,6,5,28715,2725,25990,5198,454.1666667,9.537614679
NM_001282526,POLR3F,9,8,17261,2271,14990,1873.75,252.3333333,6.600616469
NM_006466,POLR3F,9,8,17261,2168,15093,1886.625,240.8888889,6.961715867
NM_001099407,DZANK1,21,20,83820,3521,80299,4014.95,167.6666667,22.80573701
NM_006606,RBBP9,5,4,10701,3862,6839,1709.75,772.4,1.770844122
NM_001172745,SEC23B,20,19,53454,3348,50106,2637.157895,167.4,14.96594982
NM_032985,SEC23B,20,19,53864,3451,50413,2653.315789,172.55,14.6082295
NM_001172746,SEC23B,20,19,53851,3384,50467,2656.157895,169.2,14.91341608
NM_032986,SEC23B,20,19,53864,3130,50734,2670.210526,156.5,16.20894569
NM_006363,SEC23B,20,19,53864,3433,50431,2654.263158,171.65,14.690067
NM_001242671,C20orf78,3,2,20469,651,19818,9909,217,30.44239631
NM_178483,SCP2D1,1,0,667,667,NA,NA,667,NA
NM_001278626,CRNKL1,15,14,21687,4205,17482,1248.714286,280.3333333,4.157431629
NM_001278625,CRNKL1,15,14,21687,4392,17295,1235.357143,292.8,3.93784153
NM_001278628,CRNKL1,14,13,18133,4062,14071,1082.384615,290.1428571,3.464057115
NM_001278627,CRNKL1,15,14,21687,4115,17572,1255.142857,274.3333333,4.270230863
NM_016652,CRNKL1,15,14,21687,4428,17259,1232.785714,295.2,3.897696477
NM_016100,NAA20,6,5,16341,1092,15249,3049.8,182,13.96428571
NM_181528,NAA20,5,4,16341,945,15396,3849,189,16.29206349
NM_181527,NAA20,6,5,15836,1179,14657,2931.4,196.5,12.4317218
NM_002196,INSM1,1,0,2829,2829,NA,NA,2829,NA
NM_018474,PLK1S1,13,12,120636,2211,118425,9868.75,170.0769231,53.56173677
NM_001276389,PLK1S1,11,10,120636,1983,118653,11865.3,180.2727273,59.83509834
NM_001163023,PLK1S1,11,10,120636,1956,118680,11868,177.8181818,60.67484663
NM_001163022,PLK1S1,12,11,120636,2047,118589,10780.81818,170.5833333,57.93307279
NM_033176,NKX2-4,2,1,2044,1621,423,423,810.5,0.260950031
NM_002509,NKX2-2,2,1,3006,2082,924,924,1041,0.443804035
NM_006192,PAX1,5,4,12829,5347,7482,1870.5,1069.4,1.399289321
NM_001257096,PAX1,5,4,12829,5357,7472,1868,1071.4,1.394810528
NM_153675,FOXA2,3,2,4461,2413,2048,1024,804.3333333,0.848736013
NM_021784,FOXA2,2,1,3461,2425,1036,1036,1212.5,0.427216495
NM_012072,CD93,2,1,6986,6703,283,283,3351.5,0.042219902
NM_000361,THBD,1,0,4033,4033,NA,NA,4033,NA
NM_001052,SSTR4,1,0,1259,1259,NA,NA,1259,NA
NM_001283020,NAPB,10,9,47002,3764,43238,4804.222222,376.4,11.48724761
NM_001283018,NAPB,11,10,47002,3894,43108,4310.8,354,11.07036466
NM_130794,CST11,3,2,2443,556,1887,943.5,185.3333333,3.393884892
NM_022080,NAPB,11,10,47002,3882,43120,4312,352.9090909,11.10767646
NM_022482,GZF1,5,4,8664,4746,3918,979.5,949.2,0.825537295
NM_013248,NXT1,2,1,4037,1119,2918,2918,559.5,2.607685433
NM_080830,CST11,2,1,2443,450,1993,1993,225,4.428888889
NM_138283,CSTL1,4,3,5247,740,4507,1502.333333,185,6.090540541
NM_001283026,NAPB,10,9,47002,3834,43168,4796.444444,383.4,11.25925926
NM_080610,CST9L,3,2,4018,961,3057,1528.5,320.3333333,3.181061394
NM_001281730,CST8,4,3,4919,763,4156,1385.333333,190.75,5.446920052
NM_005492,CST8,4,3,4919,922,3997,1332.333333,230.5,4.335140998
NM_001008693,CST9,2,1,3565,1691,1874,1874,845.5,1.108219988
NM_000099,CST3,3,2,4393,889,3504,1752,296.3333333,3.941507312
NM_001899,CST4,3,2,3387,739,2648,1324,246.3333333,3.583220568
NM_001288614,CST3,4,3,10153,2202,7951,2650.333333,550.5,3.610808356
NM_001898,CST1,3,2,3386,763,2623,1311.5,254.3333333,3.43774574
NM_001322,CST2,3,2,2910,697,2213,1106.5,232.3333333,3.175035868
NM_001900,CST5,3,2,3810,752,3058,1529,250.6666667,4.066489362
NM_178312,GGTLC1,6,5,1824,980,844,168.8,163.3333333,0.86122449
NM_178311,GGTLC1,6,5,3728,1052,2676,535.2,175.3333333,2.543726236
NM_003650,CST7,4,3,10700,934,9766,3255.333333,233.5,10.45610278
NM_020531,APMAP,9,8,29847,2230,27617,3452.125,247.7777778,12.38430493
NM_001252676,ACSS1,13,12,26478,3522,22956,1913,270.9230769,6.517887564
NM_199425,VSX1,3,2,3838,1199,2639,1319.5,399.6666667,2.201000834
NM_014588,VSX1,5,4,6945,2211,4734,1183.5,442.2,2.141112619
NM_001256272,VSX1,5,4,11496,2230,9266,2316.5,446,4.155156951
NM_001256271,VSX1,4,3,11496,2048,9448,3149.333333,512,4.61328125
NM_002862,PYGB,20,19,49944,4151,45793,2410.157895,207.55,11.03179957
NM_001247,ENTPD6,15,14,31023,2777,28246,2017.571429,185.1333333,10.17140799
NM_001114089,ENTPD6,14,13,31023,2707,28316,2178.153846,193.3571429,10.46028814
NM_015655,ZNF337,5,4,22620,3202,19418,4854.5,640.4,6.064334791
NM_152667,NANP,2,1,11077,3801,7276,7276,1900.5,1.914233097
NM_001037730,DEFB115,2,1,1970,269,1701,1701,134.5,6.323420074
NM_001011878,DEFB121,2,1,1423,415,1008,1008,207.5,2.428915663
NM_001171832,DEFB121,2,1,7995,460,7535,7535,230,16.38043478
NM_001271209,DEFB119,2,1,1683,489,1194,1194,244.5,2.441717791
NM_001037731,DEFB116,2,1,5375,311,5064,5064,155.5,16.2829582
NM_054112,DEFB118,2,1,5286,1139,4147,4147,569.5,3.640913082
NM_153323,DEFB119,2,1,1683,492,1191,1191,246,2.420731707
NM_153289,DEFB119,2,1,13488,506,12982,12982,253,25.65612648
NM_014012,REM1,5,4,9619,1675,7944,1986,335,4.742686567
NM_001037500,DEFB124,2,1,7509,218,7291,7291,109,33.44495413
NM_178582,HM13,3,2,25515,2172,23343,11671.5,724,10.74723757
NM_153324,DEFB123,2,1,9651,380,9271,9271,190,24.39736842
NM_032609,COX4I2,5,4,7111,689,6422,1605.5,137.8,9.320754717
NM_181353,ID1,1,0,1233,1233,NA,NA,1233,NA
NM_002165,ID1,2,1,1233,995,238,238,497.5,0.23919598
NM_012112,TPX2,18,17,62701,3680,59021,3471.823529,204.4444444,16.03831522
NM_001012644,DUSP15,7,6,8933,1219,7714,1285.666667,174.1428571,6.328137818
NM_080611,DUSP15,7,6,9611,1390,8221,1370.166667,198.5714286,5.914388489
NM_004118,FOXS1,1,0,1319,1319,NA,NA,1319,NA
NM_177991,DUSP15,7,6,9143,1191,7952,1325.333333,170.1428571,6.676742233
NM_001008409,TTLL9,15,14,72355,1622,70733,5052.357143,108.1333333,43.60850801
NM_001011718,XKR7,3,2,30453,2913,27540,13770,971,9.454170958
NM_080625,CCM2L,9,8,21741,2541,19200,2400,282.3333333,7.556080283
NM_002657,PLAGL2,3,2,15241,5659,9582,4791,1886.333333,1.69323202
NM_014742,TM9SF4,18,17,57754,3996,53758,3162.235294,222,13.45295295
NM_004798,KIF3B,9,8,57359,6122,51237,6404.625,680.2222222,8.36932375
NM_015338,ASXL1,12,11,80977,7051,73926,6720.545455,587.5833333,10.48447029
NM_001164603,ASXL1,4,3,14207,1074,13133,4377.666667,268.5,12.22811918
NM_182584,C20orf203,5,4,20358,4798,15560,3890,959.6,3.243017924
NM_012325,MAPRE1,7,6,30514,2630,27884,4647.333333,375.7142857,10.60228137
NM_006892,DNMT3B,23,22,46973,4359,42614,1937,189.5217391,9.776095435
NM_175848,DNMT3B,22,21,46973,4298,42675,2032.142857,195.3636364,9.929036761
NM_001207056,DNMT3B,18,17,46973,3877,43096,2535.058824,215.3888889,11.11581119
NM_001207055,DNMT3B,19,18,46973,3980,42993,2388.5,209.4736842,10.80226131
NM_175849,DNMT3B,20,19,46973,4107,42866,2256.105263,205.35,10.43730217
NM_175850,DNMT3B,22,21,29506,4277,25229,1201.380952,194.4090909,5.898760814
NM_025227,BPIFB2,16,15,16133,1936,14197,946.4666667,121,7.333161157
NM_182658,BPIFB3,15,14,18206,1469,16737,1195.5,97.93333333,11.39346494
NM_182519,BPIFB4,16,15,30241,2190,28051,1870.066667,136.875,12.8086758
NM_174897,BPIFB6,15,14,12401,1377,11024,787.4285714,91.8,8.005809731
NM_001042439,BPIFA3,6,5,10498,1079,9419,1883.8,179.8333333,8.729379055
NM_080574,BPIFA2,9,8,13265,1061,12204,1525.5,117.8888889,11.50235627
NM_016583,BPIFA1,9,8,7315,1032,6283,785.375,114.6666667,6.088178295
NM_178466,BPIFA3,7,6,10498,1188,9310,1551.666667,169.7142857,7.836700337
NM_001243193,BPIFA1,9,8,7315,1071,6244,780.5,119,5.830065359
NM_130852,BPIFA1,9,8,7315,1087,6228,778.5,120.7777778,5.729530819
NM_033197,BPIFB1,16,15,26745,1743,25002,1666.8,108.9375,14.34423408
NM_003098,SNTA1,8,7,35937,2348,33589,4798.428571,293.5,14.30536627
NM_001039709,CBFA2T2,11,10,87668,7460,80208,8020.8,678.1818182,10.75174263
NM_005093,CBFA2T2,12,11,87668,7749,79919,7265.363636,645.75,10.3134598
NM_031232,NECAB3,12,11,17373,2051,15322,1392.909091,170.9166667,7.470502194
NM_031231,NECAB3,13,12,17373,1950,15423,1285.25,150,7.909230769
NM_183397,PXMP4,3,2,17588,5528,12060,6030,1842.666667,2.181620839
NM_007238,PXMP4,4,3,17588,5728,11860,3953.333333,1432,2.070530726
NM_080825,C20orf144,2,1,1631,572,1059,1059,286,1.851398601
NM_001024675,ACTL10,1,0,2029,2029,NA,NA,2029,NA
NM_005225,E2F1,7,6,10920,2707,8213,1368.833333,386.7142857,3.033985962
NM_176812,CHMP4B,5,4,43065,1652,41413,10353.25,330.4,25.06840194
NM_003908,EIF2S2,9,8,23972,2601,21371,2671.375,289,8.21645521
NM_001672,ASIP,3,2,8979,587,8392,4196,195.6666667,14.29642249
NM_000687,AHCY,10,9,23146,2217,20929,2325.444444,221.7,9.440234551
NM_032514,MAP1LC3A,4,3,1650,989,661,220.3333333,247.25,0.668351871
NM_014183,DYNLRB1,4,3,24575,704,23871,7957,176,33.90767045
NM_001281729,DYNLRB1,5,4,24575,1088,23487,5871.75,217.6,21.58731618
NM_001281728,DYNLRB1,5,4,24575,780,23795,5948.75,156,30.50641026
NM_001281727,DYNLRB1,4,3,24575,700,23875,7958.333333,175,34.10714286
NM_177953,DYNLRB1,5,4,24575,784,23791,5947.75,156.8,30.34566327
NM_181509,MAP1LC3A,5,4,13463,936,12527,3131.75,187.2,13.38354701
NM_001242539,NCOA6,14,13,110857,4097,106760,8212.307692,292.6428571,26.05809129
NM_014071,NCOA6,15,14,110857,7077,103780,7412.857143,471.8,14.66440582
NM_001242393,ACSS2,18,17,53005,2873,50132,2948.941176,159.6111111,17.44935607
NM_000178,GSS,13,12,27367,1913,25454,2121.166667,147.1538462,13.3058024
NM_018677,ACSS2,18,17,51443,2997,48446,2849.764706,166.5,16.1648315
NM_001076552,ACSS2,19,18,51443,3037,48406,2689.222222,159.8421053,15.93875535
NM_178026,GGT7,15,14,28140,2655,25485,1820.357143,177,9.598870056
NM_015638,TRPC4AP,19,18,90413,3189,87224,4845.777778,167.8421053,27.35152085
NM_199368,TRPC4AP,19,18,90413,3165,87248,4847.111111,166.5789474,27.56650869
NM_006404,PROCR,4,3,5427,1488,3939,1313,372,2.647177419
NM_018217,EDEM2,11,10,32003,1924,30079,3007.9,174.9090909,15.63357588
NM_001145025,EDEM2,10,9,32003,1812,30191,3354.555556,181.2,16.66169978
NM_002212,EIF6,7,6,5912,1132,4780,796.6666667,161.7142857,4.222614841
NM_001267810,EIF6,7,6,5813,1062,4751,791.8333333,151.7142857,4.473634652
NM_178468,FAM83C,4,3,6693,3170,3523,1174.333333,792.5,1.111356467
NM_181468,EIF6,6,5,5813,1265,4548,909.6,210.8333333,3.595256917
NM_181466,EIF6,5,4,5912,1073,4839,1209.75,214.6,4.509785648
NM_000557,GDF5,2,1,4880,2385,2495,2495,1192.5,1.046121593
NM_198398,ERGIC3,14,13,15629,1380,14249,1096.076923,98.57142857,10.32536232
NM_003116,SPAG4,12,11,5158,1464,3694,335.8181818,122,2.523224044
NM_015966,ERGIC3,13,12,15629,1364,14265,1188.75,104.9230769,10.45821114
NM_001145350,C20orf173,6,5,2684,1065,1619,323.8,177.5,1.520187793
NM_006047,RBM12,3,2,16033,6705,9328,4664,2235,1.391200597
NM_001198838,RBM12,3,2,16033,6663,9370,4685,2221,1.40627345
NM_184234,RBM39,17,16,38729,2891,35838,2239.875,170.0588235,12.39640263
NM_021100,NFS1,13,12,30679,2398,28281,2356.75,184.4615385,11.79357798
NM_001198863,CPNE1,16,15,38927,1992,36935,2462.333333,124.5,18.54166667
NM_001198840,RBM12,2,1,16033,6619,9414,9414,3309.5,1.422269225
NM_080748,ROMO1,3,2,1672,464,1208,604,154.6666667,2.603448276
NM_152927,CPNE1,17,16,38927,2123,36804,2300.25,124.8823529,17.3358455
NM_152838,RBM12,3,2,16033,6673,9360,4680,2224.333333,1.402667466
NM_001242599,RBM39,16,15,38729,2824,35905,2393.666667,176.5,12.71423513
NM_001242600,RBM39,16,15,38729,2806,35923,2394.866667,175.375,12.80220955
NM_001198989,NFS1,12,11,30679,2244,28435,2585,187,12.67156863
NM_004902,RBM39,17,16,38729,2873,35856,2241,169,12.48033415
NM_003915,CPNE1,16,15,27880,2222,25658,1710.533333,138.875,11.54725473
NM_152928,CPNE1,17,16,38927,2091,36836,2302.25,123,17.61645146
NM_152926,CPNE1,16,15,38927,1995,36932,2462.133333,124.6875,18.5122807
NM_152925,CPNE1,16,15,38927,2037,36890,2459.333333,127.3125,18.10996564
NM_016558,SCAND1,3,2,1744,1374,370,185,458,0.269286754
NM_033630,SCAND1,2,1,1011,904,107,107,452,0.118362832
NM_015511,AAR2,4,3,20526,2769,17757,5919,692.25,6.412784399
NM_001271874,AAR2,4,3,20526,2490,18036,6012,622.5,7.243373494
NM_012156,EPB41L1,22,21,78061,6298,71763,3417.285714,286.2727273,11.3945697
NM_199483,C20orf24,3,2,6825,987,5838,2919,329,5.914893617
NM_021809,TGIF2,3,2,20347,3411,16936,8468,1137,4.96511287
NM_001199534,C20orf24,4,3,6825,1146,5679,1893,286.5,4.955497382
NM_001199515,TGIF2,3,2,19400,3354,16046,8023,1118,4.784138342
NM_001199514,TGIF2,3,2,20481,3452,17029,8514.5,1150.666667,4.933082271
NM_001199513,TGIF2,3,2,20481,3324,17157,8578.5,1108,5.161552347
NM_001199535,TGIF2-C20orf24,5,4,38005,1095,36910,9227.5,219,33.70776256
NM_006097,MYL9,4,3,8341,1201,7140,2380,300.25,5.945045795
NM_018840,C20orf24,4,3,6825,1118,5707,1902.333333,279.5,5.104651163
NM_181526,MYL9,3,2,8341,1038,7303,3651.5,346,7.035645472
NM_032013,NDRG3,16,15,94374,3040,91334,6088.933333,190,30.04407895
NM_022477,NDRG3,15,14,94374,3003,91371,6526.5,200.2,30.42657343
NM_199181,SOGA1,15,14,82433,3725,78708,5622,248.3333333,21.12966443
NM_080627,SOGA1,15,14,79911,8051,71860,5132.857143,536.7333333,8.925599304
NM_021081,GHRH,4,3,5811,464,5347,1782.333333,116,11.5237069
NM_001184731,GHRH,4,3,5811,461,5350,1783.333333,115.25,11.60520607
NM_002951,RPN2,17,16,62571,2524,60047,3752.9375,148.4705882,23.79041204
NM_001135771,RPN2,17,16,62571,2476,60095,3755.9375,145.6470588,24.27100162
NM_022077,MANBAL,4,3,27614,1319,26295,8765,329.75,19.93555724
NM_198291,SRC,14,13,59306,4052,55254,4250.307692,289.4285714,13.63622902
NM_005417,SRC,14,13,60749,4127,56622,4355.538462,294.7857143,13.71989339
NM_001003897,MANBAL,3,2,27614,1201,26413,13206.5,400.3333333,21.99250624
NM_181689,NNAT,2,1,2485,1223,1262,1262,611.5,1.031888798
NM_001167823,BLCAP,2,1,7136,2111,5025,5025,1055.5,2.380388441
NM_001167822,BLCAP,2,1,10266,2044,8222,8222,1022,4.022504892
NM_001167820,BLCAP,3,2,10516,2209,8307,4153.5,736.3333333,3.760525124
NM_001167821,BLCAP,2,1,10317,2038,8279,8279,1019,4.062315996
NM_006698,BLCAP,2,1,10516,2075,8441,8441,1037.5,4.067951807
NM_005386,NNAT,3,2,2485,1305,1180,590,435,0.904214559
NM_014657,TTI1,9,8,50412,3923,46489,5811.125,435.8888889,11.85036962
NM_198951,TGM2,10,9,27351,1889,25462,2829.111111,188.9,13.47908947
NM_004613,TGM2,13,12,36838,3934,32904,2742,302.6153846,8.364006101
NM_001029864,KIAA1755,14,13,50269,6426,43843,3372.538462,459,6.822751323
NM_004139,LBP,15,14,30841,1909,28932,2066.571429,127.2666667,15.15557884
NM_001282918,RALGAPB,30,29,106057,8694,97363,3357.344828,289.8,11.19887279
NM_001018082,ADIG,3,2,7268,773,6495,3247.5,257.6666667,8.40232859
NM_001282917,RALGAPB,30,29,106057,8561,97496,3361.931034,285.3666667,11.38838921
NM_020336,RALGAPB,30,29,106057,8703,97354,3357.034483,290.1,11.18625761
NM_001164431,ARHGAP40,15,14,48720,2853,45867,3276.214286,190.2,16.0767613
NM_024855,ACTR5,9,8,23994,2488,21506,2688.25,276.4444444,8.643890675
NM_030919,FAM83D,4,3,26750,2433,24317,8105.666667,608.25,9.994656802
NM_005461,MAFB,1,0,3394,3394,NA,NA,3394,NA
NM_002660,PLCG1,32,31,38198,5237,32961,1063.258065,163.65625,6.293870537
NM_182811,PLCG1,32,31,38198,5234,32964,1063.354839,163.5625,6.298051204
NM_052846,EMILIN3,4,3,6894,3831,3063,1021,957.75,0.799530149
NM_032107,L3MBTL1,22,21,34217,3388,30829,1468.047619,154,9.099468713
NM_006275,SRSF6,6,5,5742,3752,1990,398,625.3333333,0.530383795
NM_015478,L3MBTL1,19,18,27461,3214,24247,1347.055556,169.1578947,7.544181705
NM_016004,IFT52,14,13,56285,1689,54596,4199.692308,120.6428571,32.32445234
NM_001008901,GTSF1L,2,1,843,769,74,74,384.5,0.096228869
NM_176791,GTSF1L,1,0,843,843,NA,NA,843,NA
NM_016470,OSER1,4,3,14967,2246,12721,4240.333333,561.5,5.663846839
NM_020433,JPH2,6,5,75883,4791,71092,14218.4,798.5,14.83865581
NM_175913,JPH2,2,1,10763,2410,8353,8353,1205,3.465975104
NM_001080472,FITM2,2,1,4694,960,3734,3734,480,3.889583333
NM_024034,GDAP1L1,6,5,33661,2804,30857,6171.4,467.3333333,11.00463623
NM_001256739,GDAP1L1,5,4,33661,2629,31032,7758,525.8,11.80372765
NM_001256738,GDAP1L1,6,5,33820,2651,31169,6233.8,441.8333333,11.75745002
NM_001256737,GDAP1L1,6,5,33661,2861,30800,6160,476.8333333,10.76546662
NM_001256740,GDAP1L1,4,3,33661,2589,31072,10357.33333,647.25,12.001545
NM_178491,R3HDML,5,4,13636,767,12869,3217.25,153.4,16.77835724
NM_178850,HNF4A,8,7,23382,1636,21746,3106.571429,204.5,13.29217604
NM_178849,HNF4A,10,9,31591,4702,26889,2987.666667,470.2,5.71863037
NM_001258355,HNF4A,11,10,31591,4824,26767,2676.7,438.5454545,5.54871476
NM_000457,HNF4A,10,9,31591,4732,26859,2984.333333,473.2,5.676035503
NM_001287807,C20orf62,2,1,3583,702,2881,2881,351,4.103988604
NM_007066,PKIG,4,3,87258,1199,86059,28686.33333,299.75,71.77564637
NM_006811,SERINC3,10,9,22827,2602,20225,2247.222222,260.2,7.772867025
NM_198941,SERINC3,11,10,25864,1738,24126,2412.6,158,13.88147296
NM_001281444,PKIG,6,5,87258,1623,85635,17127,270.5,52.76340111
NM_001281445,PKIG,4,3,36490,1184,35306,11768.66667,296,29.81925676
NM_181805,PKIG,6,5,87258,1453,85805,17161,242.1666667,59.05368204
NM_181804,PKIG,5,4,87258,1347,85911,21477.75,269.4,63.77951002
NM_022358,KCNK15,2,1,6468,2534,3934,3934,1267,1.552486188
NM_003881,WISP2,4,3,12569,1408,11161,3720.333333,352,7.926846591
NM_006809,TOMM34,7,6,18345,2056,16289,2714.833333,293.7142857,7.92266537
NM_001124756,PABPC1L,15,14,29261,2144,27117,1936.928571,142.9333333,12.64785448
NM_080869,WFDC12,3,2,1041,777,264,132,259,0.33976834
NM_145652,WFDC5,4,3,5722,1022,4700,1566.666667,255.5,4.598825832
NM_002251,KCNS1,5,4,8805,4544,4261,1065.25,908.8,0.93772007
NM_003007,SEMG1,3,2,2778,1666,1112,556,555.3333333,0.667466987
NM_003064,SLPI,4,3,2327,600,1727,575.6666667,150,2.878333333
NM_003008,SEMG2,3,2,3091,1985,1106,553,661.6666667,0.557178841
NM_002638,PI3,3,2,1647,557,1090,545,185.6666667,1.956912029
NM_030592,MATN4,8,7,14853,1986,12867,1838.142857,248.25,6.478851964
NM_030590,MATN4,9,8,14883,2140,12743,1592.875,237.7777778,5.954672897
NM_002999,SDC4,5,4,23137,2617,20520,5130,523.4,7.841039358
NM_001048223,DBNDD2,4,3,4024,1113,2911,970.3333333,278.25,2.615453729
NM_033542,SYS1,4,3,6124,2801,3323,1107.666667,700.25,1.186362014
NM_014276,RBPJL,12,11,10983,2511,8472,770.1818182,209.25,3.3739546
NM_001281448,RBPJL,12,11,10983,2521,8462,769.2727273,210.0833333,3.356604522
NM_001281449,RBPJL,12,11,10983,2508,8475,770.4545455,209,3.379186603
NM_001048224,DBNDD2,4,3,4024,1211,2813,937.6666667,302.75,2.322873658
NM_001048222,DBNDD2,4,3,4597,1262,3335,1111.666667,315.5,2.642630745
NM_001048221,DBNDD2,4,3,4597,1164,3433,1144.333333,291,2.949312715
NM_001099791,SYS1,4,3,13704,2962,10742,3580.666667,740.5,3.626603646
NM_014477,TP53TG5,5,4,4439,986,3453,863.25,197.2,3.502028398
NM_001048225,DBNDD2,3,2,2623,1438,1185,592.5,479.3333333,0.824061196
NM_001048226,DBNDD2,3,2,2623,1536,1087,543.5,512,0.707682292
NM_001197140,DBNDD2,4,3,4431,1043,3388,1129.333333,260.75,3.248322148
NM_001197139,DBNDD2,4,3,4619,997,3622,1207.333333,249.25,3.632898696
NM_001197129,SYS1,5,4,7287,2826,4461,1115.25,565.2,1.578556263
NM_018478,DBNDD2,4,3,4391,1485,2906,968.6666667,371.25,1.956902357
NM_003833,MATN4,11,10,15085,2323,12762,1276.2,211.1818182,5.493758071
NM_006652,SPINT3,2,1,3165,478,2687,2687,239,5.621338912
NM_015937,PIGT,12,11,10180,2258,7922,720.1818182,188.1666667,3.508414526
NM_080827,WFDC6,3,2,5300,622,4678,2339,207.3333333,7.520900322
NM_001184730,PIGT,10,9,10180,1950,8230,914.4444444,195,4.220512821
NM_001184729,PIGT,11,10,10180,2056,8124,812.4,186.9090909,3.951361868
NM_001184728,PIGT,11,10,10180,2089,8091,809.1,189.9090909,3.873145045
NM_006103,WFDC2,4,3,11780,570,11210,3736.666667,142.5,19.66666667
NM_130896,WFDC8,6,5,27566,1075,26491,5298.2,179.1666667,24.6427907
NM_147198,WFDC9,5,4,23331,664,22667,5666.75,132.8,34.13704819
NM_080753,WFDC10A,2,1,1448,484,964,964,242,1.991735537
NM_147197,WFDC11,5,4,21678,620,21058,5264.5,124,33.96451613
NM_181510,WFDC8,7,6,28176,1276,26900,4483.333333,182.2857143,21.0815047
NM_178455,SPINT4,3,2,3349,383,2966,1483,127.6666667,7.744125326
NM_080614,WFDC3,7,6,17702,1007,16695,2782.5,143.8571429,16.57894737
NM_172131,WFDC10B,3,2,20370,480,19890,9945,160,41.4375
NM_172006,WFDC10B,4,3,20370,636,19734,6578,159,31.02830189
NM_172005,WFDC13,4,3,6803,1376,5427,1809,344,3.944040698
NM_001042632,SNX21,4,3,9446,3170,6276,2092,792.5,1.979810726
NM_001042633,SNX21,5,4,9446,3189,6257,1564.25,637.8,1.962057071
NM_033421,SNX21,4,3,9446,3177,6269,2089.666667,794.25,1.9732452
NM_007019,UBE2C,6,5,4383,856,3527,705.4,142.6666667,4.120327103
NM_001278535,NEURL2,2,1,2817,1456,1361,1361,728,0.934752747
NM_001127695,CTSA,15,14,7869,2301,5568,397.7142857,153.4,2.419817471
NM_001281742,UBE2C,5,4,4383,650,3733,933.25,130,5.743076923
NM_001281741,UBE2C,5,4,4383,714,3669,917.25,142.8,5.138655462
NM_080603,ZSWIM1,2,1,4059,2789,1270,1270,1394.5,0.455360344
NM_001167594,CTSA,14,13,7869,2203,5666,435.8461538,157.3571429,2.571947345
NM_006227,PLTP,16,15,13746,2116,11630,775.3333333,132.25,5.496219282
NM_001242920,PLTP,14,13,13746,1829,11917,916.6923077,130.6428571,6.515582285
NM_001242921,PLTP,14,13,12376,1741,10635,818.0769231,124.3571429,6.1085583
NM_152897,SNX21,5,4,9446,1926,7520,1880,385.2,3.904465213
NM_080752,ZSWIM3,2,1,21551,2819,18732,18732,1409.5,6.644909542
NM_080608,SPATA25,2,1,1110,721,389,389,360.5,0.539528433
NM_080749,NEURL2,2,1,2817,1442,1375,1375,721,0.953536755
NM_000308,CTSA,15,14,7869,2255,5614,401,150.3333333,2.489578714
NM_181799,UBE2C,6,5,4383,802,3581,716.2,133.6666667,4.465087282
NM_181800,UBE2C,5,4,4383,768,3615,903.75,153.6,4.70703125
NM_005469,ACOT8,6,5,15690,1177,14513,2902.6,196.1666667,12.33050127
NM_003279,TNNC2,6,5,4100,687,3413,682.6,114.5,4.96797671
NM_182676,PLTP,15,14,13746,1959,11787,841.9285714,130.6,6.016845329
NM_181801,UBE2C,6,5,3926,893,3033,606.6,148.8333333,3.396416573
NM_020708,SLC12A5,26,25,30970,6085,24885,995.4,234.0384615,4.089564503
NM_001134771,SLC12A5,26,25,38462,6067,32395,1295.8,233.3461538,5.339541783
NM_022095,ZNF335,28,27,23543,4480,19063,706.037037,160,4.255133929
NM_004994,MMP9,13,12,7655,2349,5306,442.1666667,180.6923077,2.258833546
NM_001250,CD40,9,8,11480,1625,9855,1231.875,180.5555556,6.064615385
NM_152854,CD40,8,7,11480,1562,9918,1416.857143,195.25,6.349551857
NM_015945,SLC35C2,10,9,14932,2319,12613,1401.444444,231.9,5.43898232
NM_133171,ELMO2,22,21,40583,3704,36879,1756.142857,168.3636364,9.956533477
NM_001281460,SLC35C2,11,10,14932,2652,12280,1228,241.0909091,4.630467572
NM_001281459,SLC35C2,10,9,14932,2185,12747,1416.333333,218.5,5.833867277
NM_001281458,SLC35C2,11,10,14932,2188,12744,1274.4,198.9090909,5.824497258
NM_001281457,SLC35C2,10,9,14932,2248,12684,1409.333333,224.8,5.642348754
NM_182764,ELMO2,21,20,40583,3599,36984,1849.2,171.3809524,10.27618783
NM_173179,SLC35C2,10,9,14932,2514,12418,1379.777778,251.4,4.939538584
NM_173073,SLC35C2,10,9,14932,2256,12676,1408.444444,225.6,5.618794326
NM_018102,ZNF334,5,4,13931,3902,10029,2507.25,780.4,2.5702204
NM_080721,OCSTAMP,3,2,9545,1961,7584,3792,653.6666667,3.867414584
NM_001270497,ZNF334,6,5,13931,3963,9968,1993.6,660.5,2.515266212
NM_033550,TP53RK,2,1,5274,3375,1899,1899,1687.5,0.562666667
NM_001281769,ZMYND8,4,3,58765,1279,57486,19162,319.75,44.9460516
NM_017454,STAU1,12,11,75030,3332,71698,6518,277.6666667,21.5180072
NM_001037328,STAU1,14,13,75030,3550,71480,5498.461538,253.5714286,20.13521127
NM_017453,STAU1,14,13,75030,3698,71332,5487.076923,264.1428571,19.28934559
NM_017452,STAU1,13,12,75030,3408,71622,5968.5,262.1538462,21.01584507
NM_004602,STAU1,14,13,75030,3532,71498,5499.846154,252.2857143,20.24292186
NM_021035,ZNFX1,14,13,32319,7383,24936,1918.153846,527.3571429,3.377488826
NM_004975,KCNB1,2,1,110678,3758,106920,106920,1879,28.45130389
NM_000961,PTGIS,10,9,64298,5613,58685,6520.555556,561.3,10.4551933
NM_004776,B4GALT5,9,8,80940,4736,76204,9525.5,526.2222222,16.09037162
NM_006038,SPATA2,3,2,12153,4059,8094,4047,1353,1.994087214
NM_018683,RNF114,6,5,17510,2473,15037,3007.4,412.1666667,6.080469066
NM_001135773,SPATA2,3,2,10349,4143,6206,3103,1381,1.497948347
NM_005985,SNAI1,3,2,5909,1709,4200,2100,569.6666667,2.457577531
NM_001282575,UBE2V1,5,4,34837,2598,32239,8059.75,519.6,12.40916089
NM_001282578,UBE2V1,4,3,32076,2351,29725,9908.333333,587.75,12.64355593
NM_001282577,UBE2V1,5,4,32076,2215,29861,7465.25,443,13.48126411
NM_199144,UBE2V1,5,4,34837,2469,32368,8092,493.8,13.10976104
NM_022442,UBE2V1,4,3,34837,2188,32649,10883,547,14.92184644
NM_001282580,UBE2V1,3,2,17781,1096,16685,8342.5,365.3333333,15.22354015
NM_001282579,UBE2V1,5,4,32076,2263,29813,7453.25,452.6,13.17410517
NM_001282576,UBE2V1,5,4,32076,2437,29639,7409.75,487.4,12.16208453
NM_001032288,UBE2V1,4,3,32076,2162,29914,9971.333333,540.5,13.83626272
NM_001257397,UBE2V1,5,4,32076,2246,29830,7457.5,449.2,13.28138914
NM_001257394,UBE2V1,3,2,34837,2395,32442,16221,798.3333333,13.54572025
NM_001257399,UBE2V1,5,4,32076,2280,29796,7449,456,13.06842105
NM_001257398,UBE2V1,5,4,32076,2302,29774,7443.5,460.4,12.93397046
NM_001257396,UBE2V1,3,2,32076,2035,30041,15020.5,678.3333333,14.76216216
NM_001257395,UBE2V1,4,3,32076,2153,29923,9974.333333,538.25,13.89828147
NM_001257393,UBE2V1,5,4,34837,2338,32499,8124.75,467.6,13.90034217
NM_021988,UBE2V1,4,3,34837,2545,32292,10764,636.25,12.68840864
NM_005194,CEBPB,1,0,2109,2109,NA,NA,2109,NA
NM_001285878,CEBPB,1,0,2109,2109,NA,NA,2109,NA
NM_001285879,CEBPB,1,0,2109,2109,NA,NA,2109,NA
NM_080829,FAM65C,22,21,50781,4303,46478,2213.238095,195.5909091,10.80130142
NM_032521,PARD6B,3,2,22199,4618,17581,8790.5,1539.333333,3.807059333
NM_001282532,ADNP,4,3,20875,6097,14778,4926,1524.25,2.423814991
NM_014484,MOCS3,1,0,3050,3050,NA,NA,3050,NA
NM_003859,DPM1,9,8,23657,1056,22601,2825.125,117.3333333,21.40246212
NM_002237,KCNG1,3,2,19484,2223,17261,8630.5,741,7.764732344
NM_020436,SALL4,4,3,18467,3488,14979,4993,872,4.294438073
NM_199426,ZFP64,6,5,40709,3263,37446,7489.2,543.8333333,11.47594238
NM_018197,ZFP64,6,5,40709,3269,37440,7488,544.8333333,11.45304374
NM_022088,ZFP64,5,4,40709,3106,37603,9400.75,621.2,12.10656793
NM_006526,ZNF217,5,4,16028,5640,10388,2597,1128,1.841843972
NM_003657,BCAS1,12,11,127227,3487,123740,11249.09091,290.5833333,35.4860912
NM_001128915,CYP24A1,11,10,20530,3079,17451,1745.1,279.9090909,5.667749269
NM_000782,CYP24A1,12,11,20530,3278,17252,1568.363636,273.1666667,5.262965223
NM_002623,PFDN4,4,3,11992,1350,10642,3547.333333,337.5,7.882962963
NM_080617,CBLN4,3,2,8117,3110,5007,2503.5,1036.666667,1.609967846
NM_019888,MC3R,1,0,1085,1085,NA,NA,1085,NA
NM_001164116,CASS4,7,6,47230,3186,44044,7340.666667,455.1428571,13.82423101
NM_001164115,CASS4,5,4,47084,1849,45235,11308.75,369.8,24.46457545
NM_001164114,CASS4,6,5,47084,2999,44085,8817,499.8333333,14.69989997
NM_198437,AURKA,9,8,22908,2123,20785,2598.125,235.8888889,9.790390956
NM_198435,AURKA,9,8,22908,2137,20771,2596.375,237.4444444,9.719700515
NM_198434,AURKA,10,9,22908,2248,20660,2295.555556,224.8,9.190391459
NM_198433,AURKA,11,10,22908,2558,20350,2035,232.5454545,7.955433933
NM_001033522,CSTF1,6,5,11877,2298,9579,1915.8,383,4.168407311
NM_001033521,CSTF1,6,5,12157,2301,9856,1971.2,383.5,4.283355063
NM_198436,AURKA,10,9,22908,2234,20674,2297.111111,223.4,9.254252462
NM_001324,CSTF1,6,5,12010,2329,9681,1936.2,388.1666667,4.156719622
NM_080821,FAM210B,3,2,9737,3036,6701,3350.5,1012,2.207180501
NM_020356,CASS4,6,5,47084,3161,43923,8784.6,526.8333333,13.8952863
NM_003600,AURKA,9,8,22908,2348,20560,2570,260.8888889,8.756388416
NM_001013646,FAM209B,2,1,3274,694,2580,2580,347,3.717579251
NM_001012971,FAM209A,2,1,1425,680,745,745,340,1.095588235
NM_080615,GCNT7,7,6,34435,2071,32364,5394,295.8571429,15.62723322
NM_003222,TFAP2C,7,6,9982,2872,7110,1185,410.2857143,2.475626741
NM_001190472,MTRNR2L3,1,0,1384,1384,NA,NA,1384,NA
NM_003610,RAE1,12,11,27376,1824,25552,2322.909091,152,14.00877193
NM_198265,SPO11,12,11,14220,1715,12505,1136.818182,142.9166667,7.29154519
NM_012444,SPO11,13,12,14220,1830,12390,1032.5,140.7692308,6.770491803
NM_001015885,RAE1,12,11,26903,1848,25055,2277.727273,154,13.55790043
NM_001160419,ZBP1,5,4,7693,1234,6459,1614.75,246.8,5.234197731
NM_001160418,ZBP1,7,6,16732,2080,14652,2442,297.1428571,7.044230769
NM_001160417,ZBP1,8,7,16732,2303,14429,2061.285714,287.875,6.265306122
NM_030776,ZBP1,8,7,16732,2306,14426,2060.857143,288.25,6.255854293
NM_002591,PCK1,10,9,5378,2695,2683,298.1111111,269.5,0.99554731
NM_178456,C20orf85,4,3,10202,761,9441,3147,190.25,12.40604468
NM_153360,APCDD1L,4,3,55525,3116,52409,17469.66667,779,16.81931964
NM_001204868,STX16,10,9,28275,4339,23936,2659.555556,433.9,5.516478451
NM_003763,STX16,8,7,28275,4912,23363,3337.571429,614,4.756311075
NM_001134773,STX16,9,8,28275,4925,23350,2918.75,547.2222222,4.741116751
NM_001134772,STX16,8,7,28275,4963,23312,3330.285714,620.375,4.697158976
NM_001001433,STX16,9,8,28275,4976,23299,2912.375,552.8888889,4.68227492
NM_080426,GNAS,12,11,19826,1877,17949,1631.727273,156.4166667,9.562599893
NM_000516,GNAS,13,12,19826,1920,17906,1492.166667,147.6923077,9.326041667
NM_080425,GNAS,13,12,58216,3778,54438,4536.5,290.6153846,14.40921122
NM_016592,GNAS,13,12,71457,2575,68882,5740.166667,198.0769231,26.75029126
NM_001077489,GNAS,12,11,19826,1874,17952,1632,156.1666667,9.579509072
NM_001077488,GNAS,13,12,19826,1923,17903,1491.916667,147.9230769,9.309932397
NM_001077490,GNAS,13,12,58216,3778,54438,4536.5,290.6153846,14.40921122
NM_001256403,SLMO2,5,4,9703,2478,7225,1806.25,495.6,2.915657789
NM_006886,ATP5E,3,2,3691,442,3249,1624.5,147.3333333,7.350678733
NM_198976,NELFCD,15,14,13927,2320,11607,829.0714286,154.6666667,5.003017241
NM_001336,CTSZ,6,5,12069,1506,10563,2112.6,251,7.013944223
NM_030773,TUBB1,4,3,7402,3500,3902,1300.666667,875,1.114857143
NM_016045,SLMO2,6,5,9703,2569,7134,1426.8,428.1666667,2.776956014
NM_000114,EDN3,6,5,25550,2404,23146,4629.2,400.6666667,9.6281198
NM_207034,EDN3,5,4,25550,2624,22926,5731.5,524.8,8.737042683
NM_207033,EDN3,4,3,25550,2581,22969,7656.333333,645.25,8.899263851
NM_207032,EDN3,5,4,25550,2659,22891,5722.75,531.8,8.608875517
NM_001190827,FAM217B,4,3,8260,4601,3659,1219.666667,1150.25,0.7952619
NM_001190826,FAM217B,5,4,14885,5124,9761,2440.25,1024.8,1.904957065
NM_021810,CDH26,6,5,16753,1096,15657,3131.4,182.6666667,14.28558394
NM_006242,PPP1R3D,1,0,3467,3467,NA,NA,3467,NA
NM_022106,FAM217B,4,3,8260,5057,3203,1067.666667,1264.25,0.633379474
NM_177980,CDH26,18,17,54699,3211,51488,3028.705882,178.3888889,16.0348801
NM_173644,C20orf197,4,3,17030,2736,14294,4764.666667,684,5.224415205
NM_015666,MTG2,7,6,19731,2943,16788,2798,420.4285714,5.704383282
NM_198935,SS18L1,11,10,38746,4559,34187,3418.7,414.4545455,7.498793595
NM_007232,HRH3,3,2,5308,2683,2625,1312.5,894.3333333,0.978382408
NM_002792,PSMA7,7,6,6733,1039,5694,949,148.4285714,5.48026949
NM_144703,LSM14B,9,8,12919,2603,10316,1289.5,289.2222222,3.963119478
NM_001281438,ADRM1,9,8,5968,1372,4596,574.5,152.4444444,3.349854227
NM_001281437,ADRM1,9,8,5968,1368,4600,575,152,3.362573099
NM_007002,ADRM1,10,9,5968,1490,4478,497.5555556,149,3.005369128
NM_005560,LAMA5,80,79,58254,11511,46743,591.6835443,143.8875,4.060724524
NM_175573,ADRM1,10,9,5968,1486,4482,498,148.6,3.01615074
NM_031215,CABLES2,10,9,18655,3795,14860,1651.111111,379.5,3.915678524
NM_080833,RBBP8NL,14,13,17338,2847,14491,1114.692308,203.3571429,5.089919213
NM_080473,GATA5,7,6,12475,2602,9873,1645.5,371.7142857,3.794388932
NM_001024,RPS21,6,5,1457,402,1055,211,67,2.624378109
NM_178463,C20orf166,4,3,20313,1224,19089,6363,306,15.59558824
NM_016354,SLCO4A1,12,11,29852,2788,27064,2460.363636,232.3333333,9.707317073
NM_001853,COL9A3,32,31,24099,2517,21582,696.1935484,78.65625,8.574493445
NM_007346,OGFR,7,6,9177,2427,6750,1125,346.7142857,2.781211372
NM_018270,MRGBP,5,4,4142,1641,2501,625.25,328.2,1.524070689
NM_022082,SLC17A9,13,12,15952,2605,13347,1112.25,200.3846154,5.123608445
NM_017896,GID8,5,4,10388,4432,5956,1489,886.4,1.343862816
NM_033081,DIDO1,16,15,60216,8590,51626,3441.733333,536.875,6.010011641
NM_080797,DIDO1,15,14,50739,7657,43082,3077.285714,510.4666667,5.626485569
NM_080796,DIDO1,6,5,21555,2802,18753,3750.6,467,6.692719486
NM_001193369,DIDO1,16,15,48815,8546,40269,2684.6,534.125,4.712029019
NM_001193370,DIDO1,15,14,39338,7613,31725,2266.071429,507.5333333,4.167213976
NM_022105,DIDO1,6,5,32956,2839,30117,6023.4,473.1666667,10.60831279
NM_080750,DPH3P1,1,0,1627,1627,NA,NA,1627,NA
NM_080606,BHLHE23,1,0,1058,1058,NA,NA,1058,NA
NM_017798,YTHDF1,5,4,20758,3257,17501,4375.25,651.4,5.373349708
NM_175609,ARFGAP1,14,13,17007,3316,13691,1053.153846,236.8571429,4.128769602
NM_001256573,CHRNA4,6,5,18088,5480,12608,2521.6,913.3333333,2.300729927
NM_020882,COL20A1,36,35,37749,4208,33541,958.3142857,116.8888889,7.970769962
NM_001281484,ARFGAP1,12,11,17007,3189,13818,1256.181818,265.75,4.333019755
NM_001281483,ARFGAP1,13,12,17007,3205,13802,1150.166667,246.5384615,4.306396256
NM_001281482,ARFGAP1,14,13,17007,3531,13476,1036.615385,252.2142857,3.816482583
NM_152864,NKAIN4,7,6,13758,1437,12321,2053.5,205.2857143,8.574112735
NM_000744,CHRNA4,6,5,18088,5549,12539,2507.8,924.8333333,2.25968643
NM_018209,ARFGAP1,13,12,17007,3291,13716,1143,253.1538462,4.167730173
NM_139317,BIRC7,7,6,4626,1375,3251,541.8333333,196.4285714,2.364363636
NM_022161,BIRC7,7,6,4626,1321,3305,550.8333333,188.7142857,2.501892506
NM_004518,KCNQ2,15,14,66453,3182,63271,4519.357143,212.1333333,19.8840352
NM_172109,KCNQ2,8,7,38963,1433,37530,5361.428571,179.125,26.18981158
NM_172108,KCNQ2,16,15,66453,3174,63279,4218.6,198.375,19.93667297
NM_172107,KCNQ2,17,16,66453,3268,63185,3949.0625,192.2352941,19.33445532
NM_172106,KCNQ2,16,15,66453,3213,63240,4216,200.8125,19.68253968
NM_024299,PPDPF,4,3,1393,781,612,204,195.25,0.783610755
NM_080823,SRMS,8,7,7582,2410,5172,738.8571429,301.25,2.146058091
NM_012384,GMEB2,10,9,39428,4220,35208,3912,422,8.343127962
NM_024059,C20orf195,2,1,3664,1113,2551,2551,556.5,2.292003594
NM_033405,HELZ2,14,13,9670,7521,2149,165.3076923,537.2142857,0.28573328
NM_005975,PTK6,8,7,8949,2533,6416,916.5714286,316.625,2.532964864
NM_001256358,PTK6,7,6,8949,2410,6539,1089.833333,344.2857143,2.713278008
NM_001037335,HELZ2,20,19,16155,10022,6133,322.7894737,501.1,0.611953702
NM_015894,STMN3,5,4,13907,2446,11461,2865.25,489.2,4.685609158
NM_001267546,ARFRP1,7,6,9372,2467,6905,1150.833333,352.4285714,2.798946088
NM_032527,ZGPAT,7,6,28116,2015,26101,4350.166667,287.8571429,12.95334988
NM_001267548,ARFRP1,8,7,9212,2464,6748,964,308,2.738636364
NM_001195654,ZGPAT,7,6,28116,1928,26188,4364.666667,275.4285714,13.58298755
NM_001195653,ZGPAT,7,6,28116,1936,26180,4363.333333,276.5714286,13.52272727
NM_001283009,RTEL1,35,34,38445,5160,33285,978.9705882,147.4285714,6.450581395
NM_003224,ARFRP1,8,7,9372,2562,6810,972.8571429,320.25,2.658079625
NM_017806,LIME1,6,5,2484,1205,1279,255.8,200.8333333,1.061410788
NM_016434,RTEL1,35,34,38445,4990,33455,983.9705882,142.5714286,6.704408818
NM_181485,ZGPAT,7,6,28116,1885,26231,4371.833333,269.2857143,13.91564987
NM_020062,SLC2A4RG,8,7,4194,2287,1907,272.4285714,285.875,0.833843463
NM_001267545,ARFRP1,6,5,9372,2560,6812,1362.4,426.6666667,2.6609375
NM_001267544,ARFRP1,7,6,9372,2635,6737,1122.833333,376.4285714,2.556736243
NM_001267549,ARFRP1,7,6,9372,2637,6735,1122.5,376.7142857,2.55403868
NM_001267547,ARFRP1,8,7,9372,2567,6805,972.1428571,320.875,2.650954422
NM_001276310,STMN3,5,4,13063,2356,10707,2676.75,471.2,4.544567063
NM_001083113,ZGPAT,7,6,28702,1912,26790,4465,273.1428571,14.01150628
NM_001134758,ARFRP1,7,6,9372,2632,6740,1123.333333,376,2.560790274
NM_003823,TNFRSF6B,3,2,2049,1158,891,445.5,386,0.769430052
NM_032957,RTEL1,35,34,38445,5062,33383,981.8529412,144.6285714,6.59482418
NM_001283010,RTEL1,34,33,38445,4710,33735,1022.272727,138.5294118,7.162420382
NM_080622,ABHD16B,1,0,1777,1777,NA,NA,1777,NA
NM_025219,DNAJC5,5,4,40931,5298,35633,8908.25,1059.6,6.725745564
NM_017859,UCKL1,15,14,16620,1884,14736,1052.571429,125.6,7.821656051
NM_020713,ZNF512B,17,16,13168,5939,7229,451.8125,349.3529412,1.217208284
NM_080621,SAMD10,5,4,5531,2186,3345,836.25,437.2,1.530192132
NM_001193379,UCKL1,15,14,11347,2112,9235,659.6428571,140.8,4.372632576
NM_018419,SOX18,2,1,1902,1707,195,195,853.5,0.114235501
NM_182647,OPRL1,5,4,20527,3381,17146,4286.5,676.2,5.071280686
NM_001200019,OPRL1,6,5,15629,3375,12254,2450.8,562.5,3.630814815
NM_001039467,RGS19,6,5,6791,1498,5293,1058.6,249.6666667,3.533377837
NM_001007125,LKAAEAR1,2,1,981,870,111,111,435,0.127586207
NM_005873,RGS19,6,5,6312,1598,4714,942.8,266.3333333,2.949937422
NM_003195,TCEA2,10,9,9692,1733,7959,884.3333333,173.3,4.592613964
NM_000913,OPRL1,4,3,20527,3229,17298,5766,807.25,5.357076494
NM_005286,NPBWR2,1,0,1003,1003,NA,NA,1003,NA
NM_198723,TCEA2,11,10,15263,1646,13617,1361.7,149.6363636,8.272782503
NM_018257,PCMTD2,6,5,20533,3918,16615,3323,653,4.240684022
NM_001104925,PCMTD2,6,5,20533,3837,16696,3339.2,639.5,4.351316132
NM_004535,MYT1,23,22,77781,5558,72223,3282.863636,241.6521739,12.99442245
NM_001271534,DSCAM,33,32,834698,7088,827610,25862.8125,214.7878788,116.7621332
NM_001389,DSCAM,33,32,834698,7142,827556,25861.125,216.4242424,115.8717446
NM_007038,ADAMTS5,8,7,49210,9671,39539,5648.428571,1208.875,4.088408644
NM_201413,APP,17,16,290279,3593,286686,17917.875,211.3529412,79.79014751
NM_001136016,APP,17,16,259849,3574,256275,16017.1875,210.2352941,71.70537213
NM_201414,APP,16,15,290279,3424,286855,19123.66667,214,83.77774533
NM_006447,USP16,18,17,29871,2991,26880,1581.176471,166.1666667,8.986960883
NM_001032410,USP16,19,18,29871,3055,26816,1489.777778,160.7894737,8.777741408
NM_001136131,APP,16,15,290587,3311,287276,19151.73333,206.9375,86.7641196
NM_001136129,APP,15,14,290279,3255,287024,20501.71429,217,88.17941628
NM_001136130,APP,17,16,290279,3482,286797,17924.8125,204.8235294,82.36559449
NM_001001992,USP16,18,17,29871,2988,26883,1581.352941,166,8.996987952
NM_001204303,APP,15,14,290279,3369,286910,20493.57143,224.6,85.16176907
NM_001204302,APP,16,15,290279,3538,286741,19116.06667,221.125,81.04607123
NM_001204301,APP,17,16,290279,3596,286683,17917.6875,211.5294118,79.7227475
NM_000484,APP,18,17,290279,3651,286628,16860.47059,202.8333333,78.50671049
NM_003253,TIAM1,29,28,440556,7227,433329,15476.03571,249.2068966,59.95973433
NM_001243432,ERG,12,11,294437,1526,292911,26628.27273,127.1666667,191.9469201
NM_001243429,ERG,9,8,204921,4704,200217,25027.125,522.6666667,42.56313776
NM_130438,DYRK1A,10,9,95080,5098,89982,9998,509.8,17.65045116
NM_182918,ERG,10,9,118480,4949,113531,12614.55556,494.9,22.94018994
NM_130436,DYRK1A,11,10,96474,6591,89883,8988.3,599.1818182,13.63723259
NM_101395,DYRK1A,13,12,147822,5530,142292,11857.66667,425.3846154,25.73092224
NM_001136154,ERG,12,11,281756,5120,276636,25148.72727,426.6666667,54.03046875
NM_015358,MORC3,17,16,56459,4263,52196,3262.25,250.7647059,12.24395965
NM_207584,IFNAR2,9,8,32864,1405,31459,3932.375,156.1111111,22.39074733
NM_001243428,ERG,12,11,280643,5143,275500,25045.45455,428.5833333,53.56795645
NM_001396,DYRK1A,11,10,95079,5223,89856,8985.6,474.8181818,17.2039058
NM_001136155,ERG,9,8,118480,4730,113750,14218.75,525.5555556,24.04862579
NM_000874,IFNAR2,9,8,32864,1451,31413,3926.625,161.2222222,21.64920744
NM_004449,ERG,11,10,281756,5047,276709,27670.9,458.8181818,54.82643154
NM_207585,IFNAR2,9,8,34620,2929,31691,3961.375,325.4444444,10.8197337
NM_001289125,IFNAR2,9,8,34620,2975,31645,3955.625,330.5555556,10.63697479
NM_001289126,IFNAR2,8,7,34620,2797,31823,4546.142857,349.625,11.37754737
NM_001289128,IFNAR2,8,7,34620,2843,31777,4539.571429,355.375,11.17727752
NM_015056,RRP1B,16,15,36530,5103,31427,2095.133333,318.9375,6.158534196
NM_144770,RBM11,5,4,12229,1972,10257,2564.25,394.4,5.201318458
NM_003489,NRIP1,4,3,103572,7560,96012,32004,1890,12.7
NM_001256579,LOC388813,7,6,50946,899,50047,8341.166667,128.4285714,55.66963293
NM_022136,SAMSN1,8,7,61134,1913,59221,8460.142857,239.125,30.95713539
NM_001256370,SAMSN1,9,8,98176,2194,95982,11997.75,243.7777778,43.74749316
NM_001286523,SAMSN1,9,8,61134,2038,59096,7387,226.4444444,28.99705594
NM_013396,USP25,24,23,150048,5157,144891,6299.608696,214.875,28.09598604
NM_001283041,USP25,26,25,150048,5369,144679,5787.16,206.5,26.94710374
NM_001283042,USP25,25,24,150048,5254,144794,6033.083333,210.16,27.55881233
NM_001204177,CHODL,5,4,350032,2038,347994,86998.5,407.6,170.7526987
NM_001204175,CHODL,6,5,350032,2142,347890,69578,357,162.4136321
NM_002772,TMPRSS15,25,24,134539,3969,130570,5440.416667,158.76,32.89745528
NM_001204178,CHODL,6,5,350032,2139,347893,69578.6,356.5,162.6428237
NM_001204176,CHODL,7,6,350032,2243,347789,57964.83333,320.4285714,155.0552831
NM_004540,NCAM2,18,17,541886,5020,536866,31580.35294,278.8888889,106.9454183
NM_001197297,GABPA,10,9,37515,4753,32762,3640.222222,475.3,6.892909741
NM_002040,GABPA,10,9,37444,5190,32254,3583.777778,519,6.214643545
NM_052954,CYYR1,4,3,107055,3083,103972,34657.33333,770.75,33.72429452
NM_001286622,MAP3K7CL,9,8,98420,2170,96250,12031.25,241.1111111,44.35483871
NM_000830,GRIK1,17,16,386418,3248,383170,23948.125,191.0588235,117.9710591
NM_020152,MAP3K7CL,10,9,98420,2256,96164,10684.88889,225.6,42.62588652
NM_175611,GRIK1,16,15,403030,3495,399535,26635.66667,218.4375,114.316166
NM_001286619,MAP3K7CL,7,6,83637,2073,81564,13594,296.1428571,39.34587554
NM_001286618,MAP3K7CL,9,8,98420,2135,96285,12035.625,237.2222222,45.09836066
NM_001286617,MAP3K7CL,10,9,98420,2265,96155,10683.88889,226.5,42.45253863
NM_001286620,MAP3K7CL,5,4,45406,1909,43497,10874.25,381.8,22.78522787
NM_001286634,MAP3K7CL,8,7,98420,2025,96395,13770.71429,253.125,47.60246914
NM_001286624,MAP3K7CL,4,3,30332,1509,28823,9607.666667,377.25,19.10072896
NM_199328,CLDN8,1,0,2147,2147,NA,NA,2147,NA
NM_014586,HUNK,11,10,130751,7396,123355,12335.5,672.3636364,16.67861006
NM_203446,SYNJ1,33,32,99284,7132,92152,2879.75,216.1212121,12.9209198
NM_058187,EVA1C,8,7,102967,1961,101006,14429.42857,245.125,51.50739419
NM_001160306,SYNJ1,28,27,99183,6970,92213,3415.296296,248.9285714,13.22998565
NM_001160302,SYNJ1,32,31,99183,7091,92092,2970.709677,221.59375,12.98716683
NM_144659,TCP10L,5,4,10696,2702,7994,1998.5,540.4,2.958549223
NM_014825,URB1,39,38,81984,10847,71137,1872.026316,278.1282051,6.558218862
NM_003895,SYNJ1,32,31,99284,7107,92177,2973.451613,222.09375,12.96988884
NM_001286556,EVA1C,8,7,102967,1952,101015,14430.71429,244,51.7494877
NM_206898,MRAP,5,4,22972,631,22341,5585.25,126.2,35.40570523
NM_003024,ITSN1,40,39,246827,6479,240348,6162.769231,161.975,37.0964655
NM_145858,CRYZL1,13,12,52514,1723,50791,4232.583333,132.5384615,29.47823564
NM_001001132,ITSN1,30,29,196020,5471,190549,6570.655172,182.3666667,34.8289161
NM_001754,RUNX1,9,8,261499,5976,255523,31940.375,664,42.75819946
NM_203417,RCAN1,4,3,98007,2322,95685,31895,580.5,41.20801034
NM_053277,CLIC6,6,5,48833,3806,45027,9005.4,634.3333333,11.83053074
NM_001285389,RCAN1,4,3,97404,2210,95194,31731.33333,552.5,43.07420814
NM_004414,RCAN1,4,3,98703,2536,96167,32055.66667,634,37.92074132
NM_001001890,RUNX1,6,5,100891,7280,93611,18722.2,1213.333333,12.85865385
NM_005128,DOPEY2,37,36,129735,7716,122019,3389.416667,208.5405405,15.81376361
NM_003316,TTC3,46,45,120163,9053,111110,2469.111111,196.8043478,12.27327958
NM_001146078,CLDN14,3,2,82199,1551,80648,40324,517,51.99742102
NM_001146077,CLDN14,3,2,115949,1455,114494,57247,485,78.69003436
NM_001242785,HLCS,12,11,230077,6124,223953,20359.36364,510.3333333,36.56972567
NM_001242784,HLCS,12,11,215769,6965,208804,18982.18182,580.4166667,29.97903805
NM_000411,HLCS,12,11,239358,6031,233327,21211.54545,502.5833333,38.68794561
NM_001001894,TTC3,46,45,129839,7762,122077,2712.822222,168.7391304,15.72751868
NM_005867,DSCR4,3,2,67143,1101,66042,33021,367,59.98365123
NM_002240,KCNJ6,4,3,291958,2534,289424,96474.66667,633.5,114.2162589
NM_001146218,WRB,5,4,10125,1468,8657,2164.25,293.6,5.897138965
NM_033656,BRWD1,41,40,128310,17927,110383,2759.575,437.2439024,6.157360406
NM_018963,BRWD1,42,41,128310,8848,119462,2913.707317,210.6666667,13.50158228
NM_004627,WRB,5,4,17604,1578,16026,4006.5,315.6,10.15589354
NM_006198,PCP4,3,2,61977,559,61418,30709,186.3333333,109.8711986
NM_001278650,B3GALT5,3,2,49951,2621,47330,23665,873.6666667,18.05799313
NM_001080444,IGSF5,9,8,56691,2075,54616,6827,230.5555556,26.32096386
NM_138992,BACE2,8,7,114735,8769,105966,15138,1096.125,12.08416011
NM_206964,FAM3B,7,6,40995,1247,39748,6624.666667,178.1428571,31.87489976
NM_001135099,TMPRSS2,14,13,43516,3256,40260,3096.923077,232.5714286,12.36486486
NM_005656,TMPRSS2,14,13,43609,3218,40391,3107,229.8571429,12.55158484
NM_012105,BACE2,9,8,114735,8939,105796,13224.5,993.2222222,11.83532834
NM_138991,BACE2,8,7,114735,8788,105947,15135.28571,1098.5,12.05587164
NM_058186,FAM3B,8,7,40995,1392,39603,5657.571429,174,28.45043103
NM_207629,ABCG1,15,14,81169,2938,78231,5587.928571,195.8666667,26.62729748
NM_080860,RSPH1,9,8,23869,1438,22431,2803.875,159.7777778,15.59874826
NM_001286506,RSPH1,8,7,23869,1323,22546,3220.857143,165.375,17.04157218
NM_173568,UMODL1,22,21,71681,5284,66397,3161.761905,240.1818182,12.56566995
NM_016818,ABCG1,15,14,78089,2974,75115,5365.357143,198.2666667,25.25722932
NM_001282934,PRDM15,25,24,81208,6748,74460,3102.5,269.92,11.03438056
NM_001199528,UMODL1,23,22,80039,5081,74958,3407.181818,220.9130435,14.75260775
NM_001199527,UMODL1,22,21,80039,5464,74575,3551.190476,248.3636364,13.64842606
NM_022115,PRDM15,31,30,78439,4912,73527,2450.9,158.4516129,14.96885179
NM_207628,ABCG1,17,16,97434,3054,94380,5898.75,179.6470588,30.90373281
NM_207627,ABCG1,16,15,97557,3135,94422,6294.8,195.9375,30.11866029
NM_001040424,PRDM15,24,23,81208,6687,74521,3240.043478,278.625,11.14416031
NM_207174,ABCG1,15,14,77348,2975,74373,5312.357143,198.3333333,24.99932773
NM_004915,ABCG1,15,14,78089,3010,75079,5362.785714,200.6666667,24.94318937
NM_001004416,UMODL1,23,22,71681,4901,66780,3035.454545,213.0869565,13.62579065
NM_007031,HSF2BP,9,8,130304,1908,128396,16049.5,212,67.29350105
NM_004571,PKNOX1,11,10,59423,5363,54060,5406,487.5454545,10.080179
NM_001001580,PDE9A,14,13,121758,1561,120197,9245.923077,111.5,77
NM_001001575,PDE9A,15,14,121758,1647,120111,8579.357143,109.8,72.92714026
NM_001001573,PDE9A,17,16,121758,1884,119874,7492.125,110.8235294,63.62738854
NM_001001572,PDE9A,16,15,121758,1703,120055,8003.666667,106.4375,70.49618321
NM_002606,PDE9A,20,19,121758,2080,119678,6298.842105,104,57.5375
NM_001286258,PKNOX1,10,9,59423,5190,54233,6025.888889,519,10.4495183
NM_001001585,PDE9A,18,17,121758,1952,119806,7047.411765,108.4444444,61.37602459
NM_001001584,PDE9A,18,17,121758,1828,119930,7054.705882,101.5555556,65.60722101
NM_001001583,PDE9A,19,18,121758,2001,119757,6653.166667,105.3157895,59.84857571
NM_001001582,PDE9A,19,18,121758,2008,119750,6652.777778,105.6842105,59.63645418
NM_001001581,PDE9A,18,17,121758,1929,119829,7048.764706,107.1666667,62.11975117
NM_001001579,PDE9A,17,16,121758,1764,119994,7499.625,103.7647059,68.02380952
NM_001001578,PDE9A,17,16,121758,1771,119987,7499.1875,104.1764706,67.75098814
NM_001001577,PDE9A,16,15,121758,1726,120032,8002.133333,107.875,69.54345307
NM_001001576,PDE9A,15,14,121758,1606,120152,8582.285714,107.0666667,74.81444583
NM_001001574,PDE9A,18,17,121758,1820,119938,7055.176471,101.1111111,65.9
NM_001001571,PDE9A,18,17,121758,1827,119931,7054.764706,101.5,65.64367816
NM_001001570,PDE9A,19,18,121758,1920,119838,6657.666667,101.0526316,62.415625
NM_001001569,PDE9A,16,15,121758,1692,120066,8004.4,105.75,70.96099291
NM_001001568,PDE9A,17,16,121758,1748,120010,7500.625,102.8235294,68.65560641
NM_001001567,PDE9A,19,18,121758,1899,119859,6658.833333,99.94736842,63.11690363
NM_001272037,TSPEAR,13,12,213722,4042,209680,17473.33333,310.9230769,51.87530925
NM_144991,TSPEAR,12,11,213722,3979,209743,19067.54545,331.5833333,52.71249058
NM_003274,TRAPPC10,23,22,94228,6992,87236,3965.272727,304,12.47654462
NM_002626,PFKL,22,21,27328,2935,24393,1161.571429,133.4090909,8.311073254
NM_020132,AGPAT3,10,9,122361,6565,115796,12866.22222,656.5,17.63838538
NM_001037553,AGPAT3,9,8,62198,6444,55754,6969.25,716,8.652079454
NM_003683,RRP1,13,12,14567,1820,12747,1062.25,140,7.003846154
NM_015834,ADARB1,13,12,151987,3601,148386,12365.5,277,41.20688698
NM_015833,ADARB1,12,11,151987,7039,144948,13177.09091,586.5833333,20.59212956
NM_030582,COL18A1,42,41,58212,5936,52276,1275.02439,141.3333333,8.806603774
NM_001160230,ADARB1,12,11,151987,3480,148507,13500.63636,290,42.67442529
NM_001112,ADARB1,11,10,151987,6918,145069,14506.9,628.9090909,20.96978896
NM_130445,COL18A1,43,42,108539,5425,103114,2455.095238,126.1627907,19.00718894
NM_001146116,DIP2A,38,37,111066,7316,103750,2804.054054,192.5263158,14.18124658
NM_001130141,PCBP3,13,12,92495,1924,90571,7547.583333,148,47.07432432
NM_001006114,YBEY,3,2,5846,1184,4662,2331,394.6666667,3.9375
NM_001146114,DIP2A,28,27,97572,3634,93938,3479.185185,129.7857143,25.84975234
NM_006031,PCNT,47,46,121648,10607,111041,2413.934783,225.6808511,10.46865278
NM_015151,DIP2A,38,37,111066,7328,103738,2803.72973,192.8421053,14.15638646
NM_020528,PCBP3,14,13,92495,2003,90492,6960.923077,143.0714286,45.17823265
NM_058181,YBEY,5,4,11400,1055,10345,2586.25,211,9.805687204
NM_199261,TPTE,24,23,84179,2210,81969,3563.869565,92.08333333,37.09004525
NM_199260,TPTE,22,21,84179,2094,82085,3908.809524,95.18181818,39.20009551
NM_199259,TPTE,23,22,84179,2155,82024,3728.363636,93.69565217,38.06218097
NM_001187,BAGE,5,4,41143,956,40187,10046.75,191.2,42.03661088
NM_182482,BAGE2,10,9,78085,1901,76184,8464.888889,190.1,40.07574961
NM_182484,BAGE5,9,8,78085,1764,76321,9540.125,196,43.26587302
NM_182481,BAGE3,10,9,78085,1901,76184,8464.888889,190.1,40.07574961
NM_181704,BAGE4,9,8,78085,1765,76320,9540,196.1111111,43.2407932
NM_174981,POTED,11,10,31410,1837,29573,2957.3,167,16.09853021
NM_198996,LIPI,10,9,98121,1645,96476,10719.55556,164.5,58.64802432
NM_006948,HSPA13,5,4,12074,3991,8083,2020.75,798.2,2.025306941
NM_006806,BTG3,5,4,19302,1467,17835,4458.75,293.4,12.15746421
NM_001207065,CXADR,3,2,57207,5121,52086,26043,1707,10.17106034
NM_001207064,CXADR,4,3,57207,5327,51880,17293.33333,1331.75,9.73906514
NM_001207063,CXADR,5,4,57207,5484,51723,12930.75,1096.8,9.431619256
NM_001207066,CXADR,8,7,80675,1677,78998,11285.42857,209.625,47.10673822
NM_001130914,BTG3,6,5,19302,1600,17702,3540.4,266.6666667,11.06375
NM_001338,CXADR,7,6,57207,5748,51459,8576.5,821.1428571,8.952505219
NM_017447,C21orf91,5,4,30421,5435,24986,6246.5,1087,4.59724011
NM_001100421,C21orf91,4,3,30421,5374,25047,8349,1343.5,4.660774098
NM_001100420,C21orf91,5,4,30421,5438,24983,6245.75,1087.6,4.594152262
NM_024944,CHODL,6,5,22539,2551,19988,3997.6,425.1666667,7.835358683
NM_001204174,CHODL,6,5,21497,2176,19321,3864.2,362.6666667,8.879136029
NM_017446,MRPL39,10,9,21835,1092,20743,2304.777778,109.2,18.99542125
NM_080794,MRPL39,11,10,21835,1182,20653,2065.3,107.4545455,17.47292724
NM_001685,ATP5J,4,3,11176,1164,10012,3337.333333,291,8.60137457
NM_021219,JAM2,10,9,78282,4337,73945,8216.111111,433.7,17.04980401
NM_001270408,JAM2,10,9,75293,1757,73536,8170.666667,175.7,41.85315879
NM_001270407,JAM2,9,8,78282,4228,74054,9256.75,469.7777778,17.51513718
NM_001003697,ATP5J,4,3,11176,666,10510,3503.333333,166.5,15.78078078
NM_001003696,ATP5J,4,3,11176,838,10338,3446,209.5,12.33651551
NM_001003703,ATP5J,4,3,11176,1300,9876,3292,325,7.596923077
NM_001003701,ATP5J,4,3,11176,1214,9962,3320.666667,303.5,8.205930807
NM_006988,ADAMTS1,9,8,9124,4660,4464,558,517.7777778,0.957939914
NM_182749,N6AMT1,5,4,9311,915,8396,2099,183,9.175956284
NM_013240,N6AMT1,6,5,9311,1000,8311,1662.2,166.6666667,8.311
NM_015565,LTN1,30,29,64813,7786,57027,1966.448276,259.5333333,7.324300026
NM_016940,RWDD2B,5,4,13607,1710,11897,2974.25,342,6.957309942
NM_006585,CCT8,15,14,17477,2022,15455,1103.928571,134.8,7.643422354
NM_001282908,CCT8,15,14,17477,2047,15430,1102.142857,136.4666667,7.537860283
NM_001286623,MAP3K7CL,7,6,32322,1577,30745,5124.166667,225.2857143,19.49587825
NM_001282909,CCT8,14,13,17477,1941,15536,1195.076923,138.6428571,8.004121587
NM_001282907,CCT8,16,15,17477,2331,15146,1009.733333,145.6875,6.497640498
NM_206866,BACH1,5,4,46734,5774,40960,10240,1154.8,7.093869068
NM_001186,BACH1,5,4,47251,5646,41605,10401.25,1129.2,7.368933758
NM_012131,CLDN17,1,0,732,732,NA,NA,732,NA
NM_001085455,KRTAP24-1,1,0,1651,1651,NA,NA,1651,NA
NM_203405,KRTAP26-1,1,0,1159,1159,NA,NA,1159,NA
NM_001077711,KRTAP27-1,1,0,683,683,NA,NA,683,NA
NM_001128598,KRTAP25-1,1,0,371,371,NA,NA,371,NA
NM_181623,KRTAP15-1,1,0,454,454,NA,NA,454,NA
NM_181624,KRTAP23-1,1,0,209,209,NA,NA,209,NA
NM_181622,KRTAP13-3,1,0,521,521,NA,NA,521,NA
NM_181621,KRTAP13-2,1,0,850,850,NA,NA,850,NA
NM_181599,KRTAP13-1,1,0,748,748,NA,NA,748,NA
NM_181600,KRTAP13-4,1,0,484,484,NA,NA,484,NA
NM_181604,KRTAP6-2,1,0,190,190,NA,NA,190,NA
NM_181620,KRTAP22-1,1,0,148,148,NA,NA,148,NA
NM_181610,KRTAP19-4,1,0,256,256,NA,NA,256,NA
NM_181608,KRTAP19-2,1,0,160,160,NA,NA,160,NA
NM_181607,KRTAP19-1,1,0,274,274,NA,NA,274,NA
NM_001164434,KRTAP22-2,1,0,294,294,NA,NA,294,NA
NM_181614,KRTAP19-7,1,0,193,193,NA,NA,193,NA
NM_181612,KRTAP19-6,1,0,329,329,NA,NA,329,NA
NM_181611,KRTAP19-5,1,0,220,220,NA,NA,220,NA
NM_181609,KRTAP19-3,1,0,495,495,NA,NA,495,NA
NM_181605,KRTAP6-3,1,0,617,617,NA,NA,617,NA
NM_181602,KRTAP6-1,1,0,220,220,NA,NA,220,NA
NM_001128077,KRTAP20-3,1,0,274,274,NA,NA,274,NA
NM_181615,KRTAP20-1,1,0,172,172,NA,NA,172,NA
NM_001164435,KRTAP21-3,1,0,254,254,NA,NA,254,NA
NM_181616,KRTAP20-2,1,0,199,199,NA,NA,199,NA
NM_181606,KRTAP7-1,2,1,695,695,2,2,347.5,0.002877698
NM_181619,KRTAP21-1,1,0,241,241,NA,NA,241,NA
NM_181617,KRTAP21-2,1,0,253,253,NA,NA,253,NA
NM_175857,KRTAP8-1,1,0,557,557,NA,NA,557,NA
NM_175858,KRTAP11-1,1,0,912,912,NA,NA,912,NA
NM_001099219,KRTAP19-8,1,0,319,319,NA,NA,319,NA
NM_020706,SCAF4,20,19,61120,4289,56831,2991.105263,214.45,13.25040802
NM_000454,SOD1,5,4,9310,970,8340,2085,194,8.597938144
NM_001145445,SCAF4,20,19,61120,4223,56897,2994.578947,211.15,13.47312337
NM_001145444,SCAF4,19,18,61120,4243,56877,3159.833333,223.3157895,13.40490219
NM_018944,MIS18A,5,4,10848,1576,9272,2318,315.2,5.883248731
NM_178817,MRAP,5,4,20477,1003,19474,4868.5,200.6,19.41575274
NM_001285394,MRAP,4,3,20471,880,19591,6530.333333,220,22.2625
NM_021254,C21orf59,7,6,10936,1434,9502,1583.666667,204.8571429,6.626220363
NM_019596,C21orf62,3,2,23071,4049,19022,9511,1349.666667,4.697950111
NM_013329,PAXBP1,16,15,30521,2824,27697,1846.466667,176.5,9.807719547
NM_016631,PAXBP1,18,17,37961,4013,33948,1996.941176,222.9444444,8.459506604
NM_001162496,C21orf62,2,1,23071,3967,19104,19104,1983.5,4.815729771
NM_001162495,C21orf62,4,3,23071,4125,18946,6315.333333,1031.25,4.592969697
NM_005806,OLIG2,2,1,3289,2516,773,773,1258,0.307233704
NM_138983,OLIG1,1,0,2280,2280,NA,NA,2280,NA
NM_000629,IFNAR1,11,10,34916,6105,28811,2881.1,555,4.719246519
NM_000628,IL10RB,7,6,30876,1968,28908,4818,281.1428571,14.68902439
NM_001040192,DNAJC28,2,1,3670,1494,2176,2176,747,1.456492637
NM_005534,IFNGR2,7,6,34628,2228,32400,5400,318.2857143,14.54219031
NM_006134,TMEM50B,7,6,30870,2374,28496,4749.333333,339.1428571,12.00336984
NM_017833,DNAJC28,2,1,3430,1790,1640,1640,895,0.916201117
NM_032195,SON,7,6,17631,7510,10121,1686.833333,1072.857143,1.347669774
NM_017613,DONSON,10,9,11157,2532,8625,958.3333333,253.2,3.406398104
NM_000819,GART,22,21,38228,3383,34845,1659.285714,153.7727273,10.30002956
NM_138927,SON,12,11,34478,8438,26040,2367.272727,703.1666667,3.086039346
NM_001136006,GART,22,21,38962,3522,35440,1687.619048,160.0909091,10.06246451
NM_001136005,GART,22,21,38959,3559,35400,1685.714286,161.7727273,9.946614217
NM_175085,GART,11,10,18150,2204,15946,1594.6,200.3636364,7.235027223
NM_001697,ATP5O,7,6,12403,813,11590,1931.666667,116.1428571,14.25584256
NM_001288961,LOC400863,2,1,15034,2265,12769,12769,1132.5,5.637527594
NM_006933,SLC5A3,2,1,32693,11578,21115,21115,5789,1.823717395
NM_032476,MRPS6,3,2,69513,993,68520,34260,331,69.00302115
NM_001282537,C21orf140,1,0,962,962,NA,NA,962,NA
NM_058182,SMIM11,4,3,13705,904,12801,4267,226,14.16039823
NM_172201,KCNE2,2,1,7119,805,6314,6314,402.5,7.843478261
NM_000219,KCNE1,4,3,65589,3576,62013,20671,894,17.34144295
NM_203418,RCAN1,4,3,10570,2501,8069,2689.666667,625.25,3.226309476
NM_001285393,RCAN1,4,3,8197,2264,5933,1977.666667,566,2.620583039
NM_001285391,RCAN1,4,3,9027,2533,6494,2164.666667,633.25,2.563758389
NM_001270405,KCNE1,3,2,13252,3151,10101,5050.5,1050.333333,3.205649
NM_001270404,KCNE1,2,1,64653,3238,61415,61415,1619,18.96695491
NM_001270403,KCNE1,3,2,64629,3298,61331,30665.5,1099.333333,18.59642207
NM_001270402,KCNE1,3,2,64653,3350,61303,30651.5,1116.666667,18.29940299
NM_001127669,KCNE1,3,2,12918,3159,9759,4879.5,1053,3.089268756
NM_001127670,KCNE1,2,1,9123,3423,5700,5700,1711.5,1.66520596
NM_001127668,KCNE1,3,2,12918,3187,9731,4865.5,1062.333333,3.053341701
NM_001285392,RCAN1,4,3,9027,2327,6700,2233.333333,581.75,2.879243661
NM_001122607,RUNX1,5,4,67415,2727,64688,16172,545.4,23.72130546
NM_017438,SETD4,12,11,26279,3295,22984,2089.454545,274.5833333,6.975417299
NM_001757,CBR1,3,2,3255,1324,1931,965.5,441.3333333,1.458459215
NM_001007259,SETD4,7,6,16682,1174,15508,2584.666667,167.7142857,13.20954003
NM_001007261,SETD4,8,7,16682,1269,15413,2201.857143,158.625,12.14578408
NM_001286752,SETD4,12,11,26279,3562,22717,2065.181818,296.8333333,6.377596856
NM_001286789,CBR1,3,2,3255,1955,1300,650,651.6666667,0.664961637
NM_001236,CBR3,3,2,11599,1115,10484,5242,371.6666667,9.402690583
NM_012130,CLDN14,2,1,5821,1232,4589,4589,616,3.724837662
NM_005441,CHAF1B,14,13,31438,2293,29145,2241.923077,163.7857143,12.71042303
NM_001146079,CLDN14,2,1,19470,1753,17717,17717,876.5,10.10667427
NM_144492,CLDN14,3,2,19470,1944,17526,8763,648,9.015432099
NM_009586,SIM2,10,9,46230,2424,43806,4867.333333,242.4,18.07178218
NM_005069,SIM2,11,10,50521,4188,46333,4633.3,380.7272727,11.06327603
NM_018962,RIPPLY3,4,3,13097,2238,10859,3619.666667,559.5,4.852100089
NM_153682,PIGP,5,4,7796,809,6987,1746.75,161.8,8.636588381
NM_153681,PIGP,4,3,7441,915,6526,2175.333333,228.75,7.132240437
NM_006052,DSCR3,8,7,44109,3259,40850,5835.714286,407.375,12.53451979
NM_001276436,KCNJ15,5,4,45128,3056,42072,10518,611.2,13.76701571
NM_001276435,KCNJ15,5,4,45128,3053,42075,10518.75,610.6,13.78152637
NM_002243,KCNJ15,4,3,45128,2913,42215,14071.66667,728.25,14.49193272
NM_001276437,KCNJ15,4,3,71911,2874,69037,23012.33333,718.5,24.02122477
NM_001276438,KCNJ15,3,2,71911,2791,69120,34560,930.3333333,24.76531709
NM_001276439,KCNJ15,4,3,71911,2932,68979,22993,733,23.52626194
NM_170737,KCNJ15,3,2,29406,2820,26586,13293,940,9.427659574
NM_170736,KCNJ15,3,2,45022,3064,41958,20979,1021.333333,13.69386423
NM_001256295,ETS2,11,10,19649,3946,15703,1570.3,358.7272727,3.979472884
NM_005239,ETS2,10,9,19125,3775,15350,1705.555556,377.5,4.066225166
NM_001261824,PSMG1,7,6,8070,1132,6938,1156.333333,161.7142857,6.128975265
NM_203433,PSMG1,6,5,8070,1083,6987,1397.4,180.5,6.451523546
NM_003720,PSMG1,7,6,8070,1147,6923,1153.833333,163.8571429,6.035745423
NM_001007246,BRWD1,5,4,17351,2644,14707,3676.75,528.8,5.562405446
NM_004965,HMGN1,6,5,6808,1310,5498,1099.6,218.3333333,4.196946565
NM_007341,SH3BGR,7,6,63655,1234,62421,10403.5,176.2857143,50.58427877
NM_152505,LCA5L,10,9,38360,2374,35986,3998.444444,237.4,15.15838248
NM_001001713,SH3BGR,7,6,69638,1005,68633,11438.83333,143.5714286,68.29154229
NM_033172,B3GALT5,3,2,5571,2722,2849,1424.5,907.3333333,1.04665687
NM_033171,B3GALT5,4,3,5571,2883,2688,896,720.75,0.932362123
NM_033170,B3GALT5,3,2,5571,2640,2931,1465.5,880,1.110227273
NM_006057,B3GALT5,3,2,5571,2773,2798,1399,924.3333333,1.009015507
NM_182832,PLAC4,1,0,10010,10010,NA,NA,10010,NA
NM_001282920,MX1,10,9,27166,1991,25175,2797.222222,199.1,12.6443998
NM_001178046,MX1,15,14,33185,2826,30359,2168.5,188.4,10.74274593
NM_001144925,MX1,19,18,38658,3446,35212,1956.222222,181.3684211,10.21822403
NM_002463,MX2,14,13,46921,2975,43946,3380.461538,212.5,14.77176471
NM_002462,MX1,17,16,33185,3003,30182,1886.375,176.6470588,10.05061605
NM_020639,RIPK4,8,7,27722,3880,23842,3406,485,6.144845361
NM_199050,C2CD2,13,12,41582,5859,35723,2976.916667,450.6923077,6.097115549
NM_015500,C2CD2,14,13,68782,6361,62421,4801.615385,454.3571429,9.813079704
NM_020727,ZBTB21,2,1,23558,7416,16142,16142,3708,2.176645092
NM_001098403,ZBTB21,4,3,23558,6880,16678,5559.333333,1720,2.424127907
NM_001098402,ZBTB21,3,2,23558,7482,16076,8038,2494,2.148623363
NM_005423,TFF2,4,3,4743,711,4032,1344,177.75,5.670886076
NM_003226,TFF3,3,2,3931,1057,2874,1437,352.3333333,2.719016083
NM_032405,TMPRSS3,9,8,14217,1351,12866,1608.25,150.1111111,9.523316062
NM_024022,TMPRSS3,13,12,24206,2454,21752,1812.666667,188.7692308,8.863895681
NM_003225,TFF1,3,2,4255,495,3760,1880,165,7.595959596
NM_001243467,UBASH3A,12,11,43821,2237,41584,3780.363636,186.4166667,18.58918194
NM_018961,UBASH3A,15,14,43821,2571,41250,2946.428571,171.4,16.04434072
NM_032404,TMPRSS3,10,9,17264,2149,15115,1679.444444,214.9,7.033503955
NM_001256317,TMPRSS3,13,12,24206,2451,21755,1812.916667,188.5384615,8.875968992
NM_001001895,UBASH3A,14,13,43821,2456,41365,3181.923077,175.4285714,16.84242671
NM_018964,SLC37A1,21,20,81810,3115,78695,3934.75,148.3333333,25.26324238
NM_001260476,WDR4,11,10,30365,2009,28356,2835.6,182.6363636,14.11448482
NM_001260475,WDR4,11,10,30359,2109,28250,2825,191.7272727,13.39497392
NM_001260474,WDR4,11,10,30359,2158,28201,2820.1,196.1818182,13.06811863
NM_033661,WDR4,12,11,36505,1549,34956,3177.818182,129.0833333,22.5668173
NM_018669,WDR4,11,10,30359,2161,28198,2819.8,196.4545455,13.04858862
NM_001260477,WDR4,11,10,30051,2216,27835,2783.5,201.4545455,12.56092058
NM_021075,NDUFV3,4,3,16397,2134,14263,4754.333333,533.5,6.683692596
NM_001001503,NDUFV3,3,2,16397,1038,15359,7679.5,346,14.79672447
NM_006758,U2AF1,8,7,14624,961,13663,1951.857143,120.125,14.21748179
NM_001178009,CBS,18,17,23173,2371,20802,1223.647059,131.7222222,8.773513286
NM_001178008,CBS,17,16,23173,2584,20589,1286.8125,152,7.967879257
NM_000071,CBS,17,16,22741,2607,20134,1258.375,153.3529412,7.723053318
NM_001025204,U2AF1,9,8,14624,1029,13595,1699.375,114.3333333,13.21185617
NM_001025203,U2AF1,8,7,14624,961,13663,1951.857143,120.125,14.21748179
NM_000394,CRYAA,3,2,3804,1147,2657,1328.5,382.3333333,2.316477768
NM_173354,SIK1,14,13,12606,4717,7889,606.8461538,336.9285714,1.67246131
NM_003681,PDXK,11,10,43212,7392,35820,3582,672,4.845779221
NM_000100,CSTB,3,2,2712,943,1769,884.5,314.3333333,1.87592789
NM_198155,C21orf33,6,5,12113,1580,10533,2106.6,263.3333333,6.666455696
NM_005049,PWP2,21,20,23857,3281,20576,1028.8,156.2380952,6.271258763
NM_004649,C21orf33,7,6,12113,1674,10439,1739.833333,239.1428571,6.235961768
NM_015259,ICOSLG,7,6,14179,3310,10869,1811.5,472.8571429,3.283685801
NM_000383,AIRE,14,13,12383,2313,10070,774.6153846,165.2142857,4.353653264
NM_001283051,ICOSLG,6,5,14179,2958,11221,2244.2,493,3.793441515
NM_001283050,ICOSLG,7,6,18011,1176,16835,2805.833333,168,14.31547619
NM_013369,DNMT3L,12,11,15879,1718,14161,1287.363636,143.1666667,8.242724098
NM_001283052,ICOSLG,7,6,14179,3158,11021,1836.833333,451.1428571,3.489867004
NM_175867,DNMT3L,12,11,15879,1715,14164,1287.636364,142.9166667,8.258892128
NM_003307,TRPM2,32,31,89482,5908,83574,2695.935484,184.625,14.14590386
NM_001271440,C21orf2,7,6,10460,2237,8223,1370.5,319.5714286,3.67590523
NM_001271441,C21orf2,7,6,10460,2597,7863,1310.5,371,3.027724297
NM_001271442,C21orf2,8,7,9396,2146,7250,1035.714286,268.25,3.378378378
NM_004928,C21orf2,7,6,10460,2240,8220,1370,320,3.669642857
NM_198696,KRTAP10-3,1,0,739,739,NA,NA,739,NA
NM_198694,KRTAP10-5,1,0,919,919,NA,NA,919,NA
NM_198693,KRTAP10-2,1,0,1072,1072,NA,NA,1072,NA
NM_198687,KRTAP10-4,1,0,1383,1383,NA,NA,1383,NA
NM_198691,KRTAP10-1,1,0,1012,1012,NA,NA,1012,NA
NM_030891,LRRC3,2,1,3348,2507,841,841,1253.5,0.33546071
NM_198699,KRTAP10-12,1,0,874,874,NA,NA,874,NA
NM_198698,KRTAP12-4,1,0,448,448,NA,NA,448,NA
NM_198697,KRTAP12-3,1,0,411,411,NA,NA,411,NA
NM_198695,KRTAP10-8,1,0,877,877,NA,NA,877,NA
NM_198692,KRTAP10-11,1,0,1237,1237,NA,NA,1237,NA
NM_198690,KRTAP10-9,1,0,1257,1257,NA,NA,1257,NA
NM_198688,KRTAP10-6,1,0,1239,1239,NA,NA,1239,NA
NM_198689,KRTAP10-7,2,1,1596,1582,14,14,791,0.008849558
NM_181688,KRTAP10-10,1,0,1101,1101,NA,NA,1101,NA
NM_181686,KRTAP12-1,1,0,589,589,NA,NA,589,NA
NM_181684,KRTAP12-2,1,0,740,740,NA,NA,740,NA
NM_182688,UBE2G2,7,6,33258,3505,29753,4958.833333,500.7142857,8.488730385
NM_006936,SUMO3,4,3,12514,1811,10703,3567.666667,452.75,5.909994478
NM_003343,UBE2G2,6,5,33258,3389,29869,5973.8,564.8333333,8.813514311
NM_001202489,UBE2G2,4,3,33258,3305,29953,9984.333333,826.25,9.062934947
NM_001286416,SUMO3,4,3,12514,1925,10589,3529.666667,481.25,5.500779221
NM_001127491,ITGB2,16,15,42887,2929,39958,2663.866667,183.0625,13.6421987
NM_001286822,PTTG1IP,3,2,24320,2501,21819,10909.5,833.6666667,8.724110356
NM_058190,FAM207A,6,5,36935,887,36048,7209.6,147.8333333,40.64036077
NM_000211,ITGB2,16,15,35099,2974,32125,2141.666667,185.875,10.80195024
NM_004339,PTTG1IP,6,5,24320,2832,21488,4297.6,472,7.587570621
NM_133635,POFUT2,9,8,23970,2878,21092,2636.5,319.7777778,7.328700486
NM_015227,POFUT2,8,7,23970,4831,19139,2734.142857,603.875,3.961705651
NM_001205207,SLC19A1,5,4,19915,2626,17289,4322.25,525.2,6.583777609
NM_001205206,SLC19A1,6,5,27758,1890,25868,5173.6,315,13.68677249
NM_194255,SLC19A1,6,5,27758,2878,24880,4976,479.6666667,8.644892286
NM_001848,COL6A1,35,34,23302,4260,19042,560.0588235,121.7142857,4.469953052
NM_206965,FTCD,14,13,18789,1891,16898,1299.846154,135.0714286,8.936012692
NM_001849,COL6A2,28,27,34732,3467,31265,1157.962963,123.8214286,9.017882896
NM_006657,FTCD,15,14,19307,1920,17387,1241.928571,128,9.055729167
NM_058175,COL6A2,28,27,31688,3474,28214,1044.962963,124.0714286,8.121473805
NM_058174,COL6A2,28,27,31688,3181,28507,1055.814815,113.6071429,8.961647281
NM_032261,SPATC1L,4,3,23313,1169,22144,7381.333333,292.25,18.94268606
NM_001142854,SPATC1L,5,4,23313,2321,20992,5248,464.2,9.044377424
NM_002340,LSS,22,21,39702,4280,35422,1686.761905,194.5454545,8.276168224
NM_001145437,LSS,21,20,39702,4411,35291,1764.55,210.047619,8.000680118
NM_001145436,LSS,22,21,39702,4247,35455,1688.333333,193.0454545,8.348245821
NM_003906,MCM3AP,28,27,50271,6222,44049,1631.444444,222.2142857,7.079556413
NM_001001438,LSS,23,22,40380,2715,37665,1712.045455,118.0434783,13.87292818
NM_058180,C21orf58,8,7,22771,3007,19764,2823.428571,375.875,6.572663785
NM_001286463,C21orf58,7,6,17092,1994,15098,2516.333333,284.8571429,7.571715145
NM_001286462,C21orf58,9,8,20397,1683,18714,2339.25,187,11.11942959
NM_001286477,C21orf58,8,7,22729,2636,20093,2870.428571,329.5,7.622534143
NM_001286476,C21orf58,9,8,22771,2974,19797,2474.625,330.4444444,6.656691325
NM_001146115,DIP2A,20,19,88260,2761,85499,4499.947368,138.05,30.96667874
NM_206891,DIP2A,20,19,87359,2942,84417,4443,147.1,28.69374575
NM_206890,DIP2A,21,20,88260,2891,85369,4268.45,137.6666667,29.52922864
NM_206889,DIP2A,22,21,91163,3067,88096,4195.047619,139.4090909,28.72383437
NM_006272,S100B,3,2,6506,1138,5368,2684,379.3333333,4.717047452
NM_001535,PRMT2,11,10,29531,2335,27196,2719.6,212.2727273,11.64710921
NM_001242866,PRMT2,7,6,25685,3420,22265,3710.833333,488.5714286,6.510233918
NM_001242865,PRMT2,7,6,19504,4178,15326,2554.333333,596.8571429,3.668262326
NM_001242864,PRMT2,9,8,29531,2027,27504,3438,225.2222222,13.56882092
NM_001286676,PRMT2,8,7,29531,1889,27642,3948.857143,236.125,14.63313923
NM_001286677,PRMT2,8,7,29531,1893,27638,3948.285714,236.625,14.60010565
NM_001286678,PRMT2,7,6,29531,1716,27815,4635.833333,245.1428571,16.20920746
NM_206962,PRMT2,12,11,29531,2445,27086,2462.363636,203.75,11.07811861
NM_001255975,PIWIL3,21,20,55688,3502,52186,2609.3,166.7619048,14.90177042
NM_001008496,PIWIL3,21,20,55688,3529,52159,2607.95,168.047619,14.78010768
NM_005940,MMP11,8,7,11469,2269,9200,1314.285714,283.625,4.054649625
NM_006440,TXNRD2,18,17,66476,2137,64339,3784.647059,118.7222222,30.10715957
NM_001282512,TXNRD2,12,11,47736,2093,45643,4149.363636,174.4166667,21.80745342
NM_032173,ZNRF3,9,8,140101,6479,133622,16702.75,719.8888889,20.62386171
NM_021090,MTMR3,20,19,147701,9012,138689,7299.421053,450.6,15.38936973
NM_032608,MYO18B,44,43,288889,8609,280280,6518.139535,195.6590909,32.55662679
NM_000343,SLC5A1,15,14,69994,5071,64923,4637.357143,338.0666667,12.80280024
NM_153051,MTMR3,19,18,147701,8900,138801,7711.166667,468.4210526,15.59561798
NM_153050,MTMR3,20,19,147701,8928,138773,7303.842105,446.4,15.54357079
NM_012399,PITPNB,12,11,67639,2976,64663,5878.454545,248,21.7281586
NM_001206998,ZNRF3,9,8,173723,6686,167037,20879.625,742.8888889,24.98309901
NM_001256314,SLC5A1,14,13,53856,4788,49068,3774.461538,342,10.2481203
NM_001284278,PITPNB,12,11,67547,2954,64593,5872.090909,246.1666667,21.86628301
NM_001284277,PITPNB,11,10,67639,2889,64750,6475,262.6363636,22.41259952
NM_020831,MKL1,15,14,226440,4545,221895,15849.64286,303,48.82178218
NM_002473,MYH9,41,40,106742,7546,99196,2479.9,184.0487805,13.14550755
NM_001282661,MKL1,14,13,226440,4394,222046,17080.46154,313.8571429,50.53390988
NM_001282662,MKL1,15,14,226440,4555,221885,15848.92857,303.6666667,48.71240395
NM_015366,PRR5,9,8,60875,2026,58849,7356.125,225.1111111,29.04689042
NM_198856,EFCAB6,30,29,283595,4601,278994,9620.482759,153.3666667,60.63768746
NM_013236,ATXN10,12,11,173511,3342,170169,15469.90909,278.5,50.91831239
NM_001278657,POLDIP3,9,8,31243,3501,27742,3467.75,389,7.924021708
NM_001198721,PRR5,10,9,60875,2566,58309,6478.777778,256.6,22.72369447
NM_001284305,TBC1D22A,13,12,401520,3887,397633,33136.08333,299,102.2981734
NM_001284304,TBC1D22A,14,13,412830,3948,408882,31452.46154,282,103.5668693
NM_001284303,TBC1D22A,11,10,412830,3574,409256,40925.6,324.9090909,114.5092334
NM_032311,POLDIP3,9,8,31243,3450,27793,3474.125,383.3333333,8.055942029
NM_022785,EFCAB6,32,31,283595,4961,278634,8988.193548,155.03125,56.16488611
NM_014346,TBC1D22A,13,12,412830,3810,409020,34085,293.0769231,107.3543307
NM_178136,POLDIP3,8,7,31243,3362,27881,3983,420.25,8.292980369
NM_001017529,PRR5,8,7,69136,1734,67402,9628.857143,216.75,38.87081892
NM_001017530,PRR5,8,7,60875,1908,58967,8423.857143,238.5,30.90513627
NM_001017528,PRR5,9,8,69136,1852,67284,8410.5,205.7777778,36.33045356
NM_001167621,ATXN10,11,10,173511,3149,170362,17036.2,286.2727273,54.10034932
NM_001282227,CECR1,10,9,43066,4288,38778,4308.666667,428.8,9.043376866
NM_001282229,CECR1,9,8,40797,4146,36651,4581.375,460.6666667,8.840086831
NM_001282228,CECR1,10,9,40797,4390,36407,4045.222222,439,8.293166287
NM_001282226,CECR1,10,9,40797,4482,36315,4035,448.2,8.102409639
NM_001282225,CECR1,10,9,40797,4515,36282,4031.333333,451.5,8.035880399
NM_175878,XKR3,4,3,38280,1685,36595,12198.33333,421.25,21.71810089
NM_001244570,BID,4,3,40357,1924,38433,12811,481,19.97557173
NM_001122731,MICAL3,20,19,72553,3110,69443,3654.894737,155.5,22.32893891
NM_197966,BID,6,5,39904,2525,37379,7475.8,420.8333333,14.80356436
NM_001039367,ATP6V1E1,8,7,36687,1323,35364,5052,165.375,26.73015873
NM_001039366,ATP6V1E1,8,7,36687,1347,35340,5048.571429,168.375,26.23608018
NM_001193414,TUBA8,5,4,21047,2100,18947,4736.75,420,9.022380952
NM_031413,CECR2,18,17,77219,5654,71565,4209.705882,314.1111111,12.65741068
NM_018943,TUBA8,5,4,21047,2129,18918,4729.5,425.8,8.885861907
NM_197967,BID,5,4,40357,2136,38221,9555.25,427.2,17.89372659
NM_001244569,BID,5,4,40357,1995,38362,9590.5,399,19.22907268
NM_001244567,BID,6,5,40527,2118,38409,7681.8,353,18.13456091
NM_001244572,BID,4,3,39904,2242,37662,12554,560.5,16.79839429
NM_001696,ATP6V1E1,9,8,36687,1414,35273,4409.125,157.1111111,24.94554455
NM_001196,BID,6,5,40357,2207,38150,7630,367.8333333,17.28590847
NM_015241,MICAL3,32,31,236911,9476,227435,7336.612903,296.125,24.00116083
NM_001136004,MICAL3,22,21,46733,7817,38916,1853.142857,355.3181818,4.978380453
NM_007098,CLTCL1,33,32,112254,5547,106707,3334.59375,168.0909091,19.2368848
NM_005315,GSC2,3,2,1294,621,673,336.5,207,1.08373591
NM_003325,HIRA,25,24,100997,4038,96959,4039.958333,161.52,24.01163943
NM_001835,CLTCL1,32,31,112254,5375,106879,3447.709677,167.96875,19.88446512
NM_053004,GNB1L,8,7,66530,1527,65003,9286.142857,190.875,42.56908972
NM_032775,KLHL22,7,6,54366,2623,51743,8623.833333,374.7142857,19.72664888
NM_058004,PI4KA,55,54,151123,6807,144316,2672.518519,123.7636364,21.2011165
NM_004782,SNAP29,5,4,32211,4266,27945,6986.25,853.2,6.550632911
NM_002745,MAPK1,9,8,108025,5924,102101,12762.625,658.2222222,17.23514517
NM_014634,PPM1F,8,7,33460,5193,28267,4038.142857,649.125,5.443289043
NM_138957,MAPK1,8,7,98653,1505,97148,13878.28571,188.125,64.55016611
NM_002073,GNAZ,3,2,54554,3211,51343,25671.5,1070.333333,15.98972283
NM_021574,BCR,22,21,137674,6817,130857,6231.285714,309.8636364,19.19568725
NM_014433,RTDR1,7,6,82650,1259,81391,13565.16667,179.8571429,64.64733916
NM_004327,BCR,23,22,137674,6950,130724,5942,302.173913,18.80920863
NM_001201429,CABIN1,36,35,166833,7108,159725,4563.571429,197.4444444,22.47115926
NM_001199281,CABIN1,37,36,166778,7565,159213,4422.583333,204.4594595,21.04600132
NM_012295,CABIN1,37,36,166833,7259,159574,4432.611111,196.1891892,21.98291776
NM_016327,UPB1,10,9,31304,2077,29227,3247.444444,207.7,14.07173808
NM_001254732,SPECC1L,15,14,146925,6573,140352,10025.14286,438.2,21.35280694
NM_001254733,SPECC1L,9,8,75634,4223,71411,8926.375,469.2222222,16.91001658
NM_015330,SPECC1L,17,16,146925,6796,140129,8758.0625,399.7647059,20.6193349
NM_001145468,SPECC1L,16,15,146925,6691,140234,9348.933333,418.1875,20.95860111
NM_000853,GSTT1,5,4,8147,1065,7082,1770.5,213,6.649765258
NM_001098497,SGSM1,25,24,120679,6036,114643,4776.791667,241.44,18.99320742
NM_133454,SGSM1,25,24,120679,6018,114661,4777.541667,240.72,19.05300764
NM_001039948,SGSM1,26,25,120679,6202,114477,4579.08,238.5384615,18.45807804
NM_001145206,KIAA1671,11,10,169476,10505,158971,15897.1,955,15.1328891
NM_001098498,SGSM1,24,23,120679,5852,114827,4992.478261,243.8333333,19.62183869
NM_005160,ADRBK2,21,20,164399,9076,155323,7766.15,432.1904762,17.1135963
NM_021115,SEZ6L,17,16,214125,6590,207535,12970.9375,387.6470588,31.49241275
NM_022081,HPS4,14,13,32982,5159,27823,2140.230769,368.5,5.393099438
NM_001887,CRYBB1,6,5,18631,927,17704,3540.8,154.5,19.09816613
NM_152841,HPS4,12,11,28800,4774,24026,2184.181818,397.8333333,5.032677
NM_001184777,SEZ6L,15,14,214125,6360,207765,14840.35714,424,32.66745283
NM_001184776,SEZ6L,15,14,214125,6363,207762,14840.14286,424.2,32.65157944
NM_001184775,SEZ6L,16,15,214125,6550,207575,13838.33333,409.375,31.69083969
NM_001184774,SEZ6L,16,15,214125,6556,207569,13837.93333,409.75,31.66092129
NM_001184773,SEZ6L,17,16,214125,6587,207538,12971.125,387.4705882,31.50721117
NM_002430,MN1,2,1,53223,7558,45665,45665,3779,6.041942313
NM_145862,CHEK2,14,13,54093,1785,52308,4023.692308,127.5,29.30420168
NM_001145418,TTC28,23,22,701853,11818,690035,31365.22727,513.826087,58.38847521
NM_007194,CHEK2,15,14,54093,1873,52220,3730,124.8666667,27.88040577
NM_001257387,CHEK2,16,15,54093,1988,52105,3473.666667,124.25,26.20975855
NM_001005735,CHEK2,16,15,54093,2003,52090,3472.666667,125.1875,26.00599101
NM_133455,EMID1,15,14,53687,2127,51560,3682.857143,141.8,24.24071462
NM_021076,NEFH,4,3,11098,3723,7375,2458.333333,930.75,1.980929358
NM_000268,NF2,16,15,95046,6045,89001,5933.4,377.8125,14.72307692
NM_032045,KREMEN1,10,9,95257,2769,92488,10276.44444,276.9,33.40122788
NM_001127,AP1B1,23,22,60905,4201,56704,2577.454545,182.6521739,13.49773863
NM_145730,AP1B1,21,20,60905,4169,56736,2836.8,198.5238095,13.60901895
NM_016418,NF2,17,16,95046,6091,88955,5559.6875,358.2941176,14.60433426
NM_181832,NF2,17,16,95046,6106,88940,5558.75,359.1764706,14.56600066
NM_181828,NF2,16,15,95046,5964,89082,5938.8,372.75,14.93661972
NM_181831,NF2,15,14,80361,2206,78155,5582.5,147.0666667,35.42837715
NM_181830,NF2,15,14,95046,5840,89206,6371.857143,389.3333333,15.275
NM_181829,NF2,16,15,95046,5967,89079,5938.6,372.9375,14.92860734
NM_181833,NF2,5,4,95046,4744,90302,22575.5,948.8,19.03499157
NM_001267895,EMID1,15,14,53687,2121,51566,3683.285714,141.4,24.31211693
NM_001166019,AP1B1,21,20,60905,4109,56796,2839.8,195.6666667,13.8223412
NM_019103,ZMAT5,7,6,36026,1040,34986,5831,148.5714286,33.64038462
NM_001039570,KREMEN1,9,8,73744,6147,67597,8449.625,683,10.99674638
NM_181825,NF2,16,15,80361,3092,77269,5151.266667,193.25,24.98997413
NM_001003692,ZMAT5,6,5,36026,924,35102,7020.4,154,37.98917749
NM_001193336,SEC14L6,12,11,21754,1273,20481,1861.909091,106.0833333,16.08876669
NM_001204204,SEC14L2,10,9,28363,4044,24319,2702.111111,404.4,6.013600396
NM_030758,OSBP2,14,13,213020,4354,208666,16051.23077,311,47.92512632
NM_033382,SEC14L2,11,10,20036,1840,18196,1819.6,167.2727273,9.889130435
NM_014941,MORC2,27,26,41589,4494,37095,1426.730769,166.4444444,8.254339119
NM_001282739,OSBP2,14,13,213020,4351,208669,16051.46154,310.7857143,47.95886003
NM_012429,SEC14L2,12,11,28363,4295,24068,2188,357.9166667,5.603725262
NM_001282740,OSBP2,13,12,143573,3533,140040,11670,271.7692308,39.63770167
NM_152510,HORMAD2,11,10,96611,1906,94705,9470.5,173.2727273,49.68782791
NM_001282738,OSBP2,15,14,214044,4032,210012,15000.85714,268.8,52.08630952
NM_001242896,DEPDC5,43,42,153013,5594,147419,3509.97619,130.0930233,26.35305685
NM_019843,EIF4ENIF1,19,18,50531,3720,46811,2600.611111,195.7894737,12.58360215
NM_152267,RNF185,7,6,46869,3219,43650,7275,459.8571429,13.56011184
NM_001242897,DEPDC5,40,39,153085,5195,147890,3792.051282,129.875,28.46775746
NM_001258326,SFI1,31,30,122414,4172,118242,3941.4,134.5806452,28.34180249
NM_001135825,RNF185,5,4,46869,3049,43820,10955,609.8,14.37192522
NM_001136029,DEPDC5,42,41,152174,5424,146750,3579.268293,129.1428571,27.05567847
NM_014775,SFI1,32,31,122414,4330,118084,3809.16129,135.3125,27.27113164
NM_014662,DEPDC5,42,41,153013,5500,147513,3597.878049,130.952381,26.82054545
NM_001258325,SFI1,31,30,122414,4257,118157,3938.566667,137.3225806,27.75593141
NM_001258327,SFI1,31,30,122414,4140,118274,3942.466667,133.5483871,28.56859903
NM_001164502,EIF4ENIF1,17,16,50531,3196,47335,2958.4375,188,14.81070088
NM_001164501,EIF4ENIF1,19,18,50204,3696,46508,2583.777778,194.5263158,12.58333333
NM_173566,PRR14L,9,8,68788,10837,57951,7243.875,1204.111111,5.347513149
NM_001007467,SFI1,33,32,122414,4424,117990,3687.1875,134.0606061,26.670434
NM_001135774,SYN3,14,13,545839,3155,542684,41744.92308,225.3571429,172.007607
NM_014227,SLC5A4,15,14,36857,2035,34822,2487.285714,135.6666667,17.11154791
NM_133633,SYN3,12,11,494268,2761,491507,44682.45455,230.0833333,178.0177472
NM_003490,SYN3,13,12,494268,3054,491214,40934.5,234.9230769,160.8428291
NM_133642,LARGE,15,14,647356,4153,643203,45943.07143,276.8666667,154.8767156
NM_004737,LARGE,16,15,647356,4217,643139,42875.93333,263.5625,152.5110268
NM_002133,HMOX1,5,4,13149,1595,11554,2888.5,319,7.243887147
NM_001082579,RBFOX2,14,13,289804,6948,282856,21758.15385,496.2857143,40.71042026
NM_001082578,RBFOX2,14,13,289804,6951,282853,21757.92308,496.5,40.69241836
NM_001082577,RBFOX2,12,11,101849,6949,94900,8627.272727,579.0833333,13.65664124
NM_001082576,RBFOX2,13,12,101849,6978,94871,7905.916667,536.7692308,13.59572944
NM_001031695,RBFOX2,13,12,101849,6990,94859,7904.916667,537.6923077,13.57067239
NM_014309,RBFOX2,12,11,101849,6940,94909,8628.090909,578.3333333,13.67564841
NM_030641,APOL6,3,2,20034,10142,9892,4946,3380.666667,0.97535003
NM_153609,TMPRSS6,18,17,38219,3212,35007,2059.235294,178.4444444,10.89881694
NM_006078,CACNG2,4,3,141776,4527,137249,45749.66667,1131.75,30.31787055
NM_001289000,TMPRSS6,19,18,44129,3200,40929,2273.833333,168.4210526,12.7903125
NM_001289001,TMPRSS6,18,17,43975,3143,40832,2401.882353,174.6111111,12.99140948
NM_001039141,TRIOBP,24,23,79570,10169,69401,3017.434783,423.7083333,6.82476153
NM_002405,MFNG,8,7,17379,2137,15242,2177.428571,267.125,7.132428638
NM_001195072,TMEM184B,10,9,53744,3722,50022,5558,372.2,13.43954863
NM_001195071,TMEM184B,9,8,53374,3635,49739,6217.375,403.8888889,13.68335626
NM_001242923,EIF3L,11,10,39412,1958,37454,3745.4,178,19.12870276
NM_001004426,PLA2G6,16,15,70261,3077,67184,4478.933333,192.3125,21.83425414
NM_001172687,GGA1,17,16,25092,3165,21927,1370.4375,186.1764706,6.927962085
NM_001172688,GGA1,18,17,24526,3224,21302,1253.058824,179.1111111,6.607320099
NM_012264,TMEM184B,9,8,53744,3620,50124,6265.5,402.2222222,13.84640884
NM_013365,GGA1,17,16,25092,3177,21915,1369.6875,186.8823529,6.898016997
NM_003560,PLA2G6,17,16,70261,3240,67021,4188.8125,190.5882353,20.68549383
NM_016091,EIF3L,13,12,39412,2104,37308,3109,161.8461538,17.73193916
NM_001199562,PLA2G6,16,15,70336,3032,67304,4486.933333,189.5,22.19788918
NM_001166343,MFNG,7,6,17326,2041,15285,2547.5,291.5714286,7.488975992
NM_001001561,GGA1,3,2,9648,1717,7931,3965.5,572.3333333,4.619103087
NM_001001560,GGA1,15,14,25092,2914,22178,1584.142857,194.2666667,7.6108442
NM_007068,DMC1,14,13,51249,2295,48954,3765.692308,163.9285714,21.33071895
NM_001278208,DMC1,11,10,49462,2093,47369,4736.9,190.2727273,22.63210702
NM_015373,CBY1,5,4,17199,1136,16063,4015.75,227.2,14.13996479
NM_000967,RPL3,10,9,6785,1348,5437,604.1111111,134.8,4.033382789
NM_001033853,RPL3,10,9,6785,1201,5584,620.4444444,120.1,4.649458784
NM_001002880,CBY1,6,5,17199,1277,15922,3184.4,212.8333333,12.46828504
NM_001162501,TNRC6B,23,22,157885,18303,139582,6344.636364,795.7826087,7.6261815
NM_021096,CACNA1I,37,36,118984,10039,108945,3026.25,271.3243243,10.85217651
NM_001024843,TNRC6B,24,23,290993,15983,275010,11956.95652,665.9583333,17.20640681
NM_152512,ENTHD1,7,6,150747,2717,148030,24671.66667,388.1428571,54.48288554
NM_015088,TNRC6B,21,20,157885,17971,139914,6995.7,855.7619048,7.785543375
NM_001003406,CACNA1I,36,35,118984,9933,109051,3115.742857,275.9166667,10.978657
NM_001278651,RANGAP1,17,16,41242,4372,36870,2304.375,257.1764706,8.433211345
NM_022098,XPNPEP3,10,9,75740,8019,67721,7524.555556,801.9,8.445067964
NM_002883,RANGAP1,16,15,41476,3910,37566,2504.4,244.375,9.607672634
NM_001429,EP300,31,30,87469,8792,78677,2622.566667,283.6129032,8.948703367
NM_001002876,CENPM,5,4,8409,843,7566,1891.5,168.6,8.975088968
NM_024053,CENPM,6,5,8409,936,7473,1494.6,156,7.983974359
NM_005650,TCF20,5,4,55330,7314,48016,12004,1462.8,6.564943943
NM_181492,TCF20,4,3,55330,7185,48145,16048.33333,1796.25,6.700765484
NM_005008,NHP2L1,4,3,14978,1736,13242,4414,434,7.627880184
NM_024821,CCDC134,7,6,25627,1282,24345,4057.5,183.1428571,18.98985959
NM_001003796,NHP2L1,3,2,14978,1503,13475,6737.5,501,8.965402528
NM_001197,BIK,5,4,18966,958,18008,4502,191.6,18.79749478
NM_001184970,PACSIN2,11,10,145414,3298,142116,14211.6,299.8181818,43.09157065
NM_173050,SCUBE1,22,21,140167,3890,136277,6489.380952,176.8181818,35.03264781
NM_013327,PARVB,13,12,144957,1725,143232,11936,132.6923077,83.03304348
NM_001243386,PARVB,12,11,142930,1553,141377,12852.45455,129.4166667,91.03477141
NM_001243385,PARVB,13,12,100117,1596,98521,8210.083333,122.7692308,61.72994987
NM_001099294,KIAA1644,5,4,69176,6746,62430,15607.5,1349.2,9.254372962
NM_001003828,PARVB,14,13,170023,1892,168131,12933.15385,135.1428571,88.8641649
NM_001198726,ARHGAP8,11,10,110228,1539,108689,10868.9,139.9090909,70.6231319
NM_001009880,KIAA0930,10,9,48529,6225,42304,4700.444444,622.5,6.795823293
NM_001242450,PHF21B,13,12,127833,3552,124281,10356.75,273.2307692,34.98902027
NM_148674,SMC1B,25,24,69557,4277,65280,2720,171.08,15.26303484
NM_138415,PHF21B,13,12,128540,3683,124857,10404.75,283.3076923,33.90089601
NM_181334,PRR5-ARHGAP8,15,14,160284,1872,158412,11315.14286,124.8,84.62179487
NM_001135862,PHF21B,14,13,128768,3513,125255,9635,250.9285714,35.65471107
NM_001017526,ARHGAP8,13,12,110228,1738,108490,9040.833333,133.6923077,62.42232451
NM_181335,ARHGAP8,12,11,110228,1644,108584,9871.272727,137,66.0486618
NM_001284296,PHF21B,14,13,127833,3599,124234,9556.461538,257.0714286,34.51903306
NM_015124,GRAMD4,18,17,53032,4334,48698,2864.588235,240.7777778,11.23627134
NM_014246,CELSR1,35,34,176338,11424,164914,4850.411765,326.4,14.4357493
NM_001082967,FAM19A5,4,3,262477,2624,259853,86617.66667,656,99.02934451
NM_015381,FAM19A5,4,3,175631,2645,172986,57662,661.25,65.40113422
NM_014577,BRD1,12,11,51517,4620,46897,4263.363636,385,10.1508658
NM_001164106,MOV10L1,9,8,14634,1351,13283,1660.375,150.1111111,9.831976314
NM_014678,PPP6R2,23,22,101774,4045,97729,4442.227273,175.8695652,24.16044499
NM_012401,PLXNB2,37,36,32595,6372,26223,728.4166667,172.2162162,4.115348399
NM_001242899,PPP6R2,23,22,101774,4048,97726,4442.090909,176,24.14179842
NM_001242898,PPP6R2,24,23,101774,4127,97647,4245.521739,171.9583333,23.66052823
NM_001242900,PPP6R2,23,22,101774,4044,97730,4442.272727,175.826087,24.16666667
NM_138433,KLHDC7B,1,0,2992,2992,NA,NA,2992,NA
NM_018995,MOV10L1,27,26,71683,3984,67699,2603.807692,147.5555556,16.99272088
NM_033517,SHANK3,22,21,58572,7076,51496,2452.190476,321.6363636,7.277557942
NM_001164105,MOV10L1,26,25,71433,3968,67465,2698.6,152.6153846,17.00226815
NM_001164104,MOV10L1,26,25,71683,3845,67838,2713.52,147.8846154,17.64317295
NM_001136213,POTEH,11,10,31607,2048,29559,2955.9,186.1818182,14.43310547
NM_001005239,OR11H1,1,0,982,982,NA,NA,982,NA
NM_014406,CCT8L2,1,0,2054,2054,NA,NA,2054,NA
NM_001037814,GAB4,10,9,46287,2639,43648,4849.777778,263.9,16.53959833
NM_031890,CECR6,1,0,5026,5026,NA,NA,5026,NA
NM_001163079,CECR6,2,1,5070,3963,1107,1107,1981.5,0.279333838
NM_014339,IL17RA,13,12,30737,8621,22116,1843,663.1538462,2.565363647
NM_017829,CECR5,8,7,27769,1734,26035,3719.285714,216.75,15.01441753
NM_033070,CECR5,8,7,21761,1809,19952,2850.285714,226.125,11.02929795
NM_177405,CECR1,7,6,20995,3718,17277,2879.5,531.1428571,4.646853147
NM_001289905,IL17RA,12,11,30737,8518,22219,2019.909091,709.8333333,2.608476168
NM_031481,SLC25A18,11,10,30466,2098,28368,2836.8,190.7272727,13.521449
NM_001288707,AC004019.13,4,3,9037,1842,7195,2398.333333,460.5,3.906080347
NM_015367,BCL2L13,7,6,92273,5139,87134,14522.33333,734.1428571,16.9554388
NM_001270731,BCL2L13,6,5,92273,5068,87205,17441,844.6666667,17.206985
NM_001270730,BCL2L13,5,4,92273,4809,87464,21866,961.8,18.18756498
NM_001270734,BCL2L13,5,4,92273,4923,87350,21837.5,984.6,17.74324599
NM_001270732,BCL2L13,5,4,92273,4910,87363,21840.75,982,17.79287169
NM_001270735,BCL2L13,4,3,92273,4765,87508,29169.33333,1191.25,18.36474292
NM_001270727,BCL2L13,5,4,92273,4822,87451,21862.75,964.4,18.13583575
NM_001270726,BCL2L13,6,5,92273,4967,87306,17461.2,827.8333333,17.57720958
NM_001270733,BCL2L13,2,1,24199,4349,19850,19850,2174.5,4.564267648
NM_001270729,BCL2L13,6,5,92273,4981,87292,17458.4,830.1666667,17.52499498
NM_001270728,BCL2L13,4,3,92273,4801,87472,29157.33333,1200.25,18.2195376
NM_017929,PEX26,6,5,13113,4089,9024,1804.8,681.5,2.206896552
NM_001127649,PEX26,5,4,13039,4262,8777,2194.25,852.4,2.059361802
NM_001199319,PEX26,5,4,13113,3941,9172,2293,788.2,2.327328089
NM_017414,USP18,11,10,27406,2046,25360,2536,186,12.39491691
NM_001195226,PRODH,14,13,23679,2007,21672,1667.076923,143.3571429,10.79820628
NM_016335,PRODH,15,14,23781,2423,21358,1525.571429,161.5333333,8.81469253
NM_005675,DGCR6,5,4,5867,1219,4648,1162,243.8,3.812961444
NM_053006,TSSK2,1,0,1817,1817,NA,NA,1817,NA
NM_001173534,DGCR2,9,8,86174,4361,81813,10226.625,484.5555556,18.76014676
NM_001173533,DGCR2,9,8,86174,4370,81804,10225.5,485.5555556,18.7194508
NM_022719,DGCR14,10,9,14400,5395,9005,1000.555556,539.5,1.669138091
NM_005137,DGCR2,10,9,86174,4494,81680,9075.555556,449.4,18.1753449
NM_001184781,DGCR2,10,9,86174,4485,81689,9076.555556,448.5,18.21382386
NM_001287387,SLC25A1,9,8,2932,1525,1407,175.875,169.4444444,0.922622951
NM_001256534,SLC25A1,8,7,2932,1670,1262,180.2857143,208.75,0.755688623
NM_005984,SLC25A1,9,8,3290,1690,1600,200,187.7777778,0.946745562
NM_001035247,UFD1L,12,11,29276,1742,27534,2503.090909,145.1666667,15.80597015
NM_003277,CLDN5,2,1,2315,1704,611,611,852,0.358568075
NM_001178011,CDC45,18,17,40788,1857,38931,2290.058824,103.1666667,20.9644588
NM_001178010,CDC45,20,19,40788,2093,38695,2036.578947,104.65,18.48781653
NM_005659,UFD1L,12,11,29276,1795,27481,2498.272727,149.5833333,15.3097493
NM_003504,CDC45,19,18,40788,1996,38792,2155.111111,105.0526316,19.43486974
NM_001130861,CLDN5,1,0,2315,2315,NA,NA,2315,NA
NM_001166242,C22orf39,3,2,7347,1547,5800,2900,515.6666667,3.749191984
NM_003776,MRPL40,4,3,3562,778,2784,928,194.5,3.57840617
NM_173793,C22orf39,3,2,5084,1980,3104,1552,660,1.567676768
NM_000407,GP1BB,2,1,1233,960,273,273,480,0.284375
NM_002688,Sep-05,12,11,8860,2085,6775,615.9090909,173.75,3.24940048
NM_001009939,Sep-05,11,10,4889,2278,2611,261.1,207.0909091,1.14618086
NM_080646,TBX1,9,8,22844,1473,21371,2671.375,163.6666667,14.50848608
NM_080647,TBX1,9,8,10631,2091,8540,1067.5,232.3333333,4.084170253
NM_005992,TBX1,10,9,26888,1544,25344,2816,154.4,16.41450777
NM_024627,C22orf29,3,2,8712,6638,2074,1037,2212.666667,0.312443507
NM_001135161,COMT,6,5,19040,2268,16772,3354.4,378,7.395061728
NM_001283106,TANGO2,10,9,48928,2456,46472,5163.555556,245.6,18.9218241
NM_007310,COMT,4,3,7430,2039,5391,1797,509.75,2.643943109
NM_001283116,TANGO2,9,8,44859,2209,42650,5331.25,245.4444444,19.3073789
NM_001283129,TANGO2,9,8,44859,2449,42410,5301.25,272.1111111,17.31727236
NM_001283248,TANGO2,6,5,44859,1866,42993,8598.6,311,23.04019293
NM_001283235,TANGO2,8,7,44859,2093,42766,6109.428571,261.625,20.43287148
NM_001283215,TANGO2,7,6,44859,2188,42671,7111.833333,312.5714286,19.50228519
NM_001283199,TANGO2,7,6,44859,2094,42765,7127.5,299.1428571,20.4226361
NM_001283186,TANGO2,7,6,44859,2021,42838,7139.666667,288.7142857,21.19643741
NM_001283179,TANGO2,7,6,48928,2148,46780,7796.666667,306.8571429,21.77839851
NM_001283154,TANGO2,9,8,44859,2319,42540,5317.5,257.6666667,18.34411384
NM_001283148,TANGO2,9,8,44859,2207,42652,5331.5,245.2222222,19.3257816
NM_001670,ARVCF,20,19,46909,4056,42853,2255.421053,202.8,10.56533531
NM_000754,COMT,6,5,28237,2310,25927,5185.4,385,11.22380952
NM_001135162,COMT,6,5,18455,2285,16170,3234,380.8333333,7.076586433
NM_152906,TANGO2,9,8,44859,2321,42538,5317.25,257.8888889,18.32744507
NM_002882,RANBP1,6,5,9935,1143,8792,1758.4,190.5,7.692038495
NM_001278641,RANBP1,6,5,9406,1260,8146,1629.2,210,6.465079365
NM_001190326,DGCR8,13,12,31647,4434,27213,2267.75,341.0769231,6.137347767
NM_182984,TRMT2A,13,12,5431,2853,2578,214.8333333,219.4615385,0.903610235
NM_022720,DGCR8,14,13,31647,4534,27113,2085.615385,323.8571429,5.979929422
NM_013373,ZDHHC8,11,10,16168,5023,11145,1114.5,456.6363636,2.21879355
NM_001257994,TRMT2A,12,11,5431,2998,2433,221.1818182,249.8333333,0.811541027
NM_001243537,LOC388849,6,5,1324,639,685,137,106.5,1.07198748
NM_022727,TRMT2A,12,11,5431,2976,2455,223.1818182,248,0.824932796
NM_001278640,RANBP1,6,5,9935,1140,8795,1759,190,7.714912281
NM_001278639,RANBP1,6,5,11421,1395,10026,2005.2,232.5,7.187096774
NM_001185024,ZDHHC8,11,10,16168,3231,12937,1293.7,293.7272727,4.004023522
NM_033257,DGCR6L,5,4,5869,1222,4647,1161.75,244.4,3.802782324
NM_023004,RTN4R,2,1,26880,1921,24959,24959,960.5,12.99271213
NM_001242313,TMEM191B,9,8,2773,1343,1430,178.75,149.2222222,1.064780343
NM_015672,RIMBP3,1,0,5794,5794,NA,NA,5794,NA
NM_153334,SCARF2,11,10,13274,3520,9754,975.4,320,2.771022727
NM_003426,ZNF74,5,4,14350,3949,10401,2600.25,789.8,2.63383135
NM_001256524,ZNF74,6,5,14350,3722,10628,2125.6,620.3333333,2.855454057
NM_001256525,ZNF74,5,4,14350,3621,10729,2682.25,724.2,2.962993648
NM_001256523,ZNF74,4,3,14350,3862,10488,3496,965.5,2.715691352
NM_182895,SCARF2,11,10,13274,3505,9769,976.9,318.6363636,2.787161198
NM_015889,MED15,17,16,80035,3272,76763,4797.6875,192.4705882,23.46057457
NM_001003891,MED15,18,17,80035,3393,76642,4508.352941,188.5,22.58826997
NM_002650,PI4KA,23,22,26978,3061,23917,1087.136364,133.0869565,7.813459654
NM_000185,SERPIND1,5,4,13627,2226,11401,2850.25,445.2,5.121743037
NM_001146288,AIFM3,20,19,14204,2449,11755,618.6842105,122.45,4.799918334
NM_006767,LZTR1,21,20,16770,4336,12434,621.7,206.4761905,2.867619926
NM_030573,THAP7,4,3,2345,1246,1099,366.3333333,311.5,0.882022472
NM_144704,AIFM3,21,20,16233,2386,13847,692.35,113.6190476,5.803436714
NM_001018060,AIFM3,20,19,16233,2364,13869,729.9473684,118.2,5.866751269
NM_005207,CRKL,3,2,36325,5328,30997,15498.5,1776,5.817755255
NM_001008695,THAP7,5,4,2345,1073,1272,318,214.6,1.185461323
NM_001159554,P2RX6,12,11,12862,2678,10184,925.8181818,223.1666667,3.802837939
NM_005446,P2RX6,12,11,12840,2734,10106,918.7272727,227.8333333,3.696415508
NM_004173,SLC7A4,5,4,3842,2318,1524,381,463.6,0.65746333
NM_001128635,RIMBP3B,1,0,5417,5417,NA,NA,5417,NA
NM_001128633,RIMBP3C,1,0,5794,5794,NA,NA,5794,NA
NM_015094,HIC2,3,2,34059,6799,27260,13630,2266.333333,4.009413149
NM_001207052,TMEM191C,9,8,2767,1316,1451,181.375,146.2222222,1.102583587
NM_022044,SDF2L1,3,2,2048,877,1171,585.5,292.3333333,1.335233751
NM_001128635,RIMBP3B,1,0,5417,5417,NA,NA,5417,NA
NM_001128633,RIMBP3C,1,0,5794,5794,NA,NA,5794,NA
NM_152612,CCDC116,5,4,4532,2197,2335,583.75,439.4,1.062812927
NM_003347,UBE2L3,4,3,56489,3032,53457,17819,758,17.63093668
NM_001256355,UBE2L3,4,3,74589,3011,71578,23859.33333,752.75,23.77216871
NM_001256356,UBE2L3,3,2,56489,2935,53554,26777,978.3333333,18.24667802
NM_001017964,YDJC,5,4,1964,1343,621,155.25,268.6,0.462397617
NM_148176,PPIL2,21,20,31931,2731,29200,1460,130.047619,10.69205419
NM_148175,PPIL2,21,20,31931,2873,29058,1452.9,136.8095238,10.11416638
NM_013313,YPEL1,5,4,38247,4289,33958,8489.5,857.8,7.917463278
NM_014337,PPIL2,20,19,31931,4122,27809,1463.631579,206.1,6.74648229
NM_003935,TOP3B,18,17,25845,3224,22621,1330.647059,179.1111111,7.016439206
NM_001282113,TOP3B,18,17,25845,2901,22944,1349.647059,161.1666667,7.908996898
NM_001282112,TOP3B,18,17,25845,2908,22937,1349.235294,161.5555556,7.887551582
NM_007128,VPREB1,2,1,728,643,85,85,321.5,0.132192846
NM_206956,PRAME,6,5,11429,2188,9241,1848.2,364.6666667,4.223491773
NM_206955,PRAME,6,5,11429,2209,9220,1844,368.1666667,4.173834314
NM_206953,PRAME,5,4,11575,2764,8811,2202.75,552.8,3.187771346
NM_006115,PRAME,6,5,11575,2151,9424,1884.8,358.5,4.381218038
NM_080740,ZNF280A,2,1,6554,2149,4405,4405,1074.5,2.0497906
NM_080764,ZNF280B,4,3,24735,5732,19003,6334.333333,1433,3.315247732
NM_206954,PRAME,6,5,11575,2130,9445,1889,355,4.4342723
NM_199127,GGTLC2,5,4,1588,853,735,183.75,170.6,0.861664713
NM_001282879,GGTLC2,5,4,3279,983,2296,574,196.6,2.335707019
NM_001256296,IGLL5,2,1,8055,941,7114,7114,470.5,7.560042508
NM_001178126,IGLL5,3,2,8055,1061,6994,3497,353.6666667,6.591894439
NM_004914,RAB36,11,10,19020,3833,15187,1518.7,348.4545455,3.962170624
NM_016449,C22orf43,12,11,23871,1312,22559,2050.818182,109.3333333,17.19435976
NM_152855,IGLL1,2,1,7184,786,6398,6398,393,8.139949109
NM_020070,IGLL1,3,2,7184,903,6281,3140.5,301,6.955703212
NM_213720,CHCHD10,4,3,2122,686,1436,478.6666667,171.5,2.093294461
NM_153615,RGL4,11,10,8317,2896,5421,542.1,263.2727273,1.871892265
NM_013378,VPREB3,2,1,1702,587,1115,1115,293.5,1.899488927
NM_021916,ZNF70,2,1,9509,4019,5490,5490,2009.5,1.366011446
NM_182520,C22orf15,6,5,2844,870,1974,394.8,145,2.268965517
NM_198440,DERL3,6,5,4511,3206,1305,261,534.3333333,0.407049283
NM_001024939,SLC2A11,12,11,28261,2922,25339,2303.545455,243.5,8.671800137
NM_001024938,SLC2A11,12,11,29411,3034,26377,2397.909091,252.8333333,8.69380356
NM_001282864,SLC2A11,11,10,29114,3275,25839,2583.9,297.7272727,7.889770992
NM_001007468,SMARCB1,9,8,47557,1685,45872,5734,187.2222222,27.22373887
NM_003073,SMARCB1,9,8,47557,1712,45845,5730.625,190.2222222,26.7786215
NM_002415,MIF,3,2,846,564,282,141,188,0.5
NM_030807,SLC2A11,13,12,29411,3146,26265,2188.75,242,8.348696758
NM_001135751,DERL3,7,6,4511,1076,3435,572.5,153.7142857,3.192379182
NM_001002862,DERL3,7,6,4511,3106,1405,234.1666667,443.7142857,0.45235029
NM_001355,DDT,4,3,8467,675,7792,2597.333333,168.75,11.5437037
NM_000854,GSTT2,5,4,3794,1124,2670,667.5,224.8,2.37544484
NM_000854,GSTT2,5,4,3794,1124,2670,667.5,224.8,2.37544484
NM_001144931,LOC391322,2,1,928,565,363,363,282.5,0.642477876
NM_001084393,DDTL,3,2,5724,1638,4086,2043,546,2.494505495
NM_001084392,DDT,3,2,3128,623,2505,1252.5,207.6666667,4.020866774
NM_001080843,GSTT2B,5,4,3769,1099,2670,667.5,219.8,2.429481347
NM_001080843,GSTT2B,5,4,3769,1099,2670,667.5,219.8,2.429481347
NM_001099782,GGT5,11,10,25490,2409,23081,2308.1,219,9.581154006
NM_001099781,GGT5,12,11,25490,2509,22981,2089.181818,209.0833333,9.159426066
NM_004121,GGT5,12,11,25490,2506,22984,2089.454545,208.8333333,9.171588188
NM_019601,SUSD2,15,14,7632,3198,4434,316.7142857,213.2,1.386491557
NM_001278499,ADORA2A,3,2,14800,2552,12248,6124,850.6666667,4.799373041
NM_000675,ADORA2A,3,2,14800,2572,12228,6114,857.3333333,4.754276827
NM_001278498,ADORA2A,3,2,10243,2637,7606,3803,879,2.884338263
NM_001278497,ADORA2A,4,3,10243,2744,7499,2499.666667,686,2.73287172
NM_001278500,ADORA2A,3,2,18765,2419,16346,8173,806.3333333,6.757337743
NM_004175,SNRPD3,4,3,19316,3812,15504,5168,953,4.067156348
NM_001278656,SNRPD3,4,3,19316,3798,15518,5172.666667,949.5,4.08583465
NM_031444,GUCD1,6,5,14886,3628,11258,2251.6,604.6666667,3.1030871
NM_013430,GGT1,16,15,45256,2379,42877,2858.466667,148.6875,18.02311896
NM_001032365,GGT1,16,15,21348,2391,18957,1263.8,149.4375,7.928481807
NM_001032364,GGT1,16,15,25850,2374,23476,1565.066667,148.375,9.888795282
NM_207644,FAM211B,4,3,7446,1244,6202,2067.333333,311,4.985530547
NM_005265,GGT1,16,15,25850,2485,23365,1557.666667,155.3125,9.402414487
NM_001284253,GUCD1,6,5,15514,3458,12056,2411.2,576.3333333,3.486408329
NM_001284252,GUCD1,6,5,15514,3587,11927,2385.4,597.8333333,3.325062727
NM_001284254,GUCD1,6,5,14886,3625,11261,2252.2,604.1666667,3.106482759
NM_001284256,GUCD1,5,4,14886,3385,11501,2875.25,677,3.397636632
NM_001284255,GUCD1,6,5,14886,3496,11390,2278,582.6666667,3.258009153
NM_001284257,GUCD1,5,4,14886,3382,11504,2876,676.4,3.401537552
NM_001284251,GUCD1,6,5,15514,3590,11924,2384.8,598.3333333,3.321448468
NM_013421,GGT1,17,16,25850,2620,23230,1451.875,154.1176471,8.866412214
NM_001288833,GGT1,16,15,25850,2691,23159,1543.933333,168.1875,8.606094389
NM_001001663,TMEM211,3,2,4108,510,3598,1799,170,7.054901961
NM_000496,CRYBB2,6,5,12226,769,11457,2291.4,128.1666667,14.89856957
NM_004076,CRYBB3,6,5,7511,869,6642,1328.4,144.8333333,7.643268124
NM_001135772,LRP5L,6,5,30161,1670,28491,5698.2,278.3333333,17.06047904
NM_182492,LRP5L,4,3,11141,3609,7532,2510.666667,902.25,2.08700471
NM_020437,ASPHD2,4,3,15700,3317,12383,4127.666667,829.25,3.733192644
NM_001008566,TPST2,7,6,39658,2009,37649,6274.833333,287,18.74016924
NM_012143,TFIP11,15,14,20545,2864,17681,1262.928571,190.9333333,6.17353352
NM_001013694,SRRD,7,6,8056,1300,6756,1126,185.7142857,5.196923077
NM_003595,TPST2,7,6,64377,1901,62476,10412.66667,271.5714286,32.864808
NM_001008697,TFIP11,16,15,20545,2942,17603,1173.533333,183.875,5.983344663
NM_001886,CRYBA4,6,5,8710,817,7893,1578.6,136.1666667,9.660954712
NM_001079539,XBP1,6,5,6014,1800,4214,842.8,300,2.341111111
NM_001284263,CCDC117,4,3,16629,3941,12688,4229.333333,985.25,3.21948744
NM_172002,HSCB,6,5,15455,1094,14361,2872.2,182.3333333,13.12705667
NM_005080,XBP1,5,4,6014,1825,4189,1047.25,365,2.295342466
NM_173510,CCDC117,5,4,16629,3996,12633,3158.25,799.2,3.161411411
NM_001284264,CCDC117,4,3,16629,3770,12859,4286.333333,942.5,3.410875332
NM_001284265,CCDC117,5,4,16166,3722,12444,3111,744.4,3.343363783
NM_015370,C22orf31,3,2,3249,1073,2176,1088,357.6666667,2.027958993
NM_006478,GAS2L1,6,5,5795,2549,3246,649.2,424.8333333,1.273440565
NM_012265,RHBDD3,7,6,8072,1745,6327,1054.5,249.2857143,3.625787966
NM_006477,RASL10A,3,2,2825,1493,1332,666,497.6666667,0.892163429
NM_001278730,GAS2L1,6,5,5795,1841,3954,790.8,306.8333333,2.14774579
NM_013986,EWSR1,18,17,32519,2696,29823,1754.294118,149.7777778,11.06194362
NM_001163285,EWSR1,17,16,32519,2677,29842,1865.125,157.4705882,11.14755323
NM_152236,GAS2L1,6,5,5795,2554,3241,648.2,425.6666667,1.26898982
NM_001163287,EWSR1,9,8,22676,1582,21094,2636.75,175.7777778,13.33375474
NM_001163286,EWSR1,16,15,32519,2511,30008,2000.533333,156.9375,11.95061728
NM_005243,EWSR1,17,16,32519,2680,29839,1864.9375,157.6470588,11.13395522
NM_021026,RFPL1,2,1,3874,1498,2376,2376,749,1.58611482
NM_001202502,NIPSNAP1,10,9,26289,1945,24344,2704.888889,194.5,12.51619537
NM_003678,THOC5,20,19,45582,2450,43132,2270.105263,122.5,17.60489796
NM_003634,NIPSNAP1,10,9,26530,2246,24284,2698.222222,224.6,10.81211042
NM_001002879,THOC5,20,19,45490,2581,42909,2258.368421,129.05,16.62495157
NM_001002878,THOC5,21,20,45490,2698,42792,2139.6,128.4761905,15.86063751
NM_001002877,THOC5,21,20,45582,2567,43015,2150.75,122.2380952,16.75691469
NM_182527,CABP7,5,4,11478,2985,8493,2123.25,597,2.845226131
NM_001242906,ASCC2,19,18,49698,2614,47084,2615.777778,137.5789474,18.01224178
NM_032204,ASCC2,20,19,49698,2843,46855,2466.052632,142.15,16.48083011
NM_013387,UQCR10,2,1,3046,918,2128,2128,459,2.318082789
NM_001003684,UQCR10,2,1,3046,977,2069,2069,488.5,2.117707267
NM_002309,LIF,3,2,6406,3972,2434,1217,1324,0.612789527
NM_020530,OSM,3,2,4012,1856,2156,1078,618.6666667,1.161637931
NM_001257135,LIF,2,1,6406,3792,2614,2614,1896,0.689345992
NM_001204240,TBC1D10A,9,8,34978,2027,32951,4118.875,225.2222222,16.25604341
NM_001017981,RNF215,9,8,8501,1929,6572,821.5,214.3333333,3.406946604
NM_001005409,SF3A1,16,15,24938,4941,19997,1333.133333,308.8125,4.047156446
NM_031937,TBC1D10A,9,8,34978,2006,32972,4121.5,222.8888889,16.43668993
NM_005877,SF3A1,16,15,24938,5136,19802,1320.133333,321,3.855529595
NM_001037666,GATSL3,9,8,4511,1631,2880,360,181.2222222,1.76578786
NM_001017437,CCDC157,12,11,20193,3015,17178,1561.636364,251.25,5.697512438
NM_001161368,SEC14L4,12,11,16802,2161,14641,1331,180.0833333,6.775104118
NM_001257379,SEC14L3,13,12,12820,2145,10675,889.5833333,165,4.976689977
NM_016498,MTFP1,4,3,3432,1282,2150,716.6666667,320.5,1.677067083
NM_001257382,SEC14L3,13,12,12820,2215,10605,883.75,170.3846154,4.787810384
NM_001257378,SEC14L3,14,13,12820,2316,10504,808,165.4285714,4.535405872
NM_174977,SEC14L4,12,11,16802,2529,14273,1297.545455,210.75,5.643732701
NM_174975,SEC14L3,12,11,12820,2096,10724,974.9090909,174.6666667,5.116412214
NM_001003704,MTFP1,3,2,3432,1048,2384,1192,349.3333333,2.27480916
NM_001282328,PES1,17,16,30390,2757,27633,1727.0625,162.1764706,10.02285092
NM_001282327,PES1,17,16,30390,2710,27680,1730,159.4117647,10.21402214
NM_001243225,PES1,15,14,15317,2295,13022,930.1428571,153,5.674074074
NM_000355,TCN2,9,8,19979,2081,17898,2237.25,231.2222222,8.600672753
NM_152511,DUSP18,2,1,5835,2455,3380,3380,1227.5,1.376782077
NM_014303,PES1,15,14,15317,2310,13007,929.0714286,154,5.630735931
NM_001184726,TCN2,9,8,19979,2000,17979,2247.375,222.2222222,8.9895
NM_004861,GAL3ST1,4,3,10254,1795,8459,2819.666667,448.75,4.712534819
NM_001001479,SLC35E4,2,1,12071,2544,9527,9527,1272,3.744889937
NM_001282741,OSBP2,13,12,85310,3593,81717,6809.75,276.3846154,22.74338992
NM_001282742,OSBP2,12,11,26145,3260,22885,2080.454545,271.6666667,7.01993865
NM_015715,PLA2G3,7,6,5678,2582,3096,516,368.8571429,1.199070488
NM_006932,SMTN,20,19,23330,3173,20157,1060.894737,158.65,6.352663095
NM_001284287,INPP5J,12,11,11776,2319,9457,859.7272727,193.25,4.078050884
NM_134270,SMTN,21,20,23330,3243,20087,1004.35,154.4285714,6.193956213
NM_134269,SMTN,21,20,23330,3339,19991,999.55,159,5.987121893
NM_001207018,SMTN,20,19,19630,3342,16288,857.2631579,167.1,4.873728306
NM_001207017,SMTN,21,20,21766,3249,18517,925.85,154.7142857,5.69929209
NM_080430,SELM,5,4,2790,696,2094,523.5,139.2,3.00862069
NM_001284285,INPP5J,13,12,11776,3404,8372,697.6666667,261.8461538,2.459459459
NM_001284289,INPP5J,15,14,11776,2602,9174,655.2857143,173.4666667,3.525749424
NM_001284288,INPP5J,14,13,11776,2479,9297,715.1538462,177.0714286,3.750302541
NM_001284286,INPP5J,14,13,11776,3527,8249,634.5384615,251.9285714,2.338814857
NM_001002837,INPP5J,13,12,11776,2300,9476,789.6666667,176.9230769,4.12
NM_001031801,LIMK2,15,14,29278,2929,26349,1882.071429,195.2666667,8.995903039
NM_005569,LIMK2,16,15,67818,3717,64101,4273.4,232.3125,17.24535916
NM_016733,LIMK2,15,14,31720,3863,27857,1989.785714,257.5333333,7.211234792
NM_001135911,PIK3IP1,5,4,10943,2399,8544,2136,479.8,3.561483952
NM_052880,PIK3IP1,6,5,10943,2479,8464,1692.8,413.1666667,3.414279952
NM_032052,PATZ1,5,4,20461,3752,16709,4177.25,750.4,4.453358209
NM_032051,PATZ1,3,2,5586,3004,2582,1291,1001.333333,0.859520639
NM_032050,PATZ1,4,3,20461,3678,16783,5594.333333,919.5,4.56307776
NM_014323,PATZ1,5,4,20461,3817,16644,4161,763.4,4.360492533
NM_004147,DRG1,9,8,34635,1459,33176,4147,162.1111111,22.73886223
NM_014338,PISD,9,8,12335,2688,9647,1205.875,298.6666667,3.58891369
NM_001007188,DEPDC5,22,21,61970,2466,59504,2833.52381,112.0909091,24.1297648
NM_015372,C22orf24,3,2,11831,1250,10581,5290.5,416.6666667,8.4648
NM_003405,YWHAH,2,1,13113,1795,11318,11318,897.5,6.305292479
NM_001159546,RFPL2,4,3,12117,1485,10632,3544,371.25,7.15959596
NM_001159545,RFPL2,4,3,14298,1456,12842,4280.666667,364,8.820054945
NM_001010859,C22orf42,9,8,9726,814,8912,1114,90.44444444,10.94840295
NM_006605,RFPL2,2,1,3046,1498,1548,1548,749,1.033377837
NM_001098527,RFPL2,5,4,13044,2415,10629,2657.25,483,4.401242236
NM_006604,RFPL3,3,2,6278,1217,5061,2530.5,405.6666667,4.158586689
NM_001098535,RFPL3,2,1,3296,1490,1806,1806,745,1.212080537
NM_012179,FBXO7,9,8,24113,2162,21951,2743.875,240.2222222,10.15309898
NM_014306,RTCB,12,11,24714,2078,22636,2057.818182,173.1666667,10.89316651
NM_001033024,FBXO7,9,8,23596,1767,21829,2728.625,196.3333333,12.35370685
NM_001257990,FBXO7,9,8,23596,1919,21677,2709.625,213.2222222,11.29598749
NM_174932,BPIFC,15,14,43541,1995,41546,2967.571429,133,20.82506266
NM_000362,TIMP3,5,4,62228,5491,56737,14184.25,1098.2,10.33272628
NM_001008494,ISX,4,3,21252,3387,17865,5955,846.75,5.274579274
NM_001135729,TOM1,15,14,48721,2334,46387,3313.357143,155.6,19.87446444
NM_001135730,TOM1,14,13,48192,2268,45924,3532.615385,162,20.24867725
NM_001135732,TOM1,15,14,48192,2407,45785,3270.357143,160.4666667,19.02160366
NM_005488,TOM1,15,14,48192,2404,45788,3270.571429,160.2666667,19.04658902
NM_001003681,HMGXB4,11,10,38357,4147,34210,3421,377,8.24933687
NM_006739,MCM5,17,16,24381,2563,21818,1363.625,150.7647059,8.512680453
NM_203378,MB,4,3,10746,1157,9589,3196.333333,289.25,8.28781331
NM_203377,MB,4,3,16592,1174,15418,5139.333333,293.5,13.13287905
NM_014310,RASD2,3,2,12695,2975,9720,4860,991.6666667,3.267226891
NM_005368,MB,3,2,10575,1081,9494,4747,360.3333333,8.782608696
NM_030642,APOL5,5,4,11612,1442,10170,2542.5,288.4,7.052704577
NM_145642,APOL3,4,3,25856,3574,22282,7427.333333,893.5,6.234471181
NM_145641,APOL3,5,4,25856,3638,22218,5554.5,727.6,6.107201759
NM_145640,APOL3,3,2,20608,2127,18481,9240.5,709,8.688763517
NM_030882,APOL2,5,4,13436,2550,10886,2721.5,510,4.269019608
NM_145660,APOL4,5,4,15705,3231,12474,3118.5,646.2,3.860724234
NM_145637,APOL2,6,5,13747,2692,11055,2211,448.6666667,4.106612184
NM_145343,APOL1,7,6,14462,3024,11438,1906.333333,432,3.782407407
NM_003661,APOL1,6,5,14462,2869,11593,2318.6,478.1666667,4.04078076
NM_030643,APOL4,6,5,15705,3421,12284,2456.8,570.1666667,3.590762935
NM_001136541,APOL1,5,4,14462,2814,11648,2912,562.8,4.139303483
NM_001136540,APOL1,6,5,14462,2908,11554,2310.8,484.6666667,3.973177442
NM_024955,FOXRED2,9,8,19859,5019,14840,1855,557.6666667,2.956764296
NM_001102371,FOXRED2,9,8,19917,4980,14937,1867.125,553.3333333,2.99939759
NM_012473,TXN2,4,3,14596,1340,13256,4418.666667,335,9.892537313
NM_003753,EIF3D,15,14,18382,1964,16418,1172.714286,130.9333333,8.359470468
NM_002854,PVALB,5,4,18774,577,18197,4549.25,115.4,31.5372617
NM_006860,IFT27,7,6,17933,1100,16833,2805.5,157.1428571,15.30272727
NM_001177701,IFT27,7,6,17933,1103,16830,2805,157.5714286,15.25838622
NM_013416,NCF4,9,8,17031,1652,15379,1922.375,183.5555556,9.309322034
NM_000631,NCF4,10,9,17031,1408,15623,1735.888889,140.8,11.09588068
NM_000395,CSF2RB,14,13,26806,4860,21946,1688.153846,347.1428571,4.51563786
NM_024681,KCTD17,8,7,11656,1702,9954,1422,212.75,5.848413631
NM_001282686,KCTD17,6,5,11656,1509,10147,2029.4,251.5,6.724320742
NM_021126,MPST,3,2,10074,1352,8722,4361,450.6666667,6.451183432
NM_001013436,MPST,3,2,10182,1362,8820,4410,454,6.475770925
NM_001270483,TST,3,2,9326,1108,8218,4109,369.3333333,7.416967509
NM_003312,TST,3,2,8596,1140,7456,3728,380,6.540350877
NM_178552,TEX33,6,5,16719,1036,15683,3136.6,172.6666667,15.13803089
NM_001130517,MPST,4,3,10182,1539,8643,2881,384.75,5.615984405
NM_001163857,TEX33,6,5,16719,1055,15664,3132.8,175.8333333,14.84739336
NM_001282684,KCTD17,9,8,11656,1775,9881,1235.125,197.2222222,5.566760563
NM_001282685,KCTD17,7,6,11656,1601,10055,1675.833333,228.7142857,6.280449719
NM_001278687,SSTR3,2,1,6730,4025,2705,2705,2012.5,0.672049689
NM_031910,C1QTNF6,3,2,8126,2939,5187,2593.5,979.6666667,1.764886016
NM_000878,IL2RB,10,9,24084,4053,20031,2225.666667,405.3,4.942264989
NM_001051,SSTR3,2,1,8141,4156,3985,3985,2078,0.958854668
NM_182486,C1QTNF6,4,3,8126,1656,6470,2156.666667,414,3.907004831
NM_013385,CYTH4,13,12,32896,3151,29745,2478.75,242.3846154,9.439860362
NM_002872,RAC2,7,6,19040,1518,17522,2920.333333,216.8571429,11.5428195
NM_052906,ELFN2,3,2,59507,8364,51143,25571.5,2788,6.114658058
NM_014550,CARD10,20,19,28812,3919,24893,1310.157895,195.95,6.351875478
NM_006498,LGALS2,4,3,9773,532,9241,3080.333333,133,17.37030075
NM_152243,CDC42EP1,3,2,8941,2165,6776,3388,721.6666667,3.129792148
NM_024313,NOL12,6,5,7143,2846,4297,859.4,474.3333333,1.50983837
NM_002305,LGALS1,4,3,4198,562,3636,1212,140.5,6.46975089
NM_018957,SH3BP1,18,17,16368,2594,13774,810.2352941,144.1111111,5.309946029
NM_020315,PDXP,2,1,8204,2007,6197,6197,1003.5,3.087693074
NM_007032,TRIOBP,14,13,30324,4753,25571,1967,339.5,5.379970545
NM_003614,GALR3,2,1,2115,1159,956,956,579.5,0.824849008
NM_001171690,GCAT,10,9,9273,1666,7607,845.2222222,166.6,4.566026411
NM_014291,GCAT,9,8,8996,1513,7483,935.375,168.1111111,4.94580304
NM_138632,TRIOBP,8,7,13724,1737,11987,1712.428571,217.125,6.900978699
NM_138797,ANKRD54,8,7,13493,2107,11386,1626.571429,263.375,5.403891789
NM_005318,H1F0,1,0,2331,2331,NA,NA,2331,NA
NM_006941,SOX10,4,3,12222,2866,9356,3118.666667,716.5,3.264480112
NM_001207062,C22orf23,6,5,10621,1783,8838,1767.6,297.1666667,4.956814358
NM_021974,POLR2F,5,4,15647,2107,13540,3385,421.4,6.426198386
NM_033386,MICALL1,16,15,36312,4511,31801,2120.066667,281.9375,7.049656395
NM_032561,C22orf23,7,6,10599,1995,8604,1434,285,4.312781955
NM_012407,PICK1,13,12,18448,2220,16228,1352.333333,170.7692308,7.30990991
NM_013356,SLC16A8,5,4,5028,1901,3127,781.75,380.2,1.644923724
NM_001039583,PICK1,13,12,18448,2122,16326,1360.5,163.2307692,7.693685203
NM_001039584,PICK1,13,12,18448,2069,16379,1364.916667,159.1538462,7.916384727
NM_025045,BAIAP2L2,14,13,25782,2159,23623,1817.153846,154.2142857,10.94163965
NM_001161574,MAFF,2,1,14580,2374,12206,12206,1187,5.141533277
NM_001161572,MAFF,3,2,14580,2468,12112,6056,822.6666667,4.907617504
NM_001161573,MAFF,3,2,13492,2226,11266,5633,742,5.061096137
NM_012323,MAFF,3,2,14580,2442,12138,6069,814,4.970515971
NM_152221,CSNK1E,11,10,26718,2803,23915,2391.5,254.8181818,8.531930075
NM_001894,CSNK1E,11,10,27394,2653,24741,2474.1,241.1818182,9.325669054
NM_001289912,CSNK1E,15,14,107832,3012,104820,7487.142857,200.8,34.80079681
NM_006855,KDELR3,5,4,15387,1733,13654,3413.5,346.6,7.878822851
NM_006386,DDX17,13,12,22904,4803,18101,1508.416667,369.4615385,3.768686238
NM_152868,KCNJ4,2,1,28874,2066,26808,26808,1033,12.97579864
NM_016657,KDELR3,4,3,13572,948,12624,4208,237,13.3164557
NM_001098504,DDX17,13,12,22904,4809,18095,1507.916667,369.9230769,3.762736536
NM_004981,KCNJ4,2,1,17702,1904,15798,15798,952,8.297268908
NM_001013647,FAM227A,17,16,78511,10339,68172,4260.75,608.1764706,6.593674437
NM_015374,SUN2,18,17,21307,4019,17288,1016.941176,223.2777778,4.301567554
NM_014876,JOSD1,4,3,14913,3439,11474,3824.666667,859.75,3.33643501
NM_001199579,SUN2,18,17,21307,4082,17225,1013.235294,226.7777778,4.219745223
NM_001199580,SUN2,19,18,20750,4019,16731,929.5,211.5263158,4.162975865
NM_005740,DNAL4,4,3,15650,1491,14159,4719.666667,372.75,9.496311201
NM_020243,TOMM22,4,3,2814,1383,1431,477,345.75,1.034707158
NM_004286,GTPBP1,12,11,27787,5059,22728,2066.181818,421.5833333,4.492587468
NM_014293,NPTXR,5,4,25563,5820,19743,4935.75,1164,3.392268041
NM_014292,CBX6,5,4,8012,3273,4739,1184.75,654.6,1.447907119
NM_001193289,APOBEC3A_B,5,4,35258,1108,34150,8537.5,221.6,30.82129964
NM_001270411,APOBEC3B,8,7,10382,1471,8911,1273,183.875,6.057783821
NM_014508,APOBEC3C,4,3,4562,1113,3449,1149.666667,278.25,3.098831986
NM_152426,APOBEC3D,7,6,12140,2510,9630,1605,358.5714286,3.836653386
NM_145298,APOBEC3F,7,6,15304,4697,10607,1767.833333,671,2.258249947
NM_001270406,APOBEC3A,5,4,5663,1395,4268,1067,279,3.059498208
NM_004900,APOBEC3B,8,7,10382,1546,8836,1262.285714,193.25,5.715394567
NM_001006666,APOBEC3F,3,2,3757,808,2949,1474.5,269.3333333,3.649752475
NM_145699,APOBEC3A,5,4,5663,1449,4214,1053.5,289.8,2.90821256
NM_001166004,APOBEC3H,4,3,5383,643,4740,1580,160.75,7.371695179
NM_001166003,APOBEC3H,6,5,6845,1149,5696,1139.2,191.5,4.957354221
NM_001166002,APOBEC3H,5,4,6845,1051,5794,1448.5,210.2,5.51284491
NM_181773,APOBEC3H,5,4,6845,1054,5791,1447.75,210.8,5.4943074
NM_021822,APOBEC3G,8,7,10740,1842,8898,1271.142857,230.25,4.830618893
NM_175709,CBX7,6,5,21761,3968,17793,3558.6,661.3333333,4.484122984
NM_033016,PDGFB,7,6,17231,2387,14844,2474,341,6.218684541
NM_002608,PDGFB,7,6,21274,3384,17890,2981.666667,483.4285714,5.286643026
NM_145738,SYNGR1,4,3,14221,1307,12914,4304.666667,326.75,9.880642693
NM_145731,SYNGR1,4,3,28442,1341,27101,9033.666667,335.25,20.20954512
NM_006116,TAB1,11,10,32130,3235,28895,2889.5,294.0909091,8.931993818
NM_004711,SYNGR1,4,3,35641,4442,31199,10399.66667,1110.5,7.023638001
NM_153497,TAB1,11,10,37375,2005,35370,3537,182.2727273,17.64089776
NM_001675,ATF4,2,1,2129,2029,100,100,1014.5,0.049285362
NM_194326,RPS19BP1,4,3,3764,931,2833,944.3333333,232.75,3.042964554
NM_002409,MGAT3,2,1,34876,5088,29788,29788,2544,5.854559748
NM_019008,MIEF1,6,5,15855,5705,10150,2030,950.8333333,1.779141104
NM_001098270,MGAT3,1,0,4972,4972,NA,NA,4972,NA
NM_182810,ATF4,3,2,2124,1423,701,350.5,474.3333333,0.492621223
NM_004810,GRAP2,8,7,70300,1560,68740,9820,195,44.06410256
NM_138435,FAM83F,5,4,35092,2076,33016,8254,415.2,15.90366089
NM_000026,ADSL,13,12,20073,1576,18497,1541.416667,121.2307692,11.73667513
NM_001123378,ADSL,12,11,20073,1398,18675,1697.727273,116.5,13.3583691
NM_015705,SGSM3,22,21,39700,3011,36689,1747.095238,136.8636364,12.18498838
NM_001282660,MKL1,12,11,53161,4130,49031,4457.363636,344.1666667,11.87191283
NM_005297,MCHR1,2,1,3638,2425,1213,1213,1212.5,0.500206186
NM_001278589,ST13,12,11,32475,3563,28912,2628.363636,296.9166667,8.114510244
NM_001204827,XPNPEP3,3,2,5702,1448,4254,2127,482.6666667,2.937845304
NM_145174,DNAJB7,1,0,2578,2578,NA,NA,2578,NA
NM_006358,SLC25A17,9,8,49771,2288,47483,5935.375,254.2222222,20.75305944
NM_003932,ST13,12,11,32475,3593,28882,2625.636364,299.4166667,8.038408016
NM_001282726,SLC25A17,10,9,49771,2342,47429,5269.888889,234.2,20.25149445
NM_001282727,SLC25A17,7,6,49771,2067,47704,7950.666667,295.2857143,23.07885825
NM_014248,RBX1,5,4,21670,911,20759,5189.75,182.2,22.7870472
NM_031488,L3MBTL2,17,16,25964,3209,22755,1422.1875,188.7647059,7.090994079
NM_138481,CHADL,6,5,11423,2539,8884,1776.8,423.1666667,3.49901536
NM_003216,TEF,4,3,17401,4400,13001,4333.666667,1100,2.954772727
NM_017590,ZC3H7B,23,22,58646,5951,52695,2395.227273,258.7391304,8.854814317
NM_001145398,TEF,4,3,31997,4394,27603,9201,1098.5,6.281975421
NM_016272,TOB2,2,1,13537,4567,8970,8970,2283.5,1.964090212
NM_138338,POLR3H,7,6,18689,4185,14504,2417.333333,597.8571429,3.465710872
NM_001282885,POLR3H,7,6,18689,4178,14511,2418.5,596.8571429,3.473192915
NM_001282884,POLR3H,7,6,18806,4219,14587,2431.166667,602.7142857,3.457454373
NM_032758,PHF5A,4,3,8989,1069,7920,2640,267.25,7.408793265
NM_001098,ACO2,18,17,59866,2759,57107,3359.235294,153.2777778,20.69844146
NM_001018052,POLR3H,5,4,18689,4402,14287,3571.75,880.4,3.245570195
NM_001018050,POLR3H,6,5,18689,4490,14199,2839.8,748.3333333,3.162360802
NM_015704,DESI1,6,5,23031,3800,19231,3846.2,633.3333333,5.060789474
NM_014460,CSDC2,4,3,15658,2534,13124,4374.666667,633.5,5.179163378
NM_002676,PMM1,8,7,12983,1291,11692,1670.285714,161.375,9.056545314
NM_001288978,XRCC6,12,11,42887,2160,40727,3702.454545,180,18.85509259
NM_001288976,XRCC6,13,12,42708,2160,40548,3379,166.1538462,18.77222222
NM_001288977,XRCC6,13,12,42887,2151,40736,3394.666667,165.4615385,18.93816829
NM_001469,XRCC6,13,12,42887,2274,40613,3384.416667,174.9230769,17.85971856
NM_152513,MEI1,31,30,99943,4037,95906,3196.866667,130.2258065,23.75675006
NM_001142964,C22orf46,2,1,7595,4977,2618,2618,2488.5,0.526019691
NM_052945,TNFRSF13C,3,2,1787,937,850,425,312.3333333,0.90715048
NM_001207020,SHISA8,4,3,5115,1409,3706,1235.333333,352.25,2.630234209
NM_001110215,CENPM,2,1,1484,543,941,941,271.5,1.732965009
NM_004599,SREBF2,19,18,74231,5285,68946,3830.333333,278.1578947,13.04560076
NM_000262,NAGA,9,8,12510,3735,8775,1096.875,415,2.34939759
NM_145733,Sep-03,11,10,21296,2480,18816,1881.6,225.4545455,7.587096774
NM_019106,Sep-03,10,9,21296,4666,16630,1847.777778,466.6,3.564080583
NM_152613,WBP2NL,6,5,29750,2322,27428,5485.6,387,11.81223084
NM_033318,SMDT1,3,2,4595,1574,3021,1510.5,524.6666667,1.91931385
NM_000106,CYP2D6,9,8,4384,1668,2716,339.5,185.3333333,1.628297362
NM_002490,NDUFA6,3,2,5360,1187,4173,2086.5,395.6666667,3.51558551
NM_001025161,CYP2D6,8,7,4384,1514,2870,410,189.25,1.895640687
NM_001002034,FAM109B,3,2,5189,2335,2854,1427,778.3333333,1.222269807
NM_145912,NFAM1,6,5,51989,5610,46379,9275.8,935,8.267201426
NM_015703,RRP7A,7,6,11490,5462,6028,1004.666667,780.2857143,1.103625046
NM_001284334,SERHL2,10,9,20522,1249,19273,2141.444444,124.9,15.4307446
NM_014509,SERHL2,12,11,20522,1443,19079,1734.454545,120.25,13.22176022
NM_001171661,CYB5R3,10,9,29151,2993,26158,2906.444444,299.3,8.739726027
NM_007326,CYB5R3,9,8,29151,2931,26220,3277.5,325.6666667,8.945752303
NM_017436,A4GALT,3,2,28751,2095,26656,13328,698.3333333,12.72362768
NM_000398,CYB5R3,9,8,31561,2932,28629,3578.625,325.7777778,9.764324693
NM_001129819,CYB5R3,9,8,29151,3176,25975,3246.875,352.8888889,8.178526448
NM_001171660,CYB5R3,9,8,26796,3072,23724,2965.5,341.3333333,7.72265625
NM_001165877,ATP5L2,1,0,800,800,NA,NA,800,NA
NM_014570,ARFGAP3,16,15,60878,2849,58029,3868.6,178.0625,20.36819937
NM_001142293,ARFGAP3,15,14,60878,2716,58162,4154.428571,181.0666667,21.41458027
NM_001184971,PACSIN2,10,9,90117,3099,87018,9668.666667,309.9,28.07938045
NM_007229,PACSIN2,11,10,77277,3285,73992,7399.2,298.6363636,22.52420091
NM_012263,TTLL1,11,10,49913,1783,48130,4813,162.0909091,26.99383062
NM_001256531,TSPO,4,3,11311,989,10322,3440.666667,247.25,10.43680485
NM_001256530,TSPO,4,3,11309,1080,10229,3409.666667,270,9.471296296
NM_173467,MCAT,4,3,11193,2063,9130,3043.333333,515.75,4.425593795
NM_014507,MCAT,3,2,11193,1844,9349,4674.5,614.6666667,5.069956616
NM_015140,TTLL12,14,13,20511,3397,17114,1316.461538,242.6428571,5.037974684
NM_000714,TSPO,4,3,11730,885,10845,3615,221.25,12.25423729
NM_001044370,MPPED1,7,6,94782,2515,92267,15377.83333,359.2857143,36.68667992
NM_138814,PNPLA5,9,8,12337,2549,9788,1223.5,283.2222222,3.83993723
NM_001177675,PNPLA5,7,6,12337,2205,10132,1688.666667,315,4.595011338
NM_014351,SULT4A1,7,6,37993,2472,35521,5920.166667,353.1428571,14.36933657
NM_025225,PNPLA3,9,8,23831,2814,21017,2627.125,312.6666667,7.46872779
NM_015380,SAMM50,15,14,41153,1771,39382,2813,118.0666667,22.23715415
NM_001137605,PARVG,14,13,35515,3477,32038,2464.461538,248.3571429,9.214265171
NM_022141,PARVG,14,13,27581,3537,24044,1849.538462,252.6428571,6.797851286
NM_032287,LDOC1L,2,1,5557,5326,231,231,2663,0.043372137
NM_181333,PRR5,8,7,35485,1886,33599,4799.857143,235.75,17.81495228
NM_015264,KIAA0930,10,9,20226,6297,13929,1547.666667,629.7,2.212005717
NM_153645,NUP50,9,8,23340,5058,18282,2285.25,562,3.614472123
NM_007172,NUP50,8,7,24166,5231,18935,2705,653.875,3.619766775
NM_001167574,UPK3A,4,3,10889,687,10202,3400.666667,171.75,14.85007278
NM_006953,UPK3A,6,5,10889,1052,9837,1967.4,175.3333333,9.350760456
NM_017911,FAM118A,9,8,32053,2922,29131,3641.375,324.6666667,9.96954141
NM_001104595,FAM118A,10,9,32757,3250,29507,3278.555556,325,9.079076923
NM_015653,RIBC2,7,6,18732,1411,17321,2886.833333,201.5714286,12.275691
NM_006485,FBLN1,15,14,62864,2677,60187,4299.071429,178.4666667,22.48300336
NM_006487,FBLN1,15,14,55874,2500,53374,3812.428571,166.6666667,21.3496
NM_006486,FBLN1,17,16,98297,2964,95333,5958.3125,174.3529412,32.16363023
NM_001996,FBLN1,15,14,60525,2310,58215,4158.214286,154,25.2012987
NM_058238,WNT7B,4,3,56762,3916,52846,17615.33333,979,13.49489275
NM_018280,C22orf26,2,1,3687,1838,1849,1849,919,1.005984766
NM_006071,PKDREJ,1,0,7661,7661,NA,NA,7661,NA
NM_005036,PPARA,9,8,93156,10058,83098,10387.25,1117.555556,8.26188109
NM_207327,CDPF1,4,3,6285,1496,4789,1596.333333,374,3.201203209
NM_001001928,PPARA,8,7,93156,9973,83183,11883.28571,1246.625,8.340820215
NM_016426,GTSE1,12,11,34071,3124,30947,2813.363636,260.3333333,9.906209987
NM_001282785,TRMU,10,9,21941,1891,20050,2227.777778,189.1,10.60285563
NM_001282784,TRMU,9,8,21941,1724,20217,2527.125,191.5555556,11.72679814
NM_001282783,TRMU,10,9,21941,1808,20133,2237,180.8,11.13550885
NM_017931,TTC38,14,13,26046,2624,23422,1801.692308,187.4285714,8.926067073
NM_018006,TRMU,11,10,21941,1975,19966,1996.6,179.5454545,10.10936709
NM_001282782,TRMU,10,9,21941,1867,20074,2230.444444,186.7,10.75200857
NM_022766,CERK,13,12,53847,4458,49389,4115.75,342.9230769,11.07873486
NM_001039473,C22orf34,4,3,37902,1475,36427,12142.33333,368.75,24.69627119
NM_001289922,C22orf34,6,5,37088,1725,35363,7072.6,287.5,20.50028986
NM_024324,CRELD2,10,9,8912,1445,7467,829.6666667,144.5,5.167474048
NM_001284318,CRELD2,9,8,8912,1348,7564,945.5,149.7777778,5.611275964
NM_001284317,CRELD2,9,8,8912,1360,7552,944,151.1111111,5.552941176
NM_024105,ALG12,10,9,15254,2383,12871,1430.111111,238.3,5.40117499
NM_001135101,CRELD2,11,10,8912,1593,7319,731.9,144.8181818,4.594475832
NM_014838,ZBED4,2,1,36231,6888,29343,29343,3444,4.260017422
NM_001001694,IL17REL,15,14,18115,3650,14465,1033.214286,243.3333333,3.963013699
NM_001001852,PIM3,6,5,3579,2385,1194,238.8,397.5,0.500628931
NM_015166,MLC1,12,11,26540,3972,22568,2051.636364,331,5.681772407
NM_139202,MLC1,12,11,25963,3611,22352,2032,300.9166667,6.189975076
NM_031454,SELO,9,8,16639,2324,14315,1789.375,258.2222222,6.159638554
NM_001160300,PANX2,4,3,9566,2971,6595,2198.333333,742.75,2.219791316
NM_001159286,HDAC10,19,18,6223,2665,3558,197.6666667,140.2631579,1.335084428
NM_025204,TRABD,10,9,13669,2325,11344,1260.444444,232.5,4.879139785
NM_032019,HDAC10,20,19,6223,2726,3497,184.0526316,136.3,1.282831988
NM_052839,PANX2,3,2,9566,3055,6511,3255.5,1018.333333,2.131260229
NM_002969,MAPK12,12,11,8760,1766,6994,635.8181818,147.1666667,3.960362401
NM_002751,MAPK11,12,11,6639,2400,4239,385.3636364,200,1.76625
NM_020461,TUBGCP6,25,24,27284,6044,21240,885,241.76,3.514228987
NM_001001794,DENND6B,20,19,15099,2026,13073,688.0526316,101.3,6.452615992
NM_001014440,ODF3B,7,6,2172,977,1195,199.1666667,139.5714286,1.223132037
NM_024866,ADM2,2,1,4883,4275,608,608,2137.5,0.142222222
NM_001169111,SCO2,2,1,2038,1022,1016,1016,511,0.994129159
NM_001169110,SCO2,2,1,2579,1004,1575,1575,502,1.5687251
NM_001169109,SCO2,2,1,2873,1053,1820,1820,526.5,1.728395062
NM_001953,TYMP,10,9,4335,1669,2666,296.2222222,166.9,1.597363691
NM_014551,NCAPH2,9,8,11548,1434,10114,1264.25,159.3333333,7.052998605
NM_001113756,TYMP,9,8,4335,1852,2483,310.375,205.7777778,1.340712743
NM_001113755,TYMP,10,9,4335,1681,2654,294.8888889,168.1,1.57882213
NM_152299,NCAPH2,20,19,16566,3365,13201,694.7894737,168.25,3.923031204
NM_001253845,ADM2,3,2,4715,4035,680,340,1345,0.168525403
NM_002972,SBF1,41,40,30035,8058,21977,549.425,196.5365854,2.7273517
NM_033200,LMF2,14,13,4761,2613,2148,165.2307692,186.6428571,0.822043628
NM_017584,MIOX,10,9,3539,1447,2092,232.4444444,144.7,1.445749827
NM_001257989,TYMP,10,9,4335,1684,2651,294.5555556,168.4,1.574228029
NM_001257988,TYMP,10,9,4335,1704,2631,292.3333333,170.4,1.544014085
NM_001185011,NCAPH2,20,19,16566,3368,13198,694.6315789,168.4,3.918646081
NM_005138,SCO2,2,1,2039,993,1046,1046,496.5,1.053373615
NM_001085426,ARSA,9,8,5421,4171,1250,156.25,463.4444444,0.299688324
NM_001085425,ARSA,9,8,5421,4219,1202,150.25,468.7777778,0.284901635
NM_001145137,CPT1B,19,18,9218,2723,6495,360.8333333,143.3157895,2.385236871
NM_000487,ARSA,8,7,5421,4323,1098,156.8571429,540.375,0.253990285
NM_152246,CPT1B,20,19,9606,2661,6945,365.5263158,133.05,2.609921082
NM_152245,CPT1B,19,18,9808,2953,6855,380.8333333,155.4210526,2.3213681
NM_012324,MAPK8IP2,12,11,10850,3375,7475,679.5454545,281.25,2.214814815
NM_016431,MAPK8IP2,10,9,8419,3175,5244,582.6666667,317.5,1.651653543
NM_001145136,CPT1B,20,19,9808,2457,7351,386.8947368,122.85,2.991859992
NM_001145135,CPT1B,20,19,9808,2700,7108,374.1052632,135,2.632592593
NM_001085428,ARSA,8,7,5421,3933,1488,212.5714286,491.625,0.378337147
NM_001085427,ARSA,9,8,5421,4126,1295,161.875,458.4444444,0.313863306
NM_001145134,CPT1B,19,18,9808,2597,7211,400.6111111,136.6842105,2.776665383
NM_001123225,SYCE3,3,2,11789,445,11344,5672,148.3333333,25.49213483
NM_005198,CHKB,11,10,4043,1640,2403,240.3,149.0909091,1.465243902
NM_004377,CPT1B,19,18,9606,2914,6692,371.7777778,153.3684211,2.296499657
NM_007081,RABL2B,9,8,16169,2192,13977,1747.125,243.5555556,6.376368613
NM_001130923,RABL2B,10,9,16169,2382,13787,1531.888889,238.2,5.787993283
NM_001130922,RABL2B,9,8,16169,2196,13973,1746.625,244,6.362932605
NM_001130921,RABL2B,10,9,16169,2448,13721,1524.555556,244.8,5.60498366
NM_001130920,RABL2B,10,9,16169,2355,13814,1534.888889,235.5,5.86581741
NM_001130919,RABL2B,9,8,16169,2195,13974,1746.75,243.8888889,6.366287016
NM_001097,ACR,5,4,7077,1375,5702,1425.5,275,4.146909091
NM_001003789,RABL2B,9,8,16169,2199,13970,1746.25,244.3333333,6.352887676